,filename,width,height,class,xmin,xmax,ymin,ymax,area,mj_axis,mn_axis
0,/media/marda/TWOTB1/xBD/hurricanes/images/florence/hurricane-florence_00000318_pre_disaster.png,48,9,1,877,925,0,9,75,12.626808678328057,8.084562266773856
1,/media/marda/TWOTB1/xBD/hurricanes/images/florence/hurricane-florence_00000318_pre_disaster.png,70,13,1,912,982,0,13,226,30.65887055712172,11.354964316260743
2,/media/marda/TWOTB1/xBD/hurricanes/images/florence/hurricane-florence_00000318_pre_disaster.png,58,22,1,939,997,0,22,226,26.627132182167397,11.353543524236708
3,/media/marda/TWOTB1/xBD/hurricanes/images/florence/hurricane-florence_00000318_pre_disaster.png,53,15,1,886,939,17,32,141,16.00304718303215,11.63074990875532
4,/media/marda/TWOTB1/xBD/hurricanes/images/florence/hurricane-florence_00000318_pre_disaster.png,81,53,1,917,998,54,107,1200,54.19701921269556,29.357495685142393
5,/media/marda/TWOTB1/xBD/hurricanes/images/florence/hurricane-florence_00000318_pre_disaster.png,62,34,1,856,918,101,135,413,28.53935036306481,19.79945837165386
6,/media/marda/TWOTB1/xBD/hurricanes/images/florence/hurricane-florence_00000318_pre_disaster.png,52,19,1,888,940,127,146,118,13.33345046682098,11.911343987895908
7,/media/marda/TWOTB1/xBD/hurricanes/images/florence/hurricane-florence_00000318_pre_disaster.png,77,40,1,906,983,148,188,916,44.27489178781147,26.948091628608164
8,/media/marda/TWOTB1/xBD/hurricanes/images/florence/hurricane-florence_00000318_pre_disaster.png,47,19,1,848,895,155,174,118,13.294496451916368,11.911087385271678
9,/media/marda/TWOTB1/xBD/hurricanes/images/florence/hurricane-florence_00000318_pre_disaster.png,50,29,1,804,854,190,219,329,26.519458283190474,17.06563721504965
10,/media/marda/TWOTB1/xBD/hurricanes/images/florence/hurricane-florence_00000318_pre_disaster.png,82,64,1,858,940,192,256,1444,57.22150561975359,38.02600104727055
11,/media/marda/TWOTB1/xBD/hurricanes/images/florence/hurricane-florence_00000318_pre_disaster.png,79,61,1,903,982,361,422,1152,47.99267246893328,31.825489742850085
12,/media/marda/TWOTB1/xBD/hurricanes/images/florence/hurricane-florence_00000318_pre_disaster.png,67,44,1,948,1015,386,430,518,29.09801023910814,23.785252417352865
13,/media/marda/TWOTB1/xBD/hurricanes/images/florence/hurricane-florence_00000318_pre_disaster.png,84,69,1,735,819,414,483,1660,55.66923582906444,42.21764165411986
14,/media/marda/TWOTB1/xBD/hurricanes/images/florence/hurricane-florence_00000318_pre_disaster.png,57,41,1,710,767,451,492,451,28.566163469078063,20.908797643533998
15,/media/marda/TWOTB1/xBD/hurricanes/images/florence/hurricane-florence_00000318_pre_disaster.png,41,40,1,673,714,606,646,202,17.033499760104316,15.62288612124361
16,/media/marda/TWOTB1/xBD/hurricanes/images/florence/hurricane-florence_00000318_pre_disaster.png,45,60,1,706,751,613,673,510,41.04884130843044,16.571156825600298
17,/media/marda/TWOTB1/xBD/hurricanes/images/florence/hurricane-florence_00000318_pre_disaster.png,90,60,1,954,1044,671,731,1121,55.523848771053395,27.356621790356474
18,/media/marda/TWOTB1/xBD/hurricanes/images/florence/hurricane-florence_00000318_pre_disaster.png,46,56,1,702,748,682,738,467,34.5414455816673,18.043817413286376
19,/media/marda/TWOTB1/xBD/hurricanes/images/florence/hurricane-florence_00000318_pre_disaster.png,47,59,1,741,788,683,742,487,40.141686684364345,16.238494177348755
20,/media/marda/TWOTB1/xBD/hurricanes/images/florence/hurricane-florence_00000318_pre_disaster.png,56,48,1,695,751,738,786,487,31.29718479049701,20.49742321031242
21,/media/marda/TWOTB1/xBD/hurricanes/images/florence/hurricane-florence_00000318_pre_disaster.png,48,61,1,733,781,742,803,467,36.37470703455283,17.337385010202393
22,/media/marda/TWOTB1/xBD/hurricanes/images/florence/hurricane-florence_00000318_pre_disaster.png,43,62,1,543,586,791,853,517,32.514494229671655,21.810835111567375
23,/media/marda/TWOTB1/xBD/hurricanes/images/florence/hurricane-florence_00000318_pre_disaster.png,73,47,1,573,646,794,841,625,57.824609441657266,14.319190531583887
24,/media/marda/TWOTB1/xBD/hurricanes/images/florence/hurricane-florence_00000318_pre_disaster.png,69,74,1,891,960,825,899,650,44.17276084504773,19.651704156365053
25,/media/marda/TWOTB1/xBD/hurricanes/images/florence/hurricane-florence_00000318_pre_disaster.png,57,87,1,658,715,863,950,1309,59.7105302911781,29.726886634171766
26,/media/marda/TWOTB1/xBD/hurricanes/images/florence/hurricane-florence_00000257_pre_disaster.png,29,29,1,455,484,0,29,347,33.56850248762653,13.782272301300774
27,/media/marda/TWOTB1/xBD/hurricanes/images/florence/hurricane-florence_00000257_pre_disaster.png,32,29,1,16,48,18,47,361,37.55200488294909,12.861317058878175
28,/media/marda/TWOTB1/xBD/hurricanes/images/florence/hurricane-florence_00000257_pre_disaster.png,80,48,1,626,706,32,80,2000,55.618762067112286,48.541491593501235
29,/media/marda/TWOTB1/xBD/hurricanes/images/florence/hurricane-florence_00000257_pre_disaster.png,34,30,1,452,486,36,66,523,33.53730150979881,20.785269567115456
30,/media/marda/TWOTB1/xBD/hurricanes/images/florence/hurricane-florence_00000257_pre_disaster.png,15,13,1,38,53,38,51,91,15.421726052078416,7.809382215549011
31,/media/marda/TWOTB1/xBD/hurricanes/images/florence/hurricane-florence_00000257_pre_disaster.png,37,14,1,400,437,43,57,228,22.786956543689772,13.453781131794498
32,/media/marda/TWOTB1/xBD/hurricanes/images/florence/hurricane-florence_00000257_pre_disaster.png,30,19,1,333,363,67,86,322,21.914395530182023,19.63707989575584
33,/media/marda/TWOTB1/xBD/hurricanes/images/florence/hurricane-florence_00000257_pre_disaster.png,60,42,1,428,488,87,129,1241,43.705318718940234,37.63119556737223
34,/media/marda/TWOTB1/xBD/hurricanes/images/florence/hurricane-florence_00000257_pre_disaster.png,38,34,1,330,368,120,154,485,29.126933699807097,22.840679691144736
35,/media/marda/TWOTB1/xBD/hurricanes/images/florence/hurricane-florence_00000257_pre_disaster.png,31,37,1,94,125,138,175,550,32.8236143698073,22.394448822181065
36,/media/marda/TWOTB1/xBD/hurricanes/images/florence/hurricane-florence_00000257_pre_disaster.png,17,28,1,0,17,152,180,243,23.67334966505702,13.730066138997817
37,/media/marda/TWOTB1/xBD/hurricanes/images/florence/hurricane-florence_00000257_pre_disaster.png,57,43,1,51,108,173,216,1189,57.90996464633551,27.079462861731226
38,/media/marda/TWOTB1/xBD/hurricanes/images/florence/hurricane-florence_00000257_pre_disaster.png,48,20,1,996,1044,185,205,74,14.444764657343418,7.47943230921821
39,/media/marda/TWOTB1/xBD/hurricanes/images/florence/hurricane-florence_00000257_pre_disaster.png,82,47,1,916,998,197,244,822,51.68671689761268,21.226869586322525
40,/media/marda/TWOTB1/xBD/hurricanes/images/florence/hurricane-florence_00000257_pre_disaster.png,79,49,1,942,1021,216,265,870,37.9445349845969,30.31558829955143
41,/media/marda/TWOTB1/xBD/hurricanes/images/florence/hurricane-florence_00000257_pre_disaster.png,84,54,1,910,994,240,294,1150,48.528987630978364,31.164201773473284
42,/media/marda/TWOTB1/xBD/hurricanes/images/florence/hurricane-florence_00000257_pre_disaster.png,66,46,1,57,123,259,305,1191,70.93792178323983,22.384439719115925
43,/media/marda/TWOTB1/xBD/hurricanes/images/florence/hurricane-florence_00000257_pre_disaster.png,25,40,1,88,113,285,325,484,30.57986731600633,20.948869127198314
44,/media/marda/TWOTB1/xBD/hurricanes/images/florence/hurricane-florence_00000257_pre_disaster.png,53,47,1,16,69,290,337,1180,51.81877814843374,30.819539512265223
45,/media/marda/TWOTB1/xBD/hurricanes/images/florence/hurricane-florence_00000257_pre_disaster.png,81,95,1,106,187,341,436,3940,80.92105253737668,64.98208308010011
46,/media/marda/TWOTB1/xBD/hurricanes/images/florence/hurricane-florence_00000257_pre_disaster.png,57,97,1,197,254,438,535,2166,78.02199656618625,37.88546040266483
47,/media/marda/TWOTB1/xBD/hurricanes/images/florence/hurricane-florence_00000257_pre_disaster.png,84,63,1,920,1004,471,534,1396,45.5153737896928,41.37401591937258
48,/media/marda/TWOTB1/xBD/hurricanes/images/florence/hurricane-florence_00000257_pre_disaster.png,84,68,1,826,910,499,567,900,62.606392735536645,19.184893324009412
49,/media/marda/TWOTB1/xBD/hurricanes/images/florence/hurricane-florence_00000257_pre_disaster.png,68,74,1,225,293,548,622,2012,60.35883722475688,46.22888736498492
50,/media/marda/TWOTB1/xBD/hurricanes/images/florence/hurricane-florence_00000257_pre_disaster.png,62,40,1,917,979,548,588,351,27.61296049417042,17.015639206948567
51,/media/marda/TWOTB1/xBD/hurricanes/images/florence/hurricane-florence_00000257_pre_disaster.png,67,60,1,761,828,551,611,688,42.438292026166955,21.484958867000447
52,/media/marda/TWOTB1/xBD/hurricanes/images/florence/hurricane-florence_00000257_pre_disaster.png,57,51,1,821,878,595,646,320,26.57913815403623,16.094599520915562
53,/media/marda/TWOTB1/xBD/hurricanes/images/florence/hurricane-florence_00000257_pre_disaster.png,65,95,1,183,248,624,719,2106,75.91988225571056,45.481509328426554
54,/media/marda/TWOTB1/xBD/hurricanes/images/florence/hurricane-florence_00000257_pre_disaster.png,40,45,1,463,503,651,696,305,22.305695941384517,18.260229672553237
55,/media/marda/TWOTB1/xBD/hurricanes/images/florence/hurricane-florence_00000257_pre_disaster.png,65,68,1,400,465,717,785,920,47.81439974251014,25.682937366691633
56,/media/marda/TWOTB1/xBD/hurricanes/images/florence/hurricane-florence_00000257_pre_disaster.png,62,65,1,261,323,783,848,1044,49.89078648457865,27.953712332358755
57,/media/marda/TWOTB1/xBD/hurricanes/images/florence/hurricane-florence_00000257_pre_disaster.png,70,78,1,480,550,814,892,1088,49.03488846127378,34.36005721347503
58,/media/marda/TWOTB1/xBD/hurricanes/images/florence/hurricane-florence_00000257_pre_disaster.png,48,59,1,535,583,841,900,426,27.32138078754564,20.335369478326506
59,/media/marda/TWOTB1/xBD/hurricanes/images/florence/hurricane-florence_00000257_pre_disaster.png,12,57,1,0,12,934,991,150,18.783094743247602,11.555638194769111
60,/media/marda/TWOTB1/xBD/hurricanes/images/florence/hurricane-florence_00000261_post_disaster.png,63,42,1,729,792,183,225,766,34.06704578174558,31.870285593474897
61,/media/marda/TWOTB1/xBD/hurricanes/images/florence/hurricane-florence_00000261_post_disaster.png,62,55,1,850,912,754,809,680,32.72973937139042,27.562294491494594
62,/media/marda/TWOTB1/xBD/hurricanes/images/florence/hurricane-florence_00000233_post_disaster.png,37,72,1,182,219,753,825,856,45.54225341600404,25.023366157525842
63,/media/marda/TWOTB1/xBD/hurricanes/images/florence/hurricane-florence_00000233_post_disaster.png,18,49,1,176,194,812,861,141,16.343112647175435,11.57095179001576
64,/media/marda/TWOTB1/xBD/hurricanes/images/florence/hurricane-florence_00000233_post_disaster.png,33,55,1,194,227,816,871,393,26.27741541811462,20.1087130038511
65,/media/marda/TWOTB1/xBD/hurricanes/images/florence/hurricane-florence_00000233_post_disaster.png,29,47,1,314,343,851,898,163,15.705887872834834,13.79920065433091
66,/media/marda/TWOTB1/xBD/hurricanes/images/florence/hurricane-florence_00000233_post_disaster.png,40,55,1,347,387,866,921,353,25.265860850758628,18.52827888896789
67,/media/marda/TWOTB1/xBD/hurricanes/images/florence/hurricane-florence_00000233_post_disaster.png,21,45,1,371,392,956,1001,50,8.32344765176273,8.037923810808701
68,/media/marda/TWOTB1/xBD/hurricanes/images/florence/hurricane-florence_00000233_post_disaster.png,38,52,1,295,333,962,1014,163,31.217367782523116,7.016856198517402
69,/media/marda/TWOTB1/xBD/hurricanes/images/florence/hurricane-florence_00000233_post_disaster.png,51,55,1,291,342,988,1043,311,37.23509926156802,12.863275000135141
70,/media/marda/TWOTB1/xBD/hurricanes/images/florence/hurricane-florence_00000363_pre_disaster.png,67,46,1,598,665,142,188,951,40.771318461718515,30.82770257546746
71,/media/marda/TWOTB1/xBD/hurricanes/images/florence/hurricane-florence_00000363_pre_disaster.png,43,27,1,703,746,337,364,104,14.291670754805633,10.10717328287
72,/media/marda/TWOTB1/xBD/hurricanes/images/florence/hurricane-florence_00000363_pre_disaster.png,90,67,1,284,374,358,425,2671,82.9546871909143,43.050339726800686
73,/media/marda/TWOTB1/xBD/hurricanes/images/florence/hurricane-florence_00000363_pre_disaster.png,66,63,1,301,367,408,471,1692,52.60435028430667,42.70139837846442
74,/media/marda/TWOTB1/xBD/hurricanes/images/florence/hurricane-florence_00000363_pre_disaster.png,25,32,1,390,415,436,468,144,16.035555312501945,11.832479484789413
75,/media/marda/TWOTB1/xBD/hurricanes/images/florence/hurricane-florence_00000405_post_disaster.png,76,63,1,967,1043,95,158,1636,64.16630279570059,39.9559238986997
76,/media/marda/TWOTB1/xBD/hurricanes/images/florence/hurricane-florence_00000405_post_disaster.png,84,51,1,802,886,98,149,1873,53.9417079191131,48.43364834391783
77,/media/marda/TWOTB1/xBD/hurricanes/images/florence/hurricane-florence_00000405_post_disaster.png,78,73,1,602,680,135,208,2356,70.45781844619415,48.30911094037357
78,/media/marda/TWOTB1/xBD/hurricanes/images/florence/hurricane-florence_00000405_post_disaster.png,88,60,1,669,757,153,213,1939,65.17790327770398,45.9178173602735
79,/media/marda/TWOTB1/xBD/hurricanes/images/florence/hurricane-florence_00000405_post_disaster.png,72,50,1,5,77,155,205,1935,72.8454476654136,38.4824133075963
80,/media/marda/TWOTB1/xBD/hurricanes/images/florence/hurricane-florence_00000405_post_disaster.png,80,63,1,390,470,180,243,2101,59.90551351375849,48.815721780039816
81,/media/marda/TWOTB1/xBD/hurricanes/images/florence/hurricane-florence_00000405_post_disaster.png,72,55,1,744,816,183,238,1304,47.867087932173305,36.32942840794231
82,/media/marda/TWOTB1/xBD/hurricanes/images/florence/hurricane-florence_00000405_post_disaster.png,90,56,1,953,1043,201,257,1618,54.70825337264721,40.11859320534793
83,/media/marda/TWOTB1/xBD/hurricanes/images/florence/hurricane-florence_00000405_post_disaster.png,76,74,1,647,723,297,371,2294,66.85963896930417,51.06759177811914
84,/media/marda/TWOTB1/xBD/hurricanes/images/florence/hurricane-florence_00000405_post_disaster.png,76,63,1,67,143,313,376,1916,69.92441613190337,39.16541644182985
85,/media/marda/TWOTB1/xBD/hurricanes/images/florence/hurricane-florence_00000405_post_disaster.png,90,72,1,842,932,316,388,1804,66.90379090316529,38.95286158049649
86,/media/marda/TWOTB1/xBD/hurricanes/images/florence/hurricane-florence_00000405_post_disaster.png,80,71,1,774,854,317,388,2043,66.65685615732781,43.34910633905426
87,/media/marda/TWOTB1/xBD/hurricanes/images/florence/hurricane-florence_00000405_post_disaster.png,64,66,1,236,300,319,385,1560,47.6650729643091,45.111329931727006
88,/media/marda/TWOTB1/xBD/hurricanes/images/florence/hurricane-florence_00000405_post_disaster.png,76,71,1,712,788,325,396,2057,60.20721262527575,48.36961631505633
89,/media/marda/TWOTB1/xBD/hurricanes/images/florence/hurricane-florence_00000405_post_disaster.png,72,62,1,457,529,333,395,1770,51.767627896887205,44.74618773650613
90,/media/marda/TWOTB1/xBD/hurricanes/images/florence/hurricane-florence_00000405_post_disaster.png,76,79,1,404,480,360,439,2119,60.0119419689618,47.51915970097401
91,/media/marda/TWOTB1/xBD/hurricanes/images/florence/hurricane-florence_00000405_post_disaster.png,66,72,1,116,182,405,477,1752,64.2536436615873,39.66082843348754
92,/media/marda/TWOTB1/xBD/hurricanes/images/florence/hurricane-florence_00000405_post_disaster.png,58,79,1,0,58,487,566,2025,65.32880006599896,42.401114439164374
93,/media/marda/TWOTB1/xBD/hurricanes/images/florence/hurricane-florence_00000405_post_disaster.png,75,72,1,199,274,539,611,1799,59.91633594097015,43.07902764214838
94,/media/marda/TWOTB1/xBD/hurricanes/images/florence/hurricane-florence_00000405_post_disaster.png,80,89,1,740,820,693,782,2187,66.90272896541111,46.708469255643564
95,/media/marda/TWOTB1/xBD/hurricanes/images/florence/hurricane-florence_00000405_post_disaster.png,49,64,1,994,1043,697,761,306,41.50871944888518,9.808414097449766
96,/media/marda/TWOTB1/xBD/hurricanes/images/florence/hurricane-florence_00000405_post_disaster.png,70,78,1,613,683,699,777,1705,54.13005221224846,43.9544989753542
97,/media/marda/TWOTB1/xBD/hurricanes/images/florence/hurricane-florence_00000405_post_disaster.png,82,64,1,943,1025,721,785,1237,51.460458922884364,34.36084638260884
98,/media/marda/TWOTB1/xBD/hurricanes/images/florence/hurricane-florence_00000405_post_disaster.png,100,80,1,422,522,748,828,2554,77.3546541114195,46.102476461334746
99,/media/marda/TWOTB1/xBD/hurricanes/images/florence/hurricane-florence_00000405_post_disaster.png,78,96,1,375,453,821,917,2241,58.315643128981854,55.417422206166044
100,/media/marda/TWOTB1/xBD/hurricanes/images/florence/hurricane-florence_00000405_post_disaster.png,78,84,1,712,790,845,929,1726,61.977615164913296,41.239173064618086
101,/media/marda/TWOTB1/xBD/hurricanes/images/florence/hurricane-florence_00000405_post_disaster.png,75,88,1,787,862,848,936,1597,61.00857165010092,38.902105541424675
102,/media/marda/TWOTB1/xBD/hurricanes/images/florence/hurricane-florence_00000405_post_disaster.png,83,84,1,851,934,848,932,1930,57.74179687158652,44.237616312837915
103,/media/marda/TWOTB1/xBD/hurricanes/images/florence/hurricane-florence_00000405_post_disaster.png,69,86,1,974,1043,856,942,1159,51.447466629880246,32.70115076515535
104,/media/marda/TWOTB1/xBD/hurricanes/images/florence/hurricane-florence_00000405_post_disaster.png,44,61,1,90,134,980,1041,842,42.29009944990609,26.56827310002411
105,/media/marda/TWOTB1/xBD/hurricanes/images/florence/hurricane-florence_00000405_post_disaster.png,79,60,1,398,477,983,1043,691,60.83487678668716,17.09978536005764
106,/media/marda/TWOTB1/xBD/hurricanes/images/florence/hurricane-florence_00000426_post_disaster.png,52,41,1,455,507,0,41,838,46.719979912692345,25.08355834062316
107,/media/marda/TWOTB1/xBD/hurricanes/images/florence/hurricane-florence_00000426_post_disaster.png,83,19,1,899,982,0,19,678,51.19269964179956,18.01670459815394
108,/media/marda/TWOTB1/xBD/hurricanes/images/florence/hurricane-florence_00000426_post_disaster.png,81,39,1,294,375,30,69,1600,74.17038795397299,28.477849629266927
109,/media/marda/TWOTB1/xBD/hurricanes/images/florence/hurricane-florence_00000426_post_disaster.png,64,30,1,660,724,30,60,687,42.903746257400734,23.700330510300716
110,/media/marda/TWOTB1/xBD/hurricanes/images/florence/hurricane-florence_00000426_post_disaster.png,67,32,1,914,981,31,63,760,32.19411987315089,31.536106074044913
111,/media/marda/TWOTB1/xBD/hurricanes/images/florence/hurricane-florence_00000426_post_disaster.png,74,65,1,781,855,39,104,2113,66.97245439339719,42.09267001142055
112,/media/marda/TWOTB1/xBD/hurricanes/images/florence/hurricane-florence_00000426_post_disaster.png,55,35,1,246,301,56,91,1036,45.2923704403092,30.654908825208356
113,/media/marda/TWOTB1/xBD/hurricanes/images/florence/hurricane-florence_00000426_post_disaster.png,42,11,1,871,913,59,70,72,10.08416266847916,9.728304589661631
114,/media/marda/TWOTB1/xBD/hurricanes/images/florence/hurricane-florence_00000426_post_disaster.png,62,38,1,632,694,61,99,890,42.8118800447757,29.232114553601612
115,/media/marda/TWOTB1/xBD/hurricanes/images/florence/hurricane-florence_00000426_post_disaster.png,43,10,1,869,912,69,79,77,12.573620689767857,8.28527853802504
116,/media/marda/TWOTB1/xBD/hurricanes/images/florence/hurricane-florence_00000426_post_disaster.png,67,23,1,902,969,72,95,517,31.886386990426413,21.997126717727234
117,/media/marda/TWOTB1/xBD/hurricanes/images/florence/hurricane-florence_00000426_post_disaster.png,67,43,1,456,523,77,120,1265,45.70365069038768,36.59594429525243
118,/media/marda/TWOTB1/xBD/hurricanes/images/florence/hurricane-florence_00000426_post_disaster.png,39,44,1,124,163,86,130,893,45.08627993529415,26.44439747579573
119,/media/marda/TWOTB1/xBD/hurricanes/images/florence/hurricane-florence_00000426_post_disaster.png,31,31,1,159,190,96,127,506,29.10792127390662,23.211464178161197
120,/media/marda/TWOTB1/xBD/hurricanes/images/florence/hurricane-florence_00000426_post_disaster.png,72,50,1,476,548,119,169,1544,52.530098871937696,39.053224000962395
121,/media/marda/TWOTB1/xBD/hurricanes/images/florence/hurricane-florence_00000426_post_disaster.png,63,39,1,925,988,136,175,679,35.3338835289911,25.68346522764982
122,/media/marda/TWOTB1/xBD/hurricanes/images/florence/hurricane-florence_00000426_post_disaster.png,39,24,1,450,489,139,163,288,21.671902386537738,17.811332839064445
123,/media/marda/TWOTB1/xBD/hurricanes/images/florence/hurricane-florence_00000426_post_disaster.png,106,107,1,0,106,140,247,4912,134.18568856767666,56.614731013423516
124,/media/marda/TWOTB1/xBD/hurricanes/images/florence/hurricane-florence_00000426_post_disaster.png,68,41,1,271,339,147,188,1097,64.20547262339885,22.649924978083792
125,/media/marda/TWOTB1/xBD/hurricanes/images/florence/hurricane-florence_00000426_post_disaster.png,22,29,1,123,145,148,177,257,26.529245823168523,12.979070015931764
126,/media/marda/TWOTB1/xBD/hurricanes/images/florence/hurricane-florence_00000426_post_disaster.png,69,57,1,721,790,189,246,1578,54.07079841343314,38.70124210103319
127,/media/marda/TWOTB1/xBD/hurricanes/images/florence/hurricane-florence_00000426_post_disaster.png,37,42,1,46,83,198,240,796,37.82043322210504,27.905460981883856
128,/media/marda/TWOTB1/xBD/hurricanes/images/florence/hurricane-florence_00000426_post_disaster.png,76,53,1,850,926,224,277,1203,46.94666379621547,34.22594718683167
129,/media/marda/TWOTB1/xBD/hurricanes/images/florence/hurricane-florence_00000426_post_disaster.png,43,30,1,404,447,226,256,361,26.470408543108626,18.265433147774928
130,/media/marda/TWOTB1/xBD/hurricanes/images/florence/hurricane-florence_00000426_post_disaster.png,72,81,1,134,206,232,313,2598,77.09348605332278,47.82504806099872
131,/media/marda/TWOTB1/xBD/hurricanes/images/florence/hurricane-florence_00000426_post_disaster.png,85,61,1,635,720,232,293,1697,64.04821397240296,37.62628083529752
132,/media/marda/TWOTB1/xBD/hurricanes/images/florence/hurricane-florence_00000426_post_disaster.png,72,52,1,903,975,240,292,967,42.70270271848756,30.19871895457213
133,/media/marda/TWOTB1/xBD/hurricanes/images/florence/hurricane-florence_00000426_post_disaster.png,44,37,1,541,585,260,297,480,27.066480019292463,23.327471726336302
134,/media/marda/TWOTB1/xBD/hurricanes/images/florence/hurricane-florence_00000426_post_disaster.png,72,36,1,716,788,270,306,871,46.789829824871816,24.853317547435054
135,/media/marda/TWOTB1/xBD/hurricanes/images/florence/hurricane-florence_00000426_post_disaster.png,65,41,1,458,523,293,334,929,50.45677001365891,24.40523135413617
136,/media/marda/TWOTB1/xBD/hurricanes/images/florence/hurricane-florence_00000426_post_disaster.png,55,47,1,523,578,295,342,600,36.99409581432345,23.43095738055843
137,/media/marda/TWOTB1/xBD/hurricanes/images/florence/hurricane-florence_00000426_post_disaster.png,31,22,1,509,540,326,348,68,10.753721294181409,8.550948719400077
138,/media/marda/TWOTB1/xBD/hurricanes/images/florence/hurricane-florence_00000426_post_disaster.png,45,33,1,537,582,328,361,330,24.33298928386194,18.040752607412333
139,/media/marda/TWOTB1/xBD/hurricanes/images/florence/hurricane-florence_00000426_post_disaster.png,60,45,1,563,623,340,385,870,38.105551378054734,30.049156442394423
140,/media/marda/TWOTB1/xBD/hurricanes/images/florence/hurricane-florence_00000426_post_disaster.png,91,65,1,358,449,344,409,2641,76.79217972340678,45.316470685600464
141,/media/marda/TWOTB1/xBD/hurricanes/images/florence/hurricane-florence_00000426_post_disaster.png,27,30,1,231,258,365,395,214,18.83665834622047,15.043202935028864
142,/media/marda/TWOTB1/xBD/hurricanes/images/florence/hurricane-florence_00000426_post_disaster.png,61,23,1,841,902,370,393,243,33.03212080565145,9.895533680741385
143,/media/marda/TWOTB1/xBD/hurricanes/images/florence/hurricane-florence_00000426_post_disaster.png,39,57,1,252,291,371,428,969,44.53119706211326,28.91232270387381
144,/media/marda/TWOTB1/xBD/hurricanes/images/florence/hurricane-florence_00000426_post_disaster.png,68,27,1,893,961,372,399,344,35.02695025478959,13.106275782250455
145,/media/marda/TWOTB1/xBD/hurricanes/images/florence/hurricane-florence_00000426_post_disaster.png,40,55,1,175,215,379,434,965,41.60179706570479,30.8682965855248
146,/media/marda/TWOTB1/xBD/hurricanes/images/florence/hurricane-florence_00000426_post_disaster.png,51,35,1,738,789,390,425,358,23.427728794124725,20.06029545709066
147,/media/marda/TWOTB1/xBD/hurricanes/images/florence/hurricane-florence_00000426_post_disaster.png,52,51,1,513,565,395,446,628,34.10858311962915,24.59170731418549
148,/media/marda/TWOTB1/xBD/hurricanes/images/florence/hurricane-florence_00000426_post_disaster.png,62,54,1,565,627,400,454,926,36.410006831494954,33.9646264709045
149,/media/marda/TWOTB1/xBD/hurricanes/images/florence/hurricane-florence_00000426_post_disaster.png,66,64,1,699,765,408,472,1173,45.72166521304714,33.70128057458313
150,/media/marda/TWOTB1/xBD/hurricanes/images/florence/hurricane-florence_00000426_post_disaster.png,58,47,1,986,1044,427,474,378,30.84456439655151,16.957086316944388
151,/media/marda/TWOTB1/xBD/hurricanes/images/florence/hurricane-florence_00000426_post_disaster.png,46,81,1,68,114,431,512,1721,66.29704780071289,34.352263706195345
152,/media/marda/TWOTB1/xBD/hurricanes/images/florence/hurricane-florence_00000426_post_disaster.png,90,71,1,398,488,438,509,2533,71.53523234363944,46.99142496052968
153,/media/marda/TWOTB1/xBD/hurricanes/images/florence/hurricane-florence_00000426_post_disaster.png,63,51,1,934,997,443,494,585,35.255137002634875,22.159317914693926
154,/media/marda/TWOTB1/xBD/hurricanes/images/florence/hurricane-florence_00000426_post_disaster.png,61,72,1,484,545,479,551,1444,57.29076369196736,33.63707190166038
155,/media/marda/TWOTB1/xBD/hurricanes/images/florence/hurricane-florence_00000426_post_disaster.png,44,66,1,256,300,487,553,1059,50.59618678265174,27.940150094207308
156,/media/marda/TWOTB1/xBD/hurricanes/images/florence/hurricane-florence_00000426_post_disaster.png,76,85,1,402,478,505,590,2431,61.61774011389378,52.592107836862546
157,/media/marda/TWOTB1/xBD/hurricanes/images/florence/hurricane-florence_00000426_post_disaster.png,45,80,1,91,136,534,614,1513,55.20116896852241,37.20060184433599
158,/media/marda/TWOTB1/xBD/hurricanes/images/florence/hurricane-florence_00000426_post_disaster.png,51,54,1,512,563,593,647,542,27.53769339375303,26.299021696303587
159,/media/marda/TWOTB1/xBD/hurricanes/images/florence/hurricane-florence_00000426_post_disaster.png,18,69,1,0,18,601,670,521,46.75349077137627,15.872819131469585
160,/media/marda/TWOTB1/xBD/hurricanes/images/florence/hurricane-florence_00000426_post_disaster.png,66,68,1,427,493,602,670,1384,51.12276612316789,35.85525074949099
161,/media/marda/TWOTB1/xBD/hurricanes/images/florence/hurricane-florence_00000426_post_disaster.png,61,75,1,117,178,614,689,1412,65.37021354472347,32.19058228945852
162,/media/marda/TWOTB1/xBD/hurricanes/images/florence/hurricane-florence_00000426_post_disaster.png,38,39,1,492,530,635,674,155,16.334560847213265,12.755079344633517
163,/media/marda/TWOTB1/xBD/hurricanes/images/florence/hurricane-florence_00000426_post_disaster.png,94,98,1,294,388,642,740,3432,75.69948767808732,69.36139627553811
164,/media/marda/TWOTB1/xBD/hurricanes/images/florence/hurricane-florence_00000426_post_disaster.png,60,60,1,439,499,642,702,877,46.31258414262177,25.94117279073526
165,/media/marda/TWOTB1/xBD/hurricanes/images/florence/hurricane-florence_00000426_post_disaster.png,37,62,1,0,37,659,721,959,38.60584970377714,34.43683368544812
166,/media/marda/TWOTB1/xBD/hurricanes/images/florence/hurricane-florence_00000426_post_disaster.png,129,73,1,801,930,685,758,2194,105.60055135324184,27.909090339718755
167,/media/marda/TWOTB1/xBD/hurricanes/images/florence/hurricane-florence_00000426_post_disaster.png,108,67,1,931,1039,697,764,1554,77.88238593065537,27.077466948390118
168,/media/marda/TWOTB1/xBD/hurricanes/images/florence/hurricane-florence_00000426_post_disaster.png,59,60,1,472,531,701,761,796,44.452046246349646,23.6739386538544
169,/media/marda/TWOTB1/xBD/hurricanes/images/florence/hurricane-florence_00000426_post_disaster.png,109,78,1,697,806,719,797,1924,91.2495850691966,28.337782160526523
170,/media/marda/TWOTB1/xBD/hurricanes/images/florence/hurricane-florence_00000426_post_disaster.png,55,62,1,354,409,742,804,882,42.29413090144286,27.464883089717432
171,/media/marda/TWOTB1/xBD/hurricanes/images/florence/hurricane-florence_00000426_post_disaster.png,93,120,1,214,307,758,878,4697,86.2316282623851,72.6456808763776
172,/media/marda/TWOTB1/xBD/hurricanes/images/florence/hurricane-florence_00000426_post_disaster.png,98,130,1,484,582,771,901,4889,103.70907524209834,62.99787762362407
173,/media/marda/TWOTB1/xBD/hurricanes/images/florence/hurricane-florence_00000426_post_disaster.png,55,61,1,365,420,774,835,798,42.22148767200264,24.90778681487039
174,/media/marda/TWOTB1/xBD/hurricanes/images/florence/hurricane-florence_00000426_post_disaster.png,45,82,1,63,108,776,858,1374,54.555895597937806,33.47687327987596
175,/media/marda/TWOTB1/xBD/hurricanes/images/florence/hurricane-florence_00000426_post_disaster.png,55,79,1,989,1044,781,860,400,48.597077144880814,12.617665908340683
176,/media/marda/TWOTB1/xBD/hurricanes/images/florence/hurricane-florence_00000426_post_disaster.png,80,122,1,645,725,804,926,2340,100.28407866810709,31.425546962281377
177,/media/marda/TWOTB1/xBD/hurricanes/images/florence/hurricane-florence_00000426_post_disaster.png,67,121,1,922,989,828,949,2310,100.58225938602199,31.028243246834517
178,/media/marda/TWOTB1/xBD/hurricanes/images/florence/hurricane-florence_00000426_post_disaster.png,102,68,1,819,921,839,907,1529,75.24657779782731,27.605793167146693
179,/media/marda/TWOTB1/xBD/hurricanes/images/florence/hurricane-florence_00000426_post_disaster.png,69,70,1,558,627,891,961,948,49.13522728739365,25.663642179373603
180,/media/marda/TWOTB1/xBD/hurricanes/images/florence/hurricane-florence_00000426_post_disaster.png,107,114,1,815,922,908,1022,2137,95.51795580216128,29.9203776938931
181,/media/marda/TWOTB1/xBD/hurricanes/images/florence/hurricane-florence_00000426_post_disaster.png,72,114,1,632,704,909,1023,1903,85.71858853098207,29.885424172238203
182,/media/marda/TWOTB1/xBD/hurricanes/images/florence/hurricane-florence_00000426_post_disaster.png,94,93,1,351,445,917,1010,2613,79.25686109762486,43.77077252539094
183,/media/marda/TWOTB1/xBD/hurricanes/images/florence/hurricane-florence_00000426_post_disaster.png,66,106,1,923,989,926,1032,1723,77.3409523022848,30.513233618058948
184,/media/marda/TWOTB1/xBD/hurricanes/images/florence/hurricane-florence_00000426_post_disaster.png,107,63,1,686,793,978,1041,1122,73.66314762388326,22.389850409716622
185,/media/marda/TWOTB1/xBD/hurricanes/images/florence/hurricane-florence_00000426_post_disaster.png,51,61,1,308,359,982,1043,439,42.47208876935211,13.762942891136344
186,/media/marda/TWOTB1/xBD/hurricanes/images/florence/hurricane-florence_00000348_pre_disaster.png,33,52,1,20,53,0,52,1382,56.22820322444203,32.39124121125055
187,/media/marda/TWOTB1/xBD/hurricanes/images/florence/hurricane-florence_00000348_pre_disaster.png,94,42,1,947,1041,22,64,1310,54.70123501849123,31.69031655886696
188,/media/marda/TWOTB1/xBD/hurricanes/images/florence/hurricane-florence_00000348_pre_disaster.png,45,23,1,519,564,29,52,415,24.931724345405943,21.935852174936553
189,/media/marda/TWOTB1/xBD/hurricanes/images/florence/hurricane-florence_00000348_pre_disaster.png,31,13,1,555,586,61,74,108,13.226211267664585,11.005304094805908
190,/media/marda/TWOTB1/xBD/hurricanes/images/florence/hurricane-florence_00000348_pre_disaster.png,72,47,1,496,568,98,145,1584,58.76616544310802,36.787476415059714
191,/media/marda/TWOTB1/xBD/hurricanes/images/florence/hurricane-florence_00000348_pre_disaster.png,61,65,1,709,770,189,254,1313,62.27484438353218,29.09045886335479
192,/media/marda/TWOTB1/xBD/hurricanes/images/florence/hurricane-florence_00000348_pre_disaster.png,64,34,1,892,956,268,302,633,31.274266233930145,26.708232790486132
193,/media/marda/TWOTB1/xBD/hurricanes/images/florence/hurricane-florence_00000348_pre_disaster.png,39,33,1,322,361,273,306,331,26.003751276115878,17.00927669208861
194,/media/marda/TWOTB1/xBD/hurricanes/images/florence/hurricane-florence_00000348_pre_disaster.png,22,26,1,125,147,293,319,170,17.79545091570938,12.830612832928749
195,/media/marda/TWOTB1/xBD/hurricanes/images/florence/hurricane-florence_00000348_pre_disaster.png,87,68,1,340,427,293,361,2021,77.24026466726896,36.09855196634888
196,/media/marda/TWOTB1/xBD/hurricanes/images/florence/hurricane-florence_00000348_pre_disaster.png,59,60,1,153,212,300,360,1267,52.46874493237729,33.03760745364678
197,/media/marda/TWOTB1/xBD/hurricanes/images/florence/hurricane-florence_00000348_pre_disaster.png,60,51,1,802,862,390,441,943,42.5955905729983,29.799975044969774
198,/media/marda/TWOTB1/xBD/hurricanes/images/florence/hurricane-florence_00000348_pre_disaster.png,61,42,1,865,926,391,433,611,34.076243112234096,25.529099437024605
199,/media/marda/TWOTB1/xBD/hurricanes/images/florence/hurricane-florence_00000348_pre_disaster.png,62,44,1,968,1030,395,439,533,28.99962089767175,24.250457375741
200,/media/marda/TWOTB1/xBD/hurricanes/images/florence/hurricane-florence_00000348_pre_disaster.png,56,53,1,688,744,404,457,721,35.85302425352085,27.30730052883113
201,/media/marda/TWOTB1/xBD/hurricanes/images/florence/hurricane-florence_00000348_pre_disaster.png,60,40,1,737,797,419,459,702,35.319501429606895,26.232831064806074
202,/media/marda/TWOTB1/xBD/hurricanes/images/florence/hurricane-florence_00000348_pre_disaster.png,55,61,1,617,672,428,489,1005,45.898890497706105,28.77620262930955
203,/media/marda/TWOTB1/xBD/hurricanes/images/florence/hurricane-florence_00000348_pre_disaster.png,17,30,1,139,156,429,459,98,11.824453731990346,11.127777936096674
204,/media/marda/TWOTB1/xBD/hurricanes/images/florence/hurricane-florence_00000348_pre_disaster.png,42,24,1,819,861,433,457,80,11.489125293076057,9.16515138991168
205,/media/marda/TWOTB1/xBD/hurricanes/images/florence/hurricane-florence_00000348_pre_disaster.png,39,45,1,234,273,435,480,467,32.2435916751106,19.16016602750544
206,/media/marda/TWOTB1/xBD/hurricanes/images/florence/hurricane-florence_00000348_pre_disaster.png,65,89,1,266,331,442,531,2009,68.68269217871651,48.440842946268496
207,/media/marda/TWOTB1/xBD/hurricanes/images/florence/hurricane-florence_00000348_pre_disaster.png,31,43,1,125,156,453,496,385,25.476428809959927,20.190498595861083
208,/media/marda/TWOTB1/xBD/hurricanes/images/florence/hurricane-florence_00000348_pre_disaster.png,89,32,1,806,895,454,486,631,63.78424855824149,13.46568843642969
209,/media/marda/TWOTB1/xBD/hurricanes/images/florence/hurricane-florence_00000348_pre_disaster.png,46,43,1,558,604,459,502,374,23.849792414263145,20.94292177635763
210,/media/marda/TWOTB1/xBD/hurricanes/images/florence/hurricane-florence_00000348_pre_disaster.png,60,65,1,496,556,467,532,815,49.46812860184689,28.56290688151769
211,/media/marda/TWOTB1/xBD/hurricanes/images/florence/hurricane-florence_00000348_pre_disaster.png,85,41,1,806,891,476,517,561,58.928609828393625,12.71278970660346
212,/media/marda/TWOTB1/xBD/hurricanes/images/florence/hurricane-florence_00000348_pre_disaster.png,44,26,1,854,898,476,502,94,13.482054406759584,9.433462098423908
213,/media/marda/TWOTB1/xBD/hurricanes/images/florence/hurricane-florence_00000348_pre_disaster.png,40,54,1,180,220,483,537,699,33.75700993188425,27.383100625781484
214,/media/marda/TWOTB1/xBD/hurricanes/images/florence/hurricane-florence_00000348_pre_disaster.png,55,39,1,989,1044,483,522,290,23.92303243144089,16.208145392751586
215,/media/marda/TWOTB1/xBD/hurricanes/images/florence/hurricane-florence_00000348_pre_disaster.png,56,68,1,515,571,511,579,924,50.465965784043675,25.805387986572946
216,/media/marda/TWOTB1/xBD/hurricanes/images/florence/hurricane-florence_00000348_pre_disaster.png,55,60,1,184,239,512,572,1101,47.221602762335344,30.524987833558374
217,/media/marda/TWOTB1/xBD/hurricanes/images/florence/hurricane-florence_00000348_pre_disaster.png,49,50,1,626,675,513,563,720,34.74073654613587,27.611855380711255
218,/media/marda/TWOTB1/xBD/hurricanes/images/florence/hurricane-florence_00000348_pre_disaster.png,58,50,1,856,914,520,570,588,30.611902479583712,25.654955324515875
219,/media/marda/TWOTB1/xBD/hurricanes/images/florence/hurricane-florence_00000348_pre_disaster.png,53,56,1,409,462,521,577,673,39.72431168981196,22.383508521420524
220,/media/marda/TWOTB1/xBD/hurricanes/images/florence/hurricane-florence_00000348_pre_disaster.png,50,31,1,910,960,521,552,104,14.623058444740824,9.637461219798197
221,/media/marda/TWOTB1/xBD/hurricanes/images/florence/hurricane-florence_00000348_pre_disaster.png,57,36,1,881,938,530,566,290,25.659572146747358,15.147555123233067
222,/media/marda/TWOTB1/xBD/hurricanes/images/florence/hurricane-florence_00000348_pre_disaster.png,46,33,1,998,1044,541,574,71,15.003086145962335,6.286618324123929
223,/media/marda/TWOTB1/xBD/hurricanes/images/florence/hurricane-florence_00000348_pre_disaster.png,30,32,1,576,606,550,582,120,13.808210118138652,11.489125293076057
224,/media/marda/TWOTB1/xBD/hurricanes/images/florence/hurricane-florence_00000348_pre_disaster.png,29,33,1,430,459,561,594,85,11.236294413237108,10.209735463746327
225,/media/marda/TWOTB1/xBD/hurricanes/images/florence/hurricane-florence_00000348_pre_disaster.png,43,55,1,106,149,570,625,681,35.4837093452227,25.61746930768522
226,/media/marda/TWOTB1/xBD/hurricanes/images/florence/hurricane-florence_00000348_pre_disaster.png,56,68,1,327,383,570,638,1215,43.95342437027613,36.34128849428283
227,/media/marda/TWOTB1/xBD/hurricanes/images/florence/hurricane-florence_00000348_pre_disaster.png,46,39,1,438,484,570,609,305,35.51732243394795,13.944451960339906
228,/media/marda/TWOTB1/xBD/hurricanes/images/florence/hurricane-florence_00000348_pre_disaster.png,45,50,1,530,575,574,624,641,34.131876525499905,24.951663241046834
229,/media/marda/TWOTB1/xBD/hurricanes/images/florence/hurricane-florence_00000348_pre_disaster.png,39,56,1,447,486,590,646,699,35.832514924158296,26.016283996720638
230,/media/marda/TWOTB1/xBD/hurricanes/images/florence/hurricane-florence_00000348_pre_disaster.png,40,41,1,558,598,604,645,313,22.5895101732457,18.332539476992288
231,/media/marda/TWOTB1/xBD/hurricanes/images/florence/hurricane-florence_00000348_pre_disaster.png,35,103,1,0,35,627,730,1994,89.74171551825609,33.31883696593138
232,/media/marda/TWOTB1/xBD/hurricanes/images/florence/hurricane-florence_00000348_pre_disaster.png,34,48,1,342,376,628,676,300,21.259953581464977,18.87729195334257
233,/media/marda/TWOTB1/xBD/hurricanes/images/florence/hurricane-florence_00000348_pre_disaster.png,45,60,1,536,581,631,691,814,39.462055678350204,27.312626250962378
234,/media/marda/TWOTB1/xBD/hurricanes/images/florence/hurricane-florence_00000348_pre_disaster.png,76,41,1,631,707,631,672,572,59.27837421997887,12.888068973438813
235,/media/marda/TWOTB1/xBD/hurricanes/images/florence/hurricane-florence_00000348_pre_disaster.png,45,71,1,444,489,646,717,1095,52.26304474023521,28.446980001985594
236,/media/marda/TWOTB1/xBD/hurricanes/images/florence/hurricane-florence_00000348_pre_disaster.png,44,44,1,742,786,657,701,194,19.815239087731502,13.148462765354509
237,/media/marda/TWOTB1/xBD/hurricanes/images/florence/hurricane-florence_00000348_pre_disaster.png,47,63,1,771,818,661,724,483,42.62584903667602,15.148800681955192
238,/media/marda/TWOTB1/xBD/hurricanes/images/florence/hurricane-florence_00000348_pre_disaster.png,25,45,1,60,85,665,710,296,21.527836124167788,18.189084978401663
239,/media/marda/TWOTB1/xBD/hurricanes/images/florence/hurricane-florence_00000348_pre_disaster.png,38,77,1,363,401,665,742,1249,60.07355915077332,27.75697032594268
240,/media/marda/TWOTB1/xBD/hurricanes/images/florence/hurricane-florence_00000348_pre_disaster.png,40,39,1,565,605,677,716,269,22.482319453674254,15.8550919431563
241,/media/marda/TWOTB1/xBD/hurricanes/images/florence/hurricane-florence_00000348_pre_disaster.png,57,77,1,178,235,681,758,1379,50.02193414247906,40.39437291545943
242,/media/marda/TWOTB1/xBD/hurricanes/images/florence/hurricane-florence_00000348_pre_disaster.png,52,71,1,634,686,692,763,704,44.53903227280632,24.538689447925954
243,/media/marda/TWOTB1/xBD/hurricanes/images/florence/hurricane-florence_00000348_pre_disaster.png,49,66,1,541,590,700,766,895,44.22288812646372,28.404075936721927
244,/media/marda/TWOTB1/xBD/hurricanes/images/florence/hurricane-florence_00000348_pre_disaster.png,55,48,1,680,735,705,753,336,30.063926820398372,14.940144684217431
245,/media/marda/TWOTB1/xBD/hurricanes/images/florence/hurricane-florence_00000348_pre_disaster.png,39,67,1,453,492,711,778,817,42.83864213403642,25.45976388973908
246,/media/marda/TWOTB1/xBD/hurricanes/images/florence/hurricane-florence_00000348_pre_disaster.png,51,75,1,365,416,738,813,1276,48.881125122181444,38.549306178129754
247,/media/marda/TWOTB1/xBD/hurricanes/images/florence/hurricane-florence_00000348_pre_disaster.png,33,67,1,455,488,762,829,572,44.02431111118195,17.338852754515337
248,/media/marda/TWOTB1/xBD/hurricanes/images/florence/hurricane-florence_00000348_pre_disaster.png,44,56,1,540,584,763,819,597,31.507379378057248,25.180329483306082
249,/media/marda/TWOTB1/xBD/hurricanes/images/florence/hurricane-florence_00000348_pre_disaster.png,53,66,1,241,294,772,838,1264,51.73830875775841,34.10871467794403
250,/media/marda/TWOTB1/xBD/hurricanes/images/florence/hurricane-florence_00000348_pre_disaster.png,47,81,1,55,102,781,862,1309,48.95997740350739,37.47707274119167
251,/media/marda/TWOTB1/xBD/hurricanes/images/florence/hurricane-florence_00000348_pre_disaster.png,55,56,1,634,689,785,841,782,34.94773934735613,29.508252464003533
252,/media/marda/TWOTB1/xBD/hurricanes/images/florence/hurricane-florence_00000348_pre_disaster.png,59,55,1,439,498,813,868,918,48.226578116502324,25.272752281671725
253,/media/marda/TWOTB1/xBD/hurricanes/images/florence/hurricane-florence_00000348_pre_disaster.png,35,51,1,238,273,815,866,503,30.592950346055574,21.898823949544433
254,/media/marda/TWOTB1/xBD/hurricanes/images/florence/hurricane-florence_00000348_pre_disaster.png,40,67,1,0,40,830,897,806,35.71552332376932,29.705778498111396
255,/media/marda/TWOTB1/xBD/hurricanes/images/florence/hurricane-florence_00000348_pre_disaster.png,34,66,1,92,126,840,906,545,32.25550308671372,22.566062202560815
256,/media/marda/TWOTB1/xBD/hurricanes/images/florence/hurricane-florence_00000348_pre_disaster.png,32,70,1,267,299,849,919,912,43.86342439892262,27.688746209726915
257,/media/marda/TWOTB1/xBD/hurricanes/images/florence/hurricane-florence_00000348_pre_disaster.png,43,51,1,571,614,851,902,209,22.01815858867432,12.460926263486488
258,/media/marda/TWOTB1/xBD/hurricanes/images/florence/hurricane-florence_00000348_pre_disaster.png,18,48,1,33,51,873,921,145,16.39585956659624,11.864897347741975
259,/media/marda/TWOTB1/xBD/hurricanes/images/florence/hurricane-florence_00000348_pre_disaster.png,42,68,1,62,104,878,946,1014,44.961662724469214,31.610807671248974
260,/media/marda/TWOTB1/xBD/hurricanes/images/florence/hurricane-florence_00000348_pre_disaster.png,53,85,1,429,482,902,987,1385,52.773232774327305,35.471089421310786
261,/media/marda/TWOTB1/xBD/hurricanes/images/florence/hurricane-florence_00000348_pre_disaster.png,27,52,1,29,56,903,955,373,30.74795186362586,16.22688945580455
262,/media/marda/TWOTB1/xBD/hurricanes/images/florence/hurricane-florence_00000348_pre_disaster.png,7,48,1,0,7,904,952,50,11.134002490572739,6.367573206482988
263,/media/marda/TWOTB1/xBD/hurricanes/images/florence/hurricane-florence_00000348_pre_disaster.png,14,49,1,13,27,907,956,97,13.012735514599916,10.065963406717616
264,/media/marda/TWOTB1/xBD/hurricanes/images/florence/hurricane-florence_00000348_pre_disaster.png,79,82,1,510,589,907,989,1128,64.90135212091312,23.195548783563712
265,/media/marda/TWOTB1/xBD/hurricanes/images/florence/hurricane-florence_00000348_pre_disaster.png,52,67,1,377,429,908,975,842,42.306719633314664,26.420289170613184
266,/media/marda/TWOTB1/xBD/hurricanes/images/florence/hurricane-florence_00000348_pre_disaster.png,36,64,1,56,92,917,981,902,39.331177837549106,30.426232343573602
267,/media/marda/TWOTB1/xBD/hurricanes/images/florence/hurricane-florence_00000348_pre_disaster.png,31,48,1,481,512,923,971,144,15.055363438919823,12.75201197850026
268,/media/marda/TWOTB1/xBD/hurricanes/images/florence/hurricane-florence_00000348_pre_disaster.png,24,57,1,27,51,926,983,476,26.264977589830856,23.960190240201214
269,/media/marda/TWOTB1/xBD/hurricanes/images/florence/hurricane-florence_00000348_pre_disaster.png,16,54,1,4,20,930,984,145,17.852449251196578,10.888175352697823
270,/media/marda/TWOTB1/xBD/hurricanes/images/florence/hurricane-florence_00000348_pre_disaster.png,69,56,1,648,717,939,995,724,46.54848455801176,20.41643115964439
271,/media/marda/TWOTB1/xBD/hurricanes/images/florence/hurricane-florence_00000348_pre_disaster.png,30,79,1,155,185,947,1026,892,45.42619544827298,26.215716651106565
272,/media/marda/TWOTB1/xBD/hurricanes/images/florence/hurricane-florence_00000348_pre_disaster.png,38,75,1,60,98,956,1031,1390,43.52668216014324,42.61445149451917
273,/media/marda/TWOTB1/xBD/hurricanes/images/florence/hurricane-florence_00000429_post_disaster.png,32,26,1,414,446,471,497,140,17.937708775997002,10.306023193822229
274,/media/marda/TWOTB1/xBD/hurricanes/images/florence/hurricane-florence_00000429_post_disaster.png,22,55,1,106,128,565,620,500,38.41844437663983,17.421475358850387
275,/media/marda/TWOTB1/xBD/hurricanes/images/florence/hurricane-florence_00000429_post_disaster.png,17,34,1,100,117,608,642,94,13.62814087367327,9.34957560609314
276,/media/marda/TWOTB1/xBD/hurricanes/images/florence/hurricane-florence_00000429_post_disaster.png,17,63,1,3,20,819,882,296,33.648859174843416,11.80376913472875
277,/media/marda/TWOTB1/xBD/hurricanes/images/florence/hurricane-florence_00000429_post_disaster.png,17,67,1,0,17,851,918,419,35.91966029459801,16.02912721069403
278,/media/marda/TWOTB1/xBD/hurricanes/images/florence/hurricane-florence_00000128_post_disaster.png,35,20,1,770,805,303,323,44,8.348617343403225,7.1196220549614155
279,/media/marda/TWOTB1/xBD/hurricanes/images/florence/hurricane-florence_00000236_pre_disaster.png,64,43,1,469,533,142,185,506,57.81863311037261,12.20383855070609
280,/media/marda/TWOTB1/xBD/hurricanes/images/florence/hurricane-florence_00000236_pre_disaster.png,72,74,1,439,511,179,253,1930,72.90446746406697,35.02982799784597
281,/media/marda/TWOTB1/xBD/hurricanes/images/florence/hurricane-florence_00000236_pre_disaster.png,33,21,1,410,443,180,201,146,14.229253937688664,13.768782584090978
282,/media/marda/TWOTB1/xBD/hurricanes/images/florence/hurricane-florence_00000236_pre_disaster.png,87,82,1,457,544,275,357,2382,79.50152182449659,40.18493909094046
283,/media/marda/TWOTB1/xBD/hurricanes/images/florence/hurricane-florence_00000236_pre_disaster.png,35,33,1,364,399,302,335,220,23.383524690325157,12.582325114554902
284,/media/marda/TWOTB1/xBD/hurricanes/images/florence/hurricane-florence_00000236_pre_disaster.png,40,30,1,596,636,390,420,148,16.779821266236684,11.853348841988241
285,/media/marda/TWOTB1/xBD/hurricanes/images/florence/hurricane-florence_00000236_pre_disaster.png,50,36,1,694,744,418,454,217,18.721362830827818,15.531676399177686
286,/media/marda/TWOTB1/xBD/hurricanes/images/florence/hurricane-florence_00000236_pre_disaster.png,62,50,1,621,683,422,472,624,39.63947606793837,21.084748941214418
287,/media/marda/TWOTB1/xBD/hurricanes/images/florence/hurricane-florence_00000236_pre_disaster.png,64,53,1,661,725,437,490,598,43.52083406122305,18.280038810546387
288,/media/marda/TWOTB1/xBD/hurricanes/images/florence/hurricane-florence_00000236_pre_disaster.png,83,76,1,601,684,477,553,1447,71.91464122877895,28.26960329002954
289,/media/marda/TWOTB1/xBD/hurricanes/images/florence/hurricane-florence_00000236_pre_disaster.png,56,48,1,729,785,504,552,411,30.529650749573303,17.630800327927112
290,/media/marda/TWOTB1/xBD/hurricanes/images/florence/hurricane-florence_00000236_pre_disaster.png,59,65,1,424,483,523,588,1002,45.61456408497171,28.81917703056075
291,/media/marda/TWOTB1/xBD/hurricanes/images/florence/hurricane-florence_00000236_pre_disaster.png,65,67,1,392,457,590,657,1143,45.81873642772062,36.01963102928318
292,/media/marda/TWOTB1/xBD/hurricanes/images/florence/hurricane-florence_00000236_pre_disaster.png,42,49,1,457,499,597,646,335,24.7291931686497,17.959039969079367
293,/media/marda/TWOTB1/xBD/hurricanes/images/florence/hurricane-florence_00000236_pre_disaster.png,24,47,1,284,308,797,844,142,14.581253294349649,13.054857559052273
294,/media/marda/TWOTB1/xBD/hurricanes/images/florence/hurricane-florence_00000236_pre_disaster.png,26,49,1,263,289,811,860,152,15.291097661627067,13.360007916425797
295,/media/marda/TWOTB1/xBD/hurricanes/images/florence/hurricane-florence_00000236_pre_disaster.png,65,70,1,400,465,824,894,1141,46.52962883250886,31.893963594494537
296,/media/marda/TWOTB1/xBD/hurricanes/images/florence/hurricane-florence_00000236_pre_disaster.png,47,69,1,370,417,829,898,633,32.47620802297309,26.64483852881137
297,/media/marda/TWOTB1/xBD/hurricanes/images/florence/hurricane-florence_00000236_pre_disaster.png,64,78,1,491,555,886,964,975,49.885495729073455,25.823813592781352
298,/media/marda/TWOTB1/xBD/hurricanes/images/florence/hurricane-florence_00000236_pre_disaster.png,31,49,1,491,522,951,1000,84,11.291169973129106,10.022613995136396
299,/media/marda/TWOTB1/xBD/hurricanes/images/florence/hurricane-florence_00000236_pre_disaster.png,41,54,1,506,547,956,1010,201,17.4997384746561,15.244413975361663
300,/media/marda/TWOTB1/xBD/hurricanes/images/florence/hurricane-florence_00000382_post_disaster.png,43,17,1,722,765,19,36,180,17.750245085554962,13.375337887330648
301,/media/marda/TWOTB1/xBD/hurricanes/images/florence/hurricane-florence_00000382_post_disaster.png,31,53,1,22,53,301,354,849,39.28342545853078,28.178738349505664
302,/media/marda/TWOTB1/xBD/hurricanes/images/florence/hurricane-florence_00000382_post_disaster.png,41,46,1,98,139,317,363,868,37.53837695678955,30.234723637393177
303,/media/marda/TWOTB1/xBD/hurricanes/images/florence/hurricane-florence_00000382_post_disaster.png,18,28,1,38,56,350,378,177,17.515131927532494,13.580245380773516
304,/media/marda/TWOTB1/xBD/hurricanes/images/florence/hurricane-florence_00000382_post_disaster.png,34,66,1,55,89,429,495,1077,51.803578649753526,27.661322107555797
305,/media/marda/TWOTB1/xBD/hurricanes/images/florence/hurricane-florence_00000382_post_disaster.png,21,43,1,85,106,441,484,322,26.35116251161658,17.1368501593388
306,/media/marda/TWOTB1/xBD/hurricanes/images/florence/hurricane-florence_00000382_post_disaster.png,217,110,1,284,501,535,645,6199,238.60757348133268,34.601857863905344
307,/media/marda/TWOTB1/xBD/hurricanes/images/florence/hurricane-florence_00000382_post_disaster.png,18,30,1,282,300,583,613,65,9.87820619109951,8.476474989341966
308,/media/marda/TWOTB1/xBD/hurricanes/images/florence/hurricane-florence_00000382_post_disaster.png,45,80,1,151,196,589,669,1466,55.342000411440395,36.15459098436523
309,/media/marda/TWOTB1/xBD/hurricanes/images/florence/hurricane-florence_00000382_post_disaster.png,28,39,1,216,244,621,660,170,19.51557116518995,11.665490069731101
310,/media/marda/TWOTB1/xBD/hurricanes/images/florence/hurricane-florence_00000382_post_disaster.png,56,49,1,243,299,674,723,721,54.082471554227915,17.751589847518975
311,/media/marda/TWOTB1/xBD/hurricanes/images/florence/hurricane-florence_00000382_post_disaster.png,49,74,1,220,269,736,810,1395,52.019374989527705,38.058129260698884
312,/media/marda/TWOTB1/xBD/hurricanes/images/florence/hurricane-florence_00000382_post_disaster.png,54,73,1,158,212,737,810,1314,48.276485448425,35.864176158106936
313,/media/marda/TWOTB1/xBD/hurricanes/images/florence/hurricane-florence_00000382_post_disaster.png,20,43,1,211,231,772,815,135,16.75686657656206,10.79851454425366
314,/media/marda/TWOTB1/xBD/hurricanes/images/florence/hurricane-florence_00000382_post_disaster.png,32,80,1,196,228,835,915,674,52.22193466548844,18.769451372071526
315,/media/marda/TWOTB1/xBD/hurricanes/images/florence/hurricane-florence_00000382_post_disaster.png,62,67,1,796,858,875,942,847,39.416124876725824,28.9809728294382
316,/media/marda/TWOTB1/xBD/hurricanes/images/florence/hurricane-florence_00000382_post_disaster.png,44,103,1,196,240,924,1027,901,77.67476186825314,17.493717512359435
317,/media/marda/TWOTB1/xBD/hurricanes/images/florence/hurricane-florence_00000382_post_disaster.png,27,49,1,231,258,950,999,143,19.10605494840613,10.10957069084741
318,/media/marda/TWOTB1/xBD/hurricanes/images/florence/hurricane-florence_00000345_pre_disaster.png,165,62,1,186,351,117,179,4923,163.9323063612871,40.915620602710895
319,/media/marda/TWOTB1/xBD/hurricanes/images/florence/hurricane-florence_00000345_pre_disaster.png,70,66,1,938,1008,776,842,601,41.31127275875477,19.28957189353113
320,/media/marda/TWOTB1/xBD/hurricanes/images/florence/hurricane-florence_00000345_pre_disaster.png,56,55,1,836,892,989,1044,223,21.99234648135274,14.17624018949035
321,/media/marda/TWOTB1/xBD/hurricanes/images/florence/hurricane-florence_00000220_pre_disaster.png,34,10,1,8,42,0,10,214,31.694452467210947,9.659938976728531
322,/media/marda/TWOTB1/xBD/hurricanes/images/florence/hurricane-florence_00000243_post_disaster.png,35,20,1,199,234,39,59,296,27.474108271545347,14.473700992151644
323,/media/marda/TWOTB1/xBD/hurricanes/images/florence/hurricane-florence_00000243_post_disaster.png,61,53,1,424,485,108,161,1182,42.2439782207529,37.27053321514898
324,/media/marda/TWOTB1/xBD/hurricanes/images/florence/hurricane-florence_00000243_post_disaster.png,72,64,1,364,436,226,290,1809,53.74517328486447,46.0745758704447
325,/media/marda/TWOTB1/xBD/hurricanes/images/florence/hurricane-florence_00000243_post_disaster.png,31,36,1,353,384,242,278,244,29.36155277929411,11.224816437903103
326,/media/marda/TWOTB1/xBD/hurricanes/images/florence/hurricane-florence_00000243_post_disaster.png,45,23,1,791,836,346,369,97,13.396924398940131,9.665504689155147
327,/media/marda/TWOTB1/xBD/hurricanes/images/florence/hurricane-florence_00000243_post_disaster.png,61,39,1,739,800,354,393,602,34.79319705321706,23.154340313423322
328,/media/marda/TWOTB1/xBD/hurricanes/images/florence/hurricane-florence_00000243_post_disaster.png,60,65,1,784,844,395,460,616,54.280078694054346,15.16527436038864
329,/media/marda/TWOTB1/xBD/hurricanes/images/florence/hurricane-florence_00000243_post_disaster.png,87,74,1,957,1044,522,596,1497,51.36440194615021,38.531393784663685
330,/media/marda/TWOTB1/xBD/hurricanes/images/florence/hurricane-florence_00000243_post_disaster.png,52,74,1,633,685,576,650,775,61.1018422750631,16.884327549392825
331,/media/marda/TWOTB1/xBD/hurricanes/images/florence/hurricane-florence_00000243_post_disaster.png,62,50,1,860,922,599,649,400,24.082169747024583,22.217040763240586
332,/media/marda/TWOTB1/xBD/hurricanes/images/florence/hurricane-florence_00000243_post_disaster.png,56,54,1,913,969,610,664,252,35.04167134853725,10.281923623741559
333,/media/marda/TWOTB1/xBD/hurricanes/images/florence/hurricane-florence_00000243_post_disaster.png,61,54,1,835,896,614,668,473,26.58940813880657,23.779191551006463
334,/media/marda/TWOTB1/xBD/hurricanes/images/florence/hurricane-florence_00000243_post_disaster.png,46,38,1,998,1044,615,653,49,12.726446934062029,5.608056091393508
335,/media/marda/TWOTB1/xBD/hurricanes/images/florence/hurricane-florence_00000243_post_disaster.png,57,41,1,927,984,632,673,153,22.8115607827859,8.961720438362038
336,/media/marda/TWOTB1/xBD/hurricanes/images/florence/hurricane-florence_00000243_post_disaster.png,69,53,1,940,1009,652,705,556,31.511541343603938,23.168620800088842
337,/media/marda/TWOTB1/xBD/hurricanes/images/florence/hurricane-florence_00000243_post_disaster.png,35,35,1,591,626,660,695,77,10.55588999393662,9.879886005155614
338,/media/marda/TWOTB1/xBD/hurricanes/images/florence/hurricane-florence_00000243_post_disaster.png,48,39,1,888,936,669,708,123,15.051559531908593,11.040032121476829
339,/media/marda/TWOTB1/xBD/hurricanes/images/florence/hurricane-florence_00000243_post_disaster.png,61,68,1,608,669,680,748,1051,42.76160217554167,32.8117674748645
340,/media/marda/TWOTB1/xBD/hurricanes/images/florence/hurricane-florence_00000243_post_disaster.png,73,84,1,836,909,680,764,1414,58.3152616741024,34.18334532305352
341,/media/marda/TWOTB1/xBD/hurricanes/images/florence/hurricane-florence_00000243_post_disaster.png,67,77,1,916,983,829,906,790,48.162759050453346,21.909761861846302
342,/media/marda/TWOTB1/xBD/hurricanes/images/florence/hurricane-florence_00000261_pre_disaster.png,63,42,1,729,792,183,225,766,34.06704578174558,31.870285593474897
343,/media/marda/TWOTB1/xBD/hurricanes/images/florence/hurricane-florence_00000261_pre_disaster.png,62,55,1,850,912,754,809,680,32.72973937139042,27.562294491494594
344,/media/marda/TWOTB1/xBD/hurricanes/images/florence/hurricane-florence_00000393_post_disaster.png,60,9,1,585,645,0,9,189,36.2848853859413,7.777599163323771
345,/media/marda/TWOTB1/xBD/hurricanes/images/florence/hurricane-florence_00000393_post_disaster.png,51,46,1,638,689,18,64,604,52.52028353378615,15.31166138060679
346,/media/marda/TWOTB1/xBD/hurricanes/images/florence/hurricane-florence_00000393_post_disaster.png,66,52,1,728,794,93,145,1116,55.73460105245081,26.560744689040007
347,/media/marda/TWOTB1/xBD/hurricanes/images/florence/hurricane-florence_00000393_post_disaster.png,64,55,1,756,820,163,218,1012,55.16043131929987,24.35682011649203
348,/media/marda/TWOTB1/xBD/hurricanes/images/florence/hurricane-florence_00000393_post_disaster.png,52,28,1,691,743,216,244,279,24.4031184446152,15.318082146699172
349,/media/marda/TWOTB1/xBD/hurricanes/images/florence/hurricane-florence_00000393_post_disaster.png,64,52,1,768,832,226,278,889,46.8568373338776,25.107069788643805
350,/media/marda/TWOTB1/xBD/hurricanes/images/florence/hurricane-florence_00000393_post_disaster.png,47,18,1,806,853,275,293,114,16.5763128080722,9.017182029660878
351,/media/marda/TWOTB1/xBD/hurricanes/images/florence/hurricane-florence_00000393_post_disaster.png,44,19,1,782,826,278,297,142,15.294392112742031,12.263240389194621
352,/media/marda/TWOTB1/xBD/hurricanes/images/florence/hurricane-florence_00000323_pre_disaster.png,47,44,1,745,792,751,795,296,21.42758678171418,18.37582097331432
353,/media/marda/TWOTB1/xBD/hurricanes/images/florence/hurricane-florence_00000323_pre_disaster.png,59,66,1,835,894,947,1013,416,25.917797735406236,21.448350084456106
354,/media/marda/TWOTB1/xBD/hurricanes/images/florence/hurricane-florence_00000111_pre_disaster.png,73,49,1,522,595,285,334,1014,58.08130823688171,23.209306667103643
355,/media/marda/TWOTB1/xBD/hurricanes/images/florence/hurricane-florence_00000111_pre_disaster.png,19,28,1,56,75,350,378,241,20.01069155576004,15.577363835344807
356,/media/marda/TWOTB1/xBD/hurricanes/images/florence/hurricane-florence_00000111_pre_disaster.png,35,26,1,509,544,373,399,114,13.573734686029754,11.301893520844123
357,/media/marda/TWOTB1/xBD/hurricanes/images/florence/hurricane-florence_00000111_pre_disaster.png,37,36,1,120,157,427,463,336,35.164880607337096,12.772840623213511
358,/media/marda/TWOTB1/xBD/hurricanes/images/florence/hurricane-florence_00000202_post_disaster.png,41,35,1,150,191,0,35,907,37.746815876043634,33.69184864528814
359,/media/marda/TWOTB1/xBD/hurricanes/images/florence/hurricane-florence_00000202_post_disaster.png,57,17,1,568,625,0,17,303,29.47438635157825,15.832949985232936
360,/media/marda/TWOTB1/xBD/hurricanes/images/florence/hurricane-florence_00000202_post_disaster.png,51,18,1,854,905,0,18,143,23.49458830308574,8.210875273062657
361,/media/marda/TWOTB1/xBD/hurricanes/images/florence/hurricane-florence_00000202_post_disaster.png,101,32,1,916,1017,0,32,1056,55.45060948747665,29.3053549457404
362,/media/marda/TWOTB1/xBD/hurricanes/images/florence/hurricane-florence_00000202_post_disaster.png,39,40,1,333,372,5,45,732,41.42108496275289,23.61830018479905
363,/media/marda/TWOTB1/xBD/hurricanes/images/florence/hurricane-florence_00000202_post_disaster.png,56,39,1,611,667,6,45,582,40.078178253547236,19.944965501934043
364,/media/marda/TWOTB1/xBD/hurricanes/images/florence/hurricane-florence_00000202_post_disaster.png,59,44,1,744,803,24,68,735,41.72438667329568,24.357228672863595
365,/media/marda/TWOTB1/xBD/hurricanes/images/florence/hurricane-florence_00000202_post_disaster.png,57,27,1,764,821,68,95,398,24.440100423607895,21.69466901286097
366,/media/marda/TWOTB1/xBD/hurricanes/images/florence/hurricane-florence_00000202_post_disaster.png,57,35,1,710,767,73,108,609,35.72454686834,22.13518461210095
367,/media/marda/TWOTB1/xBD/hurricanes/images/florence/hurricane-florence_00000202_post_disaster.png,55,31,1,708,763,117,148,380,23.097292880049636,21.794569531403724
368,/media/marda/TWOTB1/xBD/hurricanes/images/florence/hurricane-florence_00000202_post_disaster.png,82,59,1,951,1033,128,187,1805,54.237511323982865,44.04441529535745
369,/media/marda/TWOTB1/xBD/hurricanes/images/florence/hurricane-florence_00000202_post_disaster.png,75,49,1,674,749,142,191,1047,49.83081415782194,28.043667641412945
370,/media/marda/TWOTB1/xBD/hurricanes/images/florence/hurricane-florence_00000202_post_disaster.png,73,55,1,508,581,153,208,1234,52.34132580732695,35.82320958941591
371,/media/marda/TWOTB1/xBD/hurricanes/images/florence/hurricane-florence_00000202_post_disaster.png,50,17,1,909,959,191,208,90,12.399479486862164,9.776821660857772
372,/media/marda/TWOTB1/xBD/hurricanes/images/florence/hurricane-florence_00000202_post_disaster.png,58,32,1,753,811,195,227,394,30.064454429397426,17.511800209769955
373,/media/marda/TWOTB1/xBD/hurricanes/images/florence/hurricane-florence_00000202_post_disaster.png,48,42,1,173,221,197,239,1008,44.96024824361512,30.499213734814816
374,/media/marda/TWOTB1/xBD/hurricanes/images/florence/hurricane-florence_00000202_post_disaster.png,75,63,1,968,1043,199,262,1613,58.084266797893335,37.143999426953854
375,/media/marda/TWOTB1/xBD/hurricanes/images/florence/hurricane-florence_00000202_post_disaster.png,51,38,1,392,443,215,253,473,36.1268766352791,17.50176141428892
376,/media/marda/TWOTB1/xBD/hurricanes/images/florence/hurricane-florence_00000202_post_disaster.png,39,45,1,74,113,217,262,1031,38.07551185561116,35.546853192942855
377,/media/marda/TWOTB1/xBD/hurricanes/images/florence/hurricane-florence_00000202_post_disaster.png,63,57,1,457,520,223,280,1183,50.31772106960604,31.326000219834924
378,/media/marda/TWOTB1/xBD/hurricanes/images/florence/hurricane-florence_00000202_post_disaster.png,25,49,1,0,25,231,280,741,40.44143150023446,24.723489778622856
379,/media/marda/TWOTB1/xBD/hurricanes/images/florence/hurricane-florence_00000202_post_disaster.png,80,52,1,599,679,237,289,1296,59.665833198636996,28.362893899037058
380,/media/marda/TWOTB1/xBD/hurricanes/images/florence/hurricane-florence_00000202_post_disaster.png,59,36,1,939,998,243,279,383,28.186189733547167,18.06098126118793
381,/media/marda/TWOTB1/xBD/hurricanes/images/florence/hurricane-florence_00000202_post_disaster.png,45,29,1,585,630,275,304,238,21.157739246828484,15.031594297117413
382,/media/marda/TWOTB1/xBD/hurricanes/images/florence/hurricane-florence_00000202_post_disaster.png,79,60,1,655,734,279,339,1526,49.30065457136541,41.61404747153206
383,/media/marda/TWOTB1/xBD/hurricanes/images/florence/hurricane-florence_00000202_post_disaster.png,53,67,1,267,320,283,350,1696,60.88337628366664,38.714169156935995
384,/media/marda/TWOTB1/xBD/hurricanes/images/florence/hurricane-florence_00000202_post_disaster.png,62,65,1,981,1043,293,358,887,63.2372685985189,20.28695910151613
385,/media/marda/TWOTB1/xBD/hurricanes/images/florence/hurricane-florence_00000202_post_disaster.png,43,32,1,158,201,294,326,657,40.86225352368587,21.217945105795398
386,/media/marda/TWOTB1/xBD/hurricanes/images/florence/hurricane-florence_00000202_post_disaster.png,20,37,1,124,144,305,342,335,26.094421278667017,16.89710799368494
387,/media/marda/TWOTB1/xBD/hurricanes/images/florence/hurricane-florence_00000202_post_disaster.png,73,55,1,511,584,315,370,1211,47.88254604682486,33.92633482957741
388,/media/marda/TWOTB1/xBD/hurricanes/images/florence/hurricane-florence_00000202_post_disaster.png,83,57,1,866,949,327,384,1569,51.16986765344631,39.809016662426735
389,/media/marda/TWOTB1/xBD/hurricanes/images/florence/hurricane-florence_00000202_post_disaster.png,92,91,1,672,764,333,424,2150,88.18839096245814,37.87389053640246
390,/media/marda/TWOTB1/xBD/hurricanes/images/florence/hurricane-florence_00000202_post_disaster.png,43,63,1,146,189,350,413,1202,49.29062824227847,34.1948409698173
391,/media/marda/TWOTB1/xBD/hurricanes/images/florence/hurricane-florence_00000202_post_disaster.png,56,42,1,246,302,353,395,927,49.455756819106526,24.6405998123214
392,/media/marda/TWOTB1/xBD/hurricanes/images/florence/hurricane-florence_00000202_post_disaster.png,65,60,1,478,543,362,422,1181,42.929335828784026,36.65437038493045
393,/media/marda/TWOTB1/xBD/hurricanes/images/florence/hurricane-florence_00000202_post_disaster.png,26,45,1,115,141,374,419,510,35.021267817089694,19.742947797108616
394,/media/marda/TWOTB1/xBD/hurricanes/images/florence/hurricane-florence_00000202_post_disaster.png,57,53,1,236,293,416,469,1023,53.96934182723285,27.454128779176436
395,/media/marda/TWOTB1/xBD/hurricanes/images/florence/hurricane-florence_00000202_post_disaster.png,86,89,1,916,1002,465,554,2095,80.02669358204315,39.40187970090498
396,/media/marda/TWOTB1/xBD/hurricanes/images/florence/hurricane-florence_00000202_post_disaster.png,53,48,1,402,455,484,532,645,36.960708333192855,22.892559798343903
397,/media/marda/TWOTB1/xBD/hurricanes/images/florence/hurricane-florence_00000202_post_disaster.png,48,45,1,233,281,485,530,879,42.05190296216172,27.55642597887103
398,/media/marda/TWOTB1/xBD/hurricanes/images/florence/hurricane-florence_00000202_post_disaster.png,55,46,1,709,764,502,548,482,28.02126261398671,22.723492097335765
399,/media/marda/TWOTB1/xBD/hurricanes/images/florence/hurricane-florence_00000202_post_disaster.png,70,70,1,748,818,506,576,1323,47.16843050918058,36.80494019611162
400,/media/marda/TWOTB1/xBD/hurricanes/images/florence/hurricane-florence_00000202_post_disaster.png,51,64,1,363,414,524,588,941,41.7310866100302,30.041162284480787
401,/media/marda/TWOTB1/xBD/hurricanes/images/florence/hurricane-florence_00000202_post_disaster.png,58,61,1,398,456,533,594,796,43.369007324255044,24.48491603531551
402,/media/marda/TWOTB1/xBD/hurricanes/images/florence/hurricane-florence_00000202_post_disaster.png,75,84,1,937,1012,544,628,1469,68.41968131907238,28.40540472499418
403,/media/marda/TWOTB1/xBD/hurricanes/images/florence/hurricane-florence_00000202_post_disaster.png,68,73,1,769,837,610,683,1325,49.520173431932065,35.411271470520155
404,/media/marda/TWOTB1/xBD/hurricanes/images/florence/hurricane-florence_00000202_post_disaster.png,91,77,1,950,1041,640,717,1569,62.271934788555434,38.15158275458675
405,/media/marda/TWOTB1/xBD/hurricanes/images/florence/hurricane-florence_00000202_post_disaster.png,86,93,1,788,874,713,806,2116,64.53297629049978,47.96413287676218
406,/media/marda/TWOTB1/xBD/hurricanes/images/florence/hurricane-florence_00000202_post_disaster.png,76,70,1,967,1043,715,785,997,43.83297657150246,30.454912156431725
407,/media/marda/TWOTB1/xBD/hurricanes/images/florence/hurricane-florence_00000202_post_disaster.png,67,61,1,686,753,753,814,842,41.06821869784789,27.097182274009874
408,/media/marda/TWOTB1/xBD/hurricanes/images/florence/hurricane-florence_00000202_post_disaster.png,53,77,1,990,1043,802,879,345,45.96663036886508,11.083981767686028
409,/media/marda/TWOTB1/xBD/hurricanes/images/florence/hurricane-florence_00000202_post_disaster.png,90,93,1,739,829,885,978,2298,59.55488725701357,50.97240178691655
410,/media/marda/TWOTB1/xBD/hurricanes/images/florence/hurricane-florence_00000202_post_disaster.png,75,85,1,894,969,944,1029,1247,48.40461521707153,34.14118709329567
411,/media/marda/TWOTB1/xBD/hurricanes/images/florence/hurricane-florence_00000074_post_disaster.png,66,37,1,977,1043,37,74,739,35.07288005853142,28.326070481341468
412,/media/marda/TWOTB1/xBD/hurricanes/images/florence/hurricane-florence_00000074_post_disaster.png,77,60,1,467,544,121,181,1778,50.01119591670475,47.676018309398465
413,/media/marda/TWOTB1/xBD/hurricanes/images/florence/hurricane-florence_00000184_post_disaster.png,40,22,1,35,75,0,22,571,38.48271538826516,20.263879407473123
414,/media/marda/TWOTB1/xBD/hurricanes/images/florence/hurricane-florence_00000184_post_disaster.png,47,18,1,166,213,0,18,404,35.174692835225294,16.895327481341987
415,/media/marda/TWOTB1/xBD/hurricanes/images/florence/hurricane-florence_00000184_post_disaster.png,48,21,1,228,276,0,21,540,39.01760643526924,19.18970191710583
416,/media/marda/TWOTB1/xBD/hurricanes/images/florence/hurricane-florence_00000184_post_disaster.png,47,46,1,71,118,54,100,1013,50.34860321994138,26.54488235068609
417,/media/marda/TWOTB1/xBD/hurricanes/images/florence/hurricane-florence_00000184_post_disaster.png,48,40,1,120,168,95,135,960,43.06547809304258,29.52847371287777
418,/media/marda/TWOTB1/xBD/hurricanes/images/florence/hurricane-florence_00000184_post_disaster.png,22,49,1,0,22,117,166,614,42.25377999753954,20.073498366907042
419,/media/marda/TWOTB1/xBD/hurricanes/images/florence/hurricane-florence_00000184_post_disaster.png,48,41,1,175,223,118,159,937,42.05131408128882,29.586645816049273
420,/media/marda/TWOTB1/xBD/hurricanes/images/florence/hurricane-florence_00000184_post_disaster.png,54,43,1,224,278,126,169,1029,41.44549157068269,33.59661605424145
421,/media/marda/TWOTB1/xBD/hurricanes/images/florence/hurricane-florence_00000184_post_disaster.png,44,45,1,27,71,151,196,951,43.234022570779885,28.967345531772626
422,/media/marda/TWOTB1/xBD/hurricanes/images/florence/hurricane-florence_00000184_post_disaster.png,53,43,1,269,322,163,206,907,42.68632056422051,28.003842136367876
423,/media/marda/TWOTB1/xBD/hurricanes/images/florence/hurricane-florence_00000184_post_disaster.png,47,39,1,71,118,186,225,867,42.87641430510636,27.09561542956435
424,/media/marda/TWOTB1/xBD/hurricanes/images/florence/hurricane-florence_00000184_post_disaster.png,45,46,1,122,167,199,245,926,42.000943468206515,29.191188377231853
425,/media/marda/TWOTB1/xBD/hurricanes/images/florence/hurricane-florence_00000184_post_disaster.png,18,25,1,27,45,211,236,153,15.02813717474666,13.64482454441416
426,/media/marda/TWOTB1/xBD/hurricanes/images/florence/hurricane-florence_00000184_post_disaster.png,48,42,1,304,352,218,260,681,33.87192130774841,27.2357725007615
427,/media/marda/TWOTB1/xBD/hurricanes/images/florence/hurricane-florence_00000184_post_disaster.png,45,51,1,166,211,225,276,934,38.46123951332285,32.93315070363424
428,/media/marda/TWOTB1/xBD/hurricanes/images/florence/hurricane-florence_00000184_post_disaster.png,45,48,1,331,376,273,321,899,41.656275782430846,28.685100095214732
429,/media/marda/TWOTB1/xBD/hurricanes/images/florence/hurricane-florence_00000184_post_disaster.png,42,45,1,231,273,280,325,756,37.253044968245796,27.10937851619664
430,/media/marda/TWOTB1/xBD/hurricanes/images/florence/hurricane-florence_00000184_post_disaster.png,31,42,1,0,31,307,349,586,33.70212935905742,24.123624963038186
431,/media/marda/TWOTB1/xBD/hurricanes/images/florence/hurricane-florence_00000184_post_disaster.png,44,58,1,41,85,307,365,1297,44.128385255885505,38.71161772957554
432,/media/marda/TWOTB1/xBD/hurricanes/images/florence/hurricane-florence_00000184_post_disaster.png,23,28,1,125,148,309,337,152,18.673442244654595,10.87093411235489
433,/media/marda/TWOTB1/xBD/hurricanes/images/florence/hurricane-florence_00000184_post_disaster.png,27,27,1,188,215,324,351,189,21.026664712812998,11.922541706388106
434,/media/marda/TWOTB1/xBD/hurricanes/images/florence/hurricane-florence_00000184_post_disaster.png,46,51,1,94,140,329,380,978,44.542753990956264,28.772949312719046
435,/media/marda/TWOTB1/xBD/hurricanes/images/florence/hurricane-florence_00000184_post_disaster.png,19,27,1,223,242,330,357,135,14.965582248526122,12.052221343828055
436,/media/marda/TWOTB1/xBD/hurricanes/images/florence/hurricane-florence_00000184_post_disaster.png,40,41,1,339,379,343,384,677,32.494885973036546,28.056763145044542
437,/media/marda/TWOTB1/xBD/hurricanes/images/florence/hurricane-florence_00000184_post_disaster.png,40,45,1,168,208,356,401,783,35.486501679307956,28.845305926295584
438,/media/marda/TWOTB1/xBD/hurricanes/images/florence/hurricane-florence_00000184_post_disaster.png,48,42,1,221,269,360,402,897,42.74051206231665,27.997532629243135
439,/media/marda/TWOTB1/xBD/hurricanes/images/florence/hurricane-florence_00000184_post_disaster.png,48,58,1,330,378,403,461,949,42.92008194365212,29.058434828001268
440,/media/marda/TWOTB1/xBD/hurricanes/images/florence/hurricane-florence_00000184_post_disaster.png,41,48,1,10,51,418,466,799,40.458828067117686,26.57223025964238
441,/media/marda/TWOTB1/xBD/hurricanes/images/florence/hurricane-florence_00000184_post_disaster.png,49,47,1,62,111,434,481,1024,49.1633563894976,28.78177834780226
442,/media/marda/TWOTB1/xBD/hurricanes/images/florence/hurricane-florence_00000184_post_disaster.png,42,49,1,128,170,450,499,803,36.346313640222995,30.148071587188568
443,/media/marda/TWOTB1/xBD/hurricanes/images/florence/hurricane-florence_00000184_post_disaster.png,49,53,1,185,234,468,521,942,42.063947488788656,29.571558041593487
444,/media/marda/TWOTB1/xBD/hurricanes/images/florence/hurricane-florence_00000184_post_disaster.png,50,60,1,347,397,468,528,997,42.08357343033298,34.16344367949006
445,/media/marda/TWOTB1/xBD/hurricanes/images/florence/hurricane-florence_00000184_post_disaster.png,36,46,1,2,38,499,545,732,38.32858685925238,25.28623370385971
446,/media/marda/TWOTB1/xBD/hurricanes/images/florence/hurricane-florence_00000184_post_disaster.png,47,56,1,235,282,516,572,793,36.353616339905145,29.688397125890592
447,/media/marda/TWOTB1/xBD/hurricanes/images/florence/hurricane-florence_00000184_post_disaster.png,52,59,1,359,411,529,588,985,39.18669154934902,33.291747025048274
448,/media/marda/TWOTB1/xBD/hurricanes/images/florence/hurricane-florence_00000184_post_disaster.png,64,108,1,118,182,540,648,2373,95.10407535492551,44.039777946829865
449,/media/marda/TWOTB1/xBD/hurricanes/images/florence/hurricane-florence_00000184_post_disaster.png,40,52,1,274,314,567,619,625,32.05541246150532,25.73067374327321
450,/media/marda/TWOTB1/xBD/hurricanes/images/florence/hurricane-florence_00000184_post_disaster.png,53,59,1,378,431,596,655,936,38.411439017328746,32.52916486821883
451,/media/marda/TWOTB1/xBD/hurricanes/images/florence/hurricane-florence_00000184_post_disaster.png,36,74,1,0,36,615,689,985,42.71239987057213,37.318392342083925
452,/media/marda/TWOTB1/xBD/hurricanes/images/florence/hurricane-florence_00000184_post_disaster.png,48,70,1,276,324,625,695,1077,46.32005027501423,30.83100930454745
453,/media/marda/TWOTB1/xBD/hurricanes/images/florence/hurricane-florence_00000184_post_disaster.png,31,52,1,246,277,644,696,429,29.202252465761948,19.529408430024475
454,/media/marda/TWOTB1/xBD/hurricanes/images/florence/hurricane-florence_00000184_post_disaster.png,57,50,1,688,745,672,722,488,29.547731930646062,21.909133840838642
455,/media/marda/TWOTB1/xBD/hurricanes/images/florence/hurricane-florence_00000184_post_disaster.png,55,47,1,557,612,687,734,360,34.74114512984413,14.54316675503098
456,/media/marda/TWOTB1/xBD/hurricanes/images/florence/hurricane-florence_00000184_post_disaster.png,42,39,1,694,736,694,733,92,13.902414728731426,8.914251819659482
457,/media/marda/TWOTB1/xBD/hurricanes/images/florence/hurricane-florence_00000184_post_disaster.png,44,41,1,700,744,701,742,121,16.210090965686785,10.083442706170269
458,/media/marda/TWOTB1/xBD/hurricanes/images/florence/hurricane-florence_00000184_post_disaster.png,78,67,1,464,542,710,777,1386,62.49044015765487,29.50352351603882
459,/media/marda/TWOTB1/xBD/hurricanes/images/florence/hurricane-florence_00000184_post_disaster.png,97,139,1,320,417,746,885,4774,118.77187459196209,59.63607918003337
460,/media/marda/TWOTB1/xBD/hurricanes/images/florence/hurricane-florence_00000184_post_disaster.png,79,73,1,708,787,770,843,1413,50.176223215532396,37.892808876336446
461,/media/marda/TWOTB1/xBD/hurricanes/images/florence/hurricane-florence_00000184_post_disaster.png,26,57,1,260,286,786,843,301,25.124529370675173,16.03303869009928
462,/media/marda/TWOTB1/xBD/hurricanes/images/florence/hurricane-florence_00000184_post_disaster.png,122,118,1,570,692,789,907,5885,98.85329955985857,87.85458226217837
463,/media/marda/TWOTB1/xBD/hurricanes/images/florence/hurricane-florence_00000184_post_disaster.png,85,127,1,123,208,804,931,4763,98.09620827024696,65.06951952713013
464,/media/marda/TWOTB1/xBD/hurricanes/images/florence/hurricane-florence_00000184_post_disaster.png,23,49,1,234,257,819,868,204,18.082635471816392,14.983171178906492
465,/media/marda/TWOTB1/xBD/hurricanes/images/florence/hurricane-florence_00000184_post_disaster.png,52,64,1,213,265,838,902,888,46.507954243654645,25.360976544281694
466,/media/marda/TWOTB1/xBD/hurricanes/images/florence/hurricane-florence_00000184_post_disaster.png,32,51,1,287,319,863,914,241,22.641058638398693,14.260577674815265
467,/media/marda/TWOTB1/xBD/hurricanes/images/florence/hurricane-florence_00000184_post_disaster.png,30,50,1,9,39,864,914,286,32.394062398080365,11.832500381494784
468,/media/marda/TWOTB1/xBD/hurricanes/images/florence/hurricane-florence_00000184_post_disaster.png,51,50,1,397,448,866,916,277,39.14504601327716,9.493061315246894
469,/media/marda/TWOTB1/xBD/hurricanes/images/florence/hurricane-florence_00000184_post_disaster.png,49,52,1,616,665,871,923,314,25.6627404236042,16.38409973517182
470,/media/marda/TWOTB1/xBD/hurricanes/images/florence/hurricane-florence_00000184_post_disaster.png,18,45,1,25,43,880,925,138,18.944360326244407,9.827994337553424
471,/media/marda/TWOTB1/xBD/hurricanes/images/florence/hurricane-florence_00000184_post_disaster.png,24,55,1,225,249,895,950,184,18.69602372820269,13.1819211263218
472,/media/marda/TWOTB1/xBD/hurricanes/images/florence/hurricane-florence_00000184_post_disaster.png,10,47,1,6,16,898,945,68,9.852632352540299,9.436274836210513
473,/media/marda/TWOTB1/xBD/hurricanes/images/florence/hurricane-florence_00000184_post_disaster.png,15,45,1,233,248,915,960,63,10.327955589886445,8.0
474,/media/marda/TWOTB1/xBD/hurricanes/images/florence/hurricane-florence_00000184_post_disaster.png,34,53,1,517,551,916,969,156,17.00549448926891,12.350508113699977
475,/media/marda/TWOTB1/xBD/hurricanes/images/florence/hurricane-florence_00000459_pre_disaster.png,28,52,1,0,28,0,52,931,46.54547123589193,31.203519892302197
476,/media/marda/TWOTB1/xBD/hurricanes/images/florence/hurricane-florence_00000459_pre_disaster.png,69,31,1,308,377,0,31,845,45.87543566636055,32.01514787647992
477,/media/marda/TWOTB1/xBD/hurricanes/images/florence/hurricane-florence_00000459_pre_disaster.png,51,11,1,585,636,0,11,253,28.496679982511306,11.622737937909777
478,/media/marda/TWOTB1/xBD/hurricanes/images/florence/hurricane-florence_00000459_pre_disaster.png,55,26,1,662,717,0,26,498,30.470876211996067,21.74004647078656
479,/media/marda/TWOTB1/xBD/hurricanes/images/florence/hurricane-florence_00000459_pre_disaster.png,91,61,1,711,802,0,61,2072,71.19020596367223,46.44185264018034
480,/media/marda/TWOTB1/xBD/hurricanes/images/florence/hurricane-florence_00000459_pre_disaster.png,9,11,1,61,70,57,68,81,11.893328104054724,9.137289889789303
481,/media/marda/TWOTB1/xBD/hurricanes/images/florence/hurricane-florence_00000459_pre_disaster.png,82,56,1,221,303,97,153,2335,67.06965833805867,48.05047309548832
482,/media/marda/TWOTB1/xBD/hurricanes/images/florence/hurricane-florence_00000459_pre_disaster.png,76,63,1,521,597,108,171,1884,64.7383163611208,39.05140528006153
483,/media/marda/TWOTB1/xBD/hurricanes/images/florence/hurricane-florence_00000459_pre_disaster.png,63,42,1,981,1044,110,152,535,33.914938381149554,22.130053095277624
484,/media/marda/TWOTB1/xBD/hurricanes/images/florence/hurricane-florence_00000459_pre_disaster.png,46,55,1,45,91,143,198,1577,52.270683753066066,41.975052359048135
485,/media/marda/TWOTB1/xBD/hurricanes/images/florence/hurricane-florence_00000459_pre_disaster.png,74,70,1,329,403,152,222,2317,62.12561116662108,51.70657638532209
486,/media/marda/TWOTB1/xBD/hurricanes/images/florence/hurricane-florence_00000459_pre_disaster.png,103,66,1,742,845,153,219,2479,69.84337281311775,48.24488036922713
487,/media/marda/TWOTB1/xBD/hurricanes/images/florence/hurricane-florence_00000459_pre_disaster.png,32,44,1,0,32,163,207,1117,42.58234987602826,34.7749442374363
488,/media/marda/TWOTB1/xBD/hurricanes/images/florence/hurricane-florence_00000459_pre_disaster.png,90,57,1,565,655,169,226,2138,64.34432323595452,44.146323125313515
489,/media/marda/TWOTB1/xBD/hurricanes/images/florence/hurricane-florence_00000459_pre_disaster.png,62,59,1,159,221,199,258,1426,56.49016833553939,33.768239426780326
490,/media/marda/TWOTB1/xBD/hurricanes/images/florence/hurricane-florence_00000459_pre_disaster.png,66,68,1,198,264,253,321,1874,61.512963342239296,44.22197177434853
491,/media/marda/TWOTB1/xBD/hurricanes/images/florence/hurricane-florence_00000459_pre_disaster.png,75,62,1,493,568,280,342,1545,47.340516858021196,43.53341369947993
492,/media/marda/TWOTB1/xBD/hurricanes/images/florence/hurricane-florence_00000459_pre_disaster.png,67,74,1,349,416,375,449,1691,56.02623640437738,42.39586857807183
493,/media/marda/TWOTB1/xBD/hurricanes/images/florence/hurricane-florence_00000459_pre_disaster.png,86,82,1,409,495,396,478,2414,73.32885040038984,43.41769834917243
494,/media/marda/TWOTB1/xBD/hurricanes/images/florence/hurricane-florence_00000459_pre_disaster.png,33,67,1,0,33,458,525,1103,49.106491132451104,30.803257092717068
495,/media/marda/TWOTB1/xBD/hurricanes/images/florence/hurricane-florence_00000459_pre_disaster.png,54,60,1,21,75,483,543,1382,50.403014880928694,36.80788038223672
496,/media/marda/TWOTB1/xBD/hurricanes/images/florence/hurricane-florence_00000459_pre_disaster.png,60,71,1,56,116,509,580,1621,54.48803530200199,40.073154879670305
497,/media/marda/TWOTB1/xBD/hurricanes/images/florence/hurricane-florence_00000459_pre_disaster.png,57,66,1,94,151,537,603,1389,51.607231985857574,36.347965053489816
498,/media/marda/TWOTB1/xBD/hurricanes/images/florence/hurricane-florence_00000459_pre_disaster.png,61,76,1,129,190,566,642,1557,50.33086655177538,42.07574188923507
499,/media/marda/TWOTB1/xBD/hurricanes/images/florence/hurricane-florence_00000459_pre_disaster.png,18,57,1,0,18,581,638,233,29.940612068622226,15.753111871805558
500,/media/marda/TWOTB1/xBD/hurricanes/images/florence/hurricane-florence_00000459_pre_disaster.png,58,86,1,168,226,593,679,1670,57.02572534345268,39.71248798026598
501,/media/marda/TWOTB1/xBD/hurricanes/images/florence/hurricane-florence_00000459_pre_disaster.png,49,82,1,210,259,627,709,1406,55.757391187921904,35.4130582452616
502,/media/marda/TWOTB1/xBD/hurricanes/images/florence/hurricane-florence_00000459_pre_disaster.png,60,70,1,29,89,632,702,1544,54.74545459751406,37.61310024323627
503,/media/marda/TWOTB1/xBD/hurricanes/images/florence/hurricane-florence_00000459_pre_disaster.png,39,65,1,79,118,660,725,842,37.74500370389708,31.547748955326934
504,/media/marda/TWOTB1/xBD/hurricanes/images/florence/hurricane-florence_00000459_pre_disaster.png,63,69,1,981,1044,670,739,637,44.61803049590285,22.16083585896279
505,/media/marda/TWOTB1/xBD/hurricanes/images/florence/hurricane-florence_00000459_pre_disaster.png,66,83,1,269,335,687,770,1618,53.334925744686586,42.71352777060233
506,/media/marda/TWOTB1/xBD/hurricanes/images/florence/hurricane-florence_00000459_pre_disaster.png,46,75,1,113,159,690,765,1111,42.88645084917751,36.02061952733837
507,/media/marda/TWOTB1/xBD/hurricanes/images/florence/hurricane-florence_00000459_pre_disaster.png,57,79,1,17,74,691,770,1493,49.41317032377334,41.50167466882546
508,/media/marda/TWOTB1/xBD/hurricanes/images/florence/hurricane-florence_00000459_pre_disaster.png,51,90,1,141,192,715,805,1619,56.47649534779498,39.41970332891079
509,/media/marda/TWOTB1/xBD/hurricanes/images/florence/hurricane-florence_00000459_pre_disaster.png,56,82,1,313,369,718,800,1352,50.42449922173232,35.291263752314826
510,/media/marda/TWOTB1/xBD/hurricanes/images/florence/hurricane-florence_00000459_pre_disaster.png,11,65,1,0,11,728,793,328,42.08296900660087,10.75482190958551
511,/media/marda/TWOTB1/xBD/hurricanes/images/florence/hurricane-florence_00000459_pre_disaster.png,61,90,1,337,398,758,848,1614,55.06446091966263,39.51262471548777
512,/media/marda/TWOTB1/xBD/hurricanes/images/florence/hurricane-florence_00000459_pre_disaster.png,43,73,1,105,148,761,834,966,41.85422850443386,33.29930835660281
513,/media/marda/TWOTB1/xBD/hurricanes/images/florence/hurricane-florence_00000459_pre_disaster.png,67,78,1,226,293,772,850,1530,56.339457595159274,36.24142747946684
514,/media/marda/TWOTB1/xBD/hurricanes/images/florence/hurricane-florence_00000459_pre_disaster.png,67,93,1,370,437,787,880,1711,54.29795358278003,42.16177991441414
515,/media/marda/TWOTB1/xBD/hurricanes/images/florence/hurricane-florence_00000459_pre_disaster.png,16,83,1,0,16,792,875,492,51.787514669004786,13.871195208471422
516,/media/marda/TWOTB1/xBD/hurricanes/images/florence/hurricane-florence_00000459_pre_disaster.png,55,94,1,196,251,802,896,1545,57.429235474129605,36.80427264886081
517,/media/marda/TWOTB1/xBD/hurricanes/images/florence/hurricane-florence_00000459_pre_disaster.png,76,80,1,401,477,825,905,1616,56.49260887921454,38.385129104047216
518,/media/marda/TWOTB1/xBD/hurricanes/images/florence/hurricane-florence_00000459_pre_disaster.png,49,92,1,166,215,837,929,1435,54.24477766340034,35.475735284820104
519,/media/marda/TWOTB1/xBD/hurricanes/images/florence/hurricane-florence_00000459_pre_disaster.png,54,86,1,271,325,838,924,1249,49.88735308295848,36.57123559245369
520,/media/marda/TWOTB1/xBD/hurricanes/images/florence/hurricane-florence_00000459_pre_disaster.png,80,82,1,444,524,858,940,1572,55.14767178356957,38.77980465226981
521,/media/marda/TWOTB1/xBD/hurricanes/images/florence/hurricane-florence_00000459_pre_disaster.png,41,86,1,71,112,880,966,1368,51.0451076968475,35.70340233492894
522,/media/marda/TWOTB1/xBD/hurricanes/images/florence/hurricane-florence_00000459_pre_disaster.png,78,99,1,478,556,885,984,1893,59.01785375952344,43.72713168468938
523,/media/marda/TWOTB1/xBD/hurricanes/images/florence/hurricane-florence_00000459_pre_disaster.png,47,89,1,25,72,888,977,1582,55.34832887056852,38.723843858914314
524,/media/marda/TWOTB1/xBD/hurricanes/images/florence/hurricane-florence_00000459_pre_disaster.png,71,85,1,327,398,895,980,1583,55.82917096735929,39.39586075181603
525,/media/marda/TWOTB1/xBD/hurricanes/images/florence/hurricane-florence_00000459_pre_disaster.png,77,86,1,359,436,917,1003,1650,56.30358336316464,38.96791361922521
526,/media/marda/TWOTB1/xBD/hurricanes/images/florence/hurricane-florence_00000459_pre_disaster.png,75,99,1,502,577,920,1019,1807,57.98190091625542,41.94932303079084
527,/media/marda/TWOTB1/xBD/hurricanes/images/florence/hurricane-florence_00000459_pre_disaster.png,66,89,1,392,458,953,1042,1584,55.527482315822326,38.051885680742615
528,/media/marda/TWOTB1/xBD/hurricanes/images/florence/hurricane-florence_00000459_pre_disaster.png,77,83,1,526,603,959,1042,1576,52.23651902748163,40.35303668563433
529,/media/marda/TWOTB1/xBD/hurricanes/images/florence/hurricane-florence_00000459_pre_disaster.png,24,57,1,131,155,968,1025,217,19.010430734933323,15.260040977374002
530,/media/marda/TWOTB1/xBD/hurricanes/images/florence/hurricane-florence_00000459_pre_disaster.png,55,58,1,420,475,986,1044,317,34.59157073146256,15.594881351263204
531,/media/marda/TWOTB1/xBD/hurricanes/images/florence/hurricane-florence_00000336_post_disaster.png,18,11,1,189,207,25,36,62,11.446514176567868,7.424626317382524
532,/media/marda/TWOTB1/xBD/hurricanes/images/florence/hurricane-florence_00000336_post_disaster.png,52,26,1,721,773,92,118,314,23.763111644732525,17.657819836919234
533,/media/marda/TWOTB1/xBD/hurricanes/images/florence/hurricane-florence_00000336_post_disaster.png,45,18,1,697,742,99,117,162,15.264986079985961,14.18853763506656
534,/media/marda/TWOTB1/xBD/hurricanes/images/florence/hurricane-florence_00000336_post_disaster.png,69,54,1,761,830,105,159,808,54.84424365196123,19.660439765637925
535,/media/marda/TWOTB1/xBD/hurricanes/images/florence/hurricane-florence_00000336_post_disaster.png,37,15,1,669,706,121,136,64,12.957394137331368,6.685490327556438
536,/media/marda/TWOTB1/xBD/hurricanes/images/florence/hurricane-florence_00000336_post_disaster.png,65,38,1,619,684,149,187,625,43.095235471834776,19.353208162656475
537,/media/marda/TWOTB1/xBD/hurricanes/images/florence/hurricane-florence_00000336_post_disaster.png,37,39,1,30,67,159,198,726,31.798659818024934,30.133039304885617
538,/media/marda/TWOTB1/xBD/hurricanes/images/florence/hurricane-florence_00000336_post_disaster.png,43,22,1,660,703,165,187,168,18.442860739398604,12.211700412971755
539,/media/marda/TWOTB1/xBD/hurricanes/images/florence/hurricane-florence_00000336_post_disaster.png,68,59,1,649,717,193,252,855,62.973326801434084,18.13017630111573
540,/media/marda/TWOTB1/xBD/hurricanes/images/florence/hurricane-florence_00000336_post_disaster.png,41,22,1,598,639,205,227,107,17.700858204051094,8.133198477153883
541,/media/marda/TWOTB1/xBD/hurricanes/images/florence/hurricane-florence_00000336_post_disaster.png,87,91,1,178,265,235,326,3526,84.1376732345565,55.26007754881642
542,/media/marda/TWOTB1/xBD/hurricanes/images/florence/hurricane-florence_00000341_post_disaster.png,151,155,1,162,313,572,727,8004,161.5312641606226,66.16785533894898
543,/media/marda/TWOTB1/xBD/hurricanes/images/florence/hurricane-florence_00000341_post_disaster.png,162,170,1,89,251,615,785,7889,198.01296617828808,52.959830765200685
544,/media/marda/TWOTB1/xBD/hurricanes/images/florence/hurricane-florence_00000007_post_disaster.png,75,37,1,62,137,0,37,1434,74.03572481216295,29.370318622577035
545,/media/marda/TWOTB1/xBD/hurricanes/images/florence/hurricane-florence_00000007_post_disaster.png,98,72,1,541,639,157,229,2877,69.91449641773096,54.40420356197186
546,/media/marda/TWOTB1/xBD/hurricanes/images/florence/hurricane-florence_00000007_post_disaster.png,97,86,1,453,550,235,321,3173,69.59894248529406,61.31446941726855
547,/media/marda/TWOTB1/xBD/hurricanes/images/florence/hurricane-florence_00000007_post_disaster.png,89,85,1,511,600,273,358,2697,66.77900670061824,55.917626108235964
548,/media/marda/TWOTB1/xBD/hurricanes/images/florence/hurricane-florence_00000007_post_disaster.png,118,96,1,754,872,414,510,3431,79.48973244530225,65.39437542962871
549,/media/marda/TWOTB1/xBD/hurricanes/images/florence/hurricane-florence_00000007_post_disaster.png,70,80,1,335,405,489,569,1807,67.71999919104275,35.316455133372244
550,/media/marda/TWOTB1/xBD/hurricanes/images/florence/hurricane-florence_00000007_post_disaster.png,85,111,1,959,1044,536,647,1972,84.37200446452042,38.02277483312945
551,/media/marda/TWOTB1/xBD/hurricanes/images/florence/hurricane-florence_00000007_post_disaster.png,87,100,1,477,564,542,642,2658,82.69277886140232,42.8716324532392
552,/media/marda/TWOTB1/xBD/hurricanes/images/florence/hurricane-florence_00000007_post_disaster.png,69,85,1,569,638,593,678,1215,68.18983015199133,23.592961263472194
553,/media/marda/TWOTB1/xBD/hurricanes/images/florence/hurricane-florence_00000007_post_disaster.png,123,101,1,620,743,660,761,3117,106.68232263680568,38.967881235297476
554,/media/marda/TWOTB1/xBD/hurricanes/images/florence/hurricane-florence_00000007_post_disaster.png,98,102,1,760,858,730,832,2579,81.99379536356253,43.23174993430077
555,/media/marda/TWOTB1/xBD/hurricanes/images/florence/hurricane-florence_00000007_post_disaster.png,128,134,1,869,997,820,954,4820,99.79243084454588,64.41958941764425
556,/media/marda/TWOTB1/xBD/hurricanes/images/florence/hurricane-florence_00000007_post_disaster.png,285,169,1,176,461,870,1039,15199,262.21184048434844,85.1729927081228
557,/media/marda/TWOTB1/xBD/hurricanes/images/florence/hurricane-florence_00000007_post_disaster.png,68,93,1,976,1044,879,972,1024,56.35805812071169,27.158496015688396
558,/media/marda/TWOTB1/xBD/hurricanes/images/florence/hurricane-florence_00000497_pre_disaster.png,63,69,1,585,648,905,974,706,37.87718687822439,24.894574821075906
559,/media/marda/TWOTB1/xBD/hurricanes/images/florence/hurricane-florence_00000497_pre_disaster.png,78,83,1,771,849,913,996,1200,40.45972384897426,39.56373959207077
560,/media/marda/TWOTB1/xBD/hurricanes/images/florence/hurricane-florence_00000497_pre_disaster.png,64,70,1,820,884,946,1016,558,32.51348898234365,22.90850782838035
561,/media/marda/TWOTB1/xBD/hurricanes/images/florence/hurricane-florence_00000497_pre_disaster.png,43,59,1,315,358,985,1044,348,27.57791450862996,17.38776698074031
562,/media/marda/TWOTB1/xBD/hurricanes/images/florence/hurricane-florence_00000217_pre_disaster.png,93,93,1,284,377,0,93,5031,95.67161170938118,69.89792508414119
563,/media/marda/TWOTB1/xBD/hurricanes/images/florence/hurricane-florence_00000217_pre_disaster.png,154,55,1,352,506,0,55,4907,153.25380070498198,50.90633001482434
564,/media/marda/TWOTB1/xBD/hurricanes/images/florence/hurricane-florence_00000217_pre_disaster.png,90,16,1,531,621,0,16,574,61.49038950136333,14.132499459854618
565,/media/marda/TWOTB1/xBD/hurricanes/images/florence/hurricane-florence_00000217_pre_disaster.png,58,17,1,615,673,0,17,444,35.09903809010381,17.216998222315496
566,/media/marda/TWOTB1/xBD/hurricanes/images/florence/hurricane-florence_00000217_pre_disaster.png,75,31,1,729,804,0,31,859,49.92454987951102,27.17370987894402
567,/media/marda/TWOTB1/xBD/hurricanes/images/florence/hurricane-florence_00000217_pre_disaster.png,85,52,1,910,995,6,58,1650,48.39878335214184,44.66440231468387
568,/media/marda/TWOTB1/xBD/hurricanes/images/florence/hurricane-florence_00000217_pre_disaster.png,61,19,1,971,1032,7,26,310,23.058964696814574,17.6869372002982
569,/media/marda/TWOTB1/xBD/hurricanes/images/florence/hurricane-florence_00000217_pre_disaster.png,63,63,1,367,430,30,93,1984,64.44174236013218,44.640648863747494
570,/media/marda/TWOTB1/xBD/hurricanes/images/florence/hurricane-florence_00000217_pre_disaster.png,60,71,1,465,525,50,121,1716,74.86680966081991,30.500926935994876
571,/media/marda/TWOTB1/xBD/hurricanes/images/florence/hurricane-florence_00000217_pre_disaster.png,70,25,1,699,769,56,81,615,45.52743730674944,18.08710110244807
572,/media/marda/TWOTB1/xBD/hurricanes/images/florence/hurricane-florence_00000217_pre_disaster.png,49,31,1,607,656,60,91,559,32.16187011357119,22.93441087714569
573,/media/marda/TWOTB1/xBD/hurricanes/images/florence/hurricane-florence_00000217_pre_disaster.png,38,65,1,175,213,65,130,1126,67.99264189653574,21.785168657152713
574,/media/marda/TWOTB1/xBD/hurricanes/images/florence/hurricane-florence_00000217_pre_disaster.png,53,32,1,247,300,67,99,761,46.14426479311718,26.9866113624241
575,/media/marda/TWOTB1/xBD/hurricanes/images/florence/hurricane-florence_00000217_pre_disaster.png,79,35,1,549,628,67,102,1252,62.50711282583782,26.416040709414247
576,/media/marda/TWOTB1/xBD/hurricanes/images/florence/hurricane-florence_00000217_pre_disaster.png,78,35,1,730,808,67,102,1080,52.323551496210094,27.267697314737465
577,/media/marda/TWOTB1/xBD/hurricanes/images/florence/hurricane-florence_00000217_pre_disaster.png,76,51,1,8,84,69,120,1943,84.4495131098614,32.17095131501723
578,/media/marda/TWOTB1/xBD/hurricanes/images/florence/hurricane-florence_00000217_pre_disaster.png,15,40,1,0,15,89,129,362,40.18214111058165,13.105437214392772
579,/media/marda/TWOTB1/xBD/hurricanes/images/florence/hurricane-florence_00000217_pre_disaster.png,81,62,1,3,84,102,164,1965,90.51223265143712,32.399629462956305
580,/media/marda/TWOTB1/xBD/hurricanes/images/florence/hurricane-florence_00000217_pre_disaster.png,59,53,1,320,379,109,162,1531,45.779353069700996,44.62469489583177
581,/media/marda/TWOTB1/xBD/hurricanes/images/florence/hurricane-florence_00000217_pre_disaster.png,92,64,1,560,652,109,173,2830,72.03426608452503,52.55628619252347
582,/media/marda/TWOTB1/xBD/hurricanes/images/florence/hurricane-florence_00000217_pre_disaster.png,97,58,1,438,535,114,172,2107,78.63257738517176,43.614401195355185
583,/media/marda/TWOTB1/xBD/hurricanes/images/florence/hurricane-florence_00000217_pre_disaster.png,59,54,1,275,334,120,174,1631,47.440587277597444,45.877899029709035
584,/media/marda/TWOTB1/xBD/hurricanes/images/florence/hurricane-florence_00000217_pre_disaster.png,53,32,1,490,543,161,193,666,36.22629182834195,24.137583302710997
585,/media/marda/TWOTB1/xBD/hurricanes/images/florence/hurricane-florence_00000217_pre_disaster.png,25,28,1,43,68,164,192,434,25.023575959908975,22.719995303275983
586,/media/marda/TWOTB1/xBD/hurricanes/images/florence/hurricane-florence_00000217_pre_disaster.png,71,32,1,576,647,167,199,766,53.75846421417671,18.827066968171206
587,/media/marda/TWOTB1/xBD/hurricanes/images/florence/hurricane-florence_00000217_pre_disaster.png,59,41,1,715,774,179,220,725,35.831935708193846,27.01428754934379
588,/media/marda/TWOTB1/xBD/hurricanes/images/florence/hurricane-florence_00000217_pre_disaster.png,15,18,1,63,78,183,201,140,14.109182037822846,13.294174056940513
589,/media/marda/TWOTB1/xBD/hurricanes/images/florence/hurricane-florence_00000217_pre_disaster.png,76,62,1,588,664,195,257,2059,56.88059903180813,48.886279009310584
590,/media/marda/TWOTB1/xBD/hurricanes/images/florence/hurricane-florence_00000217_pre_disaster.png,55,57,1,380,435,216,273,1269,49.05171837256444,34.5228562270843
591,/media/marda/TWOTB1/xBD/hurricanes/images/florence/hurricane-florence_00000217_pre_disaster.png,81,43,1,948,1029,216,259,1237,45.7728278484551,35.30972810381816
592,/media/marda/TWOTB1/xBD/hurricanes/images/florence/hurricane-florence_00000217_pre_disaster.png,69,81,1,293,362,222,303,2884,70.20033265850294,55.559983662330275
593,/media/marda/TWOTB1/xBD/hurricanes/images/florence/hurricane-florence_00000217_pre_disaster.png,89,92,1,37,126,225,317,4059,82.22875896112586,74.06773029061301
594,/media/marda/TWOTB1/xBD/hurricanes/images/florence/hurricane-florence_00000217_pre_disaster.png,52,44,1,480,532,230,274,817,36.91716721204603,30.01334220463229
595,/media/marda/TWOTB1/xBD/hurricanes/images/florence/hurricane-florence_00000217_pre_disaster.png,29,23,1,435,464,236,259,119,13.792418785151163,11.587712480522065
596,/media/marda/TWOTB1/xBD/hurricanes/images/florence/hurricane-florence_00000217_pre_disaster.png,80,82,1,765,845,253,335,2067,79.27083886930684,34.96087658003822
597,/media/marda/TWOTB1/xBD/hurricanes/images/florence/hurricane-florence_00000217_pre_disaster.png,47,50,1,305,352,291,341,962,39.58145910643674,32.44317577329685
598,/media/marda/TWOTB1/xBD/hurricanes/images/florence/hurricane-florence_00000217_pre_disaster.png,72,58,1,507,579,303,361,1562,48.74896886891199,42.47169481421694
599,/media/marda/TWOTB1/xBD/hurricanes/images/florence/hurricane-florence_00000217_pre_disaster.png,53,41,1,743,796,306,347,491,27.581138466299937,23.7717795192911
600,/media/marda/TWOTB1/xBD/hurricanes/images/florence/hurricane-florence_00000217_pre_disaster.png,54,61,1,621,675,313,374,803,52.80647611067689,20.30420485596175
601,/media/marda/TWOTB1/xBD/hurricanes/images/florence/hurricane-florence_00000217_pre_disaster.png,84,56,1,812,896,346,402,1500,53.405062989758655,37.09250874883139
602,/media/marda/TWOTB1/xBD/hurricanes/images/florence/hurricane-florence_00000217_pre_disaster.png,58,45,1,524,582,359,404,776,38.568367847022806,27.03563284091804
603,/media/marda/TWOTB1/xBD/hurricanes/images/florence/hurricane-florence_00000217_pre_disaster.png,96,136,1,345,441,393,529,3997,150.51519646945314,41.384694840439934
604,/media/marda/TWOTB1/xBD/hurricanes/images/florence/hurricane-florence_00000217_pre_disaster.png,54,50,1,656,710,402,452,701,32.53361103759055,28.499682396715425
605,/media/marda/TWOTB1/xBD/hurricanes/images/florence/hurricane-florence_00000217_pre_disaster.png,75,68,1,111,186,411,479,2344,76.29135022482437,41.027750977301636
606,/media/marda/TWOTB1/xBD/hurricanes/images/florence/hurricane-florence_00000217_pre_disaster.png,74,55,1,539,613,420,475,1337,52.208279417563865,34.548389549341834
607,/media/marda/TWOTB1/xBD/hurricanes/images/florence/hurricane-florence_00000217_pre_disaster.png,61,49,1,736,797,432,481,683,31.167565119529907,29.46334690262831
608,/media/marda/TWOTB1/xBD/hurricanes/images/florence/hurricane-florence_00000217_pre_disaster.png,82,59,1,660,742,434,493,1352,59.63716100650278,30.843002126484738
609,/media/marda/TWOTB1/xBD/hurricanes/images/florence/hurricane-florence_00000217_pre_disaster.png,50,53,1,480,530,454,507,722,34.38287829325265,28.053183690526513
610,/media/marda/TWOTB1/xBD/hurricanes/images/florence/hurricane-florence_00000217_pre_disaster.png,39,54,1,18,57,461,515,1002,40.20168590654778,32.89239385387021
611,/media/marda/TWOTB1/xBD/hurricanes/images/florence/hurricane-florence_00000217_pre_disaster.png,78,54,1,544,622,470,524,1274,60.00945858816637,28.43003568242887
612,/media/marda/TWOTB1/xBD/hurricanes/images/florence/hurricane-florence_00000217_pre_disaster.png,16,41,1,0,16,480,521,277,23.864416564201854,15.7636585982527
613,/media/marda/TWOTB1/xBD/hurricanes/images/florence/hurricane-florence_00000217_pre_disaster.png,48,39,1,493,541,487,526,446,28.95017742602206,20.362034221646933
614,/media/marda/TWOTB1/xBD/hurricanes/images/florence/hurricane-florence_00000217_pre_disaster.png,63,53,1,567,630,507,560,863,39.38619640940973,29.179595708422053
615,/media/marda/TWOTB1/xBD/hurricanes/images/florence/hurricane-florence_00000217_pre_disaster.png,73,56,1,678,751,507,563,1097,49.0420600574115,29.779535701640384
616,/media/marda/TWOTB1/xBD/hurricanes/images/florence/hurricane-florence_00000217_pre_disaster.png,48,36,1,395,443,508,544,300,34.76967873770306,11.556859263332534
617,/media/marda/TWOTB1/xBD/hurricanes/images/florence/hurricane-florence_00000217_pre_disaster.png,43,41,1,530,573,514,555,347,22.28877056512922,20.566673662270535
618,/media/marda/TWOTB1/xBD/hurricanes/images/florence/hurricane-florence_00000217_pre_disaster.png,48,38,1,779,827,539,577,217,17.441800775701218,16.681325740167825
619,/media/marda/TWOTB1/xBD/hurricanes/images/florence/hurricane-florence_00000217_pre_disaster.png,55,50,1,696,751,554,604,588,29.152622821425783,26.803682867242784
620,/media/marda/TWOTB1/xBD/hurricanes/images/florence/hurricane-florence_00000217_pre_disaster.png,42,38,1,729,771,560,598,156,17.26293946128869,12.103873002832703
621,/media/marda/TWOTB1/xBD/hurricanes/images/florence/hurricane-florence_00000217_pre_disaster.png,57,73,1,583,640,565,638,1181,54.76625814096025,28.793918657042482
622,/media/marda/TWOTB1/xBD/hurricanes/images/florence/hurricane-florence_00000217_pre_disaster.png,105,70,1,108,213,573,643,2545,111.02361056887949,30.37862581406331
623,/media/marda/TWOTB1/xBD/hurricanes/images/florence/hurricane-florence_00000217_pre_disaster.png,20,40,1,124,144,637,677,174,16.45315970105202,13.946743792748801
624,/media/marda/TWOTB1/xBD/hurricanes/images/florence/hurricane-florence_00000217_pre_disaster.png,77,68,1,591,668,652,720,1374,60.91262645354499,32.46463278696095
625,/media/marda/TWOTB1/xBD/hurricanes/images/florence/hurricane-florence_00000217_pre_disaster.png,114,70,1,722,836,670,740,2318,91.38408867139475,33.49857771998715
626,/media/marda/TWOTB1/xBD/hurricanes/images/florence/hurricane-florence_00000217_pre_disaster.png,38,48,1,526,564,678,726,288,25.43763326234242,14.990143391145853
627,/media/marda/TWOTB1/xBD/hurricanes/images/florence/hurricane-florence_00000217_pre_disaster.png,91,66,1,868,959,680,746,1460,58.84407399498427,33.10800575099227
628,/media/marda/TWOTB1/xBD/hurricanes/images/florence/hurricane-florence_00000217_pre_disaster.png,105,73,1,139,244,683,756,2529,109.98439814342618,30.442442029323125
629,/media/marda/TWOTB1/xBD/hurricanes/images/florence/hurricane-florence_00000217_pre_disaster.png,86,79,1,434,520,694,773,2004,71.31630461077776,39.940532717884814
630,/media/marda/TWOTB1/xBD/hurricanes/images/florence/hurricane-florence_00000217_pre_disaster.png,25,44,1,12,37,699,743,251,27.284357063532063,12.090190532340646
631,/media/marda/TWOTB1/xBD/hurricanes/images/florence/hurricane-florence_00000217_pre_disaster.png,58,67,1,20,78,720,787,1208,61.11033964111502,27.348528819892536
632,/media/marda/TWOTB1/xBD/hurricanes/images/florence/hurricane-florence_00000217_pre_disaster.png,58,64,1,840,898,734,798,670,36.322781013452406,24.732770638358982
633,/media/marda/TWOTB1/xBD/hurricanes/images/florence/hurricane-florence_00000217_pre_disaster.png,74,67,1,494,568,740,807,1084,49.909201290438666,33.91208864410408
634,/media/marda/TWOTB1/xBD/hurricanes/images/florence/hurricane-florence_00000217_pre_disaster.png,38,70,1,232,270,776,846,782,43.8472278986528,23.789122076410784
635,/media/marda/TWOTB1/xBD/hurricanes/images/florence/hurricane-florence_00000217_pre_disaster.png,25,42,1,216,241,783,825,147,18.114393014302944,10.929913488349547
636,/media/marda/TWOTB1/xBD/hurricanes/images/florence/hurricane-florence_00000217_pre_disaster.png,98,84,1,780,878,801,885,2203,70.59510481950724,40.956711228146915
637,/media/marda/TWOTB1/xBD/hurricanes/images/florence/hurricane-florence_00000217_pre_disaster.png,39,74,1,99,138,819,893,938,41.01612041127148,30.388413756870264
638,/media/marda/TWOTB1/xBD/hurricanes/images/florence/hurricane-florence_00000217_pre_disaster.png,35,85,1,43,78,839,924,1149,56.14315324555576,27.22008387455146
639,/media/marda/TWOTB1/xBD/hurricanes/images/florence/hurricane-florence_00000217_pre_disaster.png,31,57,1,252,283,839,896,386,23.461810964441177,22.00381617482305
640,/media/marda/TWOTB1/xBD/hurricanes/images/florence/hurricane-florence_00000217_pre_disaster.png,72,94,1,665,737,860,954,1851,61.65142235989459,39.47807809748949
641,/media/marda/TWOTB1/xBD/hurricanes/images/florence/hurricane-florence_00000217_pre_disaster.png,91,87,1,894,985,868,955,2050,53.39358024532674,50.92335537640548
642,/media/marda/TWOTB1/xBD/hurricanes/images/florence/hurricane-florence_00000217_pre_disaster.png,33,63,1,264,297,887,950,548,29.020393305672176,24.839652002883092
643,/media/marda/TWOTB1/xBD/hurricanes/images/florence/hurricane-florence_00000217_pre_disaster.png,80,71,1,486,566,896,967,1468,64.3043486653678,30.2010789965767
644,/media/marda/TWOTB1/xBD/hurricanes/images/florence/hurricane-florence_00000217_pre_disaster.png,111,90,1,807,918,920,1010,2702,78.50308622004921,45.43268985299531
645,/media/marda/TWOTB1/xBD/hurricanes/images/florence/hurricane-florence_00000217_pre_disaster.png,64,73,1,272,336,946,1019,1265,52.685432039530326,31.673639079943683
646,/media/marda/TWOTB1/xBD/hurricanes/images/florence/hurricane-florence_00000217_pre_disaster.png,63,60,1,807,870,974,1034,464,31.852325718765442,19.30631362611852
647,/media/marda/TWOTB1/xBD/hurricanes/images/florence/hurricane-florence_00000217_pre_disaster.png,56,62,1,289,345,980,1042,884,45.448500740149576,26.189283508915118
648,/media/marda/TWOTB1/xBD/hurricanes/images/florence/hurricane-florence_00000158_pre_disaster.png,33,20,1,345,378,95,115,231,18.33963226292025,16.641206497149536
649,/media/marda/TWOTB1/xBD/hurricanes/images/florence/hurricane-florence_00000158_pre_disaster.png,46,83,1,214,260,883,966,1291,48.85894589726755,35.41909528928282
650,/media/marda/TWOTB1/xBD/hurricanes/images/florence/hurricane-florence_00000158_pre_disaster.png,21,52,1,160,181,894,946,214,17.869574528157468,15.979182040003142
651,/media/marda/TWOTB1/xBD/hurricanes/images/florence/hurricane-florence_00000158_pre_disaster.png,27,66,1,279,306,968,1034,384,31.18127310278146,16.366692264348
652,/media/marda/TWOTB1/xBD/hurricanes/images/florence/hurricane-florence_00000129_pre_disaster.png,21,24,1,22,43,196,220,309,21.0200442631445,19.199600498335357
653,/media/marda/TWOTB1/xBD/hurricanes/images/florence/hurricane-florence_00000129_pre_disaster.png,24,56,1,0,24,231,287,762,45.81666275263716,23.316536951735113
654,/media/marda/TWOTB1/xBD/hurricanes/images/florence/hurricane-florence_00000129_pre_disaster.png,35,43,1,409,444,788,831,183,20.963441301114216,11.602182189009927
655,/media/marda/TWOTB1/xBD/hurricanes/images/florence/hurricane-florence_00000129_pre_disaster.png,21,38,1,431,452,790,828,30,6.831300510639732,5.656854249492381
656,/media/marda/TWOTB1/xBD/hurricanes/images/florence/hurricane-florence_00000118_post_disaster.png,57,47,1,687,744,705,752,323,33.02848677076414,13.090894278590287
657,/media/marda/TWOTB1/xBD/hurricanes/images/florence/hurricane-florence_00000118_post_disaster.png,56,48,1,615,671,710,758,416,32.869690568494775,17.42134826479738
658,/media/marda/TWOTB1/xBD/hurricanes/images/florence/hurricane-florence_00000118_post_disaster.png,49,44,1,837,886,775,819,142,14.507421866630555,13.085291423146833
659,/media/marda/TWOTB1/xBD/hurricanes/images/florence/hurricane-florence_00000118_post_disaster.png,54,52,1,783,837,784,836,303,25.39164919249803,15.766396953530167
660,/media/marda/TWOTB1/xBD/hurricanes/images/florence/hurricane-florence_00000118_post_disaster.png,49,52,1,769,818,812,864,204,17.617170342349322,15.481425154517332
661,/media/marda/TWOTB1/xBD/hurricanes/images/florence/hurricane-florence_00000118_post_disaster.png,74,67,1,786,860,813,880,847,41.798464873867175,26.661996741239687
662,/media/marda/TWOTB1/xBD/hurricanes/images/florence/hurricane-florence_00000118_post_disaster.png,42,49,1,684,726,885,934,114,14.255230719854504,10.698439265866774
663,/media/marda/TWOTB1/xBD/hurricanes/images/florence/hurricane-florence_00000118_post_disaster.png,45,51,1,762,807,893,944,131,14.006612667118342,12.536168314277777
664,/media/marda/TWOTB1/xBD/hurricanes/images/florence/hurricane-florence_00000118_post_disaster.png,32,43,1,660,692,971,1014,46,8.820351326857361,7.0198936741736695
665,/media/marda/TWOTB1/xBD/hurricanes/images/florence/hurricane-florence_00000118_post_disaster.png,33,45,1,657,690,980,1025,71,10.87019246569509,8.697225572569343
666,/media/marda/TWOTB1/xBD/hurricanes/images/florence/hurricane-florence_00000118_post_disaster.png,60,60,1,707,767,981,1041,604,32.356183334029744,25.252087051792458
667,/media/marda/TWOTB1/xBD/hurricanes/images/florence/hurricane-florence_00000085_pre_disaster.png,34,46,1,160,194,379,425,811,35.58456549079584,30.10685899542782
668,/media/marda/TWOTB1/xBD/hurricanes/images/florence/hurricane-florence_00000085_pre_disaster.png,52,73,1,167,219,425,498,1684,56.354221156420145,41.80876002413216
669,/media/marda/TWOTB1/xBD/hurricanes/images/florence/hurricane-florence_00000085_pre_disaster.png,51,57,1,698,749,571,628,342,41.86488639880054,10.868527891352699
670,/media/marda/TWOTB1/xBD/hurricanes/images/florence/hurricane-florence_00000085_pre_disaster.png,85,55,1,809,894,571,626,1232,54.68126677531752,30.91245269027395
671,/media/marda/TWOTB1/xBD/hurricanes/images/florence/hurricane-florence_00000085_pre_disaster.png,15,66,1,1,16,604,670,552,47.281871295780675,15.560233820636821
672,/media/marda/TWOTB1/xBD/hurricanes/images/florence/hurricane-florence_00000085_pre_disaster.png,47,38,1,881,928,623,661,134,14.702825732570746,12.29027241661756
673,/media/marda/TWOTB1/xBD/hurricanes/images/florence/hurricane-florence_00000085_pre_disaster.png,23,78,1,172,195,665,743,817,61.05782302417951,17.844930111441414
674,/media/marda/TWOTB1/xBD/hurricanes/images/florence/hurricane-florence_00000085_pre_disaster.png,22,72,1,2,24,687,759,770,51.45906332844397,20.264110531214914
675,/media/marda/TWOTB1/xBD/hurricanes/images/florence/hurricane-florence_00000085_pre_disaster.png,35,63,1,179,214,745,808,808,37.39372033779771,28.969986037672065
676,/media/marda/TWOTB1/xBD/hurricanes/images/florence/hurricane-florence_00000085_pre_disaster.png,21,39,1,217,238,745,784,143,14.966629547095765,12.649110640673518
677,/media/marda/TWOTB1/xBD/hurricanes/images/florence/hurricane-florence_00000085_pre_disaster.png,19,45,1,221,240,776,821,145,18.81471791010743,10.317030121785622
678,/media/marda/TWOTB1/xBD/hurricanes/images/florence/hurricane-florence_00000085_pre_disaster.png,33,81,1,189,222,824,905,1021,52.80104231125134,25.628626356931786
679,/media/marda/TWOTB1/xBD/hurricanes/images/florence/hurricane-florence_00000085_pre_disaster.png,36,52,1,337,373,827,879,354,25.04757022299998,18.920987231834207
680,/media/marda/TWOTB1/xBD/hurricanes/images/florence/hurricane-florence_00000085_pre_disaster.png,34,67,1,245,279,832,899,681,36.66057222705541,25.025006433272335
681,/media/marda/TWOTB1/xBD/hurricanes/images/florence/hurricane-florence_00000085_pre_disaster.png,34,52,1,414,448,859,911,304,20.616483742476596,19.66474733747909
682,/media/marda/TWOTB1/xBD/hurricanes/images/florence/hurricane-florence_00000085_pre_disaster.png,95,88,1,342,437,870,958,2887,89.35602465014185,50.57213543195508
683,/media/marda/TWOTB1/xBD/hurricanes/images/florence/hurricane-florence_00000085_pre_disaster.png,22,44,1,429,451,886,930,35,7.41491867322567,6.505774628622548
684,/media/marda/TWOTB1/xBD/hurricanes/images/florence/hurricane-florence_00000085_pre_disaster.png,48,62,1,458,506,894,956,573,35.255562874992364,21.676113349325025
685,/media/marda/TWOTB1/xBD/hurricanes/images/florence/hurricane-florence_00000085_pre_disaster.png,32,53,1,427,459,895,948,205,17.01788580407101,16.08523802162421
686,/media/marda/TWOTB1/xBD/hurricanes/images/florence/hurricane-florence_00000085_pre_disaster.png,60,109,1,569,629,932,1041,1596,74.39730187906395,31.639719099315258
687,/media/marda/TWOTB1/xBD/hurricanes/images/florence/hurricane-florence_00000085_pre_disaster.png,42,61,1,531,573,947,1008,416,26.00935382277413,21.414670798500154
688,/media/marda/TWOTB1/xBD/hurricanes/images/florence/hurricane-florence_00000085_pre_disaster.png,45,48,1,407,452,996,1044,163,29.18854292647017,7.61791640402895
689,/media/marda/TWOTB1/xBD/hurricanes/images/florence/hurricane-florence_00000184_pre_disaster.png,40,22,1,35,75,0,22,571,38.48271538826516,20.263879407473123
690,/media/marda/TWOTB1/xBD/hurricanes/images/florence/hurricane-florence_00000184_pre_disaster.png,47,18,1,166,213,0,18,404,35.174692835225294,16.895327481341987
691,/media/marda/TWOTB1/xBD/hurricanes/images/florence/hurricane-florence_00000184_pre_disaster.png,48,21,1,228,276,0,21,540,39.01760643526924,19.18970191710583
692,/media/marda/TWOTB1/xBD/hurricanes/images/florence/hurricane-florence_00000184_pre_disaster.png,47,46,1,71,118,54,100,1013,50.34860321994138,26.54488235068609
693,/media/marda/TWOTB1/xBD/hurricanes/images/florence/hurricane-florence_00000184_pre_disaster.png,48,40,1,120,168,95,135,960,43.06547809304258,29.52847371287777
694,/media/marda/TWOTB1/xBD/hurricanes/images/florence/hurricane-florence_00000184_pre_disaster.png,22,49,1,0,22,117,166,614,42.25377999753954,20.073498366907042
695,/media/marda/TWOTB1/xBD/hurricanes/images/florence/hurricane-florence_00000184_pre_disaster.png,48,41,1,175,223,118,159,937,42.05131408128882,29.586645816049273
696,/media/marda/TWOTB1/xBD/hurricanes/images/florence/hurricane-florence_00000184_pre_disaster.png,54,43,1,224,278,126,169,1029,41.44549157068269,33.59661605424145
697,/media/marda/TWOTB1/xBD/hurricanes/images/florence/hurricane-florence_00000184_pre_disaster.png,44,45,1,27,71,151,196,951,43.234022570779885,28.967345531772626
698,/media/marda/TWOTB1/xBD/hurricanes/images/florence/hurricane-florence_00000184_pre_disaster.png,53,43,1,269,322,163,206,907,42.68632056422051,28.003842136367876
699,/media/marda/TWOTB1/xBD/hurricanes/images/florence/hurricane-florence_00000184_pre_disaster.png,47,39,1,71,118,186,225,867,42.87641430510636,27.09561542956435
700,/media/marda/TWOTB1/xBD/hurricanes/images/florence/hurricane-florence_00000184_pre_disaster.png,45,46,1,122,167,199,245,926,42.000943468206515,29.191188377231853
701,/media/marda/TWOTB1/xBD/hurricanes/images/florence/hurricane-florence_00000184_pre_disaster.png,18,25,1,27,45,211,236,153,15.02813717474666,13.64482454441416
702,/media/marda/TWOTB1/xBD/hurricanes/images/florence/hurricane-florence_00000184_pre_disaster.png,48,42,1,304,352,218,260,681,33.87192130774841,27.2357725007615
703,/media/marda/TWOTB1/xBD/hurricanes/images/florence/hurricane-florence_00000184_pre_disaster.png,45,51,1,166,211,225,276,934,38.46123951332285,32.93315070363424
704,/media/marda/TWOTB1/xBD/hurricanes/images/florence/hurricane-florence_00000184_pre_disaster.png,45,48,1,331,376,273,321,899,41.656275782430846,28.685100095214732
705,/media/marda/TWOTB1/xBD/hurricanes/images/florence/hurricane-florence_00000184_pre_disaster.png,42,45,1,231,273,280,325,756,37.253044968245796,27.10937851619664
706,/media/marda/TWOTB1/xBD/hurricanes/images/florence/hurricane-florence_00000184_pre_disaster.png,31,42,1,0,31,307,349,586,33.70212935905742,24.123624963038186
707,/media/marda/TWOTB1/xBD/hurricanes/images/florence/hurricane-florence_00000184_pre_disaster.png,44,58,1,41,85,307,365,1297,44.128385255885505,38.71161772957554
708,/media/marda/TWOTB1/xBD/hurricanes/images/florence/hurricane-florence_00000184_pre_disaster.png,23,28,1,125,148,309,337,152,18.673442244654595,10.87093411235489
709,/media/marda/TWOTB1/xBD/hurricanes/images/florence/hurricane-florence_00000184_pre_disaster.png,27,27,1,188,215,324,351,189,21.026664712812998,11.922541706388106
710,/media/marda/TWOTB1/xBD/hurricanes/images/florence/hurricane-florence_00000184_pre_disaster.png,46,51,1,94,140,329,380,978,44.542753990956264,28.772949312719046
711,/media/marda/TWOTB1/xBD/hurricanes/images/florence/hurricane-florence_00000184_pre_disaster.png,19,27,1,223,242,330,357,135,14.965582248526122,12.052221343828055
712,/media/marda/TWOTB1/xBD/hurricanes/images/florence/hurricane-florence_00000184_pre_disaster.png,40,41,1,339,379,343,384,677,32.494885973036546,28.056763145044542
713,/media/marda/TWOTB1/xBD/hurricanes/images/florence/hurricane-florence_00000184_pre_disaster.png,40,45,1,168,208,356,401,783,35.486501679307956,28.845305926295584
714,/media/marda/TWOTB1/xBD/hurricanes/images/florence/hurricane-florence_00000184_pre_disaster.png,48,42,1,221,269,360,402,897,42.74051206231665,27.997532629243135
715,/media/marda/TWOTB1/xBD/hurricanes/images/florence/hurricane-florence_00000184_pre_disaster.png,48,58,1,330,378,403,461,949,42.92008194365212,29.058434828001268
716,/media/marda/TWOTB1/xBD/hurricanes/images/florence/hurricane-florence_00000184_pre_disaster.png,41,48,1,10,51,418,466,799,40.458828067117686,26.57223025964238
717,/media/marda/TWOTB1/xBD/hurricanes/images/florence/hurricane-florence_00000184_pre_disaster.png,49,47,1,62,111,434,481,1024,49.1633563894976,28.78177834780226
718,/media/marda/TWOTB1/xBD/hurricanes/images/florence/hurricane-florence_00000184_pre_disaster.png,42,49,1,128,170,450,499,803,36.346313640222995,30.148071587188568
719,/media/marda/TWOTB1/xBD/hurricanes/images/florence/hurricane-florence_00000184_pre_disaster.png,49,53,1,185,234,468,521,942,42.063947488788656,29.571558041593487
720,/media/marda/TWOTB1/xBD/hurricanes/images/florence/hurricane-florence_00000184_pre_disaster.png,50,60,1,347,397,468,528,997,42.08357343033298,34.16344367949006
721,/media/marda/TWOTB1/xBD/hurricanes/images/florence/hurricane-florence_00000184_pre_disaster.png,36,46,1,2,38,499,545,732,38.32858685925238,25.28623370385971
722,/media/marda/TWOTB1/xBD/hurricanes/images/florence/hurricane-florence_00000184_pre_disaster.png,47,56,1,235,282,516,572,793,36.353616339905145,29.688397125890592
723,/media/marda/TWOTB1/xBD/hurricanes/images/florence/hurricane-florence_00000184_pre_disaster.png,52,59,1,359,411,529,588,985,39.18669154934902,33.291747025048274
724,/media/marda/TWOTB1/xBD/hurricanes/images/florence/hurricane-florence_00000184_pre_disaster.png,64,108,1,118,182,540,648,2373,95.10407535492551,44.039777946829865
725,/media/marda/TWOTB1/xBD/hurricanes/images/florence/hurricane-florence_00000184_pre_disaster.png,40,52,1,274,314,567,619,625,32.05541246150532,25.73067374327321
726,/media/marda/TWOTB1/xBD/hurricanes/images/florence/hurricane-florence_00000184_pre_disaster.png,53,59,1,378,431,596,655,936,38.411439017328746,32.52916486821883
727,/media/marda/TWOTB1/xBD/hurricanes/images/florence/hurricane-florence_00000184_pre_disaster.png,36,74,1,0,36,615,689,985,42.71239987057213,37.318392342083925
728,/media/marda/TWOTB1/xBD/hurricanes/images/florence/hurricane-florence_00000184_pre_disaster.png,48,70,1,276,324,625,695,1077,46.32005027501423,30.83100930454745
729,/media/marda/TWOTB1/xBD/hurricanes/images/florence/hurricane-florence_00000184_pre_disaster.png,31,52,1,246,277,644,696,429,29.202252465761948,19.529408430024475
730,/media/marda/TWOTB1/xBD/hurricanes/images/florence/hurricane-florence_00000184_pre_disaster.png,57,50,1,688,745,672,722,488,29.547731930646062,21.909133840838642
731,/media/marda/TWOTB1/xBD/hurricanes/images/florence/hurricane-florence_00000184_pre_disaster.png,55,47,1,557,612,687,734,360,34.74114512984413,14.54316675503098
732,/media/marda/TWOTB1/xBD/hurricanes/images/florence/hurricane-florence_00000184_pre_disaster.png,42,39,1,694,736,694,733,92,13.902414728731426,8.914251819659482
733,/media/marda/TWOTB1/xBD/hurricanes/images/florence/hurricane-florence_00000184_pre_disaster.png,44,41,1,700,744,701,742,121,16.210090965686785,10.083442706170269
734,/media/marda/TWOTB1/xBD/hurricanes/images/florence/hurricane-florence_00000184_pre_disaster.png,78,67,1,464,542,710,777,1386,62.49044015765487,29.50352351603882
735,/media/marda/TWOTB1/xBD/hurricanes/images/florence/hurricane-florence_00000184_pre_disaster.png,97,139,1,320,417,746,885,4774,118.77187459196209,59.63607918003337
736,/media/marda/TWOTB1/xBD/hurricanes/images/florence/hurricane-florence_00000184_pre_disaster.png,79,73,1,708,787,770,843,1413,50.176223215532396,37.892808876336446
737,/media/marda/TWOTB1/xBD/hurricanes/images/florence/hurricane-florence_00000184_pre_disaster.png,26,57,1,260,286,786,843,301,25.124529370675173,16.03303869009928
738,/media/marda/TWOTB1/xBD/hurricanes/images/florence/hurricane-florence_00000184_pre_disaster.png,122,118,1,570,692,789,907,5886,98.84668463087739,87.85654811213281
739,/media/marda/TWOTB1/xBD/hurricanes/images/florence/hurricane-florence_00000184_pre_disaster.png,85,127,1,123,208,804,931,4763,98.09620827024696,65.06951952713013
740,/media/marda/TWOTB1/xBD/hurricanes/images/florence/hurricane-florence_00000184_pre_disaster.png,23,49,1,234,257,819,868,204,18.082635471816392,14.983171178906492
741,/media/marda/TWOTB1/xBD/hurricanes/images/florence/hurricane-florence_00000184_pre_disaster.png,52,64,1,213,265,838,902,888,46.507954243654645,25.360976544281694
742,/media/marda/TWOTB1/xBD/hurricanes/images/florence/hurricane-florence_00000184_pre_disaster.png,32,51,1,287,319,863,914,241,22.641058638398693,14.260577674815265
743,/media/marda/TWOTB1/xBD/hurricanes/images/florence/hurricane-florence_00000184_pre_disaster.png,30,50,1,9,39,864,914,286,32.394062398080365,11.832500381494784
744,/media/marda/TWOTB1/xBD/hurricanes/images/florence/hurricane-florence_00000184_pre_disaster.png,51,50,1,397,448,866,916,277,39.14504601327716,9.493061315246894
745,/media/marda/TWOTB1/xBD/hurricanes/images/florence/hurricane-florence_00000184_pre_disaster.png,49,52,1,616,665,871,923,314,25.6627404236042,16.38409973517182
746,/media/marda/TWOTB1/xBD/hurricanes/images/florence/hurricane-florence_00000184_pre_disaster.png,18,45,1,25,43,880,925,138,18.944360326244407,9.827994337553424
747,/media/marda/TWOTB1/xBD/hurricanes/images/florence/hurricane-florence_00000184_pre_disaster.png,24,55,1,225,249,895,950,184,18.69602372820269,13.1819211263218
748,/media/marda/TWOTB1/xBD/hurricanes/images/florence/hurricane-florence_00000184_pre_disaster.png,10,47,1,6,16,898,945,68,9.852632352540299,9.436274836210513
749,/media/marda/TWOTB1/xBD/hurricanes/images/florence/hurricane-florence_00000184_pre_disaster.png,15,45,1,233,248,915,960,63,10.327955589886445,8.0
750,/media/marda/TWOTB1/xBD/hurricanes/images/florence/hurricane-florence_00000184_pre_disaster.png,34,53,1,517,551,916,969,156,17.00549448926891,12.350508113699977
751,/media/marda/TWOTB1/xBD/hurricanes/images/florence/hurricane-florence_00000342_post_disaster.png,27,42,1,116,143,0,42,673,45.525043876330685,21.286280872260146
752,/media/marda/TWOTB1/xBD/hurricanes/images/florence/hurricane-florence_00000342_post_disaster.png,13,13,1,16,29,13,26,155,15.482069149321514,13.340058011824867
753,/media/marda/TWOTB1/xBD/hurricanes/images/florence/hurricane-florence_00000342_post_disaster.png,78,54,1,470,548,218,272,1601,59.001370742038326,36.1237267839738
754,/media/marda/TWOTB1/xBD/hurricanes/images/florence/hurricane-florence_00000342_post_disaster.png,28,26,1,432,460,232,258,162,18.921174243893823,11.52191812724663
755,/media/marda/TWOTB1/xBD/hurricanes/images/florence/hurricane-florence_00000342_post_disaster.png,57,45,1,418,475,347,392,684,43.42704029321374,22.282709448213396
756,/media/marda/TWOTB1/xBD/hurricanes/images/florence/hurricane-florence_00000342_post_disaster.png,21,23,1,33,54,366,389,170,22.64549320666378,10.007687912686954
757,/media/marda/TWOTB1/xBD/hurricanes/images/florence/hurricane-florence_00000342_post_disaster.png,29,18,1,429,458,386,404,78,14.966629547095765,6.831300510639732
758,/media/marda/TWOTB1/xBD/hurricanes/images/florence/hurricane-florence_00000342_post_disaster.png,22,64,1,0,22,414,478,897,52.148078643553184,22.864766254497727
759,/media/marda/TWOTB1/xBD/hurricanes/images/florence/hurricane-florence_00000012_post_disaster.png,52,74,1,0,52,10,84,1573,86.76835059278123,30.891522580468685
760,/media/marda/TWOTB1/xBD/hurricanes/images/florence/hurricane-florence_00000012_post_disaster.png,24,28,1,40,64,44,72,483,28.49509099492331,22.669148571863772
761,/media/marda/TWOTB1/xBD/hurricanes/images/florence/hurricane-florence_00000012_post_disaster.png,51,42,1,186,237,55,97,785,52.0006577919591,20.362838111659357
762,/media/marda/TWOTB1/xBD/hurricanes/images/florence/hurricane-florence_00000012_post_disaster.png,63,36,1,633,696,75,111,762,33.128523037411234,30.27542957223373
763,/media/marda/TWOTB1/xBD/hurricanes/images/florence/hurricane-florence_00000012_post_disaster.png,56,39,1,641,697,106,145,550,38.927329404523334,18.5848285404524
764,/media/marda/TWOTB1/xBD/hurricanes/images/florence/hurricane-florence_00000012_post_disaster.png,7,74,1,0,7,121,195,348,75.55616095767925,6.968138532053996
765,/media/marda/TWOTB1/xBD/hurricanes/images/florence/hurricane-florence_00000012_post_disaster.png,47,23,1,676,723,134,157,153,24.20728667584559,8.495083362957752
766,/media/marda/TWOTB1/xBD/hurricanes/images/florence/hurricane-florence_00000012_post_disaster.png,81,45,1,882,963,182,227,1173,44.632844155426554,35.06327878668219
767,/media/marda/TWOTB1/xBD/hurricanes/images/florence/hurricane-florence_00000012_post_disaster.png,57,64,1,20,77,313,377,1476,49.83082718492075,41.45116873874593
768,/media/marda/TWOTB1/xBD/hurricanes/images/florence/hurricane-florence_00000012_post_disaster.png,52,42,1,551,603,406,448,467,31.940584168183236,19.538875021802106
769,/media/marda/TWOTB1/xBD/hurricanes/images/florence/hurricane-florence_00000012_post_disaster.png,83,110,1,364,447,414,524,3322,96.0451504277606,47.05945882951384
770,/media/marda/TWOTB1/xBD/hurricanes/images/florence/hurricane-florence_00000012_post_disaster.png,87,95,1,516,603,456,551,3083,80.75896275839003,50.70574075654377
771,/media/marda/TWOTB1/xBD/hurricanes/images/florence/hurricane-florence_00000012_post_disaster.png,28,42,1,3,31,472,514,413,26.079859547738007,20.957454048757644
772,/media/marda/TWOTB1/xBD/hurricanes/images/florence/hurricane-florence_00000012_post_disaster.png,21,62,1,0,21,495,557,553,38.096619040022986,20.79113617962677
773,/media/marda/TWOTB1/xBD/hurricanes/images/florence/hurricane-florence_00000012_post_disaster.png,63,54,1,717,780,505,559,728,33.69546749874602,28.84068071030867
774,/media/marda/TWOTB1/xBD/hurricanes/images/florence/hurricane-florence_00000012_post_disaster.png,101,84,1,483,584,567,651,3140,81.48714611329395,51.15510411998074
775,/media/marda/TWOTB1/xBD/hurricanes/images/florence/hurricane-florence_00000012_post_disaster.png,197,219,1,361,558,700,919,21516,183.1416181165592,156.44696506948216
776,/media/marda/TWOTB1/xBD/hurricanes/images/florence/hurricane-florence_00000012_post_disaster.png,268,237,1,509,777,747,984,31761,250.05410167448687,169.83408302658984
777,/media/marda/TWOTB1/xBD/hurricanes/images/florence/hurricane-florence_00000012_post_disaster.png,75,70,1,896,971,871,941,846,33.93685808586193,32.79006044980433
778,/media/marda/TWOTB1/xBD/hurricanes/images/florence/hurricane-florence_00000012_post_disaster.png,7,58,1,0,7,886,944,92,20.58773168113777,6.5124377055138325
779,/media/marda/TWOTB1/xBD/hurricanes/images/florence/hurricane-florence_00000012_post_disaster.png,15,48,1,128,143,886,934,86,11.320872939048385,10.060072635186788
780,/media/marda/TWOTB1/xBD/hurricanes/images/florence/hurricane-florence_00000012_post_disaster.png,33,74,1,134,167,901,975,737,39.9267299336865,24.483853201595895
781,/media/marda/TWOTB1/xBD/hurricanes/images/florence/hurricane-florence_00000012_post_disaster.png,56,57,1,941,997,912,969,169,23.418767877397222,10.213961516210635
782,/media/marda/TWOTB1/xBD/hurricanes/images/florence/hurricane-florence_00000012_post_disaster.png,41,74,1,87,128,917,991,686,39.937512707169,22.93215995274263
783,/media/marda/TWOTB1/xBD/hurricanes/images/florence/hurricane-florence_00000012_post_disaster.png,51,76,1,159,210,919,995,939,45.83672155479272,27.155811900370555
784,/media/marda/TWOTB1/xBD/hurricanes/images/florence/hurricane-florence_00000012_post_disaster.png,45,76,1,185,230,942,1018,925,41.16133408103818,30.522681971382198
785,/media/marda/TWOTB1/xBD/hurricanes/images/florence/hurricane-florence_00000012_post_disaster.png,44,83,1,219,263,945,1028,854,50.67934328159821,22.382753219096042
786,/media/marda/TWOTB1/xBD/hurricanes/images/florence/hurricane-florence_00000012_post_disaster.png,43,70,1,67,110,946,1016,707,41.92806138632811,22.41129575446325
787,/media/marda/TWOTB1/xBD/hurricanes/images/florence/hurricane-florence_00000012_post_disaster.png,50,80,1,243,293,960,1040,1035,48.70011081748489,28.064239616917295
788,/media/marda/TWOTB1/xBD/hurricanes/images/florence/hurricane-florence_00000012_post_disaster.png,43,64,1,52,95,977,1041,773,40.63847049828076,25.008555659569925
789,/media/marda/TWOTB1/xBD/hurricanes/images/florence/hurricane-florence_00000012_post_disaster.png,51,63,1,275,326,978,1041,780,39.77345825130813,26.253947957592654
790,/media/marda/TWOTB1/xBD/hurricanes/images/florence/hurricane-florence_00000012_post_disaster.png,42,61,1,310,352,982,1043,397,27.17773934831768,20.145318524867967
791,/media/marda/TWOTB1/xBD/hurricanes/images/florence/hurricane-florence_00000012_post_disaster.png,71,56,1,872,943,987,1043,304,32.13610679890042,14.5338118026909
792,/media/marda/TWOTB1/xBD/hurricanes/images/florence/hurricane-florence_00000012_post_disaster.png,25,51,1,34,59,992,1043,143,21.54813286754779,10.164490959733504
793,/media/marda/TWOTB1/xBD/hurricanes/images/florence/hurricane-florence_00000197_pre_disaster.png,40,39,1,734,774,402,441,230,26.698225911331694,11.469636405503598
794,/media/marda/TWOTB1/xBD/hurricanes/images/florence/hurricane-florence_00000197_pre_disaster.png,59,69,1,774,833,435,504,1288,59.254687228952065,29.92126248690128
795,/media/marda/TWOTB1/xBD/hurricanes/images/florence/hurricane-florence_00000197_pre_disaster.png,39,25,1,801,840,453,478,57,9.418308044861673,8.047699319587153
796,/media/marda/TWOTB1/xBD/hurricanes/images/florence/hurricane-florence_00000197_pre_disaster.png,37,30,1,665,702,478,508,152,14.69323779199841,13.856607723112534
797,/media/marda/TWOTB1/xBD/hurricanes/images/florence/hurricane-florence_00000197_pre_disaster.png,41,30,1,792,833,515,545,90,11.489125293076057,10.327955589886445
798,/media/marda/TWOTB1/xBD/hurricanes/images/florence/hurricane-florence_00000197_pre_disaster.png,52,68,1,647,699,516,584,949,49.38618530270488,25.08649159251831
799,/media/marda/TWOTB1/xBD/hurricanes/images/florence/hurricane-florence_00000197_pre_disaster.png,80,60,1,558,638,519,579,1536,60.25790876618426,33.65152364929682
800,/media/marda/TWOTB1/xBD/hurricanes/images/florence/hurricane-florence_00000197_pre_disaster.png,58,49,1,676,734,525,574,470,31.335571564961533,19.866447688049085
801,/media/marda/TWOTB1/xBD/hurricanes/images/florence/hurricane-florence_00000197_pre_disaster.png,48,53,1,517,565,556,609,411,35.266625691060106,15.565580246603423
802,/media/marda/TWOTB1/xBD/hurricanes/images/florence/hurricane-florence_00000254_pre_disaster.png,69,35,1,237,306,178,213,1517,62.634677006986735,31.97527677173672
803,/media/marda/TWOTB1/xBD/hurricanes/images/florence/hurricane-florence_00000254_pre_disaster.png,48,48,1,393,441,236,284,946,43.41734869427233,30.488224784299657
804,/media/marda/TWOTB1/xBD/hurricanes/images/florence/hurricane-florence_00000254_pre_disaster.png,39,61,1,362,401,253,314,1404,61.19912853410033,30.58321979997092
805,/media/marda/TWOTB1/xBD/hurricanes/images/florence/hurricane-florence_00000254_pre_disaster.png,29,32,1,404,433,276,308,246,25.725342007454564,12.81368481104838
806,/media/marda/TWOTB1/xBD/hurricanes/images/florence/hurricane-florence_00000254_pre_disaster.png,34,28,1,433,467,427,455,210,20.239943839241917,13.780165917145592
807,/media/marda/TWOTB1/xBD/hurricanes/images/florence/hurricane-florence_00000254_pre_disaster.png,63,57,1,901,964,445,502,921,44.186446500033725,27.839124353372558
808,/media/marda/TWOTB1/xBD/hurricanes/images/florence/hurricane-florence_00000254_pre_disaster.png,44,61,1,395,439,446,507,1019,47.5740517378275,28.341137740870845
809,/media/marda/TWOTB1/xBD/hurricanes/images/florence/hurricane-florence_00000254_pre_disaster.png,39,76,1,219,258,455,531,1574,66.08738247447555,31.79616262313599
810,/media/marda/TWOTB1/xBD/hurricanes/images/florence/hurricane-florence_00000254_pre_disaster.png,42,71,1,427,469,732,803,877,47.211685009457085,24.820030399649404
811,/media/marda/TWOTB1/xBD/hurricanes/images/florence/hurricane-florence_00000254_pre_disaster.png,29,43,1,468,497,756,799,147,15.694209446802125,12.584596217151764
812,/media/marda/TWOTB1/xBD/hurricanes/images/florence/hurricane-florence_00000254_pre_disaster.png,38,49,1,505,543,873,922,237,18.956758024812146,16.784985454174436
813,/media/marda/TWOTB1/xBD/hurricanes/images/florence/hurricane-florence_00000254_pre_disaster.png,42,71,1,443,485,882,953,700,36.40914236116571,25.533353646607715
814,/media/marda/TWOTB1/xBD/hurricanes/images/florence/hurricane-florence_00000254_pre_disaster.png,40,53,1,490,530,899,952,253,20.414384611469487,16.62968449898472
815,/media/marda/TWOTB1/xBD/hurricanes/images/florence/hurricane-florence_00000254_pre_disaster.png,22,47,1,249,271,960,1007,148,15.603581731572659,12.606685897975245
816,/media/marda/TWOTB1/xBD/hurricanes/images/florence/hurricane-florence_00000254_pre_disaster.png,24,55,1,223,247,963,1018,266,19.77685451340791,18.011196221506058
817,/media/marda/TWOTB1/xBD/hurricanes/images/florence/hurricane-florence_00000254_pre_disaster.png,44,78,1,455,499,964,1042,961,46.30291110714529,27.445856148543815
818,/media/marda/TWOTB1/xBD/hurricanes/images/florence/hurricane-florence_00000254_pre_disaster.png,19,52,1,211,230,965,1017,176,18.439088914585774,12.649110640673518
819,/media/marda/TWOTB1/xBD/hurricanes/images/florence/hurricane-florence_00000254_pre_disaster.png,53,61,1,514,567,972,1033,660,36.13312974265601,24.13438391347185
820,/media/marda/TWOTB1/xBD/hurricanes/images/florence/hurricane-florence_00000254_pre_disaster.png,25,54,1,289,314,980,1034,210,17.281975195754296,16.1245154965971
821,/media/marda/TWOTB1/xBD/hurricanes/images/florence/hurricane-florence_00000254_pre_disaster.png,25,63,1,324,349,981,1044,270,26.259621319562648,13.673537270454357
822,/media/marda/TWOTB1/xBD/hurricanes/images/florence/hurricane-florence_00000254_pre_disaster.png,22,47,1,293,315,997,1044,81,13.398971321787323,7.945014804749435
823,/media/marda/TWOTB1/xBD/hurricanes/images/florence/hurricane-florence_00000399_post_disaster.png,63,25,1,483,546,3,28,626,50.39683680482901,16.380287783482196
824,/media/marda/TWOTB1/xBD/hurricanes/images/florence/hurricane-florence_00000399_post_disaster.png,33,16,1,524,557,47,63,127,14.954759807410865,11.40922971691673
825,/media/marda/TWOTB1/xBD/hurricanes/images/florence/hurricane-florence_00000399_post_disaster.png,51,52,1,580,631,52,104,849,54.363878514867594,22.183641292101168
826,/media/marda/TWOTB1/xBD/hurricanes/images/florence/hurricane-florence_00000399_post_disaster.png,59,27,1,515,574,99,126,532,42.925648735567385,16.715593540904706
827,/media/marda/TWOTB1/xBD/hurricanes/images/florence/hurricane-florence_00000399_post_disaster.png,55,24,1,620,675,125,149,338,33.195635484432955,13.62931907348007
828,/media/marda/TWOTB1/xBD/hurricanes/images/florence/hurricane-florence_00000399_post_disaster.png,49,23,1,541,590,142,165,307,31.301094140156398,13.005694248565922
829,/media/marda/TWOTB1/xBD/hurricanes/images/florence/hurricane-florence_00000399_post_disaster.png,46,23,1,646,692,170,193,234,22.38279611528793,13.987852255118513
830,/media/marda/TWOTB1/xBD/hurricanes/images/florence/hurricane-florence_00000399_post_disaster.png,62,29,1,543,605,184,213,483,46.995062119496005,13.722856682659293
831,/media/marda/TWOTB1/xBD/hurricanes/images/florence/hurricane-florence_00000399_post_disaster.png,53,34,1,664,717,199,233,346,28.419350739185862,18.894229592555256
832,/media/marda/TWOTB1/xBD/hurricanes/images/florence/hurricane-florence_00000399_post_disaster.png,66,37,1,668,734,249,286,520,43.898716408904484,15.715423378646415
833,/media/marda/TWOTB1/xBD/hurricanes/images/florence/hurricane-florence_00000399_post_disaster.png,43,26,1,571,614,266,292,236,21.67113286174578,14.640027335140218
834,/media/marda/TWOTB1/xBD/hurricanes/images/florence/hurricane-florence_00000399_post_disaster.png,67,35,1,570,637,273,308,599,50.29739974079067,15.901774506355281
835,/media/marda/TWOTB1/xBD/hurricanes/images/florence/hurricane-florence_00000399_post_disaster.png,65,38,1,592,657,310,348,597,43.035108054360826,21.722681912894426
836,/media/marda/TWOTB1/xBD/hurricanes/images/florence/hurricane-florence_00000399_post_disaster.png,71,64,1,467,538,355,419,1350,56.20947057630778,31.82073769254878
837,/media/marda/TWOTB1/xBD/hurricanes/images/florence/hurricane-florence_00000399_post_disaster.png,100,66,1,802,902,358,424,1849,66.57296470928907,39.66423855644848
838,/media/marda/TWOTB1/xBD/hurricanes/images/florence/hurricane-florence_00000399_post_disaster.png,117,152,1,226,343,371,523,8091,151.17468569373833,72.75701028528383
839,/media/marda/TWOTB1/xBD/hurricanes/images/florence/hurricane-florence_00000399_post_disaster.png,84,43,1,912,996,382,425,821,49.65327427624447,21.870956010017522
840,/media/marda/TWOTB1/xBD/hurricanes/images/florence/hurricane-florence_00000399_post_disaster.png,61,44,1,874,935,410,454,386,25.361049936408953,20.299810531229515
841,/media/marda/TWOTB1/xBD/hurricanes/images/florence/hurricane-florence_00000399_post_disaster.png,141,82,1,53,194,423,505,4828,146.25098181280643,44.95885837911889
842,/media/marda/TWOTB1/xBD/hurricanes/images/florence/hurricane-florence_00000399_post_disaster.png,84,70,1,890,974,431,501,1117,60.1175599559584,24.907831980485888
843,/media/marda/TWOTB1/xBD/hurricanes/images/florence/hurricane-florence_00000399_post_disaster.png,78,132,1,155,233,473,605,4717,126.07135409122712,53.73488237968185
844,/media/marda/TWOTB1/xBD/hurricanes/images/florence/hurricane-florence_00000399_post_disaster.png,67,121,1,85,152,491,612,3417,106.0975045841823,44.252696979794806
845,/media/marda/TWOTB1/xBD/hurricanes/images/florence/hurricane-florence_00000399_post_disaster.png,63,55,1,533,596,494,549,578,47.92699804282183,16.29050668063794
846,/media/marda/TWOTB1/xBD/hurricanes/images/florence/hurricane-florence_00000399_post_disaster.png,58,56,1,567,625,536,592,704,31.992839487447107,29.856518038127348
847,/media/marda/TWOTB1/xBD/hurricanes/images/florence/hurricane-florence_00000399_post_disaster.png,63,56,1,533,596,558,614,636,47.206226469422305,17.987412968098237
848,/media/marda/TWOTB1/xBD/hurricanes/images/florence/hurricane-florence_00000399_post_disaster.png,71,67,1,465,536,589,656,1223,52.76706717767353,30.946312121080656
849,/media/marda/TWOTB1/xBD/hurricanes/images/florence/hurricane-florence_00000399_post_disaster.png,71,61,1,83,154,617,678,1261,75.04419380419048,22.344129819529687
850,/media/marda/TWOTB1/xBD/hurricanes/images/florence/hurricane-florence_00000399_post_disaster.png,62,59,1,335,397,631,690,844,52.90193005132212,21.158830835124338
851,/media/marda/TWOTB1/xBD/hurricanes/images/florence/hurricane-florence_00000399_post_disaster.png,48,63,1,105,153,678,741,796,45.35028812399225,23.432746767171206
852,/media/marda/TWOTB1/xBD/hurricanes/images/florence/hurricane-florence_00000399_post_disaster.png,73,68,1,634,707,688,756,1320,49.94596007120273,35.36980286949302
853,/media/marda/TWOTB1/xBD/hurricanes/images/florence/hurricane-florence_00000399_post_disaster.png,20,51,1,98,118,725,776,194,23.852640390704078,10.882692207846441
854,/media/marda/TWOTB1/xBD/hurricanes/images/florence/hurricane-florence_00000399_post_disaster.png,33,62,1,320,353,935,997,314,27.622416894448822,15.080877059764875
855,/media/marda/TWOTB1/xBD/hurricanes/images/florence/hurricane-florence_00000399_post_disaster.png,45,80,1,285,330,953,1033,794,46.802598480975114,23.27722424939061
856,/media/marda/TWOTB1/xBD/hurricanes/images/florence/hurricane-florence_00000400_post_disaster.png,50,52,1,0,50,491,543,1227,56.45845634210092,29.02212926676371
857,/media/marda/TWOTB1/xBD/hurricanes/images/florence/hurricane-florence_00000400_post_disaster.png,19,32,1,74,93,496,528,204,21.41571638321682,12.731966172297762
858,/media/marda/TWOTB1/xBD/hurricanes/images/florence/hurricane-florence_00000400_post_disaster.png,26,35,1,167,193,535,570,309,25.44894819426311,16.186998728827437
859,/media/marda/TWOTB1/xBD/hurricanes/images/florence/hurricane-florence_00000400_post_disaster.png,58,60,1,116,174,592,652,1186,57.0125737640106,27.772722950090383
860,/media/marda/TWOTB1/xBD/hurricanes/images/florence/hurricane-florence_00000400_post_disaster.png,41,57,1,386,427,757,814,605,30.684303199824704,27.55178566256898
861,/media/marda/TWOTB1/xBD/hurricanes/images/florence/hurricane-florence_00000400_post_disaster.png,20,39,1,346,366,798,837,52,8.822175282350482,7.797207334834404
862,/media/marda/TWOTB1/xBD/hurricanes/images/florence/hurricane-florence_00000400_post_disaster.png,23,47,1,391,414,805,852,113,16.39954773721334,9.226720193899611
863,/media/marda/TWOTB1/xBD/hurricanes/images/florence/hurricane-florence_00000400_post_disaster.png,24,55,1,309,333,815,870,211,25.702664145098776,10.984931227502276
864,/media/marda/TWOTB1/xBD/hurricanes/images/florence/hurricane-florence_00000400_post_disaster.png,55,72,1,30,85,845,917,1159,57.217572622246124,27.02894272386625
865,/media/marda/TWOTB1/xBD/hurricanes/images/florence/hurricane-florence_00000400_post_disaster.png,62,73,1,362,424,857,930,1257,47.716766825919194,36.961739204001404
866,/media/marda/TWOTB1/xBD/hurricanes/images/florence/hurricane-florence_00000400_post_disaster.png,27,50,1,196,223,882,932,210,18.149107010496767,15.501047612332966
867,/media/marda/TWOTB1/xBD/hurricanes/images/florence/hurricane-florence_00000457_pre_disaster.png,123,49,1,503,626,403,452,2897,113.5788821491544,33.934003022688884
868,/media/marda/TWOTB1/xBD/hurricanes/images/florence/hurricane-florence_00000457_pre_disaster.png,118,49,1,515,633,463,512,2868,110.34281688219116,34.673641040068986
869,/media/marda/TWOTB1/xBD/hurricanes/images/florence/hurricane-florence_00000457_pre_disaster.png,91,54,1,545,636,519,573,1995,76.5843702944869,34.53332782092853
870,/media/marda/TWOTB1/xBD/hurricanes/images/florence/hurricane-florence_00000457_pre_disaster.png,90,107,1,954,1044,898,1005,2266,77.07468723555361,41.35920672804952
871,/media/marda/TWOTB1/xBD/hurricanes/images/florence/hurricane-florence_00000166_post_disaster.png,61,53,1,545,606,381,434,863,37.799621070099185,30.365336644509387
872,/media/marda/TWOTB1/xBD/hurricanes/images/florence/hurricane-florence_00000166_post_disaster.png,62,48,1,715,777,484,532,658,30.851595151131885,27.984602113106643
873,/media/marda/TWOTB1/xBD/hurricanes/images/florence/hurricane-florence_00000166_post_disaster.png,78,63,1,722,800,552,615,1154,47.90374468622935,31.57762362837368
874,/media/marda/TWOTB1/xBD/hurricanes/images/florence/hurricane-florence_00000166_post_disaster.png,83,59,1,839,922,606,665,552,57.11236880521427,12.926206027176748
875,/media/marda/TWOTB1/xBD/hurricanes/images/florence/hurricane-florence_00000166_post_disaster.png,75,62,1,913,988,670,732,786,34.55284163126286,30.65122651407892
876,/media/marda/TWOTB1/xBD/hurricanes/images/florence/hurricane-florence_00000195_pre_disaster.png,55,14,1,795,850,0,14,192,20.461527752147752,13.241690794745319
877,/media/marda/TWOTB1/xBD/hurricanes/images/florence/hurricane-florence_00000195_pre_disaster.png,26,47,1,93,119,582,629,442,27.825312986444168,21.369087327324443
878,/media/marda/TWOTB1/xBD/hurricanes/images/florence/hurricane-florence_00000195_pre_disaster.png,27,38,1,199,226,618,656,148,19.32470149602018,10.296376622345113
879,/media/marda/TWOTB1/xBD/hurricanes/images/florence/hurricane-florence_00000195_pre_disaster.png,77,78,1,146,223,627,705,1824,75.92818153840848,38.16229760848169
880,/media/marda/TWOTB1/xBD/hurricanes/images/florence/hurricane-florence_00000195_pre_disaster.png,44,52,1,282,326,643,695,526,31.78491070780989,23.78498889781097
881,/media/marda/TWOTB1/xBD/hurricanes/images/florence/hurricane-florence_00000195_pre_disaster.png,56,67,1,99,155,758,825,1236,58.34264692996903,27.86410348724796
882,/media/marda/TWOTB1/xBD/hurricanes/images/florence/hurricane-florence_00000195_pre_disaster.png,31,63,1,140,171,981,1044,369,24.350227437448794,20.115176347729978
883,/media/marda/TWOTB1/xBD/hurricanes/images/florence/hurricane-florence_00000195_pre_disaster.png,21,52,1,172,193,992,1044,125,15.4281843923152,11.188745343277843
884,/media/marda/TWOTB1/xBD/hurricanes/images/florence/hurricane-florence_00000178_pre_disaster.png,53,38,1,276,329,0,38,1083,39.1175125046986,38.540699366280954
885,/media/marda/TWOTB1/xBD/hurricanes/images/florence/hurricane-florence_00000178_pre_disaster.png,32,13,1,406,438,52,65,104,13.29190035744663,10.661269295642946
886,/media/marda/TWOTB1/xBD/hurricanes/images/florence/hurricane-florence_00000178_pre_disaster.png,59,59,1,168,227,154,213,1489,47.51074222765284,41.8209015915783
887,/media/marda/TWOTB1/xBD/hurricanes/images/florence/hurricane-florence_00000178_pre_disaster.png,51,50,1,227,278,185,235,1006,45.28372232337522,29.50521345064443
888,/media/marda/TWOTB1/xBD/hurricanes/images/florence/hurricane-florence_00000178_pre_disaster.png,26,23,1,359,385,437,460,82,15.756288999556018,6.951256270930285
889,/media/marda/TWOTB1/xBD/hurricanes/images/florence/hurricane-florence_00000178_pre_disaster.png,53,59,1,377,430,447,506,1272,44.838512752073115,37.73941547041028
890,/media/marda/TWOTB1/xBD/hurricanes/images/florence/hurricane-florence_00000178_pre_disaster.png,33,41,1,322,355,465,506,427,27.04073716805927,21.131903181282944
891,/media/marda/TWOTB1/xBD/hurricanes/images/florence/hurricane-florence_00000178_pre_disaster.png,28,44,1,239,267,550,594,268,23.050158030375545,15.572396296826488
892,/media/marda/TWOTB1/xBD/hurricanes/images/florence/hurricane-florence_00000178_pre_disaster.png,29,36,1,332,361,569,605,264,19.27884470215488,18.21419274329653
893,/media/marda/TWOTB1/xBD/hurricanes/images/florence/hurricane-florence_00000178_pre_disaster.png,19,27,1,323,342,571,598,49,8.0,8.0
894,/media/marda/TWOTB1/xBD/hurricanes/images/florence/hurricane-florence_00000178_pre_disaster.png,50,53,1,621,671,616,669,686,32.70402134834847,28.005408067452382
895,/media/marda/TWOTB1/xBD/hurricanes/images/florence/hurricane-florence_00000178_pre_disaster.png,28,37,1,350,378,678,715,163,18.05938930815491,12.344255559905664
896,/media/marda/TWOTB1/xBD/hurricanes/images/florence/hurricane-florence_00000178_pre_disaster.png,40,62,1,409,449,679,741,813,42.907738846926335,25.250027688981458
897,/media/marda/TWOTB1/xBD/hurricanes/images/florence/hurricane-florence_00000178_pre_disaster.png,28,47,1,200,228,748,795,190,17.370376621547575,14.620696045937713
898,/media/marda/TWOTB1/xBD/hurricanes/images/florence/hurricane-florence_00000453_pre_disaster.png,36,49,1,273,309,385,434,650,39.49940619819274,23.7395829273418
899,/media/marda/TWOTB1/xBD/hurricanes/images/florence/hurricane-florence_00000453_pre_disaster.png,53,40,1,98,151,394,434,690,58.643739677060964,15.501055408077914
900,/media/marda/TWOTB1/xBD/hurricanes/images/florence/hurricane-florence_00000453_pre_disaster.png,56,45,1,328,384,400,445,829,47.83553214353843,23.13832704050977
901,/media/marda/TWOTB1/xBD/hurricanes/images/florence/hurricane-florence_00000453_pre_disaster.png,48,36,1,184,232,404,440,496,44.99214399036559,15.348563520638896
902,/media/marda/TWOTB1/xBD/hurricanes/images/florence/hurricane-florence_00000453_pre_disaster.png,22,29,1,296,318,414,443,97,13.156016658111202,9.94675480678194
903,/media/marda/TWOTB1/xBD/hurricanes/images/florence/hurricane-florence_00000453_pre_disaster.png,32,32,1,255,287,435,467,242,25.413954874702714,12.76524996208616
904,/media/marda/TWOTB1/xBD/hurricanes/images/florence/hurricane-florence_00000453_pre_disaster.png,34,34,1,329,363,438,472,285,23.723566598236108,15.957604536797113
905,/media/marda/TWOTB1/xBD/hurricanes/images/florence/hurricane-florence_00000453_pre_disaster.png,36,40,1,322,358,458,498,386,23.90666747647484,21.57033936507955
906,/media/marda/TWOTB1/xBD/hurricanes/images/florence/hurricane-florence_00000491_post_disaster.png,79,59,1,588,667,54,113,2047,56.39305513944912,50.20126428589471
907,/media/marda/TWOTB1/xBD/hurricanes/images/florence/hurricane-florence_00000491_post_disaster.png,82,60,1,545,627,0,60,2146,59.417745312013345,50.5015176938536
908,/media/marda/TWOTB1/xBD/hurricanes/images/florence/hurricane-florence_00000491_post_disaster.png,98,61,1,891,989,149,210,2117,65.88225679183182,44.58997772612035
909,/media/marda/TWOTB1/xBD/hurricanes/images/florence/hurricane-florence_00000491_post_disaster.png,87,76,1,826,913,173,249,2366,68.56652974836801,48.11551450587205
910,/media/marda/TWOTB1/xBD/hurricanes/images/florence/hurricane-florence_00000491_post_disaster.png,88,72,1,953,1041,290,362,1753,58.2345182772727,41.33006964468328
911,/media/marda/TWOTB1/xBD/hurricanes/images/florence/hurricane-florence_00000491_post_disaster.png,85,70,1,836,921,349,419,1627,60.98737966472331,35.20695721080173
912,/media/marda/TWOTB1/xBD/hurricanes/images/florence/hurricane-florence_00000491_post_disaster.png,106,70,1,905,1011,508,578,1994,66.68359686199157,41.79831307283724
913,/media/marda/TWOTB1/xBD/hurricanes/images/florence/hurricane-florence_00000491_post_disaster.png,76,82,1,790,866,555,637,1748,60.62498400470072,39.421236745924716
914,/media/marda/TWOTB1/xBD/hurricanes/images/florence/hurricane-florence_00000491_post_disaster.png,86,78,1,797,883,616,694,1599,49.703181438309144,44.49182104205396
915,/media/marda/TWOTB1/xBD/hurricanes/images/florence/hurricane-florence_00000491_post_disaster.png,72,108,1,971,1043,809,917,1575,76.24948750576858,31.473771418550815
916,/media/marda/TWOTB1/xBD/hurricanes/images/florence/hurricane-florence_00000369_post_disaster.png,63,43,1,217,280,122,165,1110,67.92196200290343,25.723829862172593
917,/media/marda/TWOTB1/xBD/hurricanes/images/florence/hurricane-florence_00000369_post_disaster.png,25,22,1,296,321,139,161,205,19.825503131867215,13.81989841264554
918,/media/marda/TWOTB1/xBD/hurricanes/images/florence/hurricane-florence_00000369_post_disaster.png,32,24,1,339,371,188,212,353,22.659845071777724,20.853468764502615
919,/media/marda/TWOTB1/xBD/hurricanes/images/florence/hurricane-florence_00000152_pre_disaster.png,47,35,1,502,549,247,282,408,23.4887940576912,22.93299096648429
920,/media/marda/TWOTB1/xBD/hurricanes/images/florence/hurricane-florence_00000152_pre_disaster.png,40,29,1,537,577,253,282,205,23.223920679922912,11.68267689973266
921,/media/marda/TWOTB1/xBD/hurricanes/images/florence/hurricane-florence_00000152_pre_disaster.png,63,57,1,392,455,254,311,811,65.82279267381912,16.335698868538124
922,/media/marda/TWOTB1/xBD/hurricanes/images/florence/hurricane-florence_00000152_pre_disaster.png,39,27,1,514,553,293,320,197,18.61088147315767,13.946242297244371
923,/media/marda/TWOTB1/xBD/hurricanes/images/florence/hurricane-florence_00000152_pre_disaster.png,55,52,1,444,499,309,361,883,40.521021040748046,28.58563121703239
924,/media/marda/TWOTB1/xBD/hurricanes/images/florence/hurricane-florence_00000152_pre_disaster.png,61,54,1,665,726,496,550,615,30.718839465404656,27.39652346266341
925,/media/marda/TWOTB1/xBD/hurricanes/images/florence/hurricane-florence_00000152_pre_disaster.png,62,54,1,621,683,512,566,696,34.30495216921134,26.778864179586
926,/media/marda/TWOTB1/xBD/hurricanes/images/florence/hurricane-florence_00000125_pre_disaster.png,21,49,1,0,21,386,435,410,31.56041587815432,19.66653882209613
927,/media/marda/TWOTB1/xBD/hurricanes/images/florence/hurricane-florence_00000125_pre_disaster.png,24,59,1,0,24,425,484,547,37.10420556874409,22.139626379658765
928,/media/marda/TWOTB1/xBD/hurricanes/images/florence/hurricane-florence_00000125_pre_disaster.png,42,53,1,487,529,818,871,216,24.633593210503328,12.813779467823167
929,/media/marda/TWOTB1/xBD/hurricanes/images/florence/hurricane-florence_00000124_pre_disaster.png,72,47,1,722,794,253,300,1086,42.50014265093739,33.487653452906116
930,/media/marda/TWOTB1/xBD/hurricanes/images/florence/hurricane-florence_00000124_pre_disaster.png,34,46,1,77,111,373,419,622,30.879125388843125,26.737350227844864
931,/media/marda/TWOTB1/xBD/hurricanes/images/florence/hurricane-florence_00000124_pre_disaster.png,55,41,1,343,398,396,437,657,47.80845038128671,18.361658510950175
932,/media/marda/TWOTB1/xBD/hurricanes/images/florence/hurricane-florence_00000124_pre_disaster.png,49,57,1,323,372,468,525,855,40.44088902449065,28.04529748294563
933,/media/marda/TWOTB1/xBD/hurricanes/images/florence/hurricane-florence_00000124_pre_disaster.png,63,60,1,866,929,800,860,418,25.315821383756248,22.038936319523355
934,/media/marda/TWOTB1/xBD/hurricanes/images/florence/hurricane-florence_00000124_pre_disaster.png,65,62,1,880,945,835,897,515,32.02265651128763,21.763219334213883
935,/media/marda/TWOTB1/xBD/hurricanes/images/florence/hurricane-florence_00000124_pre_disaster.png,80,67,1,951,1031,879,946,821,36.275869297753566,29.703706981879186
936,/media/marda/TWOTB1/xBD/hurricanes/images/florence/hurricane-florence_00000433_post_disaster.png,59,35,1,984,1043,0,35,409,40.08439406733726,17.251994287086383
937,/media/marda/TWOTB1/xBD/hurricanes/images/florence/hurricane-florence_00000433_post_disaster.png,45,32,1,98,143,84,116,581,45.54566635659273,18.370086897385004
938,/media/marda/TWOTB1/xBD/hurricanes/images/florence/hurricane-florence_00000433_post_disaster.png,70,38,1,863,933,93,131,738,36.079331793862565,27.864606514310232
939,/media/marda/TWOTB1/xBD/hurricanes/images/florence/hurricane-florence_00000433_post_disaster.png,56,25,1,907,963,117,142,216,18.367347962383604,15.895403374706634
940,/media/marda/TWOTB1/xBD/hurricanes/images/florence/hurricane-florence_00000433_post_disaster.png,74,46,1,969,1043,132,178,760,42.05588071346705,25.85593455491909
941,/media/marda/TWOTB1/xBD/hurricanes/images/florence/hurricane-florence_00000433_post_disaster.png,18,17,1,23,41,140,157,128,16.53880872055161,10.641028050898374
942,/media/marda/TWOTB1/xBD/hurricanes/images/florence/hurricane-florence_00000433_post_disaster.png,29,37,1,66,95,145,182,410,38.7820542335082,16.325690329344276
943,/media/marda/TWOTB1/xBD/hurricanes/images/florence/hurricane-florence_00000433_post_disaster.png,68,37,1,753,821,149,186,475,45.03662453871977,14.546547210728479
944,/media/marda/TWOTB1/xBD/hurricanes/images/florence/hurricane-florence_00000433_post_disaster.png,70,38,1,908,978,169,207,651,30.393208079687966,28.291787136003144
945,/media/marda/TWOTB1/xBD/hurricanes/images/florence/hurricane-florence_00000433_post_disaster.png,35,32,1,248,283,176,208,329,30.60609006498529,14.36234459518825
946,/media/marda/TWOTB1/xBD/hurricanes/images/florence/hurricane-florence_00000433_post_disaster.png,74,82,1,455,529,199,281,1799,78.35768126545054,40.40039730098816
947,/media/marda/TWOTB1/xBD/hurricanes/images/florence/hurricane-florence_00000433_post_disaster.png,80,53,1,667,747,206,259,1140,56.538748806198015,26.79554562596786
948,/media/marda/TWOTB1/xBD/hurricanes/images/florence/hurricane-florence_00000433_post_disaster.png,40,37,1,284,324,215,252,420,33.19344758147701,16.735030648542754
949,/media/marda/TWOTB1/xBD/hurricanes/images/florence/hurricane-florence_00000433_post_disaster.png,50,49,1,200,250,235,284,689,48.95106345775146,18.821637998286523
950,/media/marda/TWOTB1/xBD/hurricanes/images/florence/hurricane-florence_00000433_post_disaster.png,58,49,1,319,377,235,284,739,53.004282771452644,19.59195409195222
951,/media/marda/TWOTB1/xBD/hurricanes/images/florence/hurricane-florence_00000433_post_disaster.png,36,53,1,59,95,254,307,929,40.21137830385406,31.46093249199584
952,/media/marda/TWOTB1/xBD/hurricanes/images/florence/hurricane-florence_00000433_post_disaster.png,73,65,1,361,434,258,323,1705,51.4308882312694,44.318415114361265
953,/media/marda/TWOTB1/xBD/hurricanes/images/florence/hurricane-florence_00000433_post_disaster.png,8,28,1,0,8,261,289,83,17.954870317112317,7.099303009928973
954,/media/marda/TWOTB1/xBD/hurricanes/images/florence/hurricane-florence_00000433_post_disaster.png,43,44,1,228,271,266,310,560,41.372595511968626,18.47602207249824
955,/media/marda/TWOTB1/xBD/hurricanes/images/florence/hurricane-florence_00000433_post_disaster.png,54,34,1,714,768,270,304,307,27.860834009696838,14.722872272611367
956,/media/marda/TWOTB1/xBD/hurricanes/images/florence/hurricane-florence_00000433_post_disaster.png,64,61,1,657,721,271,332,933,50.99722334004338,31.119679236822304
957,/media/marda/TWOTB1/xBD/hurricanes/images/florence/hurricane-florence_00000433_post_disaster.png,51,30,1,743,794,275,305,264,23.63270521651715,14.883541513000912
958,/media/marda/TWOTB1/xBD/hurricanes/images/florence/hurricane-florence_00000433_post_disaster.png,40,42,1,254,294,283,325,453,38.05747690139207,15.899474632766493
959,/media/marda/TWOTB1/xBD/hurricanes/images/florence/hurricane-florence_00000433_post_disaster.png,69,65,1,586,655,289,354,1300,52.642927599223725,36.63108591674144
960,/media/marda/TWOTB1/xBD/hurricanes/images/florence/hurricane-florence_00000433_post_disaster.png,44,30,1,676,720,315,345,163,15.06887761152957,14.488304741237009
961,/media/marda/TWOTB1/xBD/hurricanes/images/florence/hurricane-florence_00000433_post_disaster.png,38,25,1,651,689,320,345,96,12.955632344714871,9.890311279997434
962,/media/marda/TWOTB1/xBD/hurricanes/images/florence/hurricane-florence_00000433_post_disaster.png,64,58,1,137,201,336,394,1181,67.72060559108338,23.202570011504154
963,/media/marda/TWOTB1/xBD/hurricanes/images/florence/hurricane-florence_00000433_post_disaster.png,58,55,1,297,355,349,404,722,55.908625035843784,17.23015838532305
964,/media/marda/TWOTB1/xBD/hurricanes/images/florence/hurricane-florence_00000433_post_disaster.png,40,41,1,217,257,382,423,497,30.21802429103743,21.97499634500174
965,/media/marda/TWOTB1/xBD/hurricanes/images/florence/hurricane-florence_00000433_post_disaster.png,52,32,1,611,663,382,414,276,26.724965426754437,13.82207274248158
966,/media/marda/TWOTB1/xBD/hurricanes/images/florence/hurricane-florence_00000433_post_disaster.png,39,34,1,445,484,400,434,282,22.514336331087005,16.759406589019964
967,/media/marda/TWOTB1/xBD/hurricanes/images/florence/hurricane-florence_00000433_post_disaster.png,48,48,1,495,543,404,452,522,31.99315487103197,22.069615989936302
968,/media/marda/TWOTB1/xBD/hurricanes/images/florence/hurricane-florence_00000433_post_disaster.png,32,48,1,0,32,412,460,644,35.187987959443326,24.03868778823626
969,/media/marda/TWOTB1/xBD/hurricanes/images/florence/hurricane-florence_00000433_post_disaster.png,36,33,1,521,557,414,447,142,15.986687150988741,11.968405714415859
970,/media/marda/TWOTB1/xBD/hurricanes/images/florence/hurricane-florence_00000433_post_disaster.png,44,57,1,436,480,416,473,816,43.522326737269935,24.924645781614384
971,/media/marda/TWOTB1/xBD/hurricanes/images/florence/hurricane-florence_00000433_post_disaster.png,42,61,1,48,90,514,575,888,34.90989982495853,33.959925711106706
972,/media/marda/TWOTB1/xBD/hurricanes/images/florence/hurricane-florence_00000433_post_disaster.png,60,63,1,576,636,565,628,1136,42.378812874234974,35.92152329751758
973,/media/marda/TWOTB1/xBD/hurricanes/images/florence/hurricane-florence_00000433_post_disaster.png,46,60,1,189,235,602,662,799,37.15612607574015,28.26427793945172
974,/media/marda/TWOTB1/xBD/hurricanes/images/florence/hurricane-florence_00000433_post_disaster.png,27,46,1,210,237,632,678,219,18.276244403434838,15.928813596589858
975,/media/marda/TWOTB1/xBD/hurricanes/images/florence/hurricane-florence_00000433_post_disaster.png,47,48,1,585,632,638,686,344,22.412609005622613,20.543783745560116
976,/media/marda/TWOTB1/xBD/hurricanes/images/florence/hurricane-florence_00000433_post_disaster.png,53,65,1,79,132,642,707,710,60.05438946868211,15.78691556587334
977,/media/marda/TWOTB1/xBD/hurricanes/images/florence/hurricane-florence_00000433_post_disaster.png,20,36,1,232,252,649,685,72,10.127654814476266,9.609588347360633
978,/media/marda/TWOTB1/xBD/hurricanes/images/florence/hurricane-florence_00000433_post_disaster.png,48,65,1,99,147,655,720,885,46.58667530295433,25.364115347723992
979,/media/marda/TWOTB1/xBD/hurricanes/images/florence/hurricane-florence_00000433_post_disaster.png,44,64,1,196,240,687,751,758,39.24684792568231,25.609830155987964
980,/media/marda/TWOTB1/xBD/hurricanes/images/florence/hurricane-florence_00000433_post_disaster.png,18,43,1,154,172,686,729,106,12.782238216082495,11.169266477025714
981,/media/marda/TWOTB1/xBD/hurricanes/images/florence/hurricane-florence_00000433_post_disaster.png,45,57,1,384,429,686,743,505,29.572199367589057,22.675905453277075
982,/media/marda/TWOTB1/xBD/hurricanes/images/florence/hurricane-florence_00000433_post_disaster.png,30,45,1,312,342,698,743,228,18.6306563669325,16.368136100665687
983,/media/marda/TWOTB1/xBD/hurricanes/images/florence/hurricane-florence_00000433_post_disaster.png,19,44,1,130,149,705,749,119,14.810099269971323,10.760463510723783
984,/media/marda/TWOTB1/xBD/hurricanes/images/florence/hurricane-florence_00000433_post_disaster.png,65,69,1,298,363,716,785,762,61.16978428946465,17.855040880606552
985,/media/marda/TWOTB1/xBD/hurricanes/images/florence/hurricane-florence_00000433_post_disaster.png,47,58,1,192,239,863,921,446,45.3781953601719,13.131404184162466
986,/media/marda/TWOTB1/xBD/hurricanes/images/florence/hurricane-florence_00000433_post_disaster.png,9,54,1,0,9,884,938,86,15.70944305973323,8.3922101423387
987,/media/marda/TWOTB1/xBD/hurricanes/images/florence/hurricane-florence_00000433_post_disaster.png,66,74,1,278,344,893,967,1086,58.017377461784086,25.398286117112956
988,/media/marda/TWOTB1/xBD/hurricanes/images/florence/hurricane-florence_00000433_post_disaster.png,50,78,1,270,320,947,1025,1208,43.44675965145411,36.65396243873801
989,/media/marda/TWOTB1/xBD/hurricanes/images/florence/hurricane-florence_00000433_post_disaster.png,86,89,1,350,436,952,1041,2189,75.98538329453216,38.76631020702762
990,/media/marda/TWOTB1/xBD/hurricanes/images/florence/hurricane-florence_00000065_pre_disaster.png,56,37,1,449,505,15,52,975,38.55888272545904,33.75349162904973
991,/media/marda/TWOTB1/xBD/hurricanes/images/florence/hurricane-florence_00000065_pre_disaster.png,64,55,1,889,953,433,488,738,36.79880387504642,26.84141988522532
992,/media/marda/TWOTB1/xBD/hurricanes/images/florence/hurricane-florence_00000450_post_disaster.png,44,52,1,241,285,28,80,1097,52.71153290338352,27.632959713583787
993,/media/marda/TWOTB1/xBD/hurricanes/images/florence/hurricane-florence_00000450_post_disaster.png,26,19,1,294,320,54,73,195,19.776626785704604,13.160038907141015
994,/media/marda/TWOTB1/xBD/hurricanes/images/florence/hurricane-florence_00000450_post_disaster.png,26,11,1,297,323,72,83,99,15.70529737342769,8.433665737450484
995,/media/marda/TWOTB1/xBD/hurricanes/images/florence/hurricane-florence_00000450_post_disaster.png,45,34,1,487,532,155,189,498,35.61873336076517,21.880274757018555
996,/media/marda/TWOTB1/xBD/hurricanes/images/florence/hurricane-florence_00000450_post_disaster.png,31,16,1,491,522,277,293,79,12.15176514137227,8.613142881135907
997,/media/marda/TWOTB1/xBD/hurricanes/images/florence/hurricane-florence_00000450_post_disaster.png,46,63,1,323,369,305,368,1019,53.45242050059224,27.699250126196564
998,/media/marda/TWOTB1/xBD/hurricanes/images/florence/hurricane-florence_00000450_post_disaster.png,21,38,1,178,199,316,354,270,27.911117523553973,13.033487471826755
999,/media/marda/TWOTB1/xBD/hurricanes/images/florence/hurricane-florence_00000450_post_disaster.png,25,39,1,369,394,319,358,302,29.119717078114302,13.841381859270898
1000,/media/marda/TWOTB1/xBD/hurricanes/images/florence/hurricane-florence_00000450_post_disaster.png,31,49,1,202,233,337,386,422,40.33285440692528,13.943101013573258
1001,/media/marda/TWOTB1/xBD/hurricanes/images/florence/hurricane-florence_00000450_post_disaster.png,41,46,1,342,383,398,444,652,29.527025753271626,28.975393588244653
1002,/media/marda/TWOTB1/xBD/hurricanes/images/florence/hurricane-florence_00000450_post_disaster.png,47,37,1,200,247,431,468,598,42.7804629182616,18.64987244190588
1003,/media/marda/TWOTB1/xBD/hurricanes/images/florence/hurricane-florence_00000450_post_disaster.png,41,65,1,356,397,433,498,688,54.186895878557095,16.82295731809208
1004,/media/marda/TWOTB1/xBD/hurricanes/images/florence/hurricane-florence_00000450_post_disaster.png,16,31,1,183,199,446,477,157,15.752475901413735,13.334119007975662
1005,/media/marda/TWOTB1/xBD/hurricanes/images/florence/hurricane-florence_00000450_post_disaster.png,38,72,1,145,183,544,616,1434,53.429014518883164,36.245834755588504
1006,/media/marda/TWOTB1/xBD/hurricanes/images/florence/hurricane-florence_00000450_post_disaster.png,41,34,1,549,590,552,586,200,21.501526811166705,12.385327803036928
1007,/media/marda/TWOTB1/xBD/hurricanes/images/florence/hurricane-florence_00000450_post_disaster.png,32,28,1,592,624,554,582,54,8.870030247326662,8.12320666941029
1008,/media/marda/TWOTB1/xBD/hurricanes/images/florence/hurricane-florence_00000450_post_disaster.png,65,55,1,230,295,572,627,1253,59.21820416479473,28.3007935154021
1009,/media/marda/TWOTB1/xBD/hurricanes/images/florence/hurricane-florence_00000450_post_disaster.png,55,71,1,466,521,728,799,911,42.494186534840544,28.39515933530226
1010,/media/marda/TWOTB1/xBD/hurricanes/images/florence/hurricane-florence_00000450_post_disaster.png,40,46,1,526,566,732,778,210,18.286842012947883,15.397927493602705
1011,/media/marda/TWOTB1/xBD/hurricanes/images/florence/hurricane-florence_00000450_post_disaster.png,51,59,1,527,578,746,805,549,27.579194092923366,26.631384897094417
1012,/media/marda/TWOTB1/xBD/hurricanes/images/florence/hurricane-florence_00000450_post_disaster.png,34,47,1,548,582,848,895,123,13.453337017993494,12.29889678861658
1013,/media/marda/TWOTB1/xBD/hurricanes/images/florence/hurricane-florence_00000450_post_disaster.png,49,72,1,589,638,892,964,428,39.19143369309855,14.599760970870808
1014,/media/marda/TWOTB1/xBD/hurricanes/images/florence/hurricane-florence_00000450_post_disaster.png,55,82,1,551,606,951,1033,1018,47.67545068027891,28.459061772779727
1015,/media/marda/TWOTB1/xBD/hurricanes/images/florence/hurricane-florence_00000044_pre_disaster.png,80,40,1,724,804,608,648,652,58.026003761709525,14.810990464498058
1016,/media/marda/TWOTB1/xBD/hurricanes/images/florence/hurricane-florence_00000044_pre_disaster.png,81,36,1,876,957,620,656,507,53.23245563015269,12.67683066036152
1017,/media/marda/TWOTB1/xBD/hurricanes/images/florence/hurricane-florence_00000044_pre_disaster.png,60,36,1,960,1020,632,668,264,25.37715508089904,13.808210118138652
1018,/media/marda/TWOTB1/xBD/hurricanes/images/florence/hurricane-florence_00000044_pre_disaster.png,81,51,1,735,816,704,755,747,52.87542255063369,21.27370714867569
1019,/media/marda/TWOTB1/xBD/hurricanes/images/florence/hurricane-florence_00000044_pre_disaster.png,36,38,1,724,760,732,770,60,10.910393961102889,7.389705546094112
1020,/media/marda/TWOTB1/xBD/hurricanes/images/florence/hurricane-florence_00000044_pre_disaster.png,41,40,1,738,779,756,796,109,13.47644604823127,10.940446637073277
1021,/media/marda/TWOTB1/xBD/hurricanes/images/florence/hurricane-florence_00000044_pre_disaster.png,39,39,1,734,773,768,807,101,12.356149927624656,10.95108599113064
1022,/media/marda/TWOTB1/xBD/hurricanes/images/florence/hurricane-florence_00000506_post_disaster.png,118,147,1,829,947,59,206,4963,167.75246622956783,39.89955484114894
1023,/media/marda/TWOTB1/xBD/hurricanes/images/florence/hurricane-florence_00000506_post_disaster.png,85,65,1,958,1043,269,334,1676,55.45290054320635,40.603842125157065
1024,/media/marda/TWOTB1/xBD/hurricanes/images/florence/hurricane-florence_00000506_post_disaster.png,74,49,1,704,778,557,606,522,53.777590837774206,12.970116429812954
1025,/media/marda/TWOTB1/xBD/hurricanes/images/florence/hurricane-florence_00000506_post_disaster.png,39,33,1,761,800,572,605,79,11.16957893883588,9.610121246880647
1026,/media/marda/TWOTB1/xBD/hurricanes/images/florence/hurricane-florence_00000506_post_disaster.png,102,87,1,682,784,573,660,2133,86.08377066354467,43.07563393729064
1027,/media/marda/TWOTB1/xBD/hurricanes/images/florence/hurricane-florence_00000506_post_disaster.png,42,33,1,768,810,580,613,96,12.955632344714871,9.890311279997434
1028,/media/marda/TWOTB1/xBD/hurricanes/images/florence/hurricane-florence_00000506_post_disaster.png,104,85,1,920,1024,862,947,1336,78.20221854618127,22.903369372070426
1029,/media/marda/TWOTB1/xBD/hurricanes/images/florence/hurricane-florence_00000316_post_disaster.png,52,6,1,800,852,0,6,63,18.1139309583086,5.2622236559297395
1030,/media/marda/TWOTB1/xBD/hurricanes/images/florence/hurricane-florence_00000316_post_disaster.png,60,36,1,984,1044,0,36,521,33.90295073976182,21.33577281126356
1031,/media/marda/TWOTB1/xBD/hurricanes/images/florence/hurricane-florence_00000316_post_disaster.png,46,25,1,662,708,168,193,273,20.418858465694942,17.91534025497453
1032,/media/marda/TWOTB1/xBD/hurricanes/images/florence/hurricane-florence_00000316_post_disaster.png,75,30,1,663,738,189,219,663,51.40960924472105,19.294123811881473
1033,/media/marda/TWOTB1/xBD/hurricanes/images/florence/hurricane-florence_00000316_post_disaster.png,77,48,1,913,990,259,307,1061,39.28155861961121,35.347272661875266
1034,/media/marda/TWOTB1/xBD/hurricanes/images/florence/hurricane-florence_00000316_post_disaster.png,66,45,1,750,816,260,305,884,40.047423929465076,29.002616600967425
1035,/media/marda/TWOTB1/xBD/hurricanes/images/florence/hurricane-florence_00000316_post_disaster.png,49,27,1,732,781,268,295,253,19.984365705946487,16.945532880917213
1036,/media/marda/TWOTB1/xBD/hurricanes/images/florence/hurricane-florence_00000316_post_disaster.png,45,47,1,571,616,298,345,615,37.44139577765963,21.946915169852105
1037,/media/marda/TWOTB1/xBD/hurricanes/images/florence/hurricane-florence_00000316_post_disaster.png,50,30,1,768,818,316,346,230,19.917296204347494,15.113763554134646
1038,/media/marda/TWOTB1/xBD/hurricanes/images/florence/hurricane-florence_00000316_post_disaster.png,52,59,1,585,637,337,396,1335,53.124581222150454,33.54596681228679
1039,/media/marda/TWOTB1/xBD/hurricanes/images/florence/hurricane-florence_00000316_post_disaster.png,92,65,1,890,982,444,509,1876,56.90052486400683,43.978694607377605
1040,/media/marda/TWOTB1/xBD/hurricanes/images/florence/hurricane-florence_00000316_post_disaster.png,66,49,1,948,1014,464,513,675,31.665687700486203,28.46918645592345
1041,/media/marda/TWOTB1/xBD/hurricanes/images/florence/hurricane-florence_00000316_post_disaster.png,127,84,1,917,1044,553,637,2875,109.14110537173137,39.160156233605726
1042,/media/marda/TWOTB1/xBD/hurricanes/images/florence/hurricane-florence_00000316_post_disaster.png,54,40,1,768,822,573,613,233,25.985633398629624,11.759191520456787
1043,/media/marda/TWOTB1/xBD/hurricanes/images/florence/hurricane-florence_00000316_post_disaster.png,67,59,1,672,739,592,651,712,36.22029537451833,31.040863244910096
1044,/media/marda/TWOTB1/xBD/hurricanes/images/florence/hurricane-florence_00000316_post_disaster.png,80,90,1,627,707,598,688,1731,71.24091537725451,33.88858114137605
1045,/media/marda/TWOTB1/xBD/hurricanes/images/florence/hurricane-florence_00000316_post_disaster.png,96,71,1,838,934,607,678,1982,68.30366726175671,39.49180532458906
1046,/media/marda/TWOTB1/xBD/hurricanes/images/florence/hurricane-florence_00000316_post_disaster.png,41,38,1,769,810,609,647,92,11.804286982585277,10.515315131322915
1047,/media/marda/TWOTB1/xBD/hurricanes/images/florence/hurricane-florence_00000316_post_disaster.png,55,36,1,974,1029,676,712,152,18.237980323708182,11.213091207702485
1048,/media/marda/TWOTB1/xBD/hurricanes/images/florence/hurricane-florence_00000316_post_disaster.png,61,81,1,406,467,928,1009,1165,41.05399643445186,37.42340807360726
1049,/media/marda/TWOTB1/xBD/hurricanes/images/florence/hurricane-florence_00000316_post_disaster.png,31,49,1,491,522,941,990,83,11.561499741626143,9.74465134052907
1050,/media/marda/TWOTB1/xBD/hurricanes/images/florence/hurricane-florence_00000316_post_disaster.png,48,68,1,454,502,967,1035,562,29.829548073502977,24.847023294298314
1051,/media/marda/TWOTB1/xBD/hurricanes/images/florence/hurricane-florence_00000316_post_disaster.png,74,67,1,933,1007,974,1041,796,39.11509009029375,26.751225111150568
1052,/media/marda/TWOTB1/xBD/hurricanes/images/florence/hurricane-florence_00000316_post_disaster.png,73,63,1,894,967,978,1041,636,33.18879013716458,25.76193977522586
1053,/media/marda/TWOTB1/xBD/hurricanes/images/florence/hurricane-florence_00000448_post_disaster.png,44,40,1,187,231,17,57,1214,40.3000073985083,39.631345772038536
1054,/media/marda/TWOTB1/xBD/hurricanes/images/florence/hurricane-florence_00000448_post_disaster.png,53,36,1,99,152,23,59,1311,55.1123563613768,33.21600989305134
1055,/media/marda/TWOTB1/xBD/hurricanes/images/florence/hurricane-florence_00000448_post_disaster.png,51,24,1,305,356,54,78,812,44.53092547738799,24.320541792912316
1056,/media/marda/TWOTB1/xBD/hurricanes/images/florence/hurricane-florence_00000448_post_disaster.png,28,36,1,211,239,60,96,645,41.87521040609633,21.486316170764226
1057,/media/marda/TWOTB1/xBD/hurricanes/images/florence/hurricane-florence_00000448_post_disaster.png,63,25,1,536,599,95,120,872,45.080864627955584,25.12257731954501
1058,/media/marda/TWOTB1/xBD/hurricanes/images/florence/hurricane-florence_00000448_post_disaster.png,23,13,1,341,364,96,109,98,13.471634608367156,9.83331851531443
1059,/media/marda/TWOTB1/xBD/hurricanes/images/florence/hurricane-florence_00000448_post_disaster.png,31,53,1,141,172,106,159,942,52.0720115511433,24.63957886947877
1060,/media/marda/TWOTB1/xBD/hurricanes/images/florence/hurricane-florence_00000448_post_disaster.png,45,38,1,250,295,132,170,843,36.98460084411354,30.4601358183839
1061,/media/marda/TWOTB1/xBD/hurricanes/images/florence/hurricane-florence_00000448_post_disaster.png,20,15,1,288,308,133,148,96,11.730380376268224,10.965250471135075
1062,/media/marda/TWOTB1/xBD/hurricanes/images/florence/hurricane-florence_00000448_post_disaster.png,23,24,1,182,205,136,160,315,22.01190648519376,19.08860759409365
1063,/media/marda/TWOTB1/xBD/hurricanes/images/florence/hurricane-florence_00000448_post_disaster.png,60,27,1,495,555,143,170,792,41.80117027226676,25.22329948808391
1064,/media/marda/TWOTB1/xBD/hurricanes/images/florence/hurricane-florence_00000448_post_disaster.png,45,27,1,591,636,269,296,218,18.64463818194652,15.689437909946102
1065,/media/marda/TWOTB1/xBD/hurricanes/images/florence/hurricane-florence_00000448_post_disaster.png,39,32,1,631,670,356,388,264,21.87965102637628,15.986094120065681
1066,/media/marda/TWOTB1/xBD/hurricanes/images/florence/hurricane-florence_00000448_post_disaster.png,44,29,1,697,741,361,390,168,16.58334595183395,13.699210707308787
1067,/media/marda/TWOTB1/xBD/hurricanes/images/florence/hurricane-florence_00000241_post_disaster.png,71,82,1,638,709,302,384,1771,75.28162743946035,36.12566554096531
1068,/media/marda/TWOTB1/xBD/hurricanes/images/florence/hurricane-florence_00000241_post_disaster.png,59,54,1,750,809,316,370,833,41.85945150764483,26.66691590365306
1069,/media/marda/TWOTB1/xBD/hurricanes/images/florence/hurricane-florence_00000241_post_disaster.png,55,36,1,710,765,327,363,382,25.659147479468672,20.43837094824034
1070,/media/marda/TWOTB1/xBD/hurricanes/images/florence/hurricane-florence_00000241_post_disaster.png,131,66,1,653,784,401,467,2257,114.02946535361117,42.12893485421769
1071,/media/marda/TWOTB1/xBD/hurricanes/images/florence/hurricane-florence_00000241_post_disaster.png,72,83,1,517,589,411,494,2149,63.445708649021235,47.76175321564983
1072,/media/marda/TWOTB1/xBD/hurricanes/images/florence/hurricane-florence_00000241_post_disaster.png,41,34,1,593,634,431,465,223,17.505392322741123,16.263937178461177
1073,/media/marda/TWOTB1/xBD/hurricanes/images/florence/hurricane-florence_00000241_post_disaster.png,120,81,1,714,834,580,661,3528,97.04189019412723,53.820593597258494
1074,/media/marda/TWOTB1/xBD/hurricanes/images/florence/hurricane-florence_00000241_post_disaster.png,64,75,1,749,813,663,738,1489,55.90156332345034,36.2689807400793
1075,/media/marda/TWOTB1/xBD/hurricanes/images/florence/hurricane-florence_00000288_post_disaster.png,82,60,1,99,181,0,60,2423,72.88690177417064,47.127969778198135
1076,/media/marda/TWOTB1/xBD/hurricanes/images/florence/hurricane-florence_00000288_post_disaster.png,44,24,1,172,216,0,24,508,32.92519786010191,21.867907682748744
1077,/media/marda/TWOTB1/xBD/hurricanes/images/florence/hurricane-florence_00000288_post_disaster.png,35,26,1,28,63,82,108,748,37.192969909609246,26.380317884608928
1078,/media/marda/TWOTB1/xBD/hurricanes/images/florence/hurricane-florence_00000288_post_disaster.png,18,16,1,84,102,95,111,199,16.96280218419479,15.581763668761793
1079,/media/marda/TWOTB1/xBD/hurricanes/images/florence/hurricane-florence_00000288_post_disaster.png,30,26,1,104,134,101,127,359,24.48944958322461,19.607862842045574
1080,/media/marda/TWOTB1/xBD/hurricanes/images/florence/hurricane-florence_00000288_post_disaster.png,38,19,1,654,692,119,138,98,15.252281647638464,8.575274618256376
1081,/media/marda/TWOTB1/xBD/hurricanes/images/florence/hurricane-florence_00000288_post_disaster.png,57,60,1,53,110,135,195,2130,59.33610953840285,50.61784306465522
1082,/media/marda/TWOTB1/xBD/hurricanes/images/florence/hurricane-florence_00000288_post_disaster.png,51,28,1,635,686,145,173,314,26.40882828604342,16.064534386286816
1083,/media/marda/TWOTB1/xBD/hurricanes/images/florence/hurricane-florence_00000288_post_disaster.png,25,22,1,126,151,151,173,349,23.729296114372303,19.645421841515745
1084,/media/marda/TWOTB1/xBD/hurricanes/images/florence/hurricane-florence_00000288_post_disaster.png,37,30,1,112,149,176,206,758,35.40415001569458,28.35904148111835
1085,/media/marda/TWOTB1/xBD/hurricanes/images/florence/hurricane-florence_00000288_post_disaster.png,16,16,1,90,106,196,212,127,15.223448600354297,11.255606318474921
1086,/media/marda/TWOTB1/xBD/hurricanes/images/florence/hurricane-florence_00000045_pre_disaster.png,26,17,1,475,501,191,208,115,13.966809088803258,11.024550795721026
1087,/media/marda/TWOTB1/xBD/hurricanes/images/florence/hurricane-florence_00000045_pre_disaster.png,27,23,1,129,156,197,220,379,26.057891807773256,19.42435938815798
1088,/media/marda/TWOTB1/xBD/hurricanes/images/florence/hurricane-florence_00000045_pre_disaster.png,15,20,1,83,98,207,227,174,16.80949810124836,13.745363816854432
1089,/media/marda/TWOTB1/xBD/hurricanes/images/florence/hurricane-florence_00000045_pre_disaster.png,22,23,1,119,141,226,249,237,19.71973626050699,16.197578252371798
1090,/media/marda/TWOTB1/xBD/hurricanes/images/florence/hurricane-florence_00000045_pre_disaster.png,38,35,1,58,96,242,277,882,41.23994360202934,28.181605455514706
1091,/media/marda/TWOTB1/xBD/hurricanes/images/florence/hurricane-florence_00000045_pre_disaster.png,54,40,1,111,165,244,284,1186,54.122337050867195,29.25314670221972
1092,/media/marda/TWOTB1/xBD/hurricanes/images/florence/hurricane-florence_00000045_pre_disaster.png,43,41,1,358,401,258,299,783,35.18333070779207,30.861506870267505
1093,/media/marda/TWOTB1/xBD/hurricanes/images/florence/hurricane-florence_00000045_pre_disaster.png,25,33,1,239,264,266,299,412,28.87495476678261,19.01208915691289
1094,/media/marda/TWOTB1/xBD/hurricanes/images/florence/hurricane-florence_00000045_pre_disaster.png,68,27,1,655,723,266,293,616,47.01509525002164,17.377668827215107
1095,/media/marda/TWOTB1/xBD/hurricanes/images/florence/hurricane-florence_00000045_pre_disaster.png,50,48,1,723,773,267,315,840,46.21840675659505,24.218289443075765
1096,/media/marda/TWOTB1/xBD/hurricanes/images/florence/hurricane-florence_00000045_pre_disaster.png,45,34,1,455,500,270,304,627,31.340570024240815,26.75962197434054
1097,/media/marda/TWOTB1/xBD/hurricanes/images/florence/hurricane-florence_00000045_pre_disaster.png,75,24,1,809,884,270,294,536,49.247348601357736,14.551909798044742
1098,/media/marda/TWOTB1/xBD/hurricanes/images/florence/hurricane-florence_00000045_pre_disaster.png,65,23,1,552,617,392,415,473,49.63869458396343,12.649110640673518
1099,/media/marda/TWOTB1/xBD/hurricanes/images/florence/hurricane-florence_00000045_pre_disaster.png,35,50,1,6,41,393,443,899,38.402282265437066,33.027979757235954
1100,/media/marda/TWOTB1/xBD/hurricanes/images/florence/hurricane-florence_00000045_pre_disaster.png,67,25,1,468,535,393,418,541,56.76498920013948,12.70882329910165
1101,/media/marda/TWOTB1/xBD/hurricanes/images/florence/hurricane-florence_00000045_pre_disaster.png,33,33,1,430,463,394,427,273,19.66446627592801,18.50980413341272
1102,/media/marda/TWOTB1/xBD/hurricanes/images/florence/hurricane-florence_00000045_pre_disaster.png,13,32,1,43,56,417,449,184,16.358365260120507,14.979863970671083
1103,/media/marda/TWOTB1/xBD/hurricanes/images/florence/hurricane-florence_00000045_pre_disaster.png,55,44,1,543,598,421,465,354,40.94456336635686,11.544818912946965
1104,/media/marda/TWOTB1/xBD/hurricanes/images/florence/hurricane-florence_00000045_pre_disaster.png,33,44,1,429,462,422,466,392,29.542780229455218,17.745589186173056
1105,/media/marda/TWOTB1/xBD/hurricanes/images/florence/hurricane-florence_00000045_pre_disaster.png,28,46,1,403,431,432,478,305,33.63787986300407,12.115206579945404
1106,/media/marda/TWOTB1/xBD/hurricanes/images/florence/hurricane-florence_00000045_pre_disaster.png,18,29,1,39,57,446,475,181,19.387390423149515,12.359951023573466
1107,/media/marda/TWOTB1/xBD/hurricanes/images/florence/hurricane-florence_00000045_pre_disaster.png,51,36,1,484,535,451,487,412,34.999695181612125,16.978196433723802
1108,/media/marda/TWOTB1/xBD/hurricanes/images/florence/hurricane-florence_00000045_pre_disaster.png,53,73,1,181,234,516,589,1665,63.68311659401299,41.471904856640556
1109,/media/marda/TWOTB1/xBD/hurricanes/images/florence/hurricane-florence_00000045_pre_disaster.png,58,49,1,74,132,542,591,1215,61.413996084581846,26.278708333368353
1110,/media/marda/TWOTB1/xBD/hurricanes/images/florence/hurricane-florence_00000045_pre_disaster.png,65,57,1,95,160,591,648,1287,68.39888769637055,25.006262344383543
1111,/media/marda/TWOTB1/xBD/hurricanes/images/florence/hurricane-florence_00000405_pre_disaster.png,77,63,1,967,1044,95,158,1698,64.86275168116929,40.80761022104768
1112,/media/marda/TWOTB1/xBD/hurricanes/images/florence/hurricane-florence_00000405_pre_disaster.png,84,51,1,802,886,98,149,1873,53.9417079191131,48.43364834391783
1113,/media/marda/TWOTB1/xBD/hurricanes/images/florence/hurricane-florence_00000405_pre_disaster.png,78,73,1,602,680,135,208,2356,70.45781844619415,48.30911094037357
1114,/media/marda/TWOTB1/xBD/hurricanes/images/florence/hurricane-florence_00000405_pre_disaster.png,88,60,1,669,757,153,213,1939,65.17790327770398,45.9178173602735
1115,/media/marda/TWOTB1/xBD/hurricanes/images/florence/hurricane-florence_00000405_pre_disaster.png,72,50,1,5,77,155,205,1935,72.8454476654136,38.4824133075963
1116,/media/marda/TWOTB1/xBD/hurricanes/images/florence/hurricane-florence_00000405_pre_disaster.png,80,63,1,390,470,180,243,2101,59.90551351375849,48.815721780039816
1117,/media/marda/TWOTB1/xBD/hurricanes/images/florence/hurricane-florence_00000405_pre_disaster.png,72,55,1,744,816,183,238,1304,47.867087932173305,36.32942840794231
1118,/media/marda/TWOTB1/xBD/hurricanes/images/florence/hurricane-florence_00000405_pre_disaster.png,91,56,1,953,1044,201,257,1635,55.427770604908424,40.21325869094444
1119,/media/marda/TWOTB1/xBD/hurricanes/images/florence/hurricane-florence_00000405_pre_disaster.png,76,74,1,647,723,297,371,2294,66.85963896930417,51.06759177811914
1120,/media/marda/TWOTB1/xBD/hurricanes/images/florence/hurricane-florence_00000405_pre_disaster.png,76,63,1,67,143,313,376,1916,69.92441613190337,39.16541644182985
1121,/media/marda/TWOTB1/xBD/hurricanes/images/florence/hurricane-florence_00000405_pre_disaster.png,90,72,1,842,932,316,388,1805,66.89252945338019,38.96756885654486
1122,/media/marda/TWOTB1/xBD/hurricanes/images/florence/hurricane-florence_00000405_pre_disaster.png,80,71,1,774,854,317,388,2043,66.65685615732781,43.34910633905426
1123,/media/marda/TWOTB1/xBD/hurricanes/images/florence/hurricane-florence_00000405_pre_disaster.png,64,66,1,236,300,319,385,1560,47.6650729643091,45.111329931727006
1124,/media/marda/TWOTB1/xBD/hurricanes/images/florence/hurricane-florence_00000405_pre_disaster.png,76,71,1,712,788,325,396,2057,60.20721262527575,48.36961631505633
1125,/media/marda/TWOTB1/xBD/hurricanes/images/florence/hurricane-florence_00000405_pre_disaster.png,72,62,1,457,529,333,395,1770,51.767627896887205,44.74618773650613
1126,/media/marda/TWOTB1/xBD/hurricanes/images/florence/hurricane-florence_00000405_pre_disaster.png,76,79,1,404,480,360,439,2119,60.0119419689618,47.51915970097401
1127,/media/marda/TWOTB1/xBD/hurricanes/images/florence/hurricane-florence_00000405_pre_disaster.png,66,72,1,116,182,405,477,1752,64.2536436615873,39.66082843348754
1128,/media/marda/TWOTB1/xBD/hurricanes/images/florence/hurricane-florence_00000405_pre_disaster.png,58,79,1,0,58,487,566,2025,65.32880006599896,42.401114439164374
1129,/media/marda/TWOTB1/xBD/hurricanes/images/florence/hurricane-florence_00000405_pre_disaster.png,75,72,1,199,274,539,611,1799,59.91633594097015,43.07902764214838
1130,/media/marda/TWOTB1/xBD/hurricanes/images/florence/hurricane-florence_00000405_pre_disaster.png,80,89,1,740,820,693,782,2187,66.90272896541111,46.708469255643564
1131,/media/marda/TWOTB1/xBD/hurricanes/images/florence/hurricane-florence_00000405_pre_disaster.png,50,64,1,994,1044,697,761,342,41.51964244274223,10.963264126598933
1132,/media/marda/TWOTB1/xBD/hurricanes/images/florence/hurricane-florence_00000405_pre_disaster.png,70,78,1,613,683,699,777,1705,54.13005221224846,43.9544989753542
1133,/media/marda/TWOTB1/xBD/hurricanes/images/florence/hurricane-florence_00000405_pre_disaster.png,82,64,1,943,1025,721,785,1237,51.460458922884364,34.36084638260884
1134,/media/marda/TWOTB1/xBD/hurricanes/images/florence/hurricane-florence_00000405_pre_disaster.png,100,80,1,422,522,748,828,2554,77.3546541114195,46.102476461334746
1135,/media/marda/TWOTB1/xBD/hurricanes/images/florence/hurricane-florence_00000405_pre_disaster.png,78,96,1,375,453,821,917,2241,58.315643128981854,55.417422206166044
1136,/media/marda/TWOTB1/xBD/hurricanes/images/florence/hurricane-florence_00000405_pre_disaster.png,78,84,1,712,790,845,929,1726,61.977615164913296,41.239173064618086
1137,/media/marda/TWOTB1/xBD/hurricanes/images/florence/hurricane-florence_00000405_pre_disaster.png,75,88,1,787,862,848,936,1597,61.00857165010092,38.902105541424675
1138,/media/marda/TWOTB1/xBD/hurricanes/images/florence/hurricane-florence_00000405_pre_disaster.png,83,84,1,851,934,848,932,1930,57.74179687158652,44.237616312837915
1139,/media/marda/TWOTB1/xBD/hurricanes/images/florence/hurricane-florence_00000405_pre_disaster.png,70,86,1,974,1044,856,942,1205,52.19340917115664,33.33785387718602
1140,/media/marda/TWOTB1/xBD/hurricanes/images/florence/hurricane-florence_00000405_pre_disaster.png,44,62,1,90,134,980,1042,878,42.27751220630991,27.67964565918976
1141,/media/marda/TWOTB1/xBD/hurricanes/images/florence/hurricane-florence_00000405_pre_disaster.png,80,61,1,398,478,983,1044,755,62.33674973391972,18.072493514951795
1142,/media/marda/TWOTB1/xBD/hurricanes/images/florence/hurricane-florence_00000502_pre_disaster.png,41,49,1,361,402,737,786,308,29.89471966734697,13.685611187863389
1143,/media/marda/TWOTB1/xBD/hurricanes/images/florence/hurricane-florence_00000502_pre_disaster.png,14,36,1,125,139,777,813,50,10.830330662981256,6.259707479626183
1144,/media/marda/TWOTB1/xBD/hurricanes/images/florence/hurricane-florence_00000502_pre_disaster.png,79,59,1,392,471,782,841,1565,67.36377557162044,30.68162380315147
1145,/media/marda/TWOTB1/xBD/hurricanes/images/florence/hurricane-florence_00000502_pre_disaster.png,33,48,1,117,150,783,831,359,30.347327251712958,15.82361577835188
1146,/media/marda/TWOTB1/xBD/hurricanes/images/florence/hurricane-florence_00000502_pre_disaster.png,14,42,1,128,142,827,869,59,10.520271756090729,7.6020007092589
1147,/media/marda/TWOTB1/xBD/hurricanes/images/florence/hurricane-florence_00000502_pre_disaster.png,20,49,1,117,137,849,898,176,15.581998051966243,15.145042349987023
1148,/media/marda/TWOTB1/xBD/hurricanes/images/florence/hurricane-florence_00000502_pre_disaster.png,5,56,1,0,5,880,936,76,23.355095246312747,4.623428504109546
1149,/media/marda/TWOTB1/xBD/hurricanes/images/florence/hurricane-florence_00000049_post_disaster.png,51,14,1,870,921,84,98,112,17.07318777849458,8.831248663570424
1150,/media/marda/TWOTB1/xBD/hurricanes/images/florence/hurricane-florence_00000049_post_disaster.png,59,33,1,808,867,90,123,448,34.2012750349211,18.37540309889573
1151,/media/marda/TWOTB1/xBD/hurricanes/images/florence/hurricane-florence_00000049_post_disaster.png,45,16,1,858,903,99,115,85,12.6876921821527,8.866634512337264
1152,/media/marda/TWOTB1/xBD/hurricanes/images/florence/hurricane-florence_00000361_post_disaster.png,51,89,1,43,94,390,479,3127,83.1444183605305,49.79956961902166
1153,/media/marda/TWOTB1/xBD/hurricanes/images/florence/hurricane-florence_00000361_post_disaster.png,61,79,1,159,220,435,514,2880,66.03273994889743,57.875313622555744
1154,/media/marda/TWOTB1/xBD/hurricanes/images/florence/hurricane-florence_00000361_post_disaster.png,30,37,1,118,148,526,563,385,28.73336298769329,17.745810511187
1155,/media/marda/TWOTB1/xBD/hurricanes/images/florence/hurricane-florence_00000361_post_disaster.png,44,71,1,162,206,322,393,1946,63.440644437056086,40.520699078210214
1156,/media/marda/TWOTB1/xBD/hurricanes/images/florence/hurricane-florence_00000169_post_disaster.png,21,17,1,177,198,0,17,151,14.763405982829942,13.705736142221689
1157,/media/marda/TWOTB1/xBD/hurricanes/images/florence/hurricane-florence_00000169_post_disaster.png,16,17,1,5,21,26,43,142,14.976425177419943,12.681199416510472
1158,/media/marda/TWOTB1/xBD/hurricanes/images/florence/hurricane-florence_00000169_post_disaster.png,39,32,1,141,180,132,164,547,34.02094328384444,21.29989589564376
1159,/media/marda/TWOTB1/xBD/hurricanes/images/florence/hurricane-florence_00000169_post_disaster.png,55,21,1,737,792,132,153,185,29.36624655440983,8.451064747877343
1160,/media/marda/TWOTB1/xBD/hurricanes/images/florence/hurricane-florence_00000169_post_disaster.png,74,45,1,704,778,166,211,971,45.76362892963167,28.19718883652383
1161,/media/marda/TWOTB1/xBD/hurricanes/images/florence/hurricane-florence_00000169_post_disaster.png,52,42,1,379,431,175,217,804,34.31423438518644,31.04782626419805
1162,/media/marda/TWOTB1/xBD/hurricanes/images/florence/hurricane-florence_00000169_post_disaster.png,88,55,1,566,654,190,245,1863,67.51615878416598,39.095402115970664
1163,/media/marda/TWOTB1/xBD/hurricanes/images/florence/hurricane-florence_00000169_post_disaster.png,36,42,1,11,47,201,243,682,33.65302899321196,27.071364335565367
1164,/media/marda/TWOTB1/xBD/hurricanes/images/florence/hurricane-florence_00000169_post_disaster.png,40,21,1,704,744,204,225,97,11.709879180019312,11.128988776611532
1165,/media/marda/TWOTB1/xBD/hurricanes/images/florence/hurricane-florence_00000169_post_disaster.png,62,68,1,348,410,223,291,1530,56.168276741916245,39.66533172223789
1166,/media/marda/TWOTB1/xBD/hurricanes/images/florence/hurricane-florence_00000169_post_disaster.png,44,30,1,450,494,237,267,338,27.829411003878654,16.161001111135143
1167,/media/marda/TWOTB1/xBD/hurricanes/images/florence/hurricane-florence_00000169_post_disaster.png,28,32,1,86,114,239,271,335,22.570883655968395,19.853648211902975
1168,/media/marda/TWOTB1/xBD/hurricanes/images/florence/hurricane-florence_00000169_post_disaster.png,42,38,1,119,161,259,297,609,34.63060366849939,23.885083016819934
1169,/media/marda/TWOTB1/xBD/hurricanes/images/florence/hurricane-florence_00000169_post_disaster.png,72,57,1,402,474,273,330,1424,50.12856187165272,40.12202604302805
1170,/media/marda/TWOTB1/xBD/hurricanes/images/florence/hurricane-florence_00000169_post_disaster.png,48,43,1,167,215,277,320,829,44.37519360191471,25.039641478151257
1171,/media/marda/TWOTB1/xBD/hurricanes/images/florence/hurricane-florence_00000169_post_disaster.png,21,36,1,95,116,284,320,240,30.273428207161277,10.62301433091102
1172,/media/marda/TWOTB1/xBD/hurricanes/images/florence/hurricane-florence_00000169_post_disaster.png,9,58,1,0,9,291,349,246,49.876995596528,7.459111265251593
1173,/media/marda/TWOTB1/xBD/hurricanes/images/florence/hurricane-florence_00000169_post_disaster.png,59,44,1,638,697,310,354,583,32.74240440915284,24.163567974792624
1174,/media/marda/TWOTB1/xBD/hurricanes/images/florence/hurricane-florence_00000169_post_disaster.png,20,29,1,139,159,333,362,155,17.286773853000277,11.938998576433773
1175,/media/marda/TWOTB1/xBD/hurricanes/images/florence/hurricane-florence_00000169_post_disaster.png,85,52,1,600,685,352,404,1284,60.56112138644773,31.468372648652878
1176,/media/marda/TWOTB1/xBD/hurricanes/images/florence/hurricane-florence_00000169_post_disaster.png,52,34,1,780,832,363,397,254,18.695487282636766,18.179074653699153
1177,/media/marda/TWOTB1/xBD/hurricanes/images/florence/hurricane-florence_00000169_post_disaster.png,57,44,1,291,348,364,408,592,52.70664361979001,14.977784971776487
1178,/media/marda/TWOTB1/xBD/hurricanes/images/florence/hurricane-florence_00000169_post_disaster.png,50,51,1,369,419,368,419,837,35.92529577465996,31.13170828418647
1179,/media/marda/TWOTB1/xBD/hurricanes/images/florence/hurricane-florence_00000169_post_disaster.png,76,63,1,662,738,375,438,1347,54.28380445949434,33.03610989773931
1180,/media/marda/TWOTB1/xBD/hurricanes/images/florence/hurricane-florence_00000169_post_disaster.png,45,43,1,336,381,393,436,555,29.942763818488814,24.695814772600023
1181,/media/marda/TWOTB1/xBD/hurricanes/images/florence/hurricane-florence_00000169_post_disaster.png,22,63,1,116,138,399,462,692,53.33546920078094,17.320853843388093
1182,/media/marda/TWOTB1/xBD/hurricanes/images/florence/hurricane-florence_00000169_post_disaster.png,22,65,1,80,102,405,470,662,54.312618019221546,16.29165399140271
1183,/media/marda/TWOTB1/xBD/hurricanes/images/florence/hurricane-florence_00000169_post_disaster.png,81,58,1,723,804,410,468,1206,48.41011616160829,34.32881925233869
1184,/media/marda/TWOTB1/xBD/hurricanes/images/florence/hurricane-florence_00000169_post_disaster.png,48,37,1,157,205,411,448,471,47.2711044586431,13.283619013286653
1185,/media/marda/TWOTB1/xBD/hurricanes/images/florence/hurricane-florence_00000169_post_disaster.png,133,103,1,873,1006,415,518,4924,108.22422964585209,62.371113036304536
1186,/media/marda/TWOTB1/xBD/hurricanes/images/florence/hurricane-florence_00000169_post_disaster.png,58,55,1,428,486,416,471,853,42.6118721643029,26.553718207570498
1187,/media/marda/TWOTB1/xBD/hurricanes/images/florence/hurricane-florence_00000169_post_disaster.png,21,60,1,49,70,417,477,693,48.140704319294606,19.179697838313295
1188,/media/marda/TWOTB1/xBD/hurricanes/images/florence/hurricane-florence_00000169_post_disaster.png,20,50,1,15,35,435,485,519,37.78345526842655,18.20841451425175
1189,/media/marda/TWOTB1/xBD/hurricanes/images/florence/hurricane-florence_00000169_post_disaster.png,20,60,1,185,205,443,503,508,48.731410744765775,13.933107929988424
1190,/media/marda/TWOTB1/xBD/hurricanes/images/florence/hurricane-florence_00000169_post_disaster.png,39,37,1,480,519,451,488,245,18.411718349271684,17.805447206101466
1191,/media/marda/TWOTB1/xBD/hurricanes/images/florence/hurricane-florence_00000169_post_disaster.png,22,64,1,121,143,457,521,679,53.636092193349675,16.836362113303487
1192,/media/marda/TWOTB1/xBD/hurricanes/images/florence/hurricane-florence_00000169_post_disaster.png,23,65,1,88,111,463,528,705,53.79486311848354,17.50126459280319
1193,/media/marda/TWOTB1/xBD/hurricanes/images/florence/hurricane-florence_00000169_post_disaster.png,73,62,1,787,860,466,528,1035,42.22243051602382,32.26075130089779
1194,/media/marda/TWOTB1/xBD/hurricanes/images/florence/hurricane-florence_00000169_post_disaster.png,38,39,1,436,474,471,510,267,21.312209792073855,16.75467522457966
1195,/media/marda/TWOTB1/xBD/hurricanes/images/florence/hurricane-florence_00000169_post_disaster.png,22,58,1,23,45,479,537,608,45.59873841052773,17.6886996955545
1196,/media/marda/TWOTB1/xBD/hurricanes/images/florence/hurricane-florence_00000169_post_disaster.png,63,51,1,549,612,482,533,746,40.53554238592778,24.60017431970248
1197,/media/marda/TWOTB1/xBD/hurricanes/images/florence/hurricane-florence_00000169_post_disaster.png,80,63,1,591,671,512,575,1394,58.164544487742845,31.87554353558544
1198,/media/marda/TWOTB1/xBD/hurricanes/images/florence/hurricane-florence_00000169_post_disaster.png,24,65,1,122,146,531,596,617,49.585415871751934,16.58245055873763
1199,/media/marda/TWOTB1/xBD/hurricanes/images/florence/hurricane-florence_00000169_post_disaster.png,26,69,1,93,119,534,603,707,53.77484107127034,17.60169062275589
1200,/media/marda/TWOTB1/xBD/hurricanes/images/florence/hurricane-florence_00000169_post_disaster.png,111,116,1,630,741,535,651,4038,98.77746321831788,58.39381612104192
1201,/media/marda/TWOTB1/xBD/hurricanes/images/florence/hurricane-florence_00000169_post_disaster.png,25,68,1,32,57,547,615,721,53.780274267753796,17.71731014551172
1202,/media/marda/TWOTB1/xBD/hurricanes/images/florence/hurricane-florence_00000169_post_disaster.png,36,31,1,632,668,562,593,102,12.033397210065216,10.880150129853677
1203,/media/marda/TWOTB1/xBD/hurricanes/images/florence/hurricane-florence_00000169_post_disaster.png,41,41,1,558,599,572,613,232,19.501215238209518,15.929145662023641
1204,/media/marda/TWOTB1/xBD/hurricanes/images/florence/hurricane-florence_00000169_post_disaster.png,21,65,1,89,110,614,679,573,46.025253460684006,16.55778270287866
1205,/media/marda/TWOTB1/xBD/hurricanes/images/florence/hurricane-florence_00000169_post_disaster.png,94,66,1,815,909,666,732,1367,61.800654846944504,29.374301627254507
1206,/media/marda/TWOTB1/xBD/hurricanes/images/florence/hurricane-florence_00000169_post_disaster.png,76,75,1,951,1027,696,771,1008,47.59393820529221,28.07155105642538
1207,/media/marda/TWOTB1/xBD/hurricanes/images/florence/hurricane-florence_00000169_post_disaster.png,37,69,1,97,134,701,770,965,41.281372797014164,32.14731747930212
1208,/media/marda/TWOTB1/xBD/hurricanes/images/florence/hurricane-florence_00000169_post_disaster.png,74,67,1,876,950,712,779,863,39.995369346435716,28.624922252796647
1209,/media/marda/TWOTB1/xBD/hurricanes/images/florence/hurricane-florence_00000169_post_disaster.png,62,86,1,203,265,732,818,2320,65.6112894029702,49.591340756510334
1210,/media/marda/TWOTB1/xBD/hurricanes/images/florence/hurricane-florence_00000169_post_disaster.png,58,74,1,371,429,736,810,1047,46.41638091597605,29.780256001696113
1211,/media/marda/TWOTB1/xBD/hurricanes/images/florence/hurricane-florence_00000169_post_disaster.png,74,73,1,727,801,748,821,1195,43.18051224975017,38.74449279028919
1212,/media/marda/TWOTB1/xBD/hurricanes/images/florence/hurricane-florence_00000169_post_disaster.png,65,68,1,482,547,776,844,1100,47.064270529822664,31.216801258584773
1213,/media/marda/TWOTB1/xBD/hurricanes/images/florence/hurricane-florence_00000169_post_disaster.png,83,120,1,871,954,789,909,1968,93.94680704831264,33.457875707840095
1214,/media/marda/TWOTB1/xBD/hurricanes/images/florence/hurricane-florence_00000169_post_disaster.png,32,77,1,112,144,795,872,849,48.08382826877797,23.461934609397012
1215,/media/marda/TWOTB1/xBD/hurricanes/images/florence/hurricane-florence_00000169_post_disaster.png,82,89,1,543,625,822,911,1807,60.293635990306285,39.81470869135636
1216,/media/marda/TWOTB1/xBD/hurricanes/images/florence/hurricane-florence_00000169_post_disaster.png,34,77,1,125,159,864,941,930,49.2550452818663,25.04730653797675
1217,/media/marda/TWOTB1/xBD/hurricanes/images/florence/hurricane-florence_00000169_post_disaster.png,79,77,1,649,728,868,945,1310,49.77195884089462,36.13009382862569
1218,/media/marda/TWOTB1/xBD/hurricanes/images/florence/hurricane-florence_00000169_post_disaster.png,54,74,1,391,445,875,949,1243,45.21070589156855,36.2720901424751
1219,/media/marda/TWOTB1/xBD/hurricanes/images/florence/hurricane-florence_00000169_post_disaster.png,50,61,1,499,549,879,940,488,27.00635678112245,24.03833863469754
1220,/media/marda/TWOTB1/xBD/hurricanes/images/florence/hurricane-florence_00000169_post_disaster.png,13,81,1,0,13,892,973,329,44.753304197248376,11.070794100254668
1221,/media/marda/TWOTB1/xBD/hurricanes/images/florence/hurricane-florence_00000169_post_disaster.png,50,70,1,469,519,911,981,853,35.503772252741676,31.69648975468975
1222,/media/marda/TWOTB1/xBD/hurricanes/images/florence/hurricane-florence_00000169_post_disaster.png,52,66,1,589,641,911,977,468,25.916143491869093,23.88442560418073
1223,/media/marda/TWOTB1/xBD/hurricanes/images/florence/hurricane-florence_00000169_post_disaster.png,49,58,1,746,795,926,984,253,18.743908110102684,17.924935679778443
1224,/media/marda/TWOTB1/xBD/hurricanes/images/florence/hurricane-florence_00000169_post_disaster.png,33,83,1,138,171,928,1011,952,50.75373549260969,24.93789908780667
1225,/media/marda/TWOTB1/xBD/hurricanes/images/florence/hurricane-florence_00000169_post_disaster.png,54,60,1,764,818,934,994,300,22.432737557136466,17.868378559883542
1226,/media/marda/TWOTB1/xBD/hurricanes/images/florence/hurricane-florence_00000169_post_disaster.png,91,97,1,791,882,934,1031,1674,62.279147096530245,39.393273442186434
1227,/media/marda/TWOTB1/xBD/hurricanes/images/florence/hurricane-florence_00000169_post_disaster.png,22,78,1,0,22,957,1035,700,42.457693740911765,22.197859369098843
1228,/media/marda/TWOTB1/xBD/hurricanes/images/florence/hurricane-florence_00000169_post_disaster.png,34,49,1,507,541,966,1015,152,15.177989390659471,13.384981282377822
1229,/media/marda/TWOTB1/xBD/hurricanes/images/florence/hurricane-florence_00000169_post_disaster.png,61,60,1,736,797,969,1029,416,35.35042108616818,15.419515813926244
1230,/media/marda/TWOTB1/xBD/hurricanes/images/florence/hurricane-florence_00000169_post_disaster.png,39,57,1,428,467,972,1029,378,24.08936007250188,20.817978730463064
1231,/media/marda/TWOTB1/xBD/hurricanes/images/florence/hurricane-florence_00000169_post_disaster.png,29,50,1,521,550,993,1043,64,11.133253045787031,7.722474611060486
1232,/media/marda/TWOTB1/xBD/hurricanes/images/florence/hurricane-florence_00000169_post_disaster.png,30,48,1,126,156,995,1043,152,26.569838643433695,7.674699680255833
1233,/media/marda/TWOTB1/xBD/hurricanes/images/florence/hurricane-florence_00000169_post_disaster.png,52,48,1,610,662,995,1043,178,31.360742709809372,7.602439591392577
1234,/media/marda/TWOTB1/xBD/hurricanes/images/florence/hurricane-florence_00000545_pre_disaster.png,40,12,1,373,413,0,12,214,27.383725750305082,10.834320605313069
1235,/media/marda/TWOTB1/xBD/hurricanes/images/florence/hurricane-florence_00000545_pre_disaster.png,43,36,1,386,429,53,89,676,36.174957268559154,24.945615029930003
1236,/media/marda/TWOTB1/xBD/hurricanes/images/florence/hurricane-florence_00000545_pre_disaster.png,74,38,1,273,347,191,229,1247,70.73886812351785,23.45862940881253
1237,/media/marda/TWOTB1/xBD/hurricanes/images/florence/hurricane-florence_00000545_pre_disaster.png,48,38,1,177,225,215,253,1049,47.75306191560917,29.696151949841088
1238,/media/marda/TWOTB1/xBD/hurricanes/images/florence/hurricane-florence_00000545_pre_disaster.png,41,41,1,103,144,219,260,1016,40.74941921823603,32.927299575290164
1239,/media/marda/TWOTB1/xBD/hurricanes/images/florence/hurricane-florence_00000545_pre_disaster.png,89,136,1,283,372,241,377,5034,130.14383587424194,73.8028869652761
1240,/media/marda/TWOTB1/xBD/hurricanes/images/florence/hurricane-florence_00000545_pre_disaster.png,29,45,1,142,171,276,321,708,38.783365151262245,24.31924238208645
1241,/media/marda/TWOTB1/xBD/hurricanes/images/florence/hurricane-florence_00000545_pre_disaster.png,29,34,1,82,111,294,328,275,28.407821497796988,12.870414856396408
1242,/media/marda/TWOTB1/xBD/hurricanes/images/florence/hurricane-florence_00000545_pre_disaster.png,29,34,1,55,84,333,367,314,30.198543808620187,13.879490911310416
1243,/media/marda/TWOTB1/xBD/hurricanes/images/florence/hurricane-florence_00000545_pre_disaster.png,21,52,1,170,191,337,389,466,42.765047853581,14.493157048615059
1244,/media/marda/TWOTB1/xBD/hurricanes/images/florence/hurricane-florence_00000545_pre_disaster.png,68,54,1,790,858,339,393,752,39.798378748309,27.19961792693083
1245,/media/marda/TWOTB1/xBD/hurricanes/images/florence/hurricane-florence_00000545_pre_disaster.png,24,35,1,69,93,348,383,266,23.154123819560663,15.358598573712822
1246,/media/marda/TWOTB1/xBD/hurricanes/images/florence/hurricane-florence_00000545_pre_disaster.png,68,65,1,752,820,605,670,759,38.92817768761636,25.994678286669387
1247,/media/marda/TWOTB1/xBD/hurricanes/images/florence/hurricane-florence_00000545_pre_disaster.png,58,60,1,520,578,612,672,647,39.198711829343324,22.00960688818555
1248,/media/marda/TWOTB1/xBD/hurricanes/images/florence/hurricane-florence_00000545_pre_disaster.png,51,43,1,765,816,659,702,197,19.85370407861977,13.169842467753442
1249,/media/marda/TWOTB1/xBD/hurricanes/images/florence/hurricane-florence_00000545_pre_disaster.png,34,39,1,484,518,669,708,128,13.650370181550862,12.349144840094276
1250,/media/marda/TWOTB1/xBD/hurricanes/images/florence/hurricane-florence_00000545_pre_disaster.png,65,64,1,493,558,672,736,870,42.510314579706915,27.50211922113797
1251,/media/marda/TWOTB1/xBD/hurricanes/images/florence/hurricane-florence_00000545_pre_disaster.png,36,49,1,445,481,698,747,221,18.25727583393597,16.082047142560672
1252,/media/marda/TWOTB1/xBD/hurricanes/images/florence/hurricane-florence_00000545_pre_disaster.png,61,66,1,449,510,720,786,855,43.35460111301059,26.434888350187514
1253,/media/marda/TWOTB1/xBD/hurricanes/images/florence/hurricane-florence_00000545_pre_disaster.png,42,56,1,292,334,764,820,470,29.523895112033227,21.14840847480257
1254,/media/marda/TWOTB1/xBD/hurricanes/images/florence/hurricane-florence_00000545_pre_disaster.png,51,74,1,325,376,791,865,773,46.26148191546309,23.158410771362245
1255,/media/marda/TWOTB1/xBD/hurricanes/images/florence/hurricane-florence_00000545_pre_disaster.png,62,63,1,402,464,979,1042,612,42.89148920154136,21.62787316286078
1256,/media/marda/TWOTB1/xBD/hurricanes/images/florence/hurricane-florence_00000003_post_disaster.png,79,63,1,548,627,176,239,2051,65.61559416052924,44.34020169602179
1257,/media/marda/TWOTB1/xBD/hurricanes/images/florence/hurricane-florence_00000003_post_disaster.png,75,71,1,493,568,188,259,2114,63.30895210293345,45.52218850539659
1258,/media/marda/TWOTB1/xBD/hurricanes/images/florence/hurricane-florence_00000003_post_disaster.png,79,61,1,608,687,208,269,1550,49.38214798057773,43.52356212195573
1259,/media/marda/TWOTB1/xBD/hurricanes/images/florence/hurricane-florence_00000003_post_disaster.png,78,69,1,776,854,219,288,1979,62.04433602262911,44.31886862299222
1260,/media/marda/TWOTB1/xBD/hurricanes/images/florence/hurricane-florence_00000003_post_disaster.png,80,52,1,824,904,225,277,1682,52.8039262490323,44.12139619756935
1261,/media/marda/TWOTB1/xBD/hurricanes/images/florence/hurricane-florence_00000003_post_disaster.png,73,64,1,685,758,234,298,2021,61.590969248792845,46.62071234422569
1262,/media/marda/TWOTB1/xBD/hurricanes/images/florence/hurricane-florence_00000003_post_disaster.png,92,67,1,879,971,236,303,1970,62.24398018485737,45.87405103890408
1263,/media/marda/TWOTB1/xBD/hurricanes/images/florence/hurricane-florence_00000003_post_disaster.png,72,61,1,730,802,237,298,1982,56.612137327869796,47.08556971964669
1264,/media/marda/TWOTB1/xBD/hurricanes/images/florence/hurricane-florence_00000003_post_disaster.png,78,51,1,479,557,257,308,1853,61.55730734102135,42.15293866754864
1265,/media/marda/TWOTB1/xBD/hurricanes/images/florence/hurricane-florence_00000003_post_disaster.png,85,55,1,615,700,263,318,2139,63.11491043004657,46.91641548592318
1266,/media/marda/TWOTB1/xBD/hurricanes/images/florence/hurricane-florence_00000003_post_disaster.png,97,57,1,887,984,299,356,2027,64.94887372933772,43.962479200107154
1267,/media/marda/TWOTB1/xBD/hurricanes/images/florence/hurricane-florence_00000003_post_disaster.png,81,68,1,489,570,305,373,2006,55.05357174635638,50.97431591116389
1268,/media/marda/TWOTB1/xBD/hurricanes/images/florence/hurricane-florence_00000003_post_disaster.png,77,77,1,453,530,336,413,2355,62.82643423267958,52.112287643491605
1269,/media/marda/TWOTB1/xBD/hurricanes/images/florence/hurricane-florence_00000003_post_disaster.png,78,70,1,797,875,342,412,2020,62.51328611823795,45.111072549445026
1270,/media/marda/TWOTB1/xBD/hurricanes/images/florence/hurricane-florence_00000003_post_disaster.png,86,65,1,845,931,342,407,1726,50.577844724972955,44.97409967761329
1271,/media/marda/TWOTB1/xBD/hurricanes/images/florence/hurricane-florence_00000003_post_disaster.png,162,76,1,667,829,345,421,5529,151.67392007540434,55.71967567634914
1272,/media/marda/TWOTB1/xBD/hurricanes/images/florence/hurricane-florence_00000003_post_disaster.png,78,76,1,605,683,354,430,2127,59.29102632515948,49.88560250245714
1273,/media/marda/TWOTB1/xBD/hurricanes/images/florence/hurricane-florence_00000003_post_disaster.png,7,31,1,0,7,383,414,72,17.396718105379644,6.321812261770135
1274,/media/marda/TWOTB1/xBD/hurricanes/images/florence/hurricane-florence_00000003_post_disaster.png,93,69,1,557,650,385,454,2071,64.20089333954066,44.63413982256324
1275,/media/marda/TWOTB1/xBD/hurricanes/images/florence/hurricane-florence_00000003_post_disaster.png,103,114,1,510,613,418,532,3823,103.24784091390438,56.910079940710986
1276,/media/marda/TWOTB1/xBD/hurricanes/images/florence/hurricane-florence_00000003_post_disaster.png,45,67,1,0,45,421,488,1674,49.686628194674014,45.08409508109334
1277,/media/marda/TWOTB1/xBD/hurricanes/images/florence/hurricane-florence_00000003_post_disaster.png,24,59,1,0,24,476,535,598,40.90389316172746,19.979516903451128
1278,/media/marda/TWOTB1/xBD/hurricanes/images/florence/hurricane-florence_00000003_post_disaster.png,88,78,1,496,584,505,583,2328,66.35757360975568,49.40548876149005
1279,/media/marda/TWOTB1/xBD/hurricanes/images/florence/hurricane-florence_00000003_post_disaster.png,82,68,1,371,453,552,620,2197,69.88903691083091,45.04146058098572
1280,/media/marda/TWOTB1/xBD/hurricanes/images/florence/hurricane-florence_00000003_post_disaster.png,84,83,1,960,1044,552,635,1784,58.84672463361214,41.99278143024556
1281,/media/marda/TWOTB1/xBD/hurricanes/images/florence/hurricane-florence_00000003_post_disaster.png,90,118,1,483,573,562,680,4079,105.66522377538679,63.88875826063663
1282,/media/marda/TWOTB1/xBD/hurricanes/images/florence/hurricane-florence_00000003_post_disaster.png,97,76,1,908,1005,585,661,1704,54.10040255540099,45.677094251680565
1283,/media/marda/TWOTB1/xBD/hurricanes/images/florence/hurricane-florence_00000003_post_disaster.png,69,77,1,383,452,594,671,1835,57.36173427840319,43.676908042746625
1284,/media/marda/TWOTB1/xBD/hurricanes/images/florence/hurricane-florence_00000003_post_disaster.png,92,75,1,865,957,607,682,1489,54.05220469445203,38.93514614350084
1285,/media/marda/TWOTB1/xBD/hurricanes/images/florence/hurricane-florence_00000003_post_disaster.png,89,94,1,817,906,626,720,1982,63.36203020529237,45.37484333647673
1286,/media/marda/TWOTB1/xBD/hurricanes/images/florence/hurricane-florence_00000003_post_disaster.png,68,73,1,399,467,641,714,1641,55.63218387465038,40.112656117197986
1287,/media/marda/TWOTB1/xBD/hurricanes/images/florence/hurricane-florence_00000003_post_disaster.png,57,85,1,226,283,649,734,1743,55.54544557486169,44.58152260792608
1288,/media/marda/TWOTB1/xBD/hurricanes/images/florence/hurricane-florence_00000003_post_disaster.png,85,73,1,792,877,682,755,1533,47.31112175675163,43.16419088659067
1289,/media/marda/TWOTB1/xBD/hurricanes/images/florence/hurricane-florence_00000003_post_disaster.png,71,81,1,163,234,683,764,2074,61.525768042239356,48.061563065155084
1290,/media/marda/TWOTB1/xBD/hurricanes/images/florence/hurricane-florence_00000003_post_disaster.png,79,77,1,285,364,684,761,1867,62.47124075815356,42.22365882468065
1291,/media/marda/TWOTB1/xBD/hurricanes/images/florence/hurricane-florence_00000003_post_disaster.png,128,111,1,893,1021,685,796,3279,106.27298284527376,41.83113205775875
1292,/media/marda/TWOTB1/xBD/hurricanes/images/florence/hurricane-florence_00000003_post_disaster.png,62,89,1,120,182,702,791,2064,56.441000659361855,49.006765159860166
1293,/media/marda/TWOTB1/xBD/hurricanes/images/florence/hurricane-florence_00000003_post_disaster.png,83,84,1,757,840,706,790,1557,48.39518056777171,43.25711077863172
1294,/media/marda/TWOTB1/xBD/hurricanes/images/florence/hurricane-florence_00000003_post_disaster.png,86,89,1,713,799,731,820,1795,51.357350775430035,48.012430945316815
1295,/media/marda/TWOTB1/xBD/hurricanes/images/florence/hurricane-florence_00000003_post_disaster.png,81,74,1,310,391,741,815,1904,64.89046222133219,41.71928091792412
1296,/media/marda/TWOTB1/xBD/hurricanes/images/florence/hurricane-florence_00000003_post_disaster.png,79,95,1,673,752,756,851,1982,61.89382529508514,43.50650225001686
1297,/media/marda/TWOTB1/xBD/hurricanes/images/florence/hurricane-florence_00000003_post_disaster.png,89,80,1,856,945,758,838,1827,52.07556974247431,47.837515314493864
1298,/media/marda/TWOTB1/xBD/hurricanes/images/florence/hurricane-florence_00000003_post_disaster.png,60,88,1,84,144,761,849,1855,57.44528223986195,47.674305176016475
1299,/media/marda/TWOTB1/xBD/hurricanes/images/florence/hurricane-florence_00000003_post_disaster.png,59,89,1,261,320,806,895,1862,55.03434679830051,44.87467274596692
1300,/media/marda/TWOTB1/xBD/hurricanes/images/florence/hurricane-florence_00000003_post_disaster.png,57,79,1,341,398,806,885,1752,51.72250349089745,45.65820151019894
1301,/media/marda/TWOTB1/xBD/hurricanes/images/florence/hurricane-florence_00000003_post_disaster.png,100,124,1,873,973,808,932,3153,98.25557130208914,45.071179011861375
1302,/media/marda/TWOTB1/xBD/hurricanes/images/florence/hurricane-florence_00000003_post_disaster.png,51,82,1,95,146,820,902,1612,50.899692236026084,44.81565834621746
1303,/media/marda/TWOTB1/xBD/hurricanes/images/florence/hurricane-florence_00000003_post_disaster.png,87,85,1,740,827,845,930,1653,51.59427636152415,44.58950446492519
1304,/media/marda/TWOTB1/xBD/hurricanes/images/florence/hurricane-florence_00000003_post_disaster.png,58,90,1,174,232,853,943,1701,50.08427177236314,45.642832346178736
1305,/media/marda/TWOTB1/xBD/hurricanes/images/florence/hurricane-florence_00000003_post_disaster.png,56,99,1,48,104,869,968,2067,62.83562283707861,44.38111457584231
1306,/media/marda/TWOTB1/xBD/hurricanes/images/florence/hurricane-florence_00000003_post_disaster.png,79,93,1,782,861,882,975,1453,52.79107001483805,38.775260569830024
1307,/media/marda/TWOTB1/xBD/hurricanes/images/florence/hurricane-florence_00000003_post_disaster.png,73,89,1,835,908,892,981,1783,55.39962520454253,44.664354526206345
1308,/media/marda/TWOTB1/xBD/hurricanes/images/florence/hurricane-florence_00000003_post_disaster.png,61,86,1,127,188,893,979,1566,51.68700164976247,41.79308262419661
1309,/media/marda/TWOTB1/xBD/hurricanes/images/florence/hurricane-florence_00000003_post_disaster.png,60,103,1,351,411,911,1014,1956,67.74068854451693,41.34813483786029
1310,/media/marda/TWOTB1/xBD/hurricanes/images/florence/hurricane-florence_00000003_post_disaster.png,60,95,1,402,462,912,1007,2105,61.73112466715475,47.2107744832111
1311,/media/marda/TWOTB1/xBD/hurricanes/images/florence/hurricane-florence_00000003_post_disaster.png,53,75,1,30,83,934,1009,1333,53.69552285552702,35.62469938036513
1312,/media/marda/TWOTB1/xBD/hurricanes/images/florence/hurricane-florence_00000003_post_disaster.png,65,92,1,295,360,936,1028,1917,51.29327471497038,50.4381168452381
1313,/media/marda/TWOTB1/xBD/hurricanes/images/florence/hurricane-florence_00000003_post_disaster.png,62,94,1,236,298,937,1031,1679,51.75177229046214,43.64313707322642
1314,/media/marda/TWOTB1/xBD/hurricanes/images/florence/hurricane-florence_00000003_post_disaster.png,83,83,1,649,732,958,1041,2144,58.31701014664215,49.11839744812173
1315,/media/marda/TWOTB1/xBD/hurricanes/images/florence/hurricane-florence_00000003_post_disaster.png,54,58,1,61,115,985,1043,558,44.86238248620975,17.890383072464093
1316,/media/marda/TWOTB1/xBD/hurricanes/images/florence/hurricane-florence_00000388_pre_disaster.png,346,69,1,86,432,696,765,10174,385.2779595398478,35.284797559803714
1317,/media/marda/TWOTB1/xBD/hurricanes/images/florence/hurricane-florence_00000388_pre_disaster.png,348,70,1,84,432,755,825,10151,386.63544701681093,35.31544536126288
1318,/media/marda/TWOTB1/xBD/hurricanes/images/florence/hurricane-florence_00000388_pre_disaster.png,41,58,1,425,466,798,856,503,28.82381040141925,23.884481278464975
1319,/media/marda/TWOTB1/xBD/hurricanes/images/florence/hurricane-florence_00000388_pre_disaster.png,41,47,1,0,41,997,1044,225,46.84277919955454,6.409095567830425
1320,/media/marda/TWOTB1/xBD/hurricanes/images/florence/hurricane-florence_00000288_pre_disaster.png,82,60,1,99,181,0,60,2423,72.88690177417064,47.127969778198135
1321,/media/marda/TWOTB1/xBD/hurricanes/images/florence/hurricane-florence_00000288_pre_disaster.png,44,24,1,172,216,0,24,508,32.92519786010191,21.867907682748744
1322,/media/marda/TWOTB1/xBD/hurricanes/images/florence/hurricane-florence_00000288_pre_disaster.png,49,5,1,934,983,0,5,35,11.912323463721684,4.404846438259275
1323,/media/marda/TWOTB1/xBD/hurricanes/images/florence/hurricane-florence_00000288_pre_disaster.png,35,26,1,28,63,82,108,748,37.192969909609246,26.380317884608928
1324,/media/marda/TWOTB1/xBD/hurricanes/images/florence/hurricane-florence_00000288_pre_disaster.png,18,16,1,84,102,95,111,199,16.96280218419479,15.581763668761793
1325,/media/marda/TWOTB1/xBD/hurricanes/images/florence/hurricane-florence_00000288_pre_disaster.png,30,26,1,104,134,101,127,359,24.48944958322461,19.607862842045574
1326,/media/marda/TWOTB1/xBD/hurricanes/images/florence/hurricane-florence_00000288_pre_disaster.png,38,19,1,654,692,119,138,98,15.252281647638464,8.575274618256376
1327,/media/marda/TWOTB1/xBD/hurricanes/images/florence/hurricane-florence_00000288_pre_disaster.png,57,60,1,53,110,135,195,2130,59.33610953840285,50.61784306465522
1328,/media/marda/TWOTB1/xBD/hurricanes/images/florence/hurricane-florence_00000288_pre_disaster.png,51,28,1,635,686,145,173,314,26.40882828604342,16.064534386286816
1329,/media/marda/TWOTB1/xBD/hurricanes/images/florence/hurricane-florence_00000288_pre_disaster.png,25,22,1,126,151,151,173,349,23.729296114372303,19.645421841515745
1330,/media/marda/TWOTB1/xBD/hurricanes/images/florence/hurricane-florence_00000288_pre_disaster.png,37,30,1,112,149,176,206,758,35.40415001569458,28.35904148111835
1331,/media/marda/TWOTB1/xBD/hurricanes/images/florence/hurricane-florence_00000288_pre_disaster.png,16,16,1,90,106,196,212,127,15.223448600354297,11.255606318474921
1332,/media/marda/TWOTB1/xBD/hurricanes/images/florence/hurricane-florence_00000372_pre_disaster.png,61,83,1,506,567,281,364,1320,70.05634267326732,31.265847977889678
1333,/media/marda/TWOTB1/xBD/hurricanes/images/florence/hurricane-florence_00000372_pre_disaster.png,49,47,1,512,561,369,416,384,40.59705664038184,12.638266508191423
1334,/media/marda/TWOTB1/xBD/hurricanes/images/florence/hurricane-florence_00000372_pre_disaster.png,67,55,1,681,748,401,456,909,36.006654790987945,33.33308279482198
1335,/media/marda/TWOTB1/xBD/hurricanes/images/florence/hurricane-florence_00000372_pre_disaster.png,61,54,1,510,571,436,490,810,37.05463686303285,29.13242115834176
1336,/media/marda/TWOTB1/xBD/hurricanes/images/florence/hurricane-florence_00000372_pre_disaster.png,66,75,1,397,463,451,526,1393,61.71718506379366,29.88738162411868
1337,/media/marda/TWOTB1/xBD/hurricanes/images/florence/hurricane-florence_00000372_pre_disaster.png,63,56,1,691,754,455,511,701,38.11650533391787,24.670369887011255
1338,/media/marda/TWOTB1/xBD/hurricanes/images/florence/hurricane-florence_00000372_pre_disaster.png,85,63,1,767,852,497,560,1055,56.81344947211678,24.81209058917389
1339,/media/marda/TWOTB1/xBD/hurricanes/images/florence/hurricane-florence_00000372_pre_disaster.png,60,47,1,784,844,553,600,397,23.675308771406584,22.37010061023263
1340,/media/marda/TWOTB1/xBD/hurricanes/images/florence/hurricane-florence_00000372_pre_disaster.png,83,64,1,950,1033,582,646,1176,44.62740442296859,37.744062050475875
1341,/media/marda/TWOTB1/xBD/hurricanes/images/florence/hurricane-florence_00000372_pre_disaster.png,34,43,1,335,369,587,630,353,23.65965825957858,19.981565294199722
1342,/media/marda/TWOTB1/xBD/hurricanes/images/florence/hurricane-florence_00000372_pre_disaster.png,70,87,1,262,332,616,703,2089,64.18597644586842,45.677771581865635
1343,/media/marda/TWOTB1/xBD/hurricanes/images/florence/hurricane-florence_00000372_pre_disaster.png,48,36,1,919,967,627,663,71,10.640750135961955,9.160582595072286
1344,/media/marda/TWOTB1/xBD/hurricanes/images/florence/hurricane-florence_00000372_pre_disaster.png,64,52,1,883,947,630,682,466,25.47587950377471,24.276458799196174
1345,/media/marda/TWOTB1/xBD/hurricanes/images/florence/hurricane-florence_00000372_pre_disaster.png,44,35,1,849,893,640,675,98,12.23074930052323,10.199906502706389
1346,/media/marda/TWOTB1/xBD/hurricanes/images/florence/hurricane-florence_00000372_pre_disaster.png,48,60,1,333,381,652,712,677,31.487144118514056,28.694797859784384
1347,/media/marda/TWOTB1/xBD/hurricanes/images/florence/hurricane-florence_00000372_pre_disaster.png,47,39,1,862,909,653,692,181,15.646943399937772,14.748392902063344
1348,/media/marda/TWOTB1/xBD/hurricanes/images/florence/hurricane-florence_00000372_pre_disaster.png,48,37,1,900,948,654,691,82,11.27127700223532,9.752161616908111
1349,/media/marda/TWOTB1/xBD/hurricanes/images/florence/hurricane-florence_00000372_pre_disaster.png,47,35,1,887,934,669,704,91,11.11542739575001,10.430625872619457
1350,/media/marda/TWOTB1/xBD/hurricanes/images/florence/hurricane-florence_00000372_pre_disaster.png,33,37,1,500,533,687,724,133,13.428789240302951,12.624820341082767
1351,/media/marda/TWOTB1/xBD/hurricanes/images/florence/hurricane-florence_00000372_pre_disaster.png,32,43,1,406,438,712,755,116,15.381265870160277,10.149032817367099
1352,/media/marda/TWOTB1/xBD/hurricanes/images/florence/hurricane-florence_00000372_pre_disaster.png,30,38,1,470,500,735,773,73,13.093188818647922,7.468669011614971
1353,/media/marda/TWOTB1/xBD/hurricanes/images/florence/hurricane-florence_00000372_pre_disaster.png,50,56,1,454,504,761,817,554,32.97935001972651,22.360488639399055
1354,/media/marda/TWOTB1/xBD/hurricanes/images/florence/hurricane-florence_00000372_pre_disaster.png,31,46,1,271,302,775,821,186,23.881443985120296,10.445931906757554
1355,/media/marda/TWOTB1/xBD/hurricanes/images/florence/hurricane-florence_00000372_pre_disaster.png,69,74,1,192,261,777,851,1434,57.61217986850077,38.87175977413057
1356,/media/marda/TWOTB1/xBD/hurricanes/images/florence/hurricane-florence_00000372_pre_disaster.png,30,52,1,262,292,784,836,268,20.271468236629158,17.788160555553137
1357,/media/marda/TWOTB1/xBD/hurricanes/images/florence/hurricane-florence_00000372_pre_disaster.png,36,50,1,572,608,797,847,149,17.200789416972633,11.591840261317383
1358,/media/marda/TWOTB1/xBD/hurricanes/images/florence/hurricane-florence_00000372_pre_disaster.png,79,74,1,943,1022,806,880,698,50.54604124496744,20.444425198895225
1359,/media/marda/TWOTB1/xBD/hurricanes/images/florence/hurricane-florence_00000372_pre_disaster.png,50,44,1,907,957,825,869,89,13.428868534410414,8.763139865273665
1360,/media/marda/TWOTB1/xBD/hurricanes/images/florence/hurricane-florence_00000372_pre_disaster.png,56,75,1,345,401,882,957,825,45.83656075007167,23.928135937056457
1361,/media/marda/TWOTB1/xBD/hurricanes/images/florence/hurricane-florence_00000372_pre_disaster.png,54,93,1,114,168,895,988,1348,62.31382832352051,28.734357871882843
1362,/media/marda/TWOTB1/xBD/hurricanes/images/florence/hurricane-florence_00000372_pre_disaster.png,33,58,1,199,232,897,955,297,25.383534537299905,15.444167956856178
1363,/media/marda/TWOTB1/xBD/hurricanes/images/florence/hurricane-florence_00000372_pre_disaster.png,29,52,1,339,368,969,1021,133,15.34467112763328,11.640202565500505
1364,/media/marda/TWOTB1/xBD/hurricanes/images/florence/hurricane-florence_00000372_pre_disaster.png,34,62,1,358,392,980,1042,176,26.944018730930367,9.078697439019383
1365,/media/marda/TWOTB1/xBD/hurricanes/images/florence/hurricane-florence_00000322_post_disaster.png,89,59,1,938,1027,298,357,1231,51.37760119306037,31.57796822226936
1366,/media/marda/TWOTB1/xBD/hurricanes/images/florence/hurricane-florence_00000322_post_disaster.png,53,31,1,830,883,364,395,206,22.45431107085837,12.117126132161825
1367,/media/marda/TWOTB1/xBD/hurricanes/images/florence/hurricane-florence_00000322_post_disaster.png,40,36,1,640,680,377,413,302,26.34684167923561,15.1066955588694
1368,/media/marda/TWOTB1/xBD/hurricanes/images/florence/hurricane-florence_00000322_post_disaster.png,51,37,1,790,841,399,436,187,22.721873778386115,10.912069177647858
1369,/media/marda/TWOTB1/xBD/hurricanes/images/florence/hurricane-florence_00000322_post_disaster.png,92,67,1,807,899,410,477,1628,61.74535462839107,35.51972863481329
1370,/media/marda/TWOTB1/xBD/hurricanes/images/florence/hurricane-florence_00000322_post_disaster.png,35,34,1,596,631,439,473,171,19.82136039978378,11.535168701059456
1371,/media/marda/TWOTB1/xBD/hurricanes/images/florence/hurricane-florence_00000322_post_disaster.png,57,48,1,684,741,467,515,557,30.644813887291157,24.843254920941813
1372,/media/marda/TWOTB1/xBD/hurricanes/images/florence/hurricane-florence_00000322_post_disaster.png,44,33,1,728,772,486,519,144,14.817601918026705,12.896206038560903
1373,/media/marda/TWOTB1/xBD/hurricanes/images/florence/hurricane-florence_00000322_post_disaster.png,44,36,1,587,631,494,530,287,24.489887586705123,15.725565088305014
1374,/media/marda/TWOTB1/xBD/hurricanes/images/florence/hurricane-florence_00000322_post_disaster.png,70,67,1,746,816,510,577,1010,43.55747910100516,31.198507546112506
1375,/media/marda/TWOTB1/xBD/hurricanes/images/florence/hurricane-florence_00000322_post_disaster.png,40,38,1,577,617,518,556,276,20.2419462667027,18.050781675218204
1376,/media/marda/TWOTB1/xBD/hurricanes/images/florence/hurricane-florence_00000322_post_disaster.png,66,60,1,819,885,647,707,648,31.608277359054217,27.18231416002348
1377,/media/marda/TWOTB1/xBD/hurricanes/images/florence/hurricane-florence_00000322_post_disaster.png,45,48,1,583,628,664,712,280,19.90503941372594,18.783449559827613
1378,/media/marda/TWOTB1/xBD/hurricanes/images/florence/hurricane-florence_00000322_post_disaster.png,57,56,1,611,668,669,725,524,28.713190645533814,24.36387663078163
1379,/media/marda/TWOTB1/xBD/hurricanes/images/florence/hurricane-florence_00000322_post_disaster.png,35,51,1,490,525,681,732,273,28.943539993541336,12.581604484040442
1380,/media/marda/TWOTB1/xBD/hurricanes/images/florence/hurricane-florence_00000322_post_disaster.png,66,56,1,829,895,683,739,569,30.404638882532463,24.842134089636467
1381,/media/marda/TWOTB1/xBD/hurricanes/images/florence/hurricane-florence_00000322_post_disaster.png,38,41,1,571,609,687,728,148,17.37391105915811,11.393984824640553
1382,/media/marda/TWOTB1/xBD/hurricanes/images/florence/hurricane-florence_00000322_post_disaster.png,48,54,1,582,630,687,741,311,27.529979114427565,15.099068455438577
1383,/media/marda/TWOTB1/xBD/hurricanes/images/florence/hurricane-florence_00000322_post_disaster.png,56,67,1,533,589,696,763,677,39.313442291345424,22.945984489290336
1384,/media/marda/TWOTB1/xBD/hurricanes/images/florence/hurricane-florence_00000322_post_disaster.png,46,56,1,505,551,725,781,400,26.425549341381558,20.080237598350493
1385,/media/marda/TWOTB1/xBD/hurricanes/images/florence/hurricane-florence_00000322_post_disaster.png,56,64,1,544,600,744,808,638,33.08723095500124,25.73616200160988
1386,/media/marda/TWOTB1/xBD/hurricanes/images/florence/hurricane-florence_00000322_post_disaster.png,76,68,1,313,389,747,815,1663,66.94201768929689,32.637132201322615
1387,/media/marda/TWOTB1/xBD/hurricanes/images/florence/hurricane-florence_00000322_post_disaster.png,68,74,1,496,564,759,833,1308,45.38554351331068,39.49400420352932
1388,/media/marda/TWOTB1/xBD/hurricanes/images/florence/hurricane-florence_00000322_post_disaster.png,49,58,1,361,410,786,844,472,35.539094427425375,17.738030731793717
1389,/media/marda/TWOTB1/xBD/hurricanes/images/florence/hurricane-florence_00000322_post_disaster.png,59,74,1,448,507,829,903,940,40.02894331909205,31.065440982232392
1390,/media/marda/TWOTB1/xBD/hurricanes/images/florence/hurricane-florence_00000322_post_disaster.png,58,70,1,558,616,852,922,751,31.847320952901956,31.21418478026681
1391,/media/marda/TWOTB1/xBD/hurricanes/images/florence/hurricane-florence_00000322_post_disaster.png,72,94,1,562,634,883,977,1386,61.77740679708571,40.5305066997927
1392,/media/marda/TWOTB1/xBD/hurricanes/images/florence/hurricane-florence_00000322_post_disaster.png,27,93,1,252,279,910,1003,971,63.17120671491719,20.379467905058434
1393,/media/marda/TWOTB1/xBD/hurricanes/images/florence/hurricane-florence_00000322_post_disaster.png,68,98,1,726,794,917,1015,1704,69.09650638017465,34.12764944388558
1394,/media/marda/TWOTB1/xBD/hurricanes/images/florence/hurricane-florence_00000322_post_disaster.png,63,76,1,474,537,927,1003,895,40.878863697629306,29.64727948074981
1395,/media/marda/TWOTB1/xBD/hurricanes/images/florence/hurricane-florence_00000322_post_disaster.png,69,71,1,937,1006,936,1007,937,36.39284395368704,34.14271416714135
1396,/media/marda/TWOTB1/xBD/hurricanes/images/florence/hurricane-florence_00000322_post_disaster.png,17,43,1,216,233,978,1021,62,10.219031327149235,7.901587334048377
1397,/media/marda/TWOTB1/xBD/hurricanes/images/florence/hurricane-florence_00000322_post_disaster.png,44,63,1,656,700,978,1041,398,30.07337268310323,17.48155976767362
1398,/media/marda/TWOTB1/xBD/hurricanes/images/florence/hurricane-florence_00000322_post_disaster.png,71,60,1,404,475,981,1041,710,53.253109107871026,20.173926013482742
1399,/media/marda/TWOTB1/xBD/hurricanes/images/florence/hurricane-florence_00000322_post_disaster.png,59,57,1,928,987,985,1042,335,25.807865983635924,17.30368887914498
1400,/media/marda/TWOTB1/xBD/hurricanes/images/florence/hurricane-florence_00000322_post_disaster.png,55,49,1,756,811,994,1043,243,31.15552385479446,10.327955589886445
1401,/media/marda/TWOTB1/xBD/hurricanes/images/florence/hurricane-florence_00000322_post_disaster.png,39,48,1,784,823,994,1042,72,10.327955589886445,9.16515138991168
1402,/media/marda/TWOTB1/xBD/hurricanes/images/florence/hurricane-florence_00000322_post_disaster.png,59,47,1,141,200,779,826,709,63.26971988225682,15.659694567852657
1403,/media/marda/TWOTB1/xBD/hurricanes/images/florence/hurricane-florence_00000154_pre_disaster.png,54,25,1,944,998,454,479,109,19.498058465864748,7.702999089811469
1404,/media/marda/TWOTB1/xBD/hurricanes/images/florence/hurricane-florence_00000209_pre_disaster.png,67,39,1,589,656,141,180,1158,46.68583057535139,34.0664964955242
1405,/media/marda/TWOTB1/xBD/hurricanes/images/florence/hurricane-florence_00000209_pre_disaster.png,66,79,1,216,282,225,304,2166,69.2602635736784,43.09939064274649
1406,/media/marda/TWOTB1/xBD/hurricanes/images/florence/hurricane-florence_00000209_pre_disaster.png,41,34,1,252,293,285,319,449,31.24942997343255,19.317080683035453
1407,/media/marda/TWOTB1/xBD/hurricanes/images/florence/hurricane-florence_00000209_pre_disaster.png,66,51,1,608,674,285,336,933,40.24006647168933,30.538105696859752
1408,/media/marda/TWOTB1/xBD/hurricanes/images/florence/hurricane-florence_00000209_pre_disaster.png,18,49,1,0,18,339,388,447,36.20889595630136,17.19718039573591
1409,/media/marda/TWOTB1/xBD/hurricanes/images/florence/hurricane-florence_00000209_pre_disaster.png,32,25,1,542,574,375,400,156,14.966629547095765,13.808210118138652
1410,/media/marda/TWOTB1/xBD/hurricanes/images/florence/hurricane-florence_00000209_pre_disaster.png,75,73,1,529,604,474,547,1564,52.98420775636793,39.39812091135862
1411,/media/marda/TWOTB1/xBD/hurricanes/images/florence/hurricane-florence_00000209_pre_disaster.png,83,62,1,733,816,601,663,1030,57.98229697105973,23.57345355400049
1412,/media/marda/TWOTB1/xBD/hurricanes/images/florence/hurricane-florence_00000192_post_disaster.png,72,51,1,654,726,197,248,919,49.29773676735717,24.6187543135422
1413,/media/marda/TWOTB1/xBD/hurricanes/images/florence/hurricane-florence_00000192_post_disaster.png,42,21,1,681,723,258,279,101,13.49107207277728,10.09550477471594
1414,/media/marda/TWOTB1/xBD/hurricanes/images/florence/hurricane-florence_00000192_post_disaster.png,48,69,1,270,318,876,945,801,35.41022388540555,29.49606619698622
1415,/media/marda/TWOTB1/xBD/hurricanes/images/florence/hurricane-florence_00000094_pre_disaster.png,76,61,1,307,383,0,61,2447,70.41198259888297,51.73717269716795
1416,/media/marda/TWOTB1/xBD/hurricanes/images/florence/hurricane-florence_00000094_pre_disaster.png,46,73,1,118,164,9,82,1869,74.86153021427121,34.72230055400747
1417,/media/marda/TWOTB1/xBD/hurricanes/images/florence/hurricane-florence_00000094_pre_disaster.png,64,45,1,594,658,81,126,1301,45.92677515021213,37.84624560893303
1418,/media/marda/TWOTB1/xBD/hurricanes/images/florence/hurricane-florence_00000094_pre_disaster.png,62,41,1,127,189,92,133,1488,62.69952788110509,31.283469815420542
1419,/media/marda/TWOTB1/xBD/hurricanes/images/florence/hurricane-florence_00000094_pre_disaster.png,62,45,1,42,104,95,140,1957,63.283193461457486,42.100828736564566
1420,/media/marda/TWOTB1/xBD/hurricanes/images/florence/hurricane-florence_00000094_pre_disaster.png,53,52,1,420,473,121,173,1133,45.6888098979578,33.254923989107375
1421,/media/marda/TWOTB1/xBD/hurricanes/images/florence/hurricane-florence_00000094_pre_disaster.png,60,50,1,376,436,154,204,1407,45.54616363941867,40.850341790527324
1422,/media/marda/TWOTB1/xBD/hurricanes/images/florence/hurricane-florence_00000094_pre_disaster.png,53,34,1,623,676,170,204,638,29.702120001577008,28.357232397364857
1423,/media/marda/TWOTB1/xBD/hurricanes/images/florence/hurricane-florence_00000094_pre_disaster.png,67,51,1,269,336,185,236,1864,55.90667181223044,44.29810895366225
1424,/media/marda/TWOTB1/xBD/hurricanes/images/florence/hurricane-florence_00000094_pre_disaster.png,64,51,1,164,228,199,250,1520,59.992123661623594,33.803423115979484
1425,/media/marda/TWOTB1/xBD/hurricanes/images/florence/hurricane-florence_00000094_pre_disaster.png,25,32,1,216,241,204,236,240,24.54560388062502,13.101399294303619
1426,/media/marda/TWOTB1/xBD/hurricanes/images/florence/hurricane-florence_00000094_pre_disaster.png,58,51,1,634,692,219,270,1237,47.270704673952515,35.314163702911536
1427,/media/marda/TWOTB1/xBD/hurricanes/images/florence/hurricane-florence_00000094_pre_disaster.png,57,43,1,728,785,219,262,882,37.74782260137378,31.227432270241785
1428,/media/marda/TWOTB1/xBD/hurricanes/images/florence/hurricane-florence_00000094_pre_disaster.png,52,45,1,92,144,241,286,1127,51.8032869421171,29.465194325618615
1429,/media/marda/TWOTB1/xBD/hurricanes/images/florence/hurricane-florence_00000094_pre_disaster.png,53,45,1,24,77,268,313,1283,55.7703754504134,31.59186305846533
1430,/media/marda/TWOTB1/xBD/hurricanes/images/florence/hurricane-florence_00000094_pre_disaster.png,68,75,1,638,706,276,351,1598,68.02234909571015,33.5634302389352
1431,/media/marda/TWOTB1/xBD/hurricanes/images/florence/hurricane-florence_00000094_pre_disaster.png,92,139,1,446,538,317,456,5327,139.5337633418362,50.696753101557604
1432,/media/marda/TWOTB1/xBD/hurricanes/images/florence/hurricane-florence_00000094_pre_disaster.png,19,31,1,7,26,324,355,179,17.17475085813783,13.89505759967637
1433,/media/marda/TWOTB1/xBD/hurricanes/images/florence/hurricane-florence_00000094_pre_disaster.png,46,61,1,0,46,340,401,1534,53.902706575090306,41.56319355515785
1434,/media/marda/TWOTB1/xBD/hurricanes/images/florence/hurricane-florence_00000094_pre_disaster.png,52,35,1,686,738,389,424,437,26.43751683381466,21.70737227543527
1435,/media/marda/TWOTB1/xBD/hurricanes/images/florence/hurricane-florence_00000094_pre_disaster.png,38,60,1,0,38,391,451,1076,43.98800845125316,34.181981882199445
1436,/media/marda/TWOTB1/xBD/hurricanes/images/florence/hurricane-florence_00000094_pre_disaster.png,79,40,1,711,790,407,447,1072,57.48325449360241,24.753088087006837
1437,/media/marda/TWOTB1/xBD/hurricanes/images/florence/hurricane-florence_00000094_pre_disaster.png,56,51,1,664,720,409,460,742,35.29471692510877,28.06152230626104
1438,/media/marda/TWOTB1/xBD/hurricanes/images/florence/hurricane-florence_00000094_pre_disaster.png,70,88,1,386,456,431,519,2854,70.86841255756663,53.578203388719466
1439,/media/marda/TWOTB1/xBD/hurricanes/images/florence/hurricane-florence_00000094_pre_disaster.png,36,74,1,37,73,448,522,1284,58.73469615608459,30.51208662584947
1440,/media/marda/TWOTB1/xBD/hurricanes/images/florence/hurricane-florence_00000094_pre_disaster.png,152,110,1,418,570,481,591,8004,142.5399348698724,74.63803635661428
1441,/media/marda/TWOTB1/xBD/hurricanes/images/florence/hurricane-florence_00000094_pre_disaster.png,67,41,1,878,945,531,572,619,35.84858904266746,22.803492000687765
1442,/media/marda/TWOTB1/xBD/hurricanes/images/florence/hurricane-florence_00000094_pre_disaster.png,64,73,1,713,777,565,638,1170,54.92365911052841,28.258650395693333
1443,/media/marda/TWOTB1/xBD/hurricanes/images/florence/hurricane-florence_00000094_pre_disaster.png,188,135,1,387,575,568,703,12062,176.87943700200384,92.10297773619008
1444,/media/marda/TWOTB1/xBD/hurricanes/images/florence/hurricane-florence_00000094_pre_disaster.png,68,55,1,717,785,622,677,797,39.33521612270574,26.537221714476864
1445,/media/marda/TWOTB1/xBD/hurricanes/images/florence/hurricane-florence_00000094_pre_disaster.png,76,87,1,563,639,692,779,2132,57.921147593470074,48.644720009732254
1446,/media/marda/TWOTB1/xBD/hurricanes/images/florence/hurricane-florence_00000094_pre_disaster.png,50,62,1,829,879,694,756,419,37.108321975362266,15.109071866293224
1447,/media/marda/TWOTB1/xBD/hurricanes/images/florence/hurricane-florence_00000094_pre_disaster.png,72,65,1,746,818,707,772,979,42.36747357046285,30.25791015610296
1448,/media/marda/TWOTB1/xBD/hurricanes/images/florence/hurricane-florence_00000094_pre_disaster.png,40,49,1,522,562,709,758,283,20.200135785507353,18.64977266741628
1449,/media/marda/TWOTB1/xBD/hurricanes/images/florence/hurricane-florence_00000094_pre_disaster.png,69,77,1,466,535,720,797,1233,55.95761136518948,28.986205427679426
1450,/media/marda/TWOTB1/xBD/hurricanes/images/florence/hurricane-florence_00000094_pre_disaster.png,52,79,1,0,52,743,822,1570,49.455564297495556,41.85603794169503
1451,/media/marda/TWOTB1/xBD/hurricanes/images/florence/hurricane-florence_00000094_pre_disaster.png,72,76,1,518,590,767,843,1723,53.63817118983901,42.86069674387899
1452,/media/marda/TWOTB1/xBD/hurricanes/images/florence/hurricane-florence_00000094_pre_disaster.png,165,142,1,177,342,781,923,9511,148.2539901429784,97.49997783134448
1453,/media/marda/TWOTB1/xBD/hurricanes/images/florence/hurricane-florence_00000094_pre_disaster.png,79,76,1,600,679,784,860,1488,54.24378017462495,39.81156306267198
1454,/media/marda/TWOTB1/xBD/hurricanes/images/florence/hurricane-florence_00000094_pre_disaster.png,68,51,1,902,970,792,843,542,34.939252590931936,20.438008988139472
1455,/media/marda/TWOTB1/xBD/hurricanes/images/florence/hurricane-florence_00000094_pre_disaster.png,40,53,1,569,609,807,860,295,20.42280564441619,19.33255038260181
1456,/media/marda/TWOTB1/xBD/hurricanes/images/florence/hurricane-florence_00000094_pre_disaster.png,115,84,1,840,955,825,909,3855,89.04224312713185,56.74148928616234
1457,/media/marda/TWOTB1/xBD/hurricanes/images/florence/hurricane-florence_00000094_pre_disaster.png,56,50,1,931,987,835,885,302,22.034699802544168,18.250161148977032
1458,/media/marda/TWOTB1/xBD/hurricanes/images/florence/hurricane-florence_00000094_pre_disaster.png,57,60,1,95,152,984,1044,761,52.71590472547964,20.00779155386535
1459,/media/marda/TWOTB1/xBD/hurricanes/images/florence/hurricane-florence_00000089_pre_disaster.png,30,25,1,446,476,206,231,145,16.356122892883164,11.771729073816577
1460,/media/marda/TWOTB1/xBD/hurricanes/images/florence/hurricane-florence_00000089_pre_disaster.png,29,22,1,457,486,212,234,110,14.134220916751543,10.458844842529194
1461,/media/marda/TWOTB1/xBD/hurricanes/images/florence/hurricane-florence_00000089_pre_disaster.png,51,33,1,477,528,219,252,484,30.483898195248877,22.061072088931557
1462,/media/marda/TWOTB1/xBD/hurricanes/images/florence/hurricane-florence_00000089_pre_disaster.png,64,48,1,405,469,243,291,1073,50.184595178274236,28.550133365761255
1463,/media/marda/TWOTB1/xBD/hurricanes/images/florence/hurricane-florence_00000089_pre_disaster.png,45,57,1,249,294,375,432,1066,43.802766568968195,33.030959034628836
1464,/media/marda/TWOTB1/xBD/hurricanes/images/florence/hurricane-florence_00000089_pre_disaster.png,69,74,1,373,442,375,449,1826,65.20618707604609,37.78562998727408
1465,/media/marda/TWOTB1/xBD/hurricanes/images/florence/hurricane-florence_00000089_pre_disaster.png,29,36,1,268,297,438,474,230,20.01546851228958,15.280787182161534
1466,/media/marda/TWOTB1/xBD/hurricanes/images/florence/hurricane-florence_00000089_pre_disaster.png,31,42,1,256,287,465,507,369,26.170009507446732,18.610918083706004
1467,/media/marda/TWOTB1/xBD/hurricanes/images/florence/hurricane-florence_00000089_pre_disaster.png,37,41,1,440,477,489,530,249,26.40377888343693,12.630850521702751
1468,/media/marda/TWOTB1/xBD/hurricanes/images/florence/hurricane-florence_00000089_pre_disaster.png,22,32,1,371,393,509,541,92,12.03269054769746,10.362831236048885
1469,/media/marda/TWOTB1/xBD/hurricanes/images/florence/hurricane-florence_00000089_pre_disaster.png,103,61,1,542,645,589,650,1551,92.04269143245604,22.42969404884953
1470,/media/marda/TWOTB1/xBD/hurricanes/images/florence/hurricane-florence_00000089_pre_disaster.png,30,47,1,167,197,634,681,405,25.507122077613886,21.15268583955746
1471,/media/marda/TWOTB1/xBD/hurricanes/images/florence/hurricane-florence_00000089_pre_disaster.png,59,55,1,191,250,638,693,948,57.27210810617059,21.939777032518805
1472,/media/marda/TWOTB1/xBD/hurricanes/images/florence/hurricane-florence_00000089_pre_disaster.png,23,42,1,214,237,744,786,156,14.700979413993137,13.723059476764458
1473,/media/marda/TWOTB1/xBD/hurricanes/images/florence/hurricane-florence_00000089_pre_disaster.png,54,75,1,450,504,951,1026,871,37.462599558226664,31.343259983028133
1474,/media/marda/TWOTB1/xBD/hurricanes/images/florence/hurricane-florence_00000039_pre_disaster.png,47,51,1,222,269,252,303,825,41.38513830251083,26.5970155613926
1475,/media/marda/TWOTB1/xBD/hurricanes/images/florence/hurricane-florence_00000039_pre_disaster.png,25,30,1,151,176,285,315,236,18.900699406905666,16.72866724196843
1476,/media/marda/TWOTB1/xBD/hurricanes/images/florence/hurricane-florence_00000039_pre_disaster.png,22,26,1,213,235,307,333,142,14.468194526142934,13.249728251952678
1477,/media/marda/TWOTB1/xBD/hurricanes/images/florence/hurricane-florence_00000039_pre_disaster.png,23,28,1,213,236,356,384,137,14.13166883291293,13.049189149396653
1478,/media/marda/TWOTB1/xBD/hurricanes/images/florence/hurricane-florence_00000253_post_disaster.png,67,40,1,714,781,205,245,944,39.346615742842495,32.05019901057654
1479,/media/marda/TWOTB1/xBD/hurricanes/images/florence/hurricane-florence_00000253_post_disaster.png,88,118,1,602,690,430,548,3918,112.26317153796911,56.281951212482944
1480,/media/marda/TWOTB1/xBD/hurricanes/images/florence/hurricane-florence_00000253_post_disaster.png,55,53,1,668,723,744,797,333,28.385416431900868,15.70659082300479
1481,/media/marda/TWOTB1/xBD/hurricanes/images/florence/hurricane-florence_00000008_pre_disaster.png,65,38,1,776,841,146,184,428,42.884417916025285,13.703419941163263
1482,/media/marda/TWOTB1/xBD/hurricanes/images/florence/hurricane-florence_00000008_pre_disaster.png,123,106,1,701,824,320,426,2478,128.36061609235497,25.67475255551223
1483,/media/marda/TWOTB1/xBD/hurricanes/images/florence/hurricane-florence_00000008_pre_disaster.png,125,105,1,734,859,354,459,2456,131.0313331527255,24.886388384734516
1484,/media/marda/TWOTB1/xBD/hurricanes/images/florence/hurricane-florence_00000008_pre_disaster.png,70,79,1,603,673,777,856,1208,45.140158823872255,36.46780763953298
1485,/media/marda/TWOTB1/xBD/hurricanes/images/florence/hurricane-florence_00000008_pre_disaster.png,66,81,1,349,415,802,883,1383,45.014277028915146,41.037948879623464
1486,/media/marda/TWOTB1/xBD/hurricanes/images/florence/hurricane-florence_00000008_pre_disaster.png,73,83,1,305,378,835,918,1547,57.11566728148511,36.68012978787658
1487,/media/marda/TWOTB1/xBD/hurricanes/images/florence/hurricane-florence_00000008_pre_disaster.png,80,89,1,526,606,851,940,1716,58.335034049082445,39.859909528806185
1488,/media/marda/TWOTB1/xBD/hurricanes/images/florence/hurricane-florence_00000008_pre_disaster.png,80,91,1,696,776,854,945,1471,57.45974000933623,34.91877927216238
1489,/media/marda/TWOTB1/xBD/hurricanes/images/florence/hurricane-florence_00000008_pre_disaster.png,74,88,1,277,351,859,947,1743,58.17701921927584,40.26248959905367
1490,/media/marda/TWOTB1/xBD/hurricanes/images/florence/hurricane-florence_00000008_pre_disaster.png,69,90,1,422,491,869,959,1563,54.98031147576919,38.168112755685016
1491,/media/marda/TWOTB1/xBD/hurricanes/images/florence/hurricane-florence_00000008_pre_disaster.png,76,90,1,566,642,881,971,1519,58.30664275077116,35.81843733799448
1492,/media/marda/TWOTB1/xBD/hurricanes/images/florence/hurricane-florence_00000008_pre_disaster.png,64,85,1,400,464,894,979,1171,42.05535196096286,40.429033310005984
1493,/media/marda/TWOTB1/xBD/hurricanes/images/florence/hurricane-florence_00000008_pre_disaster.png,70,89,1,244,314,899,988,1624,57.401693310303,37.98574267577208
1494,/media/marda/TWOTB1/xBD/hurricanes/images/florence/hurricane-florence_00000008_pre_disaster.png,72,85,1,599,671,904,989,1253,43.01708129292268,39.033633406107946
1495,/media/marda/TWOTB1/xBD/hurricanes/images/florence/hurricane-florence_00000008_pre_disaster.png,59,84,1,369,428,926,1010,1116,45.0027054036245,34.676584916034116
1496,/media/marda/TWOTB1/xBD/hurricanes/images/florence/hurricane-florence_00000008_pre_disaster.png,69,89,1,213,282,932,1021,1617,57.03600315395329,38.394856786518176
1497,/media/marda/TWOTB1/xBD/hurricanes/images/florence/hurricane-florence_00000008_pre_disaster.png,68,86,1,187,255,956,1042,1659,58.665947054803354,37.46054721493128
1498,/media/marda/TWOTB1/xBD/hurricanes/images/florence/hurricane-florence_00000008_pre_disaster.png,87,82,1,672,759,960,1042,1691,59.47698852941897,37.43315963232398
1499,/media/marda/TWOTB1/xBD/hurricanes/images/florence/hurricane-florence_00000008_pre_disaster.png,65,78,1,335,400,964,1042,1250,50.4580419652449,32.21895498357424
1500,/media/marda/TWOTB1/xBD/hurricanes/images/florence/hurricane-florence_00000008_pre_disaster.png,83,75,1,518,601,967,1042,1425,57.450700216639255,32.70082751662247
1501,/media/marda/TWOTB1/xBD/hurricanes/images/florence/hurricane-florence_00000008_pre_disaster.png,40,58,1,164,204,986,1044,315,28.350042467841778,17.06918797832423
1502,/media/marda/TWOTB1/xBD/hurricanes/images/florence/hurricane-florence_00000008_pre_disaster.png,38,54,1,314,352,990,1044,193,22.71465804603791,12.710543164319914
1503,/media/marda/TWOTB1/xBD/hurricanes/images/florence/hurricane-florence_00000008_pre_disaster.png,52,53,1,651,703,991,1044,187,23.497128178787992,12.176931387606867
1504,/media/marda/TWOTB1/xBD/hurricanes/images/florence/hurricane-florence_00000391_post_disaster.png,51,32,1,0,51,0,32,1188,57.53010350727673,28.98490882208456
1505,/media/marda/TWOTB1/xBD/hurricanes/images/florence/hurricane-florence_00000391_post_disaster.png,55,15,1,894,949,16,31,157,19.012782211659925,11.097651595696597
1506,/media/marda/TWOTB1/xBD/hurricanes/images/florence/hurricane-florence_00000391_post_disaster.png,63,16,1,980,1043,41,57,243,26.63368380139131,12.24087202769237
1507,/media/marda/TWOTB1/xBD/hurricanes/images/florence/hurricane-florence_00000391_post_disaster.png,46,10,1,929,975,55,65,54,9.17755932939589,7.980263984369161
1508,/media/marda/TWOTB1/xBD/hurricanes/images/florence/hurricane-florence_00000391_post_disaster.png,99,24,1,902,1001,77,101,707,69.77128101470873,13.391021678855898
1509,/media/marda/TWOTB1/xBD/hurricanes/images/florence/hurricane-florence_00000391_post_disaster.png,41,25,1,373,414,102,127,413,28.58527332845612,19.051889014218713
1510,/media/marda/TWOTB1/xBD/hurricanes/images/florence/hurricane-florence_00000391_post_disaster.png,43,48,1,366,409,147,195,919,48.62194834947007,25.263546316273857
1511,/media/marda/TWOTB1/xBD/hurricanes/images/florence/hurricane-florence_00000391_post_disaster.png,25,19,1,154,179,149,168,200,22.720440546814444,11.662125936495036
1512,/media/marda/TWOTB1/xBD/hurricanes/images/florence/hurricane-florence_00000391_post_disaster.png,46,40,1,170,216,197,237,933,37.49073858257521,33.28678090888529
1513,/media/marda/TWOTB1/xBD/hurricanes/images/florence/hurricane-florence_00000391_post_disaster.png,60,46,1,903,963,205,251,583,39.92359852204616,19.514485738881252
1514,/media/marda/TWOTB1/xBD/hurricanes/images/florence/hurricane-florence_00000391_post_disaster.png,86,56,1,941,1027,240,296,1683,47.957997114133214,46.302275632125976
1515,/media/marda/TWOTB1/xBD/hurricanes/images/florence/hurricane-florence_00000391_post_disaster.png,26,29,1,23,49,250,279,284,22.528712819691226,16.80839567427387
1516,/media/marda/TWOTB1/xBD/hurricanes/images/florence/hurricane-florence_00000391_post_disaster.png,47,39,1,64,111,264,303,848,46.75961049334514,24.09211539997797
1517,/media/marda/TWOTB1/xBD/hurricanes/images/florence/hurricane-florence_00000391_post_disaster.png,49,46,1,547,596,274,320,762,38.54682838026782,26.32433641944191
1518,/media/marda/TWOTB1/xBD/hurricanes/images/florence/hurricane-florence_00000391_post_disaster.png,65,47,1,398,463,303,350,1180,51.71174270700329,30.168630982102123
1519,/media/marda/TWOTB1/xBD/hurricanes/images/florence/hurricane-florence_00000391_post_disaster.png,40,36,1,404,444,344,380,414,26.27272238599411,20.64222613178274
1520,/media/marda/TWOTB1/xBD/hurricanes/images/florence/hurricane-florence_00000391_post_disaster.png,19,37,1,211,230,604,641,110,12.779681778337052,11.20649449062493
1521,/media/marda/TWOTB1/xBD/hurricanes/images/florence/hurricane-florence_00000391_post_disaster.png,31,41,1,186,217,608,649,283,28.732063562682267,13.884856557811009
1522,/media/marda/TWOTB1/xBD/hurricanes/images/florence/hurricane-florence_00000134_pre_disaster.png,93,66,1,785,878,437,503,1495,52.34374117703592,40.025084633513046
1523,/media/marda/TWOTB1/xBD/hurricanes/images/florence/hurricane-florence_00000134_pre_disaster.png,53,42,1,730,783,463,505,602,28.88323781829119,27.78325455595094
1524,/media/marda/TWOTB1/xBD/hurricanes/images/florence/hurricane-florence_00000134_pre_disaster.png,31,39,1,343,374,619,658,252,20.85089190002344,16.207171429307735
1525,/media/marda/TWOTB1/xBD/hurricanes/images/florence/hurricane-florence_00000134_pre_disaster.png,77,90,1,844,921,854,944,1611,59.2609426022708,36.27753849711873
1526,/media/marda/TWOTB1/xBD/hurricanes/images/florence/hurricane-florence_00000134_pre_disaster.png,56,67,1,988,1044,975,1042,400,35.656120204888865,15.185331472658618
1527,/media/marda/TWOTB1/xBD/hurricanes/images/florence/hurricane-florence_00000453_post_disaster.png,36,49,1,273,309,385,434,650,39.49940619819274,23.7395829273418
1528,/media/marda/TWOTB1/xBD/hurricanes/images/florence/hurricane-florence_00000453_post_disaster.png,53,40,1,98,151,394,434,690,58.643739677060964,15.501055408077914
1529,/media/marda/TWOTB1/xBD/hurricanes/images/florence/hurricane-florence_00000453_post_disaster.png,56,45,1,328,384,400,445,829,47.83553214353843,23.13832704050977
1530,/media/marda/TWOTB1/xBD/hurricanes/images/florence/hurricane-florence_00000453_post_disaster.png,48,36,1,184,232,404,440,496,44.99214399036559,15.348563520638896
1531,/media/marda/TWOTB1/xBD/hurricanes/images/florence/hurricane-florence_00000453_post_disaster.png,22,29,1,296,318,414,443,97,13.156016658111202,9.94675480678194
1532,/media/marda/TWOTB1/xBD/hurricanes/images/florence/hurricane-florence_00000453_post_disaster.png,32,32,1,255,287,435,467,242,25.413954874702714,12.76524996208616
1533,/media/marda/TWOTB1/xBD/hurricanes/images/florence/hurricane-florence_00000453_post_disaster.png,34,34,1,329,363,438,472,285,23.723566598236108,15.957604536797113
1534,/media/marda/TWOTB1/xBD/hurricanes/images/florence/hurricane-florence_00000453_post_disaster.png,36,40,1,322,358,458,498,386,23.90666747647484,21.57033936507955
1535,/media/marda/TWOTB1/xBD/hurricanes/images/florence/hurricane-florence_00000196_pre_disaster.png,129,248,1,153,282,0,248,17331,282.0744474381509,85.52572441666976
1536,/media/marda/TWOTB1/xBD/hurricanes/images/florence/hurricane-florence_00000196_pre_disaster.png,52,49,1,6,58,13,62,1655,52.84595122621936,41.616996137853754
1537,/media/marda/TWOTB1/xBD/hurricanes/images/florence/hurricane-florence_00000196_pre_disaster.png,16,18,1,82,98,14,32,179,17.043234764599433,13.964602571384551
1538,/media/marda/TWOTB1/xBD/hurricanes/images/florence/hurricane-florence_00000196_pre_disaster.png,17,19,1,60,77,27,46,229,18.08376438287428,16.98577654886036
1539,/media/marda/TWOTB1/xBD/hurricanes/images/florence/hurricane-florence_00000196_pre_disaster.png,17,14,1,131,148,46,60,106,12.71224325733803,11.246081231450225
1540,/media/marda/TWOTB1/xBD/hurricanes/images/florence/hurricane-florence_00000196_pre_disaster.png,25,28,1,56,81,49,77,482,27.71273501867004,23.136089591246183
1541,/media/marda/TWOTB1/xBD/hurricanes/images/florence/hurricane-florence_00000196_pre_disaster.png,42,36,1,26,68,78,114,1026,45.254327493324055,29.866313351365374
1542,/media/marda/TWOTB1/xBD/hurricanes/images/florence/hurricane-florence_00000196_pre_disaster.png,19,36,1,154,173,133,169,275,34.58368615942064,10.640763832191853
1543,/media/marda/TWOTB1/xBD/hurricanes/images/florence/hurricane-florence_00000196_pre_disaster.png,37,43,1,44,81,144,187,1005,38.23280578557146,34.729594052427466
1544,/media/marda/TWOTB1/xBD/hurricanes/images/florence/hurricane-florence_00000196_pre_disaster.png,134,276,1,93,227,192,468,14586,315.26271646632244,70.7155797357188
1545,/media/marda/TWOTB1/xBD/hurricanes/images/florence/hurricane-florence_00000196_pre_disaster.png,106,57,1,938,1044,228,285,1527,79.54315266903932,38.21529383226644
1546,/media/marda/TWOTB1/xBD/hurricanes/images/florence/hurricane-florence_00000196_pre_disaster.png,103,189,1,197,300,255,444,8433,206.5468732941257,56.10455247225523
1547,/media/marda/TWOTB1/xBD/hurricanes/images/florence/hurricane-florence_00000196_pre_disaster.png,46,35,1,766,812,261,296,363,28.178838676915337,17.149237063649192
1548,/media/marda/TWOTB1/xBD/hurricanes/images/florence/hurricane-florence_00000196_pre_disaster.png,45,27,1,774,819,291,318,217,18.548303580158496,15.21643138322049
1549,/media/marda/TWOTB1/xBD/hurricanes/images/florence/hurricane-florence_00000196_pre_disaster.png,48,31,1,731,779,305,336,288,20.911548817535152,18.3871513395952
1550,/media/marda/TWOTB1/xBD/hurricanes/images/florence/hurricane-florence_00000196_pre_disaster.png,66,39,1,752,818,310,349,622,37.81711809408773,21.755673742231206
1551,/media/marda/TWOTB1/xBD/hurricanes/images/florence/hurricane-florence_00000196_pre_disaster.png,65,76,1,612,677,467,543,1317,57.571871172668814,33.713367808305996
1552,/media/marda/TWOTB1/xBD/hurricanes/images/florence/hurricane-florence_00000196_pre_disaster.png,39,92,1,0,39,490,582,1300,77.5592156733078,37.254047620913965
1553,/media/marda/TWOTB1/xBD/hurricanes/images/florence/hurricane-florence_00000196_pre_disaster.png,63,50,1,741,804,511,561,735,35.95320317432171,27.30121210468881
1554,/media/marda/TWOTB1/xBD/hurricanes/images/florence/hurricane-florence_00000196_pre_disaster.png,45,63,1,436,481,528,591,808,47.25426070843134,22.720082678719177
1555,/media/marda/TWOTB1/xBD/hurricanes/images/florence/hurricane-florence_00000196_pre_disaster.png,48,50,1,591,639,537,587,363,29.757425177659382,16.29924370280745
1556,/media/marda/TWOTB1/xBD/hurricanes/images/florence/hurricane-florence_00000196_pre_disaster.png,113,92,1,163,276,551,643,4418,111.20937277511237,60.7729765267286
1557,/media/marda/TWOTB1/xBD/hurricanes/images/florence/hurricane-florence_00000196_pre_disaster.png,63,79,1,645,708,561,640,1383,62.45893043500376,29.572912738090064
1558,/media/marda/TWOTB1/xBD/hurricanes/images/florence/hurricane-florence_00000196_pre_disaster.png,30,46,1,294,324,573,619,333,26.236290096216326,16.90142758262437
1559,/media/marda/TWOTB1/xBD/hurricanes/images/florence/hurricane-florence_00000196_pre_disaster.png,64,63,1,765,829,579,642,918,42.40566175792048,28.887723891189168
1560,/media/marda/TWOTB1/xBD/hurricanes/images/florence/hurricane-florence_00000196_pre_disaster.png,24,39,1,285,309,590,629,143,14.531144860497937,13.269824301208098
1561,/media/marda/TWOTB1/xBD/hurricanes/images/florence/hurricane-florence_00000196_pre_disaster.png,25,43,1,269,294,595,638,212,17.57761503671544,16.17731828543675
1562,/media/marda/TWOTB1/xBD/hurricanes/images/florence/hurricane-florence_00000196_pre_disaster.png,52,70,1,599,651,603,673,901,47.68682141900817,24.8089634286421
1563,/media/marda/TWOTB1/xBD/hurricanes/images/florence/hurricane-florence_00000196_pre_disaster.png,81,67,1,939,1020,604,671,1228,42.38657881539355,39.96827808251832
1564,/media/marda/TWOTB1/xBD/hurricanes/images/florence/hurricane-florence_00000196_pre_disaster.png,39,51,1,66,105,606,657,644,38.78146692360895,21.77094971818087
1565,/media/marda/TWOTB1/xBD/hurricanes/images/florence/hurricane-florence_00000196_pre_disaster.png,31,50,1,0,31,621,671,606,34.65400382042947,23.220159026287924
1566,/media/marda/TWOTB1/xBD/hurricanes/images/florence/hurricane-florence_00000196_pre_disaster.png,68,56,1,897,965,628,684,719,32.28577559287074,29.956351141338025
1567,/media/marda/TWOTB1/xBD/hurricanes/images/florence/hurricane-florence_00000196_pre_disaster.png,64,58,1,783,847,631,689,838,35.132390147369314,31.661207922862538
1568,/media/marda/TWOTB1/xBD/hurricanes/images/florence/hurricane-florence_00000196_pre_disaster.png,46,59,1,164,210,637,696,921,43.12005452453421,28.372253322405683
1569,/media/marda/TWOTB1/xBD/hurricanes/images/florence/hurricane-florence_00000196_pre_disaster.png,54,53,1,671,725,642,695,536,28.25260840169509,25.158740147810246
1570,/media/marda/TWOTB1/xBD/hurricanes/images/florence/hurricane-florence_00000196_pre_disaster.png,20,44,1,69,89,649,693,296,21.038760964407338,18.835496873932883
1571,/media/marda/TWOTB1/xBD/hurricanes/images/florence/hurricane-florence_00000196_pre_disaster.png,71,59,1,858,929,655,714,858,35.28685581146002,32.24336869802826
1572,/media/marda/TWOTB1/xBD/hurricanes/images/florence/hurricane-florence_00000196_pre_disaster.png,49,64,1,56,105,669,733,1251,46.49352464206782,35.655133201077746
1573,/media/marda/TWOTB1/xBD/hurricanes/images/florence/hurricane-florence_00000196_pre_disaster.png,83,66,1,798,881,671,737,1286,52.97863076049059,35.24395157685813
1574,/media/marda/TWOTB1/xBD/hurricanes/images/florence/hurricane-florence_00000196_pre_disaster.png,64,63,1,358,422,677,740,1320,51.978545443005345,33.894106094636825
1575,/media/marda/TWOTB1/xBD/hurricanes/images/florence/hurricane-florence_00000196_pre_disaster.png,76,78,1,667,743,683,761,1821,55.52810697836818,44.299172507300305
1576,/media/marda/TWOTB1/xBD/hurricanes/images/florence/hurricane-florence_00000196_pre_disaster.png,25,52,1,241,266,686,738,230,23.473060418118266,14.32863307237231
1577,/media/marda/TWOTB1/xBD/hurricanes/images/florence/hurricane-florence_00000196_pre_disaster.png,13,45,1,26,39,698,743,165,16.955006323477004,12.947497684560501
1578,/media/marda/TWOTB1/xBD/hurricanes/images/florence/hurricane-florence_00000196_pre_disaster.png,64,112,1,59,123,707,819,2951,97.94685691762277,45.64784260854219
1579,/media/marda/TWOTB1/xBD/hurricanes/images/florence/hurricane-florence_00000196_pre_disaster.png,49,74,1,195,244,708,782,1406,46.244992415437025,40.73961173302797
1580,/media/marda/TWOTB1/xBD/hurricanes/images/florence/hurricane-florence_00000196_pre_disaster.png,26,42,1,243,269,708,750,159,17.32529352182004,12.334108681880018
1581,/media/marda/TWOTB1/xBD/hurricanes/images/florence/hurricane-florence_00000196_pre_disaster.png,48,46,1,542,590,709,755,309,30.250072232680957,13.572377305583856
1582,/media/marda/TWOTB1/xBD/hurricanes/images/florence/hurricane-florence_00000196_pre_disaster.png,64,62,1,489,553,713,775,1037,47.4596168937791,30.391092960103375
1583,/media/marda/TWOTB1/xBD/hurricanes/images/florence/hurricane-florence_00000196_pre_disaster.png,34,63,1,10,44,729,792,749,35.297616981931796,33.00460257516386
1584,/media/marda/TWOTB1/xBD/hurricanes/images/florence/hurricane-florence_00000196_pre_disaster.png,62,82,1,546,608,730,812,1475,55.04733721430322,35.42636976533291
1585,/media/marda/TWOTB1/xBD/hurricanes/images/florence/hurricane-florence_00000196_pre_disaster.png,76,59,1,957,1033,737,796,779,39.09474891267436,26.170121153193755
1586,/media/marda/TWOTB1/xBD/hurricanes/images/florence/hurricane-florence_00000196_pre_disaster.png,64,75,1,502,566,751,826,1513,45.18888244338467,43.525103028146205
1587,/media/marda/TWOTB1/xBD/hurricanes/images/florence/hurricane-florence_00000196_pre_disaster.png,71,79,1,886,957,754,833,1187,51.30746946502506,30.632368187114743
1588,/media/marda/TWOTB1/xBD/hurricanes/images/florence/hurricane-florence_00000196_pre_disaster.png,39,74,1,236,275,762,836,959,45.789732434294656,27.514010109066707
1589,/media/marda/TWOTB1/xBD/hurricanes/images/florence/hurricane-florence_00000196_pre_disaster.png,8,41,1,0,8,785,826,90,13.01761541557354,9.171908804302648
1590,/media/marda/TWOTB1/xBD/hurricanes/images/florence/hurricane-florence_00000196_pre_disaster.png,37,71,1,106,143,784,855,843,40.62194728542255,27.552184030174182
1591,/media/marda/TWOTB1/xBD/hurricanes/images/florence/hurricane-florence_00000196_pre_disaster.png,49,45,1,971,1020,789,834,99,13.51743808038476,9.777768296330601
1592,/media/marda/TWOTB1/xBD/hurricanes/images/florence/hurricane-florence_00000196_pre_disaster.png,37,44,1,679,716,794,838,107,12.648848047237138,11.162916881459749
1593,/media/marda/TWOTB1/xBD/hurricanes/images/florence/hurricane-florence_00000196_pre_disaster.png,66,84,1,700,766,794,878,1446,53.929279218670466,35.019378712817776
1594,/media/marda/TWOTB1/xBD/hurricanes/images/florence/hurricane-florence_00000196_pre_disaster.png,76,65,1,833,909,798,863,966,44.26631428512531,29.012421500910083
1595,/media/marda/TWOTB1/xBD/hurricanes/images/florence/hurricane-florence_00000196_pre_disaster.png,36,70,1,345,381,805,875,598,39.840282708331706,20.054845399563764
1596,/media/marda/TWOTB1/xBD/hurricanes/images/florence/hurricane-florence_00000196_pre_disaster.png,33,61,1,116,149,821,882,556,28.055702300986226,26.48559221249059
1597,/media/marda/TWOTB1/xBD/hurricanes/images/florence/hurricane-florence_00000196_pre_disaster.png,52,64,1,279,331,827,891,913,43.615056299178036,27.955212127722564
1598,/media/marda/TWOTB1/xBD/hurricanes/images/florence/hurricane-florence_00000196_pre_disaster.png,48,42,1,967,1015,835,877,104,13.346663642539841,10.455017839070004
1599,/media/marda/TWOTB1/xBD/hurricanes/images/florence/hurricane-florence_00000196_pre_disaster.png,58,65,1,594,652,836,901,783,35.54955887014262,29.45244801115476
1600,/media/marda/TWOTB1/xBD/hurricanes/images/florence/hurricane-florence_00000196_pre_disaster.png,85,76,1,846,931,837,913,1413,51.06194218651833,38.337760591705916
1601,/media/marda/TWOTB1/xBD/hurricanes/images/florence/hurricane-florence_00000196_pre_disaster.png,63,51,1,898,961,843,894,305,28.58230848796924,14.780899137433334
1602,/media/marda/TWOTB1/xBD/hurricanes/images/florence/hurricane-florence_00000196_pre_disaster.png,51,66,1,217,268,844,910,1026,46.529538684529314,29.10528484189058
1603,/media/marda/TWOTB1/xBD/hurricanes/images/florence/hurricane-florence_00000196_pre_disaster.png,55,67,1,427,482,864,931,978,38.03009647292739,35.13570307278102
1604,/media/marda/TWOTB1/xBD/hurricanes/images/florence/hurricane-florence_00000196_pre_disaster.png,28,62,1,113,141,865,927,480,30.811011669264428,20.67511497817837
1605,/media/marda/TWOTB1/xBD/hurricanes/images/florence/hurricane-florence_00000196_pre_disaster.png,68,72,1,716,784,867,939,1014,43.22718800182887,32.95310448928429
1606,/media/marda/TWOTB1/xBD/hurricanes/images/florence/hurricane-florence_00000196_pre_disaster.png,54,54,1,536,590,883,937,445,36.507474316712376,16.194582374512798
1607,/media/marda/TWOTB1/xBD/hurricanes/images/florence/hurricane-florence_00000196_pre_disaster.png,76,77,1,862,938,897,974,1266,41.650266758973906,40.34312563019269
1608,/media/marda/TWOTB1/xBD/hurricanes/images/florence/hurricane-florence_00000196_pre_disaster.png,21,68,1,0,21,898,966,465,30.12381208788675,20.879597831405608
1609,/media/marda/TWOTB1/xBD/hurricanes/images/florence/hurricane-florence_00000196_pre_disaster.png,46,80,1,279,325,899,979,1054,44.72141935069954,31.246343614039514
1610,/media/marda/TWOTB1/xBD/hurricanes/images/florence/hurricane-florence_00000196_pre_disaster.png,63,89,1,694,757,903,992,911,56.069699214052015,23.582388369765702
1611,/media/marda/TWOTB1/xBD/hurricanes/images/florence/hurricane-florence_00000196_pre_disaster.png,26,46,1,419,445,905,951,60,9.462950117283022,8.633739859800158
1612,/media/marda/TWOTB1/xBD/hurricanes/images/florence/hurricane-florence_00000196_pre_disaster.png,51,62,1,423,474,923,985,615,36.058350530436215,22.319824014002908
1613,/media/marda/TWOTB1/xBD/hurricanes/images/florence/hurricane-florence_00000196_pre_disaster.png,60,66,1,569,629,934,1000,696,39.96101912774739,23.69950758164691
1614,/media/marda/TWOTB1/xBD/hurricanes/images/florence/hurricane-florence_00000196_pre_disaster.png,75,72,1,886,961,942,1014,811,41.890249601103875,26.795024834090878
1615,/media/marda/TWOTB1/xBD/hurricanes/images/florence/hurricane-florence_00000196_pre_disaster.png,81,83,1,736,817,945,1028,1571,48.840417261483935,42.52520287534576
1616,/media/marda/TWOTB1/xBD/hurricanes/images/florence/hurricane-florence_00000196_pre_disaster.png,58,70,1,131,189,946,1016,1220,54.74950059146991,29.64232005012878
1617,/media/marda/TWOTB1/xBD/hurricanes/images/florence/hurricane-florence_00000196_pre_disaster.png,67,71,1,434,501,969,1040,1163,54.420053473877104,28.18407115987156
1618,/media/marda/TWOTB1/xBD/hurricanes/images/florence/hurricane-florence_00000196_pre_disaster.png,90,65,1,883,973,977,1042,996,54.65142549625388,26.77868163297088
1619,/media/marda/TWOTB1/xBD/hurricanes/images/florence/hurricane-florence_00000196_pre_disaster.png,52,62,1,147,199,980,1042,840,50.99342589637151,21.551008797823712
1620,/media/marda/TWOTB1/xBD/hurricanes/images/florence/hurricane-florence_00000196_pre_disaster.png,31,59,1,26,57,985,1044,439,31.847555500658764,18.62435330649359
1621,/media/marda/TWOTB1/xBD/hurricanes/images/florence/hurricane-florence_00000189_post_disaster.png,60,74,1,28,88,967,1041,1377,57.68850449415771,32.36110367049257
1622,/media/marda/TWOTB1/xBD/hurricanes/images/florence/hurricane-florence_00000189_post_disaster.png,49,58,1,231,280,563,621,973,42.15538680070053,30.60250675270512
1623,/media/marda/TWOTB1/xBD/hurricanes/images/florence/hurricane-florence_00000189_post_disaster.png,50,63,1,350,400,701,764,772,35.828784716043664,29.612784758890427
1624,/media/marda/TWOTB1/xBD/hurricanes/images/florence/hurricane-florence_00000189_post_disaster.png,44,70,1,99,143,938,1008,849,39.97758596192637,27.765303642537404
1625,/media/marda/TWOTB1/xBD/hurricanes/images/florence/hurricane-florence_00000051_pre_disaster.png,14,15,1,14,28,2,17,111,12.572614033836002,11.742979211290754
1626,/media/marda/TWOTB1/xBD/hurricanes/images/florence/hurricane-florence_00000051_pre_disaster.png,31,42,1,134,165,81,123,982,47.588300490236264,28.19417048127676
1627,/media/marda/TWOTB1/xBD/hurricanes/images/florence/hurricane-florence_00000051_pre_disaster.png,34,36,1,97,131,109,145,567,27.787159891738074,27.094501843200305
1628,/media/marda/TWOTB1/xBD/hurricanes/images/florence/hurricane-florence_00000051_pre_disaster.png,32,26,1,413,445,136,162,232,22.250566268707743,14.224179515386314
1629,/media/marda/TWOTB1/xBD/hurricanes/images/florence/hurricane-florence_00000051_pre_disaster.png,59,43,1,392,451,155,198,996,42.05832574322687,33.82413688595526
1630,/media/marda/TWOTB1/xBD/hurricanes/images/florence/hurricane-florence_00000051_pre_disaster.png,45,39,1,77,122,186,225,1035,42.55586686536912,31.674359218500264
1631,/media/marda/TWOTB1/xBD/hurricanes/images/florence/hurricane-florence_00000051_pre_disaster.png,31,18,1,441,472,197,215,144,15.248683575389759,12.564710077876667
1632,/media/marda/TWOTB1/xBD/hurricanes/images/florence/hurricane-florence_00000051_pre_disaster.png,26,17,1,466,492,201,218,56,10.20510788404465,7.500248813118349
1633,/media/marda/TWOTB1/xBD/hurricanes/images/florence/hurricane-florence_00000051_pre_disaster.png,70,53,1,387,457,253,306,1872,57.65687915778979,43.3697270221253
1634,/media/marda/TWOTB1/xBD/hurricanes/images/florence/hurricane-florence_00000051_pre_disaster.png,29,19,1,451,480,286,305,81,13.644405198860484,7.904127427727644
1635,/media/marda/TWOTB1/xBD/hurricanes/images/florence/hurricane-florence_00000051_pre_disaster.png,68,50,1,209,277,385,435,1326,63.80443581200897,27.140405554309265
1636,/media/marda/TWOTB1/xBD/hurricanes/images/florence/hurricane-florence_00000051_pre_disaster.png,37,49,1,207,244,425,474,630,32.389972520122726,25.607704755239382
1637,/media/marda/TWOTB1/xBD/hurricanes/images/florence/hurricane-florence_00000051_pre_disaster.png,61,52,1,395,456,440,492,1104,46.4640481873567,31.23333990080319
1638,/media/marda/TWOTB1/xBD/hurricanes/images/florence/hurricane-florence_00000051_pre_disaster.png,23,21,1,439,462,480,501,35,8.0,5.656854249492381
1639,/media/marda/TWOTB1/xBD/hurricanes/images/florence/hurricane-florence_00000051_pre_disaster.png,65,70,1,536,601,496,566,1464,45.74592472708635,43.190003300270455
1640,/media/marda/TWOTB1/xBD/hurricanes/images/florence/hurricane-florence_00000051_pre_disaster.png,48,56,1,407,455,561,617,624,30.695205980940685,26.98106177210991
1641,/media/marda/TWOTB1/xBD/hurricanes/images/florence/hurricane-florence_00000051_pre_disaster.png,61,57,1,518,579,580,637,872,39.69404445114043,29.027949482989243
1642,/media/marda/TWOTB1/xBD/hurricanes/images/florence/hurricane-florence_00000051_pre_disaster.png,47,67,1,378,425,913,980,575,32.74525790240168,23.09914003075438
1643,/media/marda/TWOTB1/xBD/hurricanes/images/florence/hurricane-florence_00000051_pre_disaster.png,71,89,1,463,534,952,1041,1245,60.24047156799052,27.3768642256354
1644,/media/marda/TWOTB1/xBD/hurricanes/images/florence/hurricane-florence_00000423_post_disaster.png,29,52,1,128,157,729,781,316,23.674038413892795,17.74093217069055
1645,/media/marda/TWOTB1/xBD/hurricanes/images/florence/hurricane-florence_00000423_post_disaster.png,18,42,1,141,159,753,795,102,12.503905194070558,10.826295737152016
1646,/media/marda/TWOTB1/xBD/hurricanes/images/florence/hurricane-florence_00000250_post_disaster.png,71,40,1,467,538,322,362,729,47.2922377857337,21.811448992081775
1647,/media/marda/TWOTB1/xBD/hurricanes/images/florence/hurricane-florence_00000250_post_disaster.png,35,27,1,495,530,377,404,120,13.03111714566012,12.228336279245228
1648,/media/marda/TWOTB1/xBD/hurricanes/images/florence/hurricane-florence_00000250_post_disaster.png,40,40,1,624,664,621,661,136,15.101425992941518,12.103170054463149
1649,/media/marda/TWOTB1/xBD/hurricanes/images/florence/hurricane-florence_00000250_post_disaster.png,53,56,1,555,608,648,704,561,33.32936278439593,22.312168370647015
1650,/media/marda/TWOTB1/xBD/hurricanes/images/florence/hurricane-florence_00000250_post_disaster.png,73,72,1,587,660,686,758,1089,52.09401341674768,34.15895152571917
1651,/media/marda/TWOTB1/xBD/hurricanes/images/florence/hurricane-florence_00000532_pre_disaster.png,36,33,1,89,125,323,356,635,38.09946220750834,21.761421622578492
1652,/media/marda/TWOTB1/xBD/hurricanes/images/florence/hurricane-florence_00000532_pre_disaster.png,34,32,1,34,68,334,366,471,36.720456756538795,17.478910731432055
1653,/media/marda/TWOTB1/xBD/hurricanes/images/florence/hurricane-florence_00000532_pre_disaster.png,32,34,1,32,64,363,397,529,37.033715168790074,20.94204040547828
1654,/media/marda/TWOTB1/xBD/hurricanes/images/florence/hurricane-florence_00000532_pre_disaster.png,40,33,1,79,119,382,415,565,41.34337434003408,18.269589924144373
1655,/media/marda/TWOTB1/xBD/hurricanes/images/florence/hurricane-florence_00000532_pre_disaster.png,34,44,1,40,74,419,463,797,36.16586606384423,29.01369562473598
1656,/media/marda/TWOTB1/xBD/hurricanes/images/florence/hurricane-florence_00000532_pre_disaster.png,140,72,1,491,631,662,734,3635,136.83791136608662,37.30409045035993
1657,/media/marda/TWOTB1/xBD/hurricanes/images/florence/hurricane-florence_00000532_pre_disaster.png,138,70,1,492,630,714,784,3644,134.59403489157623,37.2388817761287
1658,/media/marda/TWOTB1/xBD/hurricanes/images/florence/hurricane-florence_00000532_pre_disaster.png,34,35,1,493,527,776,811,83,15.3221521442733,7.144820716717879
1659,/media/marda/TWOTB1/xBD/hurricanes/images/florence/hurricane-florence_00000532_pre_disaster.png,138,63,1,494,632,782,845,3606,132.03578433582658,36.31696769132193
1660,/media/marda/TWOTB1/xBD/hurricanes/images/florence/hurricane-florence_00000532_pre_disaster.png,40,46,1,496,536,825,871,273,22.54891225773729,16.096077242823316
1661,/media/marda/TWOTB1/xBD/hurricanes/images/florence/hurricane-florence_00000532_pre_disaster.png,36,49,1,460,496,835,884,302,23.201635200275394,17.41246845821052
1662,/media/marda/TWOTB1/xBD/hurricanes/images/florence/hurricane-florence_00000532_pre_disaster.png,126,73,1,458,584,858,931,3321,122.85095593831855,37.13540679197707
1663,/media/marda/TWOTB1/xBD/hurricanes/images/florence/hurricane-florence_00000532_pre_disaster.png,30,44,1,459,489,915,959,83,14.293412556694726,7.6705837609765934
1664,/media/marda/TWOTB1/xBD/hurricanes/images/florence/hurricane-florence_00000532_pre_disaster.png,125,70,1,459,584,923,993,3188,120.53638044754894,35.13597576660213
1665,/media/marda/TWOTB1/xBD/hurricanes/images/florence/hurricane-florence_00000532_pre_disaster.png,24,48,1,458,482,964,1012,67,12.729364880519679,7.322277896119611
1666,/media/marda/TWOTB1/xBD/hurricanes/images/florence/hurricane-florence_00000532_pre_disaster.png,124,66,1,460,584,976,1042,2918,120.33989228316341,32.27389379074651
1667,/media/marda/TWOTB1/xBD/hurricanes/images/florence/hurricane-florence_00000187_post_disaster.png,45,37,1,504,549,451,488,331,25.12499563981039,17.646942010908912
1668,/media/marda/TWOTB1/xBD/hurricanes/images/florence/hurricane-florence_00000187_post_disaster.png,82,32,1,961,1043,461,493,506,50.50648234597668,13.401476648615636
1669,/media/marda/TWOTB1/xBD/hurricanes/images/florence/hurricane-florence_00000187_post_disaster.png,96,56,1,553,649,472,528,1907,81.73123595003213,30.89679612355479
1670,/media/marda/TWOTB1/xBD/hurricanes/images/florence/hurricane-florence_00000187_post_disaster.png,35,36,1,373,408,487,523,260,19.870479086764416,17.518457938835986
1671,/media/marda/TWOTB1/xBD/hurricanes/images/florence/hurricane-florence_00000187_post_disaster.png,64,90,1,676,740,506,596,1438,75.62811554991298,25.334489302042087
1672,/media/marda/TWOTB1/xBD/hurricanes/images/florence/hurricane-florence_00000187_post_disaster.png,53,37,1,576,629,513,550,311,35.278391330278595,11.716833027192356
1673,/media/marda/TWOTB1/xBD/hurricanes/images/florence/hurricane-florence_00000187_post_disaster.png,95,126,1,378,473,519,645,5341,111.03398177710518,64.03684017942035
1674,/media/marda/TWOTB1/xBD/hurricanes/images/florence/hurricane-florence_00000187_post_disaster.png,54,54,1,579,633,525,579,580,38.78918205234977,24.96778276422456
1675,/media/marda/TWOTB1/xBD/hurricanes/images/florence/hurricane-florence_00000187_post_disaster.png,101,56,1,942,1043,528,584,1187,74.24945107712327,21.314840776309
1676,/media/marda/TWOTB1/xBD/hurricanes/images/florence/hurricane-florence_00000187_post_disaster.png,125,144,1,243,368,539,683,8291,110.60211996649214,103.60439735720281
1677,/media/marda/TWOTB1/xBD/hurricanes/images/florence/hurricane-florence_00000187_post_disaster.png,75,81,1,465,540,542,623,2332,56.93714916778721,54.14446898900222
1678,/media/marda/TWOTB1/xBD/hurricanes/images/florence/hurricane-florence_00000187_post_disaster.png,39,32,1,588,627,556,588,106,18.359440675109518,7.745162481879835
1679,/media/marda/TWOTB1/xBD/hurricanes/images/florence/hurricane-florence_00000187_post_disaster.png,121,143,1,121,242,577,720,8279,110.39136493306852,102.90503932849046
1680,/media/marda/TWOTB1/xBD/hurricanes/images/florence/hurricane-florence_00000187_post_disaster.png,76,77,1,927,1003,597,674,1424,55.38366808356991,34.02379670363239
1681,/media/marda/TWOTB1/xBD/hurricanes/images/florence/hurricane-florence_00000187_post_disaster.png,94,61,1,649,743,610,671,1254,76.342528995454,21.793990765211348
1682,/media/marda/TWOTB1/xBD/hurricanes/images/florence/hurricane-florence_00000187_post_disaster.png,116,147,1,3,119,614,761,8119,109.52938265918418,102.02355991541582
1683,/media/marda/TWOTB1/xBD/hurricanes/images/florence/hurricane-florence_00000187_post_disaster.png,49,77,1,545,594,635,712,849,55.99442358699569,20.0201773563338
1684,/media/marda/TWOTB1/xBD/hurricanes/images/florence/hurricane-florence_00000187_post_disaster.png,66,108,1,642,708,660,768,1751,94.71330282000584,24.560394819840802
1685,/media/marda/TWOTB1/xBD/hurricanes/images/florence/hurricane-florence_00000187_post_disaster.png,95,75,1,429,524,667,742,2221,83.15667120579545,35.62681517871454
1686,/media/marda/TWOTB1/xBD/hurricanes/images/florence/hurricane-florence_00000187_post_disaster.png,58,91,1,696,754,672,763,1042,74.13759627930631,18.58599500348787
1687,/media/marda/TWOTB1/xBD/hurricanes/images/florence/hurricane-florence_00000187_post_disaster.png,65,101,1,389,454,674,775,2176,81.06991055483746,35.809236588507666
1688,/media/marda/TWOTB1/xBD/hurricanes/images/florence/hurricane-florence_00000187_post_disaster.png,65,89,1,328,393,697,786,2069,56.61631835863609,48.40091955223413
1689,/media/marda/TWOTB1/xBD/hurricanes/images/florence/hurricane-florence_00000187_post_disaster.png,50,52,1,728,778,699,751,317,22.549721639215544,18.803349717817273
1690,/media/marda/TWOTB1/xBD/hurricanes/images/florence/hurricane-florence_00000187_post_disaster.png,81,123,1,538,619,700,823,3234,103.04406424364873,41.767246218301295
1691,/media/marda/TWOTB1/xBD/hurricanes/images/florence/hurricane-florence_00000187_post_disaster.png,47,49,1,683,730,702,751,293,20.78386266835585,18.770599375498414
1692,/media/marda/TWOTB1/xBD/hurricanes/images/florence/hurricane-florence_00000187_post_disaster.png,48,42,1,624,672,712,754,172,27.04694054973663,8.528357550399093
1693,/media/marda/TWOTB1/xBD/hurricanes/images/florence/hurricane-florence_00000187_post_disaster.png,127,111,1,204,331,714,825,5746,125.40031825313189,60.79090691673488
1694,/media/marda/TWOTB1/xBD/hurricanes/images/florence/hurricane-florence_00000187_post_disaster.png,43,60,1,638,681,723,783,374,34.637780099873,14.33743961889064
1695,/media/marda/TWOTB1/xBD/hurricanes/images/florence/hurricane-florence_00000187_post_disaster.png,50,61,1,618,668,727,788,556,36.07426337486431,22.32773164994152
1696,/media/marda/TWOTB1/xBD/hurricanes/images/florence/hurricane-florence_00000187_post_disaster.png,49,55,1,488,537,742,797,360,38.88018923054886,15.887331593121589
1697,/media/marda/TWOTB1/xBD/hurricanes/images/florence/hurricane-florence_00000187_post_disaster.png,154,126,1,43,197,751,877,7590,166.4004336123511,61.51665982884613
1698,/media/marda/TWOTB1/xBD/hurricanes/images/florence/hurricane-florence_00000187_post_disaster.png,48,57,1,465,513,756,813,547,28.36075590863028,25.757633283647653
1699,/media/marda/TWOTB1/xBD/hurricanes/images/florence/hurricane-florence_00000187_post_disaster.png,66,62,1,764,830,756,818,802,33.40238854007715,31.583247958795
1700,/media/marda/TWOTB1/xBD/hurricanes/images/florence/hurricane-florence_00000187_post_disaster.png,42,55,1,523,565,765,820,386,27.218366218587462,18.80221070262595
1701,/media/marda/TWOTB1/xBD/hurricanes/images/florence/hurricane-florence_00000187_post_disaster.png,184,126,1,575,759,765,891,5135,189.005409980731,44.89043996585298
1702,/media/marda/TWOTB1/xBD/hurricanes/images/florence/hurricane-florence_00000187_post_disaster.png,27,88,1,0,27,790,878,911,58.51915979752755,20.58030215691439
1703,/media/marda/TWOTB1/xBD/hurricanes/images/florence/hurricane-florence_00000187_post_disaster.png,78,110,1,506,584,790,900,2359,81.21935676750266,39.86689200652382
1704,/media/marda/TWOTB1/xBD/hurricanes/images/florence/hurricane-florence_00000187_post_disaster.png,126,157,1,319,445,791,948,8264,111.61160105063021,101.33237100474481
1705,/media/marda/TWOTB1/xBD/hurricanes/images/florence/hurricane-florence_00000187_post_disaster.png,53,49,1,584,637,795,844,294,33.880866819464536,11.52225337601431
1706,/media/marda/TWOTB1/xBD/hurricanes/images/florence/hurricane-florence_00000187_post_disaster.png,71,105,1,457,528,811,916,2295,74.16658652684505,41.27111874568311
1707,/media/marda/TWOTB1/xBD/hurricanes/images/florence/hurricane-florence_00000187_post_disaster.png,124,155,1,198,322,830,985,8287,110.57134706493936,102.58339840442677
1708,/media/marda/TWOTB1/xBD/hurricanes/images/florence/hurricane-florence_00000187_post_disaster.png,47,52,1,651,698,830,882,281,22.364530954309053,16.811133039406943
1709,/media/marda/TWOTB1/xBD/hurricanes/images/florence/hurricane-florence_00000187_post_disaster.png,116,157,1,79,195,867,1024,8339,113.00756283211068,101.67278964233779
1710,/media/marda/TWOTB1/xBD/hurricanes/images/florence/hurricane-florence_00000187_post_disaster.png,58,59,1,545,603,868,927,580,37.17008680241874,22.59810395305478
1711,/media/marda/TWOTB1/xBD/hurricanes/images/florence/hurricane-florence_00000187_post_disaster.png,77,61,1,966,1043,980,1041,598,44.10262751469362,18.12705518313597
1712,/media/marda/TWOTB1/xBD/hurricanes/images/florence/hurricane-florence_00000389_post_disaster.png,54,34,1,989,1043,0,34,376,36.884768875538015,13.642455293262069
1713,/media/marda/TWOTB1/xBD/hurricanes/images/florence/hurricane-florence_00000389_post_disaster.png,68,46,1,726,794,11,57,1416,49.028510802579476,38.8046742764967
1714,/media/marda/TWOTB1/xBD/hurricanes/images/florence/hurricane-florence_00000389_post_disaster.png,48,10,1,933,981,12,22,75,12.663203401899144,8.031332506150656
1715,/media/marda/TWOTB1/xBD/hurricanes/images/florence/hurricane-florence_00000389_post_disaster.png,41,13,1,795,836,58,71,86,12.183453869834992,9.4644255042248
1716,/media/marda/TWOTB1/xBD/hurricanes/images/florence/hurricane-florence_00000389_post_disaster.png,64,28,1,912,976,130,158,296,29.671218122388826,13.329275378535185
1717,/media/marda/TWOTB1/xBD/hurricanes/images/florence/hurricane-florence_00000389_post_disaster.png,60,24,1,700,760,148,172,388,34.24319493963006,15.151453047048685
1718,/media/marda/TWOTB1/xBD/hurricanes/images/florence/hurricane-florence_00000389_post_disaster.png,48,23,1,931,979,166,189,186,19.536005339136214,12.621995918688514
1719,/media/marda/TWOTB1/xBD/hurricanes/images/florence/hurricane-florence_00000389_post_disaster.png,59,38,1,668,727,185,223,566,35.18700486117054,21.203743676213485
1720,/media/marda/TWOTB1/xBD/hurricanes/images/florence/hurricane-florence_00000389_post_disaster.png,92,61,1,827,919,191,252,1806,57.58305733580185,46.64849378754811
1721,/media/marda/TWOTB1/xBD/hurricanes/images/florence/hurricane-florence_00000389_post_disaster.png,70,31,1,913,983,197,228,635,34.487060050590685,24.20489583897313
1722,/media/marda/TWOTB1/xBD/hurricanes/images/florence/hurricane-florence_00000389_post_disaster.png,39,24,1,654,693,212,236,128,15.019355330788803,11.387228172277307
1723,/media/marda/TWOTB1/xBD/hurricanes/images/florence/hurricane-florence_00000389_post_disaster.png,71,41,1,687,758,227,268,935,47.75468502917329,26.181066968468965
1724,/media/marda/TWOTB1/xBD/hurricanes/images/florence/hurricane-florence_00000389_post_disaster.png,64,54,1,208,272,295,349,1535,59.365182392185986,34.48786847248472
1725,/media/marda/TWOTB1/xBD/hurricanes/images/florence/hurricane-florence_00000389_post_disaster.png,36,42,1,139,175,316,358,694,34.56213968153522,26.54561212452872
1726,/media/marda/TWOTB1/xBD/hurricanes/images/florence/hurricane-florence_00000389_post_disaster.png,42,49,1,432,474,333,382,594,38.01374651947878,20.890590843945457
1727,/media/marda/TWOTB1/xBD/hurricanes/images/florence/hurricane-florence_00000389_post_disaster.png,40,25,1,490,530,339,364,156,23.90521981270403,8.742877192534428
1728,/media/marda/TWOTB1/xBD/hurricanes/images/florence/hurricane-florence_00000389_post_disaster.png,34,24,1,490,524,354,378,84,13.557637102737477,8.33809387832792
1729,/media/marda/TWOTB1/xBD/hurricanes/images/florence/hurricane-florence_00000389_post_disaster.png,56,51,1,162,218,363,414,1265,51.11418911727809,33.85783749165441
1730,/media/marda/TWOTB1/xBD/hurricanes/images/florence/hurricane-florence_00000389_post_disaster.png,62,54,1,475,537,375,429,1161,42.63088763284068,38.20131368991504
1731,/media/marda/TWOTB1/xBD/hurricanes/images/florence/hurricane-florence_00000389_post_disaster.png,33,28,1,243,276,385,413,257,26.668616025532287,12.805164969687025
1732,/media/marda/TWOTB1/xBD/hurricanes/images/florence/hurricane-florence_00000389_post_disaster.png,32,69,1,274,306,572,641,726,53.95780874801451,17.831107781025704
1733,/media/marda/TWOTB1/xBD/hurricanes/images/florence/hurricane-florence_00000389_post_disaster.png,31,75,1,210,241,584,659,753,62.95205703526775,15.828855640517919
1734,/media/marda/TWOTB1/xBD/hurricanes/images/florence/hurricane-florence_00000389_post_disaster.png,42,74,1,288,330,647,721,800,57.02384366784995,21.020274221441756
1735,/media/marda/TWOTB1/xBD/hurricanes/images/florence/hurricane-florence_00000389_post_disaster.png,31,74,1,223,254,661,735,752,55.45973727965737,18.613822494613284
1736,/media/marda/TWOTB1/xBD/hurricanes/images/florence/hurricane-florence_00000389_post_disaster.png,16,34,1,197,213,671,705,58,9.772922914889326,8.115989652806284
1737,/media/marda/TWOTB1/xBD/hurricanes/images/florence/hurricane-florence_00000389_post_disaster.png,31,77,1,11,42,935,1012,1028,43.13485135876692,31.049497345586595
1738,/media/marda/TWOTB1/xBD/hurricanes/images/florence/hurricane-florence_00000318_post_disaster.png,48,9,1,877,925,0,9,75,12.626808678328057,8.084562266773856
1739,/media/marda/TWOTB1/xBD/hurricanes/images/florence/hurricane-florence_00000318_post_disaster.png,70,13,1,912,982,0,13,226,30.65887055712172,11.354964316260743
1740,/media/marda/TWOTB1/xBD/hurricanes/images/florence/hurricane-florence_00000318_post_disaster.png,58,22,1,939,997,0,22,226,26.627132182167397,11.353543524236708
1741,/media/marda/TWOTB1/xBD/hurricanes/images/florence/hurricane-florence_00000318_post_disaster.png,53,15,1,886,939,17,32,141,16.00304718303215,11.63074990875532
1742,/media/marda/TWOTB1/xBD/hurricanes/images/florence/hurricane-florence_00000318_post_disaster.png,62,34,1,856,918,101,135,413,28.53935036306481,19.79945837165386
1743,/media/marda/TWOTB1/xBD/hurricanes/images/florence/hurricane-florence_00000318_post_disaster.png,52,19,1,888,940,127,146,118,13.33345046682098,11.911343987895908
1744,/media/marda/TWOTB1/xBD/hurricanes/images/florence/hurricane-florence_00000318_post_disaster.png,47,19,1,848,895,155,174,118,13.294496451916368,11.911087385271678
1745,/media/marda/TWOTB1/xBD/hurricanes/images/florence/hurricane-florence_00000318_post_disaster.png,50,29,1,804,854,190,219,329,26.519458283190474,17.06563721504965
1746,/media/marda/TWOTB1/xBD/hurricanes/images/florence/hurricane-florence_00000318_post_disaster.png,79,61,1,903,982,361,422,1152,47.99267246893328,31.825489742850085
1747,/media/marda/TWOTB1/xBD/hurricanes/images/florence/hurricane-florence_00000318_post_disaster.png,67,44,1,948,1015,386,430,518,29.09801023910814,23.785252417352865
1748,/media/marda/TWOTB1/xBD/hurricanes/images/florence/hurricane-florence_00000318_post_disaster.png,84,69,1,735,819,414,483,1660,55.66923582906444,42.21764165411986
1749,/media/marda/TWOTB1/xBD/hurricanes/images/florence/hurricane-florence_00000318_post_disaster.png,57,41,1,710,767,451,492,451,28.566163469078063,20.908797643533998
1750,/media/marda/TWOTB1/xBD/hurricanes/images/florence/hurricane-florence_00000318_post_disaster.png,41,40,1,673,714,606,646,202,17.033499760104316,15.62288612124361
1751,/media/marda/TWOTB1/xBD/hurricanes/images/florence/hurricane-florence_00000318_post_disaster.png,45,60,1,706,751,613,673,510,41.04884130843044,16.571156825600298
1752,/media/marda/TWOTB1/xBD/hurricanes/images/florence/hurricane-florence_00000318_post_disaster.png,90,61,1,954,1044,670,731,1126,55.82908452022812,27.374758293382992
1753,/media/marda/TWOTB1/xBD/hurricanes/images/florence/hurricane-florence_00000318_post_disaster.png,46,56,1,702,748,682,738,467,34.5414455816673,18.043817413286376
1754,/media/marda/TWOTB1/xBD/hurricanes/images/florence/hurricane-florence_00000318_post_disaster.png,47,59,1,741,788,683,742,487,40.141686684364345,16.238494177348755
1755,/media/marda/TWOTB1/xBD/hurricanes/images/florence/hurricane-florence_00000318_post_disaster.png,56,48,1,695,751,738,786,487,31.29718479049701,20.49742321031242
1756,/media/marda/TWOTB1/xBD/hurricanes/images/florence/hurricane-florence_00000318_post_disaster.png,48,61,1,733,781,742,803,467,36.37470703455283,17.337385010202393
1757,/media/marda/TWOTB1/xBD/hurricanes/images/florence/hurricane-florence_00000318_post_disaster.png,43,62,1,543,586,791,853,517,32.514494229671655,21.810835111567375
1758,/media/marda/TWOTB1/xBD/hurricanes/images/florence/hurricane-florence_00000318_post_disaster.png,73,47,1,573,646,794,841,625,57.824609441657266,14.319190531583887
1759,/media/marda/TWOTB1/xBD/hurricanes/images/florence/hurricane-florence_00000318_post_disaster.png,69,74,1,891,960,825,899,650,44.17276084504773,19.651704156365053
1760,/media/marda/TWOTB1/xBD/hurricanes/images/florence/hurricane-florence_00000318_post_disaster.png,57,87,1,658,715,863,950,1309,59.7105302911781,29.726886634171766
1761,/media/marda/TWOTB1/xBD/hurricanes/images/florence/hurricane-florence_00000318_post_disaster.png,81,53,1,917,998,54,107,1200,54.19701921269556,29.357495685142393
1762,/media/marda/TWOTB1/xBD/hurricanes/images/florence/hurricane-florence_00000318_post_disaster.png,77,40,1,906,983,148,188,916,44.27489178781147,26.948091628608164
1763,/media/marda/TWOTB1/xBD/hurricanes/images/florence/hurricane-florence_00000318_post_disaster.png,82,64,1,858,940,192,256,1444,57.22150561975359,38.02600104727055
1764,/media/marda/TWOTB1/xBD/hurricanes/images/florence/hurricane-florence_00000254_post_disaster.png,69,35,1,237,306,178,213,1517,62.634677006986735,31.97527677173672
1765,/media/marda/TWOTB1/xBD/hurricanes/images/florence/hurricane-florence_00000254_post_disaster.png,48,48,1,393,441,236,284,946,43.41734869427233,30.488224784299657
1766,/media/marda/TWOTB1/xBD/hurricanes/images/florence/hurricane-florence_00000254_post_disaster.png,39,61,1,362,401,253,314,1404,61.19912853410033,30.58321979997092
1767,/media/marda/TWOTB1/xBD/hurricanes/images/florence/hurricane-florence_00000254_post_disaster.png,29,32,1,404,433,276,308,246,25.725342007454564,12.81368481104838
1768,/media/marda/TWOTB1/xBD/hurricanes/images/florence/hurricane-florence_00000254_post_disaster.png,34,28,1,433,467,427,455,210,20.239943839241917,13.780165917145592
1769,/media/marda/TWOTB1/xBD/hurricanes/images/florence/hurricane-florence_00000254_post_disaster.png,63,57,1,901,964,445,502,921,44.186446500033725,27.839124353372558
1770,/media/marda/TWOTB1/xBD/hurricanes/images/florence/hurricane-florence_00000254_post_disaster.png,39,76,1,219,258,455,531,1574,66.08738247447555,31.79616262313599
1771,/media/marda/TWOTB1/xBD/hurricanes/images/florence/hurricane-florence_00000254_post_disaster.png,42,71,1,427,469,732,803,877,47.211685009457085,24.820030399649404
1772,/media/marda/TWOTB1/xBD/hurricanes/images/florence/hurricane-florence_00000254_post_disaster.png,29,43,1,468,497,756,799,147,15.694209446802125,12.584596217151764
1773,/media/marda/TWOTB1/xBD/hurricanes/images/florence/hurricane-florence_00000254_post_disaster.png,38,49,1,505,543,873,922,237,18.956758024812146,16.784985454174436
1774,/media/marda/TWOTB1/xBD/hurricanes/images/florence/hurricane-florence_00000254_post_disaster.png,42,71,1,443,485,882,953,700,36.40914236116571,25.533353646607715
1775,/media/marda/TWOTB1/xBD/hurricanes/images/florence/hurricane-florence_00000254_post_disaster.png,40,53,1,490,530,899,952,253,20.414384611469487,16.62968449898472
1776,/media/marda/TWOTB1/xBD/hurricanes/images/florence/hurricane-florence_00000254_post_disaster.png,22,47,1,249,271,960,1007,148,15.603581731572659,12.606685897975245
1777,/media/marda/TWOTB1/xBD/hurricanes/images/florence/hurricane-florence_00000254_post_disaster.png,24,55,1,223,247,963,1018,266,19.77685451340791,18.011196221506058
1778,/media/marda/TWOTB1/xBD/hurricanes/images/florence/hurricane-florence_00000254_post_disaster.png,19,52,1,211,230,965,1017,176,18.439088914585774,12.649110640673518
1779,/media/marda/TWOTB1/xBD/hurricanes/images/florence/hurricane-florence_00000254_post_disaster.png,53,61,1,514,567,972,1033,660,36.13312974265601,24.13438391347185
1780,/media/marda/TWOTB1/xBD/hurricanes/images/florence/hurricane-florence_00000254_post_disaster.png,25,54,1,289,314,980,1034,210,17.281975195754296,16.1245154965971
1781,/media/marda/TWOTB1/xBD/hurricanes/images/florence/hurricane-florence_00000254_post_disaster.png,25,62,1,324,349,981,1043,258,25.119816811659614,13.658858684354524
1782,/media/marda/TWOTB1/xBD/hurricanes/images/florence/hurricane-florence_00000254_post_disaster.png,22,46,1,293,315,997,1043,69,13.31437433395124,6.806185383374609
1783,/media/marda/TWOTB1/xBD/hurricanes/images/florence/hurricane-florence_00000254_post_disaster.png,44,61,1,395,439,446,507,1019,47.5740517378275,28.341137740870845
1784,/media/marda/TWOTB1/xBD/hurricanes/images/florence/hurricane-florence_00000254_post_disaster.png,44,77,1,455,499,964,1041,940,45.149317549420815,27.527687586370142
1785,/media/marda/TWOTB1/xBD/hurricanes/images/florence/hurricane-florence_00000122_pre_disaster.png,82,23,1,951,1033,0,23,847,48.4790610374746,23.41564271891041
1786,/media/marda/TWOTB1/xBD/hurricanes/images/florence/hurricane-florence_00000122_pre_disaster.png,37,18,1,182,219,17,35,529,34.35461001981567,20.303872700433136
1787,/media/marda/TWOTB1/xBD/hurricanes/images/florence/hurricane-florence_00000122_pre_disaster.png,302,714,1,400,702,175,889,183623,817.953419408785,305.49078052523583
1788,/media/marda/TWOTB1/xBD/hurricanes/images/florence/hurricane-florence_00000019_pre_disaster.png,65,78,1,519,584,0,78,745,95.91991925914446,10.349958502625338
1789,/media/marda/TWOTB1/xBD/hurricanes/images/florence/hurricane-florence_00000019_pre_disaster.png,106,76,1,574,680,0,76,1854,111.01642142618877,22.197090101137576
1790,/media/marda/TWOTB1/xBD/hurricanes/images/florence/hurricane-florence_00000019_pre_disaster.png,102,61,1,601,703,0,61,1509,93.059561106054,21.761344361247307
1791,/media/marda/TWOTB1/xBD/hurricanes/images/florence/hurricane-florence_00000019_pre_disaster.png,80,37,1,637,717,0,37,847,55.715554848105754,20.54986916386318
1792,/media/marda/TWOTB1/xBD/hurricanes/images/florence/hurricane-florence_00000019_pre_disaster.png,241,127,1,659,900,0,127,11349,225.90229081283,85.60548467270432
1793,/media/marda/TWOTB1/xBD/hurricanes/images/florence/hurricane-florence_00000019_pre_disaster.png,106,80,1,561,667,17,97,1763,113.11951083682567,20.793279438251744
1794,/media/marda/TWOTB1/xBD/hurricanes/images/florence/hurricane-florence_00000019_pre_disaster.png,104,79,1,546,650,42,121,2270,101.71275002049497,29.768816503730264
1795,/media/marda/TWOTB1/xBD/hurricanes/images/florence/hurricane-florence_00000019_pre_disaster.png,97,71,1,531,628,72,143,1996,89.48497219782618,29.752142387683254
1796,/media/marda/TWOTB1/xBD/hurricanes/images/florence/hurricane-florence_00000019_pre_disaster.png,68,118,1,477,545,83,201,1362,135.720349155388,33.011503301300316
1797,/media/marda/TWOTB1/xBD/hurricanes/images/florence/hurricane-florence_00000019_pre_disaster.png,240,203,1,554,794,95,298,13052,274.2742921371976,68.65023815748751
1798,/media/marda/TWOTB1/xBD/hurricanes/images/florence/hurricane-florence_00000019_pre_disaster.png,82,65,1,521,603,100,165,1295,78.33243229933699,22.040372159524225
1799,/media/marda/TWOTB1/xBD/hurricanes/images/florence/hurricane-florence_00000019_pre_disaster.png,45,54,1,0,45,109,163,1577,48.559670394927295,43.15527332441762
1800,/media/marda/TWOTB1/xBD/hurricanes/images/florence/hurricane-florence_00000019_pre_disaster.png,77,58,1,507,584,125,183,1088,69.85043178075749,20.78709913853727
1801,/media/marda/TWOTB1/xBD/hurricanes/images/florence/hurricane-florence_00000019_pre_disaster.png,72,53,1,494,566,149,202,947,62.13423955055796,20.33809937702969
1802,/media/marda/TWOTB1/xBD/hurricanes/images/florence/hurricane-florence_00000019_pre_disaster.png,55,37,1,989,1044,250,287,225,24.440403706431148,14.12634348467124
1803,/media/marda/TWOTB1/xBD/hurricanes/images/florence/hurricane-florence_00000019_pre_disaster.png,155,168,1,460,615,251,419,9740,164.93006576139064,80.40255194581773
1804,/media/marda/TWOTB1/xBD/hurricanes/images/florence/hurricane-florence_00000019_pre_disaster.png,73,45,1,971,1044,270,315,681,36.56934086016797,24.59853698546239
1805,/media/marda/TWOTB1/xBD/hurricanes/images/florence/hurricane-florence_00000019_pre_disaster.png,76,45,1,951,1027,290,335,693,36.6383663043641,25.158270143756752
1806,/media/marda/TWOTB1/xBD/hurricanes/images/florence/hurricane-florence_00000019_pre_disaster.png,73,48,1,932,1005,309,357,644,35.153998147727364,24.450687663205255
1807,/media/marda/TWOTB1/xBD/hurricanes/images/florence/hurricane-florence_00000019_pre_disaster.png,73,49,1,912,985,329,378,648,37.17309382605319,23.282394089718654
1808,/media/marda/TWOTB1/xBD/hurricanes/images/florence/hurricane-florence_00000019_pre_disaster.png,73,50,1,893,966,348,398,711,38.12431775533789,24.757444173529176
1809,/media/marda/TWOTB1/xBD/hurricanes/images/florence/hurricane-florence_00000019_pre_disaster.png,74,51,1,875,949,367,418,760,37.66713437362238,26.92440493079204
1810,/media/marda/TWOTB1/xBD/hurricanes/images/florence/hurricane-florence_00000019_pre_disaster.png,70,44,1,955,1025,370,414,484,32.271633561267386,20.034149778551495
1811,/media/marda/TWOTB1/xBD/hurricanes/images/florence/hurricane-florence_00000019_pre_disaster.png,68,46,1,976,1044,388,434,552,37.305445478233615,19.49235813967341
1812,/media/marda/TWOTB1/xBD/hurricanes/images/florence/hurricane-florence_00000019_pre_disaster.png,73,54,1,927,1000,395,449,648,39.25661882881903,22.025896130487713
1813,/media/marda/TWOTB1/xBD/hurricanes/images/florence/hurricane-florence_00000019_pre_disaster.png,69,51,1,846,915,400,451,613,36.51968785448374,22.416623208207053
1814,/media/marda/TWOTB1/xBD/hurricanes/images/florence/hurricane-florence_00000019_pre_disaster.png,52,37,1,992,1044,413,450,132,18.26927043091055,11.080495292197947
1815,/media/marda/TWOTB1/xBD/hurricanes/images/florence/hurricane-florence_00000019_pre_disaster.png,121,124,1,351,472,414,538,5402,112.3426339525273,64.08404879433999
1816,/media/marda/TWOTB1/xBD/hurricanes/images/florence/hurricane-florence_00000019_pre_disaster.png,73,51,1,949,1022,415,466,564,36.7862670126166,20.47758523007702
1817,/media/marda/TWOTB1/xBD/hurricanes/images/florence/hurricane-florence_00000019_pre_disaster.png,71,53,1,825,896,419,472,678,38.950762382878516,23.241906141494425
1818,/media/marda/TWOTB1/xBD/hurricanes/images/florence/hurricane-florence_00000019_pre_disaster.png,74,52,1,966,1040,432,484,598,37.565649709789625,21.253416229267657
1819,/media/marda/TWOTB1/xBD/hurricanes/images/florence/hurricane-florence_00000019_pre_disaster.png,72,54,1,807,879,441,495,692,41.86097742566444,22.052608201879075
1820,/media/marda/TWOTB1/xBD/hurricanes/images/florence/hurricane-florence_00000019_pre_disaster.png,65,48,1,878,943,454,502,479,30.695893721966623,20.80885091661423
1821,/media/marda/TWOTB1/xBD/hurricanes/images/florence/hurricane-florence_00000019_pre_disaster.png,70,49,1,783,853,466,515,645,41.59028627991924,20.754810807243615
1822,/media/marda/TWOTB1/xBD/hurricanes/images/florence/hurricane-florence_00000019_pre_disaster.png,70,51,1,894,964,467,518,545,36.37892143628053,19.99565971475286
1823,/media/marda/TWOTB1/xBD/hurricanes/images/florence/hurricane-florence_00000019_pre_disaster.png,70,50,1,848,918,479,529,570,35.99338753876698,21.160678134175402
1824,/media/marda/TWOTB1/xBD/hurricanes/images/florence/hurricane-florence_00000019_pre_disaster.png,72,50,1,913,985,488,538,561,36.69510172415932,20.44848321108036
1825,/media/marda/TWOTB1/xBD/hurricanes/images/florence/hurricane-florence_00000019_pre_disaster.png,69,53,1,870,939,498,551,536,35.24070688309272,20.315315332445778
1826,/media/marda/TWOTB1/xBD/hurricanes/images/florence/hurricane-florence_00000019_pre_disaster.png,72,54,1,935,1007,505,559,574,35.513431983332325,21.59039207654874
1827,/media/marda/TWOTB1/xBD/hurricanes/images/florence/hurricane-florence_00000019_pre_disaster.png,67,46,1,785,852,506,552,524,37.84803837019732,18.4911268628958
1828,/media/marda/TWOTB1/xBD/hurricanes/images/florence/hurricane-florence_00000019_pre_disaster.png,71,54,1,888,959,516,570,550,35.92190767480629,20.443496496506974
1829,/media/marda/TWOTB1/xBD/hurricanes/images/florence/hurricane-florence_00000019_pre_disaster.png,73,53,1,957,1030,525,578,556,35.58166335507226,20.736886681978966
1830,/media/marda/TWOTB1/xBD/hurricanes/images/florence/hurricane-florence_00000019_pre_disaster.png,66,53,1,803,869,529,582,557,35.830174024912836,20.57453421276784
1831,/media/marda/TWOTB1/xBD/hurricanes/images/florence/hurricane-florence_00000019_pre_disaster.png,70,53,1,908,978,535,588,534,35.7498597123711,19.828028585142736
1832,/media/marda/TWOTB1/xBD/hurricanes/images/florence/hurricane-florence_00000019_pre_disaster.png,67,55,1,977,1044,542,597,525,36.24110527830918,19.221487143951816
1833,/media/marda/TWOTB1/xBD/hurricanes/images/florence/hurricane-florence_00000019_pre_disaster.png,68,55,1,821,889,546,601,574,37.547889403520855,20.44735384080518
1834,/media/marda/TWOTB1/xBD/hurricanes/images/florence/hurricane-florence_00000019_pre_disaster.png,71,54,1,928,999,554,608,549,35.918293020777746,20.44613835485032
1835,/media/marda/TWOTB1/xBD/hurricanes/images/florence/hurricane-florence_00000019_pre_disaster.png,86,81,1,707,793,564,645,1866,51.249435742219916,48.60981274493786
1836,/media/marda/TWOTB1/xBD/hurricanes/images/florence/hurricane-florence_00000019_pre_disaster.png,68,55,1,842,910,565,620,589,36.348283132329016,21.635351336684483
1837,/media/marda/TWOTB1/xBD/hurricanes/images/florence/hurricane-florence_00000019_pre_disaster.png,73,55,1,948,1021,572,627,557,37.187720773940555,20.002416993953123
1838,/media/marda/TWOTB1/xBD/hurricanes/images/florence/hurricane-florence_00000019_pre_disaster.png,49,36,1,995,1044,575,611,77,14.153434665753508,8.264970395340278
1839,/media/marda/TWOTB1/xBD/hurricanes/images/florence/hurricane-florence_00000019_pre_disaster.png,64,58,1,792,856,576,634,639,34.904201222080545,24.36253699523072
1840,/media/marda/TWOTB1/xBD/hurricanes/images/florence/hurricane-florence_00000019_pre_disaster.png,71,56,1,862,933,583,639,615,37.993878319081944,21.61911976081417
1841,/media/marda/TWOTB1/xBD/hurricanes/images/florence/hurricane-florence_00000019_pre_disaster.png,74,59,1,967,1041,589,648,601,36.975162456745934,21.625536312498053
1842,/media/marda/TWOTB1/xBD/hurricanes/images/florence/hurricane-florence_00000019_pre_disaster.png,74,60,1,809,883,599,659,805,42.30252000006235,25.073660392635645
1843,/media/marda/TWOTB1/xBD/hurricanes/images/florence/hurricane-florence_00000019_pre_disaster.png,68,56,1,884,952,602,658,472,33.43336164602075,18.865388262424073
1844,/media/marda/TWOTB1/xBD/hurricanes/images/florence/hurricane-florence_00000019_pre_disaster.png,86,79,1,673,759,603,682,1533,55.51993212446881,39.27185822415964
1845,/media/marda/TWOTB1/xBD/hurricanes/images/florence/hurricane-florence_00000019_pre_disaster.png,73,59,1,830,903,619,678,706,38.92288981643758,24.208792174337276
1846,/media/marda/TWOTB1/xBD/hurricanes/images/florence/hurricane-florence_00000019_pre_disaster.png,69,57,1,905,974,621,678,509,33.8892521003538,20.040628673286726
1847,/media/marda/TWOTB1/xBD/hurricanes/images/florence/hurricane-florence_00000019_pre_disaster.png,67,60,1,756,823,636,696,633,36.478240455597565,23.19050556156066
1848,/media/marda/TWOTB1/xBD/hurricanes/images/florence/hurricane-florence_00000019_pre_disaster.png,75,62,1,848,923,636,698,728,40.58084430337056,23.965902854017582
1849,/media/marda/TWOTB1/xBD/hurricanes/images/florence/hurricane-florence_00000019_pre_disaster.png,72,59,1,922,994,637,696,617,33.06829203026735,24.918632189304592
1850,/media/marda/TWOTB1/xBD/hurricanes/images/florence/hurricane-florence_00000019_pre_disaster.png,62,56,1,654,716,644,700,574,35.016368299256776,21.597530016848054
1851,/media/marda/TWOTB1/xBD/hurricanes/images/florence/hurricane-florence_00000019_pre_disaster.png,57,56,1,987,1044,645,701,355,31.88209486888419,15.62778508060196
1852,/media/marda/TWOTB1/xBD/hurricanes/images/florence/hurricane-florence_00000019_pre_disaster.png,76,66,1,866,942,653,719,855,40.5165260806899,28.162145941547468
1853,/media/marda/TWOTB1/xBD/hurricanes/images/florence/hurricane-florence_00000019_pre_disaster.png,66,58,1,734,800,657,715,624,37.512614325351,22.058740596290463
1854,/media/marda/TWOTB1/xBD/hurricanes/images/florence/hurricane-florence_00000019_pre_disaster.png,67,57,1,954,1021,660,717,534,30.700613799078514,23.264949200943956
1855,/media/marda/TWOTB1/xBD/hurricanes/images/florence/hurricane-florence_00000019_pre_disaster.png,68,59,1,794,862,662,721,567,38.59881195316054,19.552027199111958
1856,/media/marda/TWOTB1/xBD/hurricanes/images/florence/hurricane-florence_00000019_pre_disaster.png,55,55,1,637,692,663,718,463,30.25271063339732,20.43708837167068
1857,/media/marda/TWOTB1/xBD/hurricanes/images/florence/hurricane-florence_00000019_pre_disaster.png,63,59,1,716,779,677,736,572,35.943743026038526,21.260291625469296
1858,/media/marda/TWOTB1/xBD/hurricanes/images/florence/hurricane-florence_00000019_pre_disaster.png,64,59,1,777,841,681,740,550,35.97975142012253,20.427547276807136
1859,/media/marda/TWOTB1/xBD/hurricanes/images/florence/hurricane-florence_00000019_pre_disaster.png,63,59,1,616,679,686,745,642,38.907124341703636,22.041131885483196
1860,/media/marda/TWOTB1/xBD/hurricanes/images/florence/hurricane-florence_00000019_pre_disaster.png,82,68,1,899,981,691,759,893,46.126065281495165,25.63713041903441
1861,/media/marda/TWOTB1/xBD/hurricanes/images/florence/hurricane-florence_00000019_pre_disaster.png,63,62,1,698,761,694,756,549,35.92552006317586,20.42870314180425
1862,/media/marda/TWOTB1/xBD/hurricanes/images/florence/hurricane-florence_00000019_pre_disaster.png,60,57,1,759,819,699,756,437,29.294775565284205,19.787481019217378
1863,/media/marda/TWOTB1/xBD/hurricanes/images/florence/hurricane-florence_00000019_pre_disaster.png,74,63,1,821,895,708,771,714,42.53086329747448,22.249352997774334
1864,/media/marda/TWOTB1/xBD/hurricanes/images/florence/hurricane-florence_00000019_pre_disaster.png,63,60,1,741,804,718,778,533,36.23331043461241,19.515050046196677
1865,/media/marda/TWOTB1/xBD/hurricanes/images/florence/hurricane-florence_00000019_pre_disaster.png,60,56,1,599,659,719,775,666,36.28229194626269,24.01645793726989
1866,/media/marda/TWOTB1/xBD/hurricanes/images/florence/hurricane-florence_00000019_pre_disaster.png,59,59,1,683,742,719,778,513,30.78489623027208,22.13090417832699
1867,/media/marda/TWOTB1/xBD/hurricanes/images/florence/hurricane-florence_00000019_pre_disaster.png,73,69,1,715,788,729,798,690,43.36520827246044,26.473331467987915
1868,/media/marda/TWOTB1/xBD/hurricanes/images/florence/hurricane-florence_00000019_pre_disaster.png,67,69,1,842,909,736,805,903,38.992881847755896,30.95110816034151
1869,/media/marda/TWOTB1/xBD/hurricanes/images/florence/hurricane-florence_00000019_pre_disaster.png,73,61,1,800,873,737,798,742,35.052219169249405,28.019769982661234
1870,/media/marda/TWOTB1/xBD/hurricanes/images/florence/hurricane-florence_00000019_pre_disaster.png,60,56,1,667,727,745,801,490,31.826020674013524,20.429084008997684
1871,/media/marda/TWOTB1/xBD/hurricanes/images/florence/hurricane-florence_00000019_pre_disaster.png,58,49,1,587,645,754,803,573,38.66874760481977,19.99924905800059
1872,/media/marda/TWOTB1/xBD/hurricanes/images/florence/hurricane-florence_00000019_pre_disaster.png,70,60,1,785,855,758,818,649,36.936846822659575,23.39771830662927
1873,/media/marda/TWOTB1/xBD/hurricanes/images/florence/hurricane-florence_00000019_pre_disaster.png,60,52,1,707,767,763,815,403,30.16514449476377,17.73628769403257
1874,/media/marda/TWOTB1/xBD/hurricanes/images/florence/hurricane-florence_00000019_pre_disaster.png,76,61,1,821,897,771,832,924,44.706065631182454,27.000045328717903
1875,/media/marda/TWOTB1/xBD/hurricanes/images/florence/hurricane-florence_00000019_pre_disaster.png,66,57,1,653,719,772,829,759,41.458555795389344,25.296184651734823
1876,/media/marda/TWOTB1/xBD/hurricanes/images/florence/hurricane-florence_00000019_pre_disaster.png,72,60,1,769,841,779,839,760,43.94272104203461,22.850256460935302
1877,/media/marda/TWOTB1/xBD/hurricanes/images/florence/hurricane-florence_00000019_pre_disaster.png,54,50,1,588,642,781,831,510,31.443470113630177,21.354147456354173
1878,/media/marda/TWOTB1/xBD/hurricanes/images/florence/hurricane-florence_00000019_pre_disaster.png,80,65,1,883,963,785,850,984,47.37922835632676,27.058017476468724
1879,/media/marda/TWOTB1/xBD/hurricanes/images/florence/hurricane-florence_00000019_pre_disaster.png,66,58,1,695,761,789,847,616,39.170620810442514,20.828499832697403
1880,/media/marda/TWOTB1/xBD/hurricanes/images/florence/hurricane-florence_00000019_pre_disaster.png,78,64,1,807,885,795,859,865,45.59307950465398,24.93876556304285
1881,/media/marda/TWOTB1/xBD/hurricanes/images/florence/hurricane-florence_00000019_pre_disaster.png,59,58,1,650,709,800,858,672,38.296427811480804,23.44461377515058
1882,/media/marda/TWOTB1/xBD/hurricanes/images/florence/hurricane-florence_00000019_pre_disaster.png,63,51,1,362,425,804,855,674,55.13079378675917,16.341647722866178
1883,/media/marda/TWOTB1/xBD/hurricanes/images/florence/hurricane-florence_00000019_pre_disaster.png,70,63,1,761,831,806,869,784,40.14465967423949,25.819588911674273
1884,/media/marda/TWOTB1/xBD/hurricanes/images/florence/hurricane-florence_00000019_pre_disaster.png,59,56,1,581,640,808,864,687,40.774971407659265,22.200669227238656
1885,/media/marda/TWOTB1/xBD/hurricanes/images/florence/hurricane-florence_00000019_pre_disaster.png,39,41,1,688,727,808,849,77,11.479247226196284,8.992540057949334
1886,/media/marda/TWOTB1/xBD/hurricanes/images/florence/hurricane-florence_00000019_pre_disaster.png,79,66,1,873,952,812,878,964,45.22566034334603,27.73645091453396
1887,/media/marda/TWOTB1/xBD/hurricanes/images/florence/hurricane-florence_00000019_pre_disaster.png,64,68,1,695,759,818,886,985,39.82562337959652,32.669373325898896
1888,/media/marda/TWOTB1/xBD/hurricanes/images/florence/hurricane-florence_00000019_pre_disaster.png,75,65,1,799,874,820,885,844,44.63560759962622,24.871448509472536
1889,/media/marda/TWOTB1/xBD/hurricanes/images/florence/hurricane-florence_00000019_pre_disaster.png,56,52,1,650,706,829,881,423,32.37141412606572,17.488533476252275
1890,/media/marda/TWOTB1/xBD/hurricanes/images/florence/hurricane-florence_00000019_pre_disaster.png,114,84,1,752,866,831,915,1926,98.56182621720386,28.415520786139993
1891,/media/marda/TWOTB1/xBD/hurricanes/images/florence/hurricane-florence_00000019_pre_disaster.png,61,56,1,578,639,835,891,642,41.533745701713066,20.551227279757107
1892,/media/marda/TWOTB1/xBD/hurricanes/images/florence/hurricane-florence_00000019_pre_disaster.png,82,67,1,861,943,838,905,1066,49.90185780098848,27.929463638464036
1893,/media/marda/TWOTB1/xBD/hurricanes/images/florence/hurricane-florence_00000019_pre_disaster.png,64,53,1,687,751,848,901,467,38.027766747479006,16.392006115453515
1894,/media/marda/TWOTB1/xBD/hurricanes/images/florence/hurricane-florence_00000019_pre_disaster.png,53,51,1,647,700,861,912,415,31.484109490540437,17.623990806262828
1895,/media/marda/TWOTB1/xBD/hurricanes/images/florence/hurricane-florence_00000019_pre_disaster.png,62,56,1,574,636,862,918,705,42.7086943306304,22.20513383853053
1896,/media/marda/TWOTB1/xBD/hurricanes/images/florence/hurricane-florence_00000019_pre_disaster.png,75,64,1,856,931,865,929,768,41.24875413940965,24.863767787952046
1897,/media/marda/TWOTB1/xBD/hurricanes/images/florence/hurricane-florence_00000019_pre_disaster.png,65,56,1,345,410,873,929,1052,57.85829700018405,24.309608679106844
1898,/media/marda/TWOTB1/xBD/hurricanes/images/florence/hurricane-florence_00000019_pre_disaster.png,53,53,1,687,740,875,928,373,26.612130854886118,18.767401710218103
1899,/media/marda/TWOTB1/xBD/hurricanes/images/florence/hurricane-florence_00000019_pre_disaster.png,76,63,1,785,861,877,940,919,46.76659682646478,26.077940669284978
1900,/media/marda/TWOTB1/xBD/hurricanes/images/florence/hurricane-florence_00000019_pre_disaster.png,67,86,1,564,631,885,971,1596,54.341637717474136,42.1791190100178
1901,/media/marda/TWOTB1/xBD/hurricanes/images/florence/hurricane-florence_00000019_pre_disaster.png,52,55,1,643,695,887,942,442,31.588198044573666,18.595308730736832
1902,/media/marda/TWOTB1/xBD/hurricanes/images/florence/hurricane-florence_00000019_pre_disaster.png,77,66,1,847,924,890,956,829,42.52130206315368,25.64660423686403
1903,/media/marda/TWOTB1/xBD/hurricanes/images/florence/hurricane-florence_00000019_pre_disaster.png,66,62,1,674,740,902,964,699,42.34941952301421,22.078628148416872
1904,/media/marda/TWOTB1/xBD/hurricanes/images/florence/hurricane-florence_00000019_pre_disaster.png,74,62,1,780,854,909,971,842,47.36542911078107,23.382354098901693
1905,/media/marda/TWOTB1/xBD/hurricanes/images/florence/hurricane-florence_00000019_pre_disaster.png,62,56,1,339,401,912,968,859,56.685874631365365,20.258122110911657
1906,/media/marda/TWOTB1/xBD/hurricanes/images/florence/hurricane-florence_00000019_pre_disaster.png,55,68,1,258,313,914,982,879,45.466704366599,25.819284947798867
1907,/media/marda/TWOTB1/xBD/hurricanes/images/florence/hurricane-florence_00000019_pre_disaster.png,53,56,1,641,694,914,970,489,32.95216761139099,19.633253829713244
1908,/media/marda/TWOTB1/xBD/hurricanes/images/florence/hurricane-florence_00000019_pre_disaster.png,75,63,1,732,807,919,982,951,49.119516125846665,25.353482259209144
1909,/media/marda/TWOTB1/xBD/hurricanes/images/florence/hurricane-florence_00000019_pre_disaster.png,78,66,1,840,918,920,986,1003,45.05790233222477,29.193980144148156
1910,/media/marda/TWOTB1/xBD/hurricanes/images/florence/hurricane-florence_00000019_pre_disaster.png,67,56,1,672,739,935,991,729,46.74494506141094,20.766761952333702
1911,/media/marda/TWOTB1/xBD/hurricanes/images/florence/hurricane-florence_00000019_pre_disaster.png,68,86,1,557,625,936,1022,1674,56.520044814361775,42.72051968105343
1912,/media/marda/TWOTB1/xBD/hurricanes/images/florence/hurricane-florence_00000019_pre_disaster.png,60,57,1,629,689,939,996,591,38.28956385501362,20.701576570871723
1913,/media/marda/TWOTB1/xBD/hurricanes/images/florence/hurricane-florence_00000019_pre_disaster.png,121,74,1,731,852,939,1013,1998,106.9125036817769,29.158634859082742
1914,/media/marda/TWOTB1/xBD/hurricanes/images/florence/hurricane-florence_00000019_pre_disaster.png,85,64,1,835,920,954,1018,1160,55.564213582840836,27.37760070363848
1915,/media/marda/TWOTB1/xBD/hurricanes/images/florence/hurricane-florence_00000019_pre_disaster.png,69,60,1,665,734,961,1021,838,44.99382148320715,24.973664895135222
1916,/media/marda/TWOTB1/xBD/hurricanes/images/florence/hurricane-florence_00000019_pre_disaster.png,60,57,1,333,393,964,1021,778,51.472730570313544,21.243766166826045
1917,/media/marda/TWOTB1/xBD/hurricanes/images/florence/hurricane-florence_00000019_pre_disaster.png,57,59,1,631,688,966,1025,571,34.192485567375904,21.740907407521544
1918,/media/marda/TWOTB1/xBD/hurricanes/images/florence/hurricane-florence_00000019_pre_disaster.png,113,72,1,733,846,970,1042,1861,96.23838008311164,27.696179249635755
1919,/media/marda/TWOTB1/xBD/hurricanes/images/florence/hurricane-florence_00000019_pre_disaster.png,80,63,1,844,924,981,1044,886,50.56208217989505,23.23150627344461
1920,/media/marda/TWOTB1/xBD/hurricanes/images/florence/hurricane-florence_00000019_pre_disaster.png,66,59,1,668,734,985,1044,645,43.977488072317556,19.352655366345992
1921,/media/marda/TWOTB1/xBD/hurricanes/images/florence/hurricane-florence_00000019_pre_disaster.png,64,56,1,552,616,988,1044,629,45.51215029576112,18.24932369005921
1922,/media/marda/TWOTB1/xBD/hurricanes/images/florence/hurricane-florence_00000019_pre_disaster.png,67,55,1,621,688,989,1044,420,43.238373026309254,13.633642382492498
1923,/media/marda/TWOTB1/xBD/hurricanes/images/florence/hurricane-florence_00000019_pre_disaster.png,41,50,1,332,373,994,1044,280,32.37956876247068,11.4701145049399
1924,/media/marda/TWOTB1/xBD/hurricanes/images/florence/hurricane-florence_00000258_pre_disaster.png,64,54,1,421,485,114,168,1179,55.771840090520655,31.67988174120378
1925,/media/marda/TWOTB1/xBD/hurricanes/images/florence/hurricane-florence_00000258_pre_disaster.png,37,27,1,488,525,146,173,278,21.32860243413777,17.460177862985013
1926,/media/marda/TWOTB1/xBD/hurricanes/images/florence/hurricane-florence_00000258_pre_disaster.png,71,58,1,684,755,190,248,1221,52.37084965441997,30.716293463087627
1927,/media/marda/TWOTB1/xBD/hurricanes/images/florence/hurricane-florence_00000258_pre_disaster.png,39,27,1,687,726,274,301,143,17.26573575130172,11.21822608779182
1928,/media/marda/TWOTB1/xBD/hurricanes/images/florence/hurricane-florence_00000258_pre_disaster.png,31,29,1,68,99,285,314,365,31.111474434899385,16.062163490586514
1929,/media/marda/TWOTB1/xBD/hurricanes/images/florence/hurricane-florence_00000258_pre_disaster.png,77,58,1,959,1036,314,372,1055,41.946261244392254,32.989909835106296
1930,/media/marda/TWOTB1/xBD/hurricanes/images/florence/hurricane-florence_00000258_pre_disaster.png,65,49,1,968,1033,366,415,580,37.488976840805186,20.656540556158973
1931,/media/marda/TWOTB1/xBD/hurricanes/images/florence/hurricane-florence_00000258_pre_disaster.png,61,38,1,983,1044,393,431,309,23.315842850526018,17.770680211210948
1932,/media/marda/TWOTB1/xBD/hurricanes/images/florence/hurricane-florence_00000258_pre_disaster.png,27,57,1,215,242,901,958,236,18.423753544004242,17.168000905081556
1933,/media/marda/TWOTB1/xBD/hurricanes/images/florence/hurricane-florence_00000258_pre_disaster.png,81,96,1,123,204,946,1042,2553,66.43479265592865,52.88548891729548
1934,/media/marda/TWOTB1/xBD/hurricanes/images/florence/hurricane-florence_00000258_pre_disaster.png,26,56,1,199,225,954,1010,176,20.36146095697096,11.568751488537226
1935,/media/marda/TWOTB1/xBD/hurricanes/images/florence/hurricane-florence_00000258_pre_disaster.png,38,58,1,74,112,986,1044,318,29.592598548596467,17.499272931571078
1936,/media/marda/TWOTB1/xBD/hurricanes/images/florence/hurricane-florence_00000479_post_disaster.png,79,34,1,680,759,43,77,932,57.72972417938353,21.560426917279436
1937,/media/marda/TWOTB1/xBD/hurricanes/images/florence/hurricane-florence_00000479_post_disaster.png,102,41,1,471,573,98,139,1874,88.51213713456356,28.64060123405027
1938,/media/marda/TWOTB1/xBD/hurricanes/images/florence/hurricane-florence_00000479_post_disaster.png,51,44,1,643,694,473,517,643,29.715011783414248,28.919834165268504
1939,/media/marda/TWOTB1/xBD/hurricanes/images/florence/hurricane-florence_00000479_post_disaster.png,39,11,1,385,424,0,11,143,24.260558708969338,9.03192207273337
1940,/media/marda/TWOTB1/xBD/hurricanes/images/florence/hurricane-florence_00000479_post_disaster.png,73,68,1,587,660,15,83,2131,69.00150918263635,42.285230491589935
1941,/media/marda/TWOTB1/xBD/hurricanes/images/florence/hurricane-florence_00000479_post_disaster.png,52,33,1,123,175,18,51,645,53.378329758316234,18.977949772224655
1942,/media/marda/TWOTB1/xBD/hurricanes/images/florence/hurricane-florence_00000479_post_disaster.png,27,21,1,247,274,28,49,203,19.961844184100457,14.485883619408735
1943,/media/marda/TWOTB1/xBD/hurricanes/images/florence/hurricane-florence_00000479_post_disaster.png,61,43,1,654,715,28,71,903,41.89934409614442,29.385138975377497
1944,/media/marda/TWOTB1/xBD/hurricanes/images/florence/hurricane-florence_00000479_post_disaster.png,44,20,1,637,681,36,56,249,18.692921906646337,17.86015260488431
1945,/media/marda/TWOTB1/xBD/hurricanes/images/florence/hurricane-florence_00000479_post_disaster.png,27,12,1,232,259,61,73,118,21.086940804897804,7.534613578660388
1946,/media/marda/TWOTB1/xBD/hurricanes/images/florence/hurricane-florence_00000479_post_disaster.png,69,54,1,519,588,196,250,1522,49.60955843562421,42.00869320913006
1947,/media/marda/TWOTB1/xBD/hurricanes/images/florence/hurricane-florence_00000479_post_disaster.png,46,34,1,569,615,246,280,375,24.006531603439992,20.68997939786669
1948,/media/marda/TWOTB1/xBD/hurricanes/images/florence/hurricane-florence_00000479_post_disaster.png,51,40,1,378,429,255,295,665,35.98936190425249,24.469053027279898
1949,/media/marda/TWOTB1/xBD/hurricanes/images/florence/hurricane-florence_00000479_post_disaster.png,40,24,1,598,638,262,286,146,16.15115951767317,12.123166212413667
1950,/media/marda/TWOTB1/xBD/hurricanes/images/florence/hurricane-florence_00000479_post_disaster.png,57,67,1,295,352,294,361,1508,52.07848487311026,38.53327198307925
1951,/media/marda/TWOTB1/xBD/hurricanes/images/florence/hurricane-florence_00000479_post_disaster.png,42,34,1,660,702,307,341,218,21.710932968420945,13.441794909027614
1952,/media/marda/TWOTB1/xBD/hurricanes/images/florence/hurricane-florence_00000479_post_disaster.png,59,58,1,578,637,426,484,1079,40.39559776768699,35.10437240177691
1953,/media/marda/TWOTB1/xBD/hurricanes/images/florence/hurricane-florence_00000009_post_disaster.png,72,43,1,891,963,75,118,888,43.38665535796861,27.521958744634485
1954,/media/marda/TWOTB1/xBD/hurricanes/images/florence/hurricane-florence_00000009_post_disaster.png,72,43,1,735,807,85,128,755,51.503294585870535,19.576596700101515
1955,/media/marda/TWOTB1/xBD/hurricanes/images/florence/hurricane-florence_00000009_post_disaster.png,55,33,1,609,664,87,120,443,38.1133514379736,15.412703496298512
1956,/media/marda/TWOTB1/xBD/hurricanes/images/florence/hurricane-florence_00000009_post_disaster.png,77,32,1,964,1041,88,120,655,34.049515063557635,25.997502739052752
1957,/media/marda/TWOTB1/xBD/hurricanes/images/florence/hurricane-florence_00000009_post_disaster.png,61,39,1,867,928,90,129,741,40.355178363238565,25.370973283442947
1958,/media/marda/TWOTB1/xBD/hurricanes/images/florence/hurricane-florence_00000009_post_disaster.png,76,42,1,615,691,105,147,998,50.3162724606678,26.524294949905045
1959,/media/marda/TWOTB1/xBD/hurricanes/images/florence/hurricane-florence_00000009_post_disaster.png,67,46,1,760,827,110,156,781,40.20258794207143,26.16692876410475
1960,/media/marda/TWOTB1/xBD/hurricanes/images/florence/hurricane-florence_00000009_post_disaster.png,80,45,1,919,999,112,157,1039,37.4245217711628,36.325601889932585
1961,/media/marda/TWOTB1/xBD/hurricanes/images/florence/hurricane-florence_00000009_post_disaster.png,67,46,1,635,702,130,176,784,48.64090149889462,23.53763354810693
1962,/media/marda/TWOTB1/xBD/hurricanes/images/florence/hurricane-florence_00000009_post_disaster.png,74,47,1,785,859,131,178,628,53.98853454451505,15.498784967600592
1963,/media/marda/TWOTB1/xBD/hurricanes/images/florence/hurricane-florence_00000009_post_disaster.png,69,47,1,560,629,147,194,929,48.74640542288539,25.418160813564885
1964,/media/marda/TWOTB1/xBD/hurricanes/images/florence/hurricane-florence_00000009_post_disaster.png,59,39,1,675,734,148,187,584,29.722933094774838,26.378448294271433
1965,/media/marda/TWOTB1/xBD/hurricanes/images/florence/hurricane-florence_00000009_post_disaster.png,76,41,1,922,998,163,204,741,41.8556064326274,23.22468215842029
1966,/media/marda/TWOTB1/xBD/hurricanes/images/florence/hurricane-florence_00000009_post_disaster.png,40,20,1,612,652,170,190,171,15.385264473162742,14.791550315838368
1967,/media/marda/TWOTB1/xBD/hurricanes/images/florence/hurricane-florence_00000009_post_disaster.png,48,23,1,709,757,171,194,190,17.408239359027675,14.613797039600783
1968,/media/marda/TWOTB1/xBD/hurricanes/images/florence/hurricane-florence_00000009_post_disaster.png,72,43,1,833,905,182,225,563,49.37410988609435,16.63900191508549
1969,/media/marda/TWOTB1/xBD/hurricanes/images/florence/hurricane-florence_00000009_post_disaster.png,62,17,1,558,620,197,214,437,45.854864054040135,12.716083916264148
1970,/media/marda/TWOTB1/xBD/hurricanes/images/florence/hurricane-florence_00000009_post_disaster.png,72,37,1,952,1024,197,234,538,35.89859758127816,20.275445235425636
1971,/media/marda/TWOTB1/xBD/hurricanes/images/florence/hurricane-florence_00000009_post_disaster.png,36,22,1,603,639,199,221,157,15.098471216242366,13.859532297705709
1972,/media/marda/TWOTB1/xBD/hurricanes/images/florence/hurricane-florence_00000009_post_disaster.png,63,40,1,713,776,199,239,513,41.43353561884495,16.700302170910614
1973,/media/marda/TWOTB1/xBD/hurricanes/images/florence/hurricane-florence_00000009_post_disaster.png,44,26,1,680,724,200,226,160,16.375786341888112,13.108532400113706
1974,/media/marda/TWOTB1/xBD/hurricanes/images/florence/hurricane-florence_00000009_post_disaster.png,36,22,1,605,641,217,239,146,14.787548630791655,13.017699982300378
1975,/media/marda/TWOTB1/xBD/hurricanes/images/florence/hurricane-florence_00000009_post_disaster.png,68,44,1,735,803,218,262,516,47.91052331872518,14.228350086352435
1976,/media/marda/TWOTB1/xBD/hurricanes/images/florence/hurricane-florence_00000009_post_disaster.png,81,55,1,876,957,223,278,903,55.130550322486044,24.446036873361745
1977,/media/marda/TWOTB1/xBD/hurricanes/images/florence/hurricane-florence_00000009_post_disaster.png,38,22,1,657,695,227,249,144,14.904050917187634,12.947799072652451
1978,/media/marda/TWOTB1/xBD/hurricanes/images/florence/hurricane-florence_00000009_post_disaster.png,63,35,1,559,622,229,264,850,44.952724535602414,25.168787071279322
1979,/media/marda/TWOTB1/xBD/hurricanes/images/florence/hurricane-florence_00000009_post_disaster.png,56,20,1,625,681,242,262,317,35.842629876929806,12.60991714188755
1980,/media/marda/TWOTB1/xBD/hurricanes/images/florence/hurricane-florence_00000009_post_disaster.png,68,43,1,757,825,242,285,512,46.64357252994986,14.570631046877988
1981,/media/marda/TWOTB1/xBD/hurricanes/images/florence/hurricane-florence_00000009_post_disaster.png,89,61,1,629,718,247,308,2091,71.80344791307841,42.95622140261697
1982,/media/marda/TWOTB1/xBD/hurricanes/images/florence/hurricane-florence_00000009_post_disaster.png,83,55,1,906,989,255,310,1041,51.87422370876224,27.098176246686258
1983,/media/marda/TWOTB1/xBD/hurricanes/images/florence/hurricane-florence_00000009_post_disaster.png,71,49,1,781,852,265,314,814,39.6918598811517,27.36069702193745
1984,/media/marda/TWOTB1/xBD/hurricanes/images/florence/hurricane-florence_00000009_post_disaster.png,75,32,1,562,637,269,301,894,55.09719121269219,21.734715880361456
1985,/media/marda/TWOTB1/xBD/hurricanes/images/florence/hurricane-florence_00000009_post_disaster.png,57,40,1,695,752,297,337,293,35.51153741222938,11.030158393264509
1986,/media/marda/TWOTB1/xBD/hurricanes/images/florence/hurricane-florence_00000009_post_disaster.png,61,33,1,572,633,301,334,778,44.92102058738009,23.02723978215595
1987,/media/marda/TWOTB1/xBD/hurricanes/images/florence/hurricane-florence_00000009_post_disaster.png,46,29,1,731,777,302,331,145,18.453872336340183,10.47905759659363
1988,/media/marda/TWOTB1/xBD/hurricanes/images/florence/hurricane-florence_00000009_post_disaster.png,78,60,1,966,1044,303,363,1022,52.16351763319247,26.024710792388333
1989,/media/marda/TWOTB1/xBD/hurricanes/images/florence/hurricane-florence_00000009_post_disaster.png,83,60,1,828,911,311,371,847,62.54814000929843,18.336927947387203
1990,/media/marda/TWOTB1/xBD/hurricanes/images/florence/hurricane-florence_00000009_post_disaster.png,44,34,1,646,690,313,347,298,20.806477056059702,18.920486160691553
1991,/media/marda/TWOTB1/xBD/hurricanes/images/florence/hurricane-florence_00000009_post_disaster.png,54,37,1,715,769,323,360,301,29.03920515678723,13.788168816167424
1992,/media/marda/TWOTB1/xBD/hurricanes/images/florence/hurricane-florence_00000009_post_disaster.png,65,48,1,739,804,334,382,498,45.6066105003768,14.43750183520083
1993,/media/marda/TWOTB1/xBD/hurricanes/images/florence/hurricane-florence_00000009_post_disaster.png,43,24,1,777,820,347,371,84,11.160749486524328,9.994444359972185
1994,/media/marda/TWOTB1/xBD/hurricanes/images/florence/hurricane-florence_00000009_post_disaster.png,42,53,1,622,664,355,408,518,44.296959122406214,16.991749747873296
1995,/media/marda/TWOTB1/xBD/hurricanes/images/florence/hurricane-florence_00000009_post_disaster.png,37,25,1,642,679,357,382,82,13.25704974865424,8.234419149611371
1996,/media/marda/TWOTB1/xBD/hurricanes/images/florence/hurricane-florence_00000009_post_disaster.png,64,47,1,564,628,359,406,933,40.48009499685115,31.80329730484737
1997,/media/marda/TWOTB1/xBD/hurricanes/images/florence/hurricane-florence_00000009_post_disaster.png,70,47,1,751,821,366,413,546,45.398167058127534,18.02260714479342
1998,/media/marda/TWOTB1/xBD/hurricanes/images/florence/hurricane-florence_00000009_post_disaster.png,86,59,1,876,962,371,430,1281,44.07752294449311,38.714005759442344
1999,/media/marda/TWOTB1/xBD/hurricanes/images/florence/hurricane-florence_00000009_post_disaster.png,61,49,1,657,718,373,422,728,33.41959662823162,28.938194714140735
2000,/media/marda/TWOTB1/xBD/hurricanes/images/florence/hurricane-florence_00000009_post_disaster.png,72,51,1,777,849,388,439,534,52.86403690096902,13.485516089546081
2001,/media/marda/TWOTB1/xBD/hurricanes/images/florence/hurricane-florence_00000009_post_disaster.png,66,47,1,538,604,390,437,835,43.86790606230096,27.714859093549197
2002,/media/marda/TWOTB1/xBD/hurricanes/images/florence/hurricane-florence_00000009_post_disaster.png,59,47,1,640,699,392,439,416,46.76236616435183,11.813905803182433
2003,/media/marda/TWOTB1/xBD/hurricanes/images/florence/hurricane-florence_00000009_post_disaster.png,61,52,1,627,688,420,472,560,41.680069367258035,17.939495283032535
2004,/media/marda/TWOTB1/xBD/hurricanes/images/florence/hurricane-florence_00000009_post_disaster.png,51,35,1,782,833,420,455,234,19.962760970297907,15.479280499035768
2005,/media/marda/TWOTB1/xBD/hurricanes/images/florence/hurricane-florence_00000009_post_disaster.png,59,36,1,971,1030,423,459,215,18.931448613099818,15.216520379432849
2006,/media/marda/TWOTB1/xBD/hurricanes/images/florence/hurricane-florence_00000009_post_disaster.png,55,35,1,907,962,428,463,177,17.613834339611543,13.467498312625663
2007,/media/marda/TWOTB1/xBD/hurricanes/images/florence/hurricane-florence_00000009_post_disaster.png,74,65,1,588,662,435,500,1205,56.84317538136053,27.98350891109152
2008,/media/marda/TWOTB1/xBD/hurricanes/images/florence/hurricane-florence_00000009_post_disaster.png,88,69,1,835,923,436,505,1485,45.00961240259511,43.902309194095125
2009,/media/marda/TWOTB1/xBD/hurricanes/images/florence/hurricane-florence_00000009_post_disaster.png,66,51,1,712,778,442,493,684,41.06107125636393,21.94279819133541
2010,/media/marda/TWOTB1/xBD/hurricanes/images/florence/hurricane-florence_00000009_post_disaster.png,63,44,1,932,995,444,488,403,25.773822765235973,20.75224530022674
2011,/media/marda/TWOTB1/xBD/hurricanes/images/florence/hurricane-florence_00000009_post_disaster.png,83,56,1,957,1040,450,506,907,42.329123406723866,28.454657898124164
2012,/media/marda/TWOTB1/xBD/hurricanes/images/florence/hurricane-florence_00000009_post_disaster.png,68,64,1,566,634,458,522,943,55.01118682438307,22.813373953701106
2013,/media/marda/TWOTB1/xBD/hurricanes/images/florence/hurricane-florence_00000009_post_disaster.png,70,64,1,883,953,470,534,1170,50.659057915016724,30.471803625177532
2014,/media/marda/TWOTB1/xBD/hurricanes/images/florence/hurricane-florence_00000009_post_disaster.png,74,58,1,970,1044,485,543,740,43.57032142300167,23.037193031150004
2015,/media/marda/TWOTB1/xBD/hurricanes/images/florence/hurricane-florence_00000009_post_disaster.png,98,77,1,522,620,490,567,1741,81.56695615929553,31.04027313565412
2016,/media/marda/TWOTB1/xBD/hurricanes/images/florence/hurricane-florence_00000009_post_disaster.png,68,60,1,664,732,491,551,639,53.114506344822175,15.910508251499644
2017,/media/marda/TWOTB1/xBD/hurricanes/images/florence/hurricane-florence_00000009_post_disaster.png,78,74,1,767,845,491,565,1130,59.315622289602985,27.63705477345522
2018,/media/marda/TWOTB1/xBD/hurricanes/images/florence/hurricane-florence_00000009_post_disaster.png,62,58,1,641,703,513,571,553,46.333479990379004,16.909632580979725
2019,/media/marda/TWOTB1/xBD/hurricanes/images/florence/hurricane-florence_00000009_post_disaster.png,63,82,1,616,679,521,603,1203,64.2654632537243,27.029695284409375
2020,/media/marda/TWOTB1/xBD/hurricanes/images/florence/hurricane-florence_00000009_post_disaster.png,76,61,1,754,830,527,588,882,49.233421185840214,23.802231041872325
2021,/media/marda/TWOTB1/xBD/hurricanes/images/florence/hurricane-florence_00000009_post_disaster.png,52,31,1,991,1043,529,560,65,10.371538803255646,8.456358520108392
2022,/media/marda/TWOTB1/xBD/hurricanes/images/florence/hurricane-florence_00000009_post_disaster.png,78,72,1,874,952,532,604,1030,56.02668941186836,24.499834910983868
2023,/media/marda/TWOTB1/xBD/hurricanes/images/florence/hurricane-florence_00000009_post_disaster.png,37,32,1,680,717,541,573,73,10.44803820491506,9.222814260591715
2024,/media/marda/TWOTB1/xBD/hurricanes/images/florence/hurricane-florence_00000009_post_disaster.png,72,69,1,735,807,548,617,895,54.587831053463255,23.610854504854636
2025,/media/marda/TWOTB1/xBD/hurricanes/images/florence/hurricane-florence_00000009_post_disaster.png,35,30,1,655,690,556,586,60,9.466809993104667,8.36271870326924
2026,/media/marda/TWOTB1/xBD/hurricanes/images/florence/hurricane-florence_00000009_post_disaster.png,83,81,1,708,791,563,644,1378,72.39525858366541,25.027883213542527
2027,/media/marda/TWOTB1/xBD/hurricanes/images/florence/hurricane-florence_00000009_post_disaster.png,38,33,1,653,691,572,605,97,12.448871424884508,10.36023423829447
2028,/media/marda/TWOTB1/xBD/hurricanes/images/florence/hurricane-florence_00000009_post_disaster.png,51,40,1,993,1044,608,648,121,14.797190639322391,11.078908495655877
2029,/media/marda/TWOTB1/xBD/hurricanes/images/florence/hurricane-florence_00000009_post_disaster.png,111,104,1,747,858,620,724,3438,75.76973437390757,59.86509137121589
2030,/media/marda/TWOTB1/xBD/hurricanes/images/florence/hurricane-florence_00000009_post_disaster.png,54,50,1,705,759,628,678,362,23.893782363804597,19.98599414301908
2031,/media/marda/TWOTB1/xBD/hurricanes/images/florence/hurricane-florence_00000009_post_disaster.png,71,71,1,530,601,629,700,1222,49.595000425256515,32.665506827251924
2032,/media/marda/TWOTB1/xBD/hurricanes/images/florence/hurricane-florence_00000009_post_disaster.png,56,54,1,988,1044,637,691,263,25.925073980452584,14.993920756057571
2033,/media/marda/TWOTB1/xBD/hurricanes/images/florence/hurricane-florence_00000009_post_disaster.png,88,68,1,730,818,671,739,1006,59.840975911308696,25.181720717496727
2034,/media/marda/TWOTB1/xBD/hurricanes/images/florence/hurricane-florence_00000009_post_disaster.png,71,53,1,638,709,697,750,589,49.88736051626571,20.87787693296744
2035,/media/marda/TWOTB1/xBD/hurricanes/images/florence/hurricane-florence_00000009_post_disaster.png,70,67,1,912,982,702,769,682,38.22987800950094,23.628842128618526
2036,/media/marda/TWOTB1/xBD/hurricanes/images/florence/hurricane-florence_00000009_post_disaster.png,74,79,1,575,649,711,790,1392,49.33135434672506,37.50117200949661
2037,/media/marda/TWOTB1/xBD/hurricanes/images/florence/hurricane-florence_00000009_post_disaster.png,139,98,1,827,966,713,811,2955,112.97117864048862,41.411339880129184
2038,/media/marda/TWOTB1/xBD/hurricanes/images/florence/hurricane-florence_00000009_post_disaster.png,91,84,1,654,745,758,842,1631,70.74244043482145,39.054613717866594
2039,/media/marda/TWOTB1/xBD/hurricanes/images/florence/hurricane-florence_00000009_post_disaster.png,84,96,1,512,596,785,881,1918,66.71110750321232,38.269214602982714
2040,/media/marda/TWOTB1/xBD/hurricanes/images/florence/hurricane-florence_00000009_post_disaster.png,54,67,1,675,729,950,1017,406,31.813524250242395,17.10270884560393
2041,/media/marda/TWOTB1/xBD/hurricanes/images/florence/hurricane-florence_00000009_post_disaster.png,50,58,1,686,736,978,1036,260,21.1352484894008,16.462608672656728
2042,/media/marda/TWOTB1/xBD/hurricanes/images/florence/hurricane-florence_00000462_pre_disaster.png,27,43,1,0,27,116,159,729,37.14509345025359,26.40403156423377
2043,/media/marda/TWOTB1/xBD/hurricanes/images/florence/hurricane-florence_00000462_pre_disaster.png,58,74,1,109,167,140,214,2115,70.1718489869732,45.583949779393436
2044,/media/marda/TWOTB1/xBD/hurricanes/images/florence/hurricane-florence_00000462_pre_disaster.png,65,42,1,177,242,169,211,1516,59.80995086599002,33.73750368173075
2045,/media/marda/TWOTB1/xBD/hurricanes/images/florence/hurricane-florence_00000462_pre_disaster.png,60,52,1,250,310,200,252,1419,47.49850843310038,39.99665606135041
2046,/media/marda/TWOTB1/xBD/hurricanes/images/florence/hurricane-florence_00000462_pre_disaster.png,68,64,1,360,428,241,305,1805,54.50632064338122,44.267456457816124
2047,/media/marda/TWOTB1/xBD/hurricanes/images/florence/hurricane-florence_00000462_pre_disaster.png,84,62,1,295,379,372,434,1887,70.10932843852213,41.508175825794375
2048,/media/marda/TWOTB1/xBD/hurricanes/images/florence/hurricane-florence_00000462_pre_disaster.png,72,67,1,739,811,375,442,1470,53.77117952582928,36.15959576733934
2049,/media/marda/TWOTB1/xBD/hurricanes/images/florence/hurricane-florence_00000462_pre_disaster.png,78,78,1,809,887,389,467,1647,60.412293999133965,38.99582264055743
2050,/media/marda/TWOTB1/xBD/hurricanes/images/florence/hurricane-florence_00000462_pre_disaster.png,99,63,1,862,961,428,491,1732,61.872723446968116,38.45542639307987
2051,/media/marda/TWOTB1/xBD/hurricanes/images/florence/hurricane-florence_00000462_pre_disaster.png,94,64,1,930,1024,444,508,1641,53.766301489119236,41.43337228519899
2052,/media/marda/TWOTB1/xBD/hurricanes/images/florence/hurricane-florence_00000462_pre_disaster.png,70,66,1,79,149,500,566,1726,63.459832532937995,38.57408914861162
2053,/media/marda/TWOTB1/xBD/hurricanes/images/florence/hurricane-florence_00000462_pre_disaster.png,78,61,1,693,771,532,593,1281,46.32178749168787,36.84261798300204
2054,/media/marda/TWOTB1/xBD/hurricanes/images/florence/hurricane-florence_00000462_pre_disaster.png,74,66,1,57,131,547,613,1794,67.57427170628644,38.938973998625755
2055,/media/marda/TWOTB1/xBD/hurricanes/images/florence/hurricane-florence_00000462_pre_disaster.png,117,80,1,817,934,564,644,2211,88.15026276433223,42.23857791233155
2056,/media/marda/TWOTB1/xBD/hurricanes/images/florence/hurricane-florence_00000462_pre_disaster.png,58,60,1,476,534,580,640,1179,41.24920532634344,37.26676339206897
2057,/media/marda/TWOTB1/xBD/hurricanes/images/florence/hurricane-florence_00000462_pre_disaster.png,102,81,1,890,992,591,672,1968,63.75508054921113,46.669012015291074
2058,/media/marda/TWOTB1/xBD/hurricanes/images/florence/hurricane-florence_00000462_pre_disaster.png,65,77,1,8,73,631,708,1819,58.970812362226205,45.129573670146904
2059,/media/marda/TWOTB1/xBD/hurricanes/images/florence/hurricane-florence_00000462_pre_disaster.png,37,80,1,0,37,674,754,1224,57.41437945236052,29.99419622362684
2060,/media/marda/TWOTB1/xBD/hurricanes/images/florence/hurricane-florence_00000462_pre_disaster.png,95,75,1,572,667,706,781,1743,66.42344035495968,38.56301758498313
2061,/media/marda/TWOTB1/xBD/hurricanes/images/florence/hurricane-florence_00000462_pre_disaster.png,71,93,1,973,1044,770,863,1263,58.046788478890875,33.04716666145653
2062,/media/marda/TWOTB1/xBD/hurricanes/images/florence/hurricane-florence_00000462_pre_disaster.png,92,74,1,477,569,777,851,1827,69.06491391537556,38.12824575524182
2063,/media/marda/TWOTB1/xBD/hurricanes/images/florence/hurricane-florence_00000462_pre_disaster.png,84,78,1,431,515,811,889,1636,63.40461332402613,39.5843883829785
2064,/media/marda/TWOTB1/xBD/hurricanes/images/florence/hurricane-florence_00000462_pre_disaster.png,56,104,1,27,83,837,941,1994,70.20401589007922,40.43563192489366
2065,/media/marda/TWOTB1/xBD/hurricanes/images/florence/hurricane-florence_00000462_pre_disaster.png,107,120,1,900,1007,885,1005,2708,84.42072355037834,50.88733570885658
2066,/media/marda/TWOTB1/xBD/hurricanes/images/florence/hurricane-florence_00000462_pre_disaster.png,66,81,1,179,245,898,979,1795,59.96523367448179,43.374468873653115
2067,/media/marda/TWOTB1/xBD/hurricanes/images/florence/hurricane-florence_00000462_pre_disaster.png,96,97,1,838,934,938,1035,2027,68.26321370256319,43.55164905491768
2068,/media/marda/TWOTB1/xBD/hurricanes/images/florence/hurricane-florence_00000448_pre_disaster.png,44,40,1,187,231,17,57,1214,40.3000073985083,39.631345772038536
2069,/media/marda/TWOTB1/xBD/hurricanes/images/florence/hurricane-florence_00000448_pre_disaster.png,53,36,1,99,152,23,59,1311,55.1123563613768,33.21600989305134
2070,/media/marda/TWOTB1/xBD/hurricanes/images/florence/hurricane-florence_00000448_pre_disaster.png,51,24,1,305,356,54,78,812,44.53092547738799,24.320541792912316
2071,/media/marda/TWOTB1/xBD/hurricanes/images/florence/hurricane-florence_00000448_pre_disaster.png,28,36,1,211,239,60,96,645,41.87521040609633,21.486316170764226
2072,/media/marda/TWOTB1/xBD/hurricanes/images/florence/hurricane-florence_00000448_pre_disaster.png,63,25,1,536,599,95,120,872,45.080864627955584,25.12257731954501
2073,/media/marda/TWOTB1/xBD/hurricanes/images/florence/hurricane-florence_00000448_pre_disaster.png,23,13,1,341,364,96,109,98,13.471634608367156,9.83331851531443
2074,/media/marda/TWOTB1/xBD/hurricanes/images/florence/hurricane-florence_00000448_pre_disaster.png,31,53,1,141,172,106,159,942,52.0720115511433,24.63957886947877
2075,/media/marda/TWOTB1/xBD/hurricanes/images/florence/hurricane-florence_00000448_pre_disaster.png,45,38,1,250,295,132,170,843,36.98460084411354,30.4601358183839
2076,/media/marda/TWOTB1/xBD/hurricanes/images/florence/hurricane-florence_00000448_pre_disaster.png,20,15,1,288,308,133,148,96,11.730380376268224,10.965250471135075
2077,/media/marda/TWOTB1/xBD/hurricanes/images/florence/hurricane-florence_00000448_pre_disaster.png,23,24,1,182,205,136,160,315,22.01190648519376,19.08860759409365
2078,/media/marda/TWOTB1/xBD/hurricanes/images/florence/hurricane-florence_00000448_pre_disaster.png,60,27,1,495,555,143,170,792,41.80117027226676,25.22329948808391
2079,/media/marda/TWOTB1/xBD/hurricanes/images/florence/hurricane-florence_00000448_pre_disaster.png,45,27,1,591,636,269,296,218,18.64463818194652,15.689437909946102
2080,/media/marda/TWOTB1/xBD/hurricanes/images/florence/hurricane-florence_00000448_pre_disaster.png,39,32,1,631,670,356,388,264,21.87965102637628,15.986094120065681
2081,/media/marda/TWOTB1/xBD/hurricanes/images/florence/hurricane-florence_00000448_pre_disaster.png,44,29,1,697,741,361,390,168,16.58334595183395,13.699210707308787
2082,/media/marda/TWOTB1/xBD/hurricanes/images/florence/hurricane-florence_00000115_pre_disaster.png,73,46,1,604,677,0,46,1400,50.53818532936936,36.69787864555256
2083,/media/marda/TWOTB1/xBD/hurricanes/images/florence/hurricane-florence_00000115_pre_disaster.png,85,34,1,740,825,0,34,1177,53.05809479619599,29.226808901198044
2084,/media/marda/TWOTB1/xBD/hurricanes/images/florence/hurricane-florence_00000115_pre_disaster.png,49,6,1,890,939,0,6,42,11.698476980650792,5.428409693274463
2085,/media/marda/TWOTB1/xBD/hurricanes/images/florence/hurricane-florence_00000115_pre_disaster.png,81,37,1,911,992,0,37,1070,44.08851229316624,33.193024156642345
2086,/media/marda/TWOTB1/xBD/hurricanes/images/florence/hurricane-florence_00000115_pre_disaster.png,65,47,1,637,702,37,84,1228,49.17205471154057,33.608583597702136
2087,/media/marda/TWOTB1/xBD/hurricanes/images/florence/hurricane-florence_00000115_pre_disaster.png,52,30,1,650,702,89,119,635,29.87175609114986,27.926150868572634
2088,/media/marda/TWOTB1/xBD/hurricanes/images/florence/hurricane-florence_00000115_pre_disaster.png,40,13,1,615,655,92,105,111,17.11999012264402,8.682460485666398
2089,/media/marda/TWOTB1/xBD/hurricanes/images/florence/hurricane-florence_00000115_pre_disaster.png,91,46,1,842,933,95,141,1434,55.177644163368,34.51892975851268
2090,/media/marda/TWOTB1/xBD/hurricanes/images/florence/hurricane-florence_00000115_pre_disaster.png,85,50,1,766,851,103,153,1391,55.59795350981172,33.84399174170935
2091,/media/marda/TWOTB1/xBD/hurricanes/images/florence/hurricane-florence_00000115_pre_disaster.png,66,63,1,674,740,120,183,1378,53.203318865235595,34.76162912645032
2092,/media/marda/TWOTB1/xBD/hurricanes/images/florence/hurricane-florence_00000115_pre_disaster.png,66,54,1,723,789,129,183,1467,51.956976410708705,37.35419071241621
2093,/media/marda/TWOTB1/xBD/hurricanes/images/florence/hurricane-florence_00000115_pre_disaster.png,77,56,1,882,959,131,187,1217,47.767781229987065,33.75105394586985
2094,/media/marda/TWOTB1/xBD/hurricanes/images/florence/hurricane-florence_00000115_pre_disaster.png,14,14,1,84,98,169,183,89,14.54830142213533,8.202277964486187
2095,/media/marda/TWOTB1/xBD/hurricanes/images/florence/hurricane-florence_00000115_pre_disaster.png,43,19,1,781,824,169,188,103,14.021000825388121,9.893965994255659
2096,/media/marda/TWOTB1/xBD/hurricanes/images/florence/hurricane-florence_00000115_pre_disaster.png,18,17,1,85,103,181,198,120,16.006702386948657,9.989045712739916
2097,/media/marda/TWOTB1/xBD/hurricanes/images/florence/hurricane-florence_00000115_pre_disaster.png,35,43,1,142,177,255,298,1006,38.06372781863492,35.15531452855602
2098,/media/marda/TWOTB1/xBD/hurricanes/images/florence/hurricane-florence_00000115_pre_disaster.png,14,16,1,178,192,276,292,75,11.31345276538022,8.662691900902116
2099,/media/marda/TWOTB1/xBD/hurricanes/images/florence/hurricane-florence_00000115_pre_disaster.png,106,93,1,161,267,300,393,5252,102.38670139096746,68.13817135238945
2100,/media/marda/TWOTB1/xBD/hurricanes/images/florence/hurricane-florence_00000115_pre_disaster.png,12,47,1,0,12,403,450,261,32.26039034505744,11.19411062115736
2101,/media/marda/TWOTB1/xBD/hurricanes/images/florence/hurricane-florence_00000115_pre_disaster.png,34,80,1,0,34,471,551,1666,66.42635806873149,33.89191683459902
2102,/media/marda/TWOTB1/xBD/hurricanes/images/florence/hurricane-florence_00000115_pre_disaster.png,115,136,1,686,801,543,679,4884,119.03610960011757,57.79671159636631
2103,/media/marda/TWOTB1/xBD/hurricanes/images/florence/hurricane-florence_00000115_pre_disaster.png,32,52,1,0,32,552,604,700,35.516092352018866,26.3970122065097
2104,/media/marda/TWOTB1/xBD/hurricanes/images/florence/hurricane-florence_00000115_pre_disaster.png,69,77,1,596,665,576,653,1606,55.01368883278641,40.72364523532476
2105,/media/marda/TWOTB1/xBD/hurricanes/images/florence/hurricane-florence_00000115_pre_disaster.png,37,40,1,666,703,656,696,114,14.325535385850324,10.509651834227377
2106,/media/marda/TWOTB1/xBD/hurricanes/images/florence/hurricane-florence_00000115_pre_disaster.png,102,111,1,731,833,657,768,3973,88.0182412248977,62.55506887053352
2107,/media/marda/TWOTB1/xBD/hurricanes/images/florence/hurricane-florence_00000115_pre_disaster.png,100,133,1,561,661,681,814,5193,118.08266395515815,62.331649258872694
2108,/media/marda/TWOTB1/xBD/hurricanes/images/florence/hurricane-florence_00000115_pre_disaster.png,60,102,1,0,60,695,797,3006,71.9231564300126,57.225607824866614
2109,/media/marda/TWOTB1/xBD/hurricanes/images/florence/hurricane-florence_00000115_pre_disaster.png,94,137,1,757,851,746,883,5424,121.75635081097026,61.205046067799245
2110,/media/marda/TWOTB1/xBD/hurricanes/images/florence/hurricane-florence_00000115_pre_disaster.png,18,58,1,70,88,789,847,321,27.02205458863334,15.879709730873522
2111,/media/marda/TWOTB1/xBD/hurricanes/images/florence/hurricane-florence_00000115_pre_disaster.png,99,132,1,575,674,794,926,4685,101.02461507197253,64.45201308774838
2112,/media/marda/TWOTB1/xBD/hurricanes/images/florence/hurricane-florence_00000115_pre_disaster.png,132,91,1,660,792,852,943,5317,120.77797613836546,59.54603476091835
2113,/media/marda/TWOTB1/xBD/hurricanes/images/florence/hurricane-florence_00000115_pre_disaster.png,33,97,1,18,51,867,964,1112,72.655320008114,20.300640277127897
2114,/media/marda/TWOTB1/xBD/hurricanes/images/florence/hurricane-florence_00000115_pre_disaster.png,26,96,1,0,26,868,964,1054,67.72867323835047,20.89677501312299
2115,/media/marda/TWOTB1/xBD/hurricanes/images/florence/hurricane-florence_00000115_pre_disaster.png,85,113,1,51,136,868,981,4170,88.7360296859219,64.80139927579026
2116,/media/marda/TWOTB1/xBD/hurricanes/images/florence/hurricane-florence_00000115_pre_disaster.png,66,86,1,81,147,948,1034,1943,68.88351049103547,38.3021734207608
2117,/media/marda/TWOTB1/xBD/hurricanes/images/florence/hurricane-florence_00000115_pre_disaster.png,18,49,1,4,22,952,1001,232,20.60428147231356,14.882191953080854
2118,/media/marda/TWOTB1/xBD/hurricanes/images/florence/hurricane-florence_00000115_pre_disaster.png,81,73,1,429,510,969,1042,1250,50.874788506078865,43.34019214795598
2119,/media/marda/TWOTB1/xBD/hurricanes/images/florence/hurricane-florence_00000511_pre_disaster.png,130,60,1,634,764,700,760,3144,117.16199274796722,35.60376006667689
2120,/media/marda/TWOTB1/xBD/hurricanes/images/florence/hurricane-florence_00000511_pre_disaster.png,128,60,1,636,764,754,814,3214,116.00169956706362,36.78622641240122
2121,/media/marda/TWOTB1/xBD/hurricanes/images/florence/hurricane-florence_00000511_pre_disaster.png,130,65,1,635,765,819,884,3157,117.62542247030504,35.647351816490094
2122,/media/marda/TWOTB1/xBD/hurricanes/images/florence/hurricane-florence_00000511_pre_disaster.png,130,66,1,636,766,873,939,3273,118.12817380562446,36.84281979971882
2123,/media/marda/TWOTB1/xBD/hurricanes/images/florence/hurricane-florence_00000511_pre_disaster.png,51,49,1,806,857,883,932,323,21.908902300206645,19.595917942265423
2124,/media/marda/TWOTB1/xBD/hurricanes/images/florence/hurricane-florence_00000165_pre_disaster.png,35,9,1,294,329,0,9,107,21.082335420095013,7.831540047326882
2125,/media/marda/TWOTB1/xBD/hurricanes/images/florence/hurricane-florence_00000165_pre_disaster.png,34,12,1,556,590,6,18,85,13.234543702613307,8.625691991149404
2126,/media/marda/TWOTB1/xBD/hurricanes/images/florence/hurricane-florence_00000165_pre_disaster.png,66,29,1,954,1020,31,60,449,24.60545219723639,24.08644748404189
2127,/media/marda/TWOTB1/xBD/hurricanes/images/florence/hurricane-florence_00000165_pre_disaster.png,40,19,1,516,556,38,57,204,18.118968829243006,15.016886832281441
2128,/media/marda/TWOTB1/xBD/hurricanes/images/florence/hurricane-florence_00000165_pre_disaster.png,36,36,1,7,43,50,86,677,36.96859301133739,24.06745371956913
2129,/media/marda/TWOTB1/xBD/hurricanes/images/florence/hurricane-florence_00000165_pre_disaster.png,69,47,1,603,672,51,98,1285,42.68435336686347,39.39931636416925
2130,/media/marda/TWOTB1/xBD/hurricanes/images/florence/hurricane-florence_00000165_pre_disaster.png,37,47,1,43,80,81,128,683,54.307051279705085,16.74931415958292
2131,/media/marda/TWOTB1/xBD/hurricanes/images/florence/hurricane-florence_00000165_pre_disaster.png,65,36,1,767,832,88,124,735,34.77454598411283,28.188516870669034
2132,/media/marda/TWOTB1/xBD/hurricanes/images/florence/hurricane-florence_00000165_pre_disaster.png,57,38,1,727,784,124,162,480,33.95324604593387,18.954334732891542
2133,/media/marda/TWOTB1/xBD/hurricanes/images/florence/hurricane-florence_00000165_pre_disaster.png,73,58,1,855,928,182,240,1184,53.72294564116558,32.83960575632666
2134,/media/marda/TWOTB1/xBD/hurricanes/images/florence/hurricane-florence_00000165_pre_disaster.png,68,43,1,784,852,185,228,1137,40.19613766063397,37.77180940271035
2135,/media/marda/TWOTB1/xBD/hurricanes/images/florence/hurricane-florence_00000165_pre_disaster.png,23,39,1,0,23,189,228,547,34.66222600019005,20.98179399189818
2136,/media/marda/TWOTB1/xBD/hurricanes/images/florence/hurricane-florence_00000165_pre_disaster.png,81,76,1,577,658,223,299,1996,67.14915969802156,39.57179184134715
2137,/media/marda/TWOTB1/xBD/hurricanes/images/florence/hurricane-florence_00000165_pre_disaster.png,58,46,1,874,932,246,292,725,40.8982074720189,23.486253456815263
2138,/media/marda/TWOTB1/xBD/hurricanes/images/florence/hurricane-florence_00000165_pre_disaster.png,60,52,1,641,701,258,310,562,53.412768439435034,13.978776912961695
2139,/media/marda/TWOTB1/xBD/hurricanes/images/florence/hurricane-florence_00000165_pre_disaster.png,62,53,1,661,723,275,328,611,50.87378665164681,16.04272797671756
2140,/media/marda/TWOTB1/xBD/hurricanes/images/florence/hurricane-florence_00000165_pre_disaster.png,49,26,1,812,861,284,310,214,18.211314300259396,15.622804639981688
2141,/media/marda/TWOTB1/xBD/hurricanes/images/florence/hurricane-florence_00000165_pre_disaster.png,63,65,1,981,1044,289,354,743,67.92303378419912,20.789094535756224
2142,/media/marda/TWOTB1/xBD/hurricanes/images/florence/hurricane-florence_00000165_pre_disaster.png,53,34,1,644,697,313,347,220,34.002759152849535,8.653235562249915
2143,/media/marda/TWOTB1/xBD/hurricanes/images/florence/hurricane-florence_00000165_pre_disaster.png,66,47,1,815,881,380,427,774,33.33099115223429,31.02352924620802
2144,/media/marda/TWOTB1/xBD/hurricanes/images/florence/hurricane-florence_00000165_pre_disaster.png,86,74,1,864,950,405,479,2028,57.613361362645875,47.12202479848302
2145,/media/marda/TWOTB1/xBD/hurricanes/images/florence/hurricane-florence_00000165_pre_disaster.png,19,50,1,0,19,500,550,309,28.637831244643717,15.239927442656882
2146,/media/marda/TWOTB1/xBD/hurricanes/images/florence/hurricane-florence_00000165_pre_disaster.png,33,58,1,31,64,506,564,657,34.02343175298834,26.785441367284808
2147,/media/marda/TWOTB1/xBD/hurricanes/images/florence/hurricane-florence_00000165_pre_disaster.png,77,49,1,842,919,506,555,774,46.996766637843585,21.995773332723193
2148,/media/marda/TWOTB1/xBD/hurricanes/images/florence/hurricane-florence_00000165_pre_disaster.png,75,58,1,922,997,507,565,910,43.03151091295018,31.081789290293717
2149,/media/marda/TWOTB1/xBD/hurricanes/images/florence/hurricane-florence_00000165_pre_disaster.png,64,60,1,927,991,572,632,759,42.82512209822185,23.496686211241563
2150,/media/marda/TWOTB1/xBD/hurricanes/images/florence/hurricane-florence_00000165_pre_disaster.png,40,30,1,875,915,576,606,58,9.772922914889326,8.115989652806284
2151,/media/marda/TWOTB1/xBD/hurricanes/images/florence/hurricane-florence_00000165_pre_disaster.png,64,64,1,937,1001,633,697,779,41.05954138476686,25.33378965959575
2152,/media/marda/TWOTB1/xBD/hurricanes/images/florence/hurricane-florence_00000165_pre_disaster.png,68,60,1,872,940,664,724,747,37.69598672162118,29.221393589893463
2153,/media/marda/TWOTB1/xBD/hurricanes/images/florence/hurricane-florence_00000165_pre_disaster.png,66,68,1,949,1015,699,767,870,41.2128696827932,28.164641251893404
2154,/media/marda/TWOTB1/xBD/hurricanes/images/florence/hurricane-florence_00000165_pre_disaster.png,86,80,1,944,1030,753,833,1438,59.41200705624623,36.69079111457899
2155,/media/marda/TWOTB1/xBD/hurricanes/images/florence/hurricane-florence_00000165_pre_disaster.png,65,74,1,976,1041,831,905,764,44.24041993215781,23.043625487357026
2156,/media/marda/TWOTB1/xBD/hurricanes/images/florence/hurricane-florence_00000165_pre_disaster.png,59,83,1,985,1044,893,976,677,50.042651041090544,18.185515661161777
2157,/media/marda/TWOTB1/xBD/hurricanes/images/florence/hurricane-florence_00000165_pre_disaster.png,61,60,1,940,1001,896,956,462,27.006168378928844,22.47747564295788
2158,/media/marda/TWOTB1/xBD/hurricanes/images/florence/hurricane-florence_00000165_pre_disaster.png,76,62,1,947,1023,953,1015,695,41.30702111562471,22.009846543987084
2159,/media/marda/TWOTB1/xBD/hurricanes/images/florence/hurricane-florence_00000165_pre_disaster.png,58,51,1,959,1017,993,1044,139,20.569917167533944,10.106184464273937
2160,/media/marda/TWOTB1/xBD/hurricanes/images/florence/hurricane-florence_00000458_pre_disaster.png,85,37,1,393,478,0,37,1229,53.94448027253851,36.564678712422
2161,/media/marda/TWOTB1/xBD/hurricanes/images/florence/hurricane-florence_00000458_pre_disaster.png,65,53,1,979,1044,0,53,913,62.29122006990762,21.526142198569165
2162,/media/marda/TWOTB1/xBD/hurricanes/images/florence/hurricane-florence_00000458_pre_disaster.png,74,53,1,78,152,52,105,2143,68.14415940775676,44.58952304380487
2163,/media/marda/TWOTB1/xBD/hurricanes/images/florence/hurricane-florence_00000458_pre_disaster.png,80,53,1,464,544,105,158,1554,56.38031422884023,39.78694528055564
2164,/media/marda/TWOTB1/xBD/hurricanes/images/florence/hurricane-florence_00000458_pre_disaster.png,90,63,1,921,1011,133,196,1919,65.99434199832383,40.27930571592048
2165,/media/marda/TWOTB1/xBD/hurricanes/images/florence/hurricane-florence_00000458_pre_disaster.png,79,65,1,795,874,144,209,2132,67.265888027533,46.632155211596306
2166,/media/marda/TWOTB1/xBD/hurricanes/images/florence/hurricane-florence_00000458_pre_disaster.png,57,57,1,987,1044,145,202,860,58.91352662288028,19.247977680307677
2167,/media/marda/TWOTB1/xBD/hurricanes/images/florence/hurricane-florence_00000458_pre_disaster.png,76,56,1,872,948,148,204,1824,57.00095005168543,43.88192866795211
2168,/media/marda/TWOTB1/xBD/hurricanes/images/florence/hurricane-florence_00000458_pre_disaster.png,19,29,1,0,19,168,197,276,21.695229868780398,17.83023541618701
2169,/media/marda/TWOTB1/xBD/hurricanes/images/florence/hurricane-florence_00000458_pre_disaster.png,18,30,1,0,18,197,227,273,22.61499223542057,17.310934713032136
2170,/media/marda/TWOTB1/xBD/hurricanes/images/florence/hurricane-florence_00000458_pre_disaster.png,75,68,1,145,220,445,513,1731,59.47855633807092,41.220917113682646
2171,/media/marda/TWOTB1/xBD/hurricanes/images/florence/hurricane-florence_00000458_pre_disaster.png,75,68,1,898,973,446,514,1243,56.02797154724055,31.80016073150321
2172,/media/marda/TWOTB1/xBD/hurricanes/images/florence/hurricane-florence_00000458_pre_disaster.png,80,68,1,943,1023,446,514,1623,53.30552250275413,41.13791803070427
2173,/media/marda/TWOTB1/xBD/hurricanes/images/florence/hurricane-florence_00000458_pre_disaster.png,72,68,1,853,925,462,530,1219,49.9565547401361,32.41002455104897
2174,/media/marda/TWOTB1/xBD/hurricanes/images/florence/hurricane-florence_00000458_pre_disaster.png,59,56,1,985,1044,464,520,461,42.23386159529472,16.181702398123317
2175,/media/marda/TWOTB1/xBD/hurricanes/images/florence/hurricane-florence_00000458_pre_disaster.png,73,70,1,366,439,491,561,1556,52.74075858305211,39.863960049681
2176,/media/marda/TWOTB1/xBD/hurricanes/images/florence/hurricane-florence_00000458_pre_disaster.png,60,77,1,194,254,501,578,1566,53.23866987372817,42.89610936877908
2177,/media/marda/TWOTB1/xBD/hurricanes/images/florence/hurricane-florence_00000458_pre_disaster.png,78,70,1,923,1001,560,630,1427,54.1470296978569,35.39301773200918
2178,/media/marda/TWOTB1/xBD/hurricanes/images/florence/hurricane-florence_00000458_pre_disaster.png,79,57,1,880,959,569,626,1129,45.21072842115897,33.56594093564635
2179,/media/marda/TWOTB1/xBD/hurricanes/images/florence/hurricane-florence_00000458_pre_disaster.png,62,64,1,982,1044,575,639,597,45.45697026747222,19.345951428035203
2180,/media/marda/TWOTB1/xBD/hurricanes/images/florence/hurricane-florence_00000458_pre_disaster.png,61,75,1,284,345,601,676,1475,47.97924096027215,41.954607924557905
2181,/media/marda/TWOTB1/xBD/hurricanes/images/florence/hurricane-florence_00000458_pre_disaster.png,86,71,1,903,989,625,696,1401,56.60331940052017,32.92626065609904
2182,/media/marda/TWOTB1/xBD/hurricanes/images/florence/hurricane-florence_00000458_pre_disaster.png,77,67,1,574,651,650,717,1618,54.85095225246337,40.04326373878593
2183,/media/marda/TWOTB1/xBD/hurricanes/images/florence/hurricane-florence_00000458_pre_disaster.png,75,61,1,900,975,680,741,778,41.405724435672965,28.83613391544541
2184,/media/marda/TWOTB1/xBD/hurricanes/images/florence/hurricane-florence_00000458_pre_disaster.png,80,80,1,538,618,716,796,1742,60.65184643894725,40.781895250137424
2185,/media/marda/TWOTB1/xBD/hurricanes/images/florence/hurricane-florence_00000458_pre_disaster.png,89,74,1,922,1011,721,795,1419,53.93434703864585,34.74429144382492
2186,/media/marda/TWOTB1/xBD/hurricanes/images/florence/hurricane-florence_00000458_pre_disaster.png,62,64,1,982,1044,729,793,485,33.955711822596975,21.886789098782575
2187,/media/marda/TWOTB1/xBD/hurricanes/images/florence/hurricane-florence_00000458_pre_disaster.png,72,83,1,972,1044,791,874,1164,48.67683748068625,35.22969258484269
2188,/media/marda/TWOTB1/xBD/hurricanes/images/florence/hurricane-florence_00000458_pre_disaster.png,81,77,1,535,616,799,876,1896,57.856625980430266,46.887018247923116
2189,/media/marda/TWOTB1/xBD/hurricanes/images/florence/hurricane-florence_00000458_pre_disaster.png,75,91,1,890,965,804,895,1543,59.975718340578865,35.32902385511952
2190,/media/marda/TWOTB1/xBD/hurricanes/images/florence/hurricane-florence_00000458_pre_disaster.png,63,79,1,390,453,863,942,1718,56.43553864372477,41.00918007777012
2191,/media/marda/TWOTB1/xBD/hurricanes/images/florence/hurricane-florence_00000458_pre_disaster.png,89,106,1,36,125,899,1005,2556,96.86173805910718,37.735821196478774
2192,/media/marda/TWOTB1/xBD/hurricanes/images/florence/hurricane-florence_00000458_pre_disaster.png,81,91,1,947,1028,910,1001,1487,54.9772140979739,38.1090699390107
2193,/media/marda/TWOTB1/xBD/hurricanes/images/florence/hurricane-florence_00000458_pre_disaster.png,60,85,1,400,460,919,1004,1631,51.522972706737725,43.97302191912897
2194,/media/marda/TWOTB1/xBD/hurricanes/images/florence/hurricane-florence_00000458_pre_disaster.png,74,91,1,903,977,919,1010,1188,52.331158350878376,33.97613755097854
2195,/media/marda/TWOTB1/xBD/hurricanes/images/florence/hurricane-florence_00000458_pre_disaster.png,87,85,1,539,626,957,1042,2229,65.72037690083253,47.87342106657583
2196,/media/marda/TWOTB1/xBD/hurricanes/images/florence/hurricane-florence_00000407_post_disaster.png,36,36,1,46,82,34,70,807,35.221623577743465,30.74060137862429
2197,/media/marda/TWOTB1/xBD/hurricanes/images/florence/hurricane-florence_00000407_post_disaster.png,153,131,1,121,274,67,198,9757,160.09396381844013,90.06538775319433
2198,/media/marda/TWOTB1/xBD/hurricanes/images/florence/hurricane-florence_00000407_post_disaster.png,40,41,1,80,120,80,121,910,36.6899636201543,32.582199140268195
2199,/media/marda/TWOTB1/xBD/hurricanes/images/florence/hurricane-florence_00000407_post_disaster.png,30,26,1,157,187,83,109,346,21.83039498444147,21.17830399313375
2200,/media/marda/TWOTB1/xBD/hurricanes/images/florence/hurricane-florence_00000407_post_disaster.png,145,169,1,80,225,870,1039,12876,136.4519188050912,127.6829985927464
2201,/media/marda/TWOTB1/xBD/hurricanes/images/florence/hurricane-florence_00000407_post_disaster.png,68,42,1,413,481,0,42,1424,49.72235582205935,38.851315787210986
2202,/media/marda/TWOTB1/xBD/hurricanes/images/florence/hurricane-florence_00000407_post_disaster.png,52,15,1,533,585,0,15,251,27.614520386641153,13.929066354933273
2203,/media/marda/TWOTB1/xBD/hurricanes/images/florence/hurricane-florence_00000407_post_disaster.png,90,36,1,557,647,0,36,1539,65.57579927080751,32.00348348338317
2204,/media/marda/TWOTB1/xBD/hurricanes/images/florence/hurricane-florence_00000407_post_disaster.png,76,56,1,598,674,17,73,1702,57.67372431183202,41.29148934789496
2205,/media/marda/TWOTB1/xBD/hurricanes/images/florence/hurricane-florence_00000407_post_disaster.png,61,47,1,446,507,22,69,1090,42.44666773353674,35.08605464768367
2206,/media/marda/TWOTB1/xBD/hurricanes/images/florence/hurricane-florence_00000407_post_disaster.png,68,60,1,460,528,59,119,1759,57.13121456759295,41.03130413456759
2207,/media/marda/TWOTB1/xBD/hurricanes/images/florence/hurricane-florence_00000407_post_disaster.png,74,48,1,476,550,103,151,1450,52.593975436546955,36.28132479327244
2208,/media/marda/TWOTB1/xBD/hurricanes/images/florence/hurricane-florence_00000407_post_disaster.png,62,79,1,24,86,587,666,2120,56.926144643401,48.99296217798469
2209,/media/marda/TWOTB1/xBD/hurricanes/images/florence/hurricane-florence_00000407_post_disaster.png,64,83,1,54,118,639,722,2179,55.86137620903905,50.80634163622952
2210,/media/marda/TWOTB1/xBD/hurricanes/images/florence/hurricane-florence_00000407_post_disaster.png,91,73,1,952,1043,698,771,1911,54.730553019680386,45.59345000945759
2211,/media/marda/TWOTB1/xBD/hurricanes/images/florence/hurricane-florence_00000181_pre_disaster.png,95,34,1,884,979,88,122,1267,64.35138828971668,29.231357354295785
2212,/media/marda/TWOTB1/xBD/hurricanes/images/florence/hurricane-florence_00000181_pre_disaster.png,46,21,1,712,758,245,266,130,18.13801234294641,9.665259539967586
2213,/media/marda/TWOTB1/xBD/hurricanes/images/florence/hurricane-florence_00000181_pre_disaster.png,83,62,1,677,760,282,344,1321,60.32104702980914,30.789690314285455
2214,/media/marda/TWOTB1/xBD/hurricanes/images/florence/hurricane-florence_00000181_pre_disaster.png,48,58,1,33,81,297,355,1293,49.06798342244543,36.1506611802765
2215,/media/marda/TWOTB1/xBD/hurricanes/images/florence/hurricane-florence_00000181_pre_disaster.png,55,59,1,198,253,367,426,1647,48.491162111734475,45.375187093649394
2216,/media/marda/TWOTB1/xBD/hurricanes/images/florence/hurricane-florence_00000181_pre_disaster.png,49,61,1,20,69,420,481,1285,48.98943228065171,36.34347349678801
2217,/media/marda/TWOTB1/xBD/hurricanes/images/florence/hurricane-florence_00000181_pre_disaster.png,21,36,1,132,153,440,476,221,19.879166648262128,14.653263158083424
2218,/media/marda/TWOTB1/xBD/hurricanes/images/florence/hurricane-florence_00000181_pre_disaster.png,81,63,1,963,1044,453,516,986,51.42743867766921,26.66229999598548
2219,/media/marda/TWOTB1/xBD/hurricanes/images/florence/hurricane-florence_00000181_pre_disaster.png,23,33,1,137,160,462,495,201,19.249482935972793,14.026516565104517
2220,/media/marda/TWOTB1/xBD/hurricanes/images/florence/hurricane-florence_00000181_pre_disaster.png,39,61,1,46,85,497,558,1179,42.64474407436934,36.915141816951575
2221,/media/marda/TWOTB1/xBD/hurricanes/images/florence/hurricane-florence_00000181_pre_disaster.png,102,70,1,825,927,588,658,1581,65.95788132210497,37.4672024533267
2222,/media/marda/TWOTB1/xBD/hurricanes/images/florence/hurricane-florence_00000181_pre_disaster.png,65,55,1,832,897,634,689,555,30.513911718750297,24.300190199388844
2223,/media/marda/TWOTB1/xBD/hurricanes/images/florence/hurricane-florence_00000181_pre_disaster.png,79,68,1,950,1029,634,702,672,52.16957143150488,17.36984528629685
2224,/media/marda/TWOTB1/xBD/hurricanes/images/florence/hurricane-florence_00000181_pre_disaster.png,74,67,1,724,798,662,729,1099,44.73246850180502,32.76502786742514
2225,/media/marda/TWOTB1/xBD/hurricanes/images/florence/hurricane-florence_00000181_pre_disaster.png,46,33,1,967,1013,684,717,45,9.014163291733533,6.790637774504804
2226,/media/marda/TWOTB1/xBD/hurricanes/images/florence/hurricane-florence_00000181_pre_disaster.png,18,60,1,0,18,691,751,308,27.654227622006577,16.480012198668568
2227,/media/marda/TWOTB1/xBD/hurricanes/images/florence/hurricane-florence_00000181_pre_disaster.png,49,45,1,797,846,699,744,142,16.172751399681214,11.825775910342026
2228,/media/marda/TWOTB1/xBD/hurricanes/images/florence/hurricane-florence_00000181_pre_disaster.png,73,71,1,744,817,707,778,981,36.478635552411646,35.56263871530959
2229,/media/marda/TWOTB1/xBD/hurricanes/images/florence/hurricane-florence_00000181_pre_disaster.png,29,57,1,16,45,714,771,421,23.834060858627733,23.588738906141323
2230,/media/marda/TWOTB1/xBD/hurricanes/images/florence/hurricane-florence_00000181_pre_disaster.png,35,53,1,177,212,739,792,392,25.408740065290566,21.034039307606996
2231,/media/marda/TWOTB1/xBD/hurricanes/images/florence/hurricane-florence_00000181_pre_disaster.png,58,98,1,195,253,758,856,1732,66.6794162318936,40.503824004159824
2232,/media/marda/TWOTB1/xBD/hurricanes/images/florence/hurricane-florence_00000181_pre_disaster.png,92,92,1,553,645,781,873,1843,77.9720566946921,33.77314068503703
2233,/media/marda/TWOTB1/xBD/hurricanes/images/florence/hurricane-florence_00000181_pre_disaster.png,44,45,1,603,647,825,870,202,21.281172468812837,12.732698038622512
2234,/media/marda/TWOTB1/xBD/hurricanes/images/florence/hurricane-florence_00000181_pre_disaster.png,28,61,1,100,128,836,897,423,28.334971269778013,19.951593608633015
2235,/media/marda/TWOTB1/xBD/hurricanes/images/florence/hurricane-florence_00000181_pre_disaster.png,38,65,1,154,192,839,904,582,28.919220547178067,27.238094658411825
2236,/media/marda/TWOTB1/xBD/hurricanes/images/florence/hurricane-florence_00000181_pre_disaster.png,48,64,1,156,204,872,936,499,47.96937492193082,13.890276615525018
2237,/media/marda/TWOTB1/xBD/hurricanes/images/florence/hurricane-florence_00000181_pre_disaster.png,52,60,1,582,634,872,932,424,27.59786650748471,20.518266829072477
2238,/media/marda/TWOTB1/xBD/hurricanes/images/florence/hurricane-florence_00000181_pre_disaster.png,53,88,1,77,130,900,988,1253,58.10057422009786,29.023869592995712
2239,/media/marda/TWOTB1/xBD/hurricanes/images/florence/hurricane-florence_00000181_pre_disaster.png,20,67,1,0,20,948,1015,379,27.753030478893912,18.835060868171947
2240,/media/marda/TWOTB1/xBD/hurricanes/images/florence/hurricane-florence_00000181_pre_disaster.png,57,85,1,251,308,954,1039,1267,43.734139817602006,41.432935942285866
2241,/media/marda/TWOTB1/xBD/hurricanes/images/florence/hurricane-florence_00000181_pre_disaster.png,30,55,1,314,344,989,1044,179,17.057940703443823,14.189428552269174
2242,/media/marda/TWOTB1/xBD/hurricanes/images/florence/hurricane-florence_00000082_post_disaster.png,79,68,1,654,733,429,497,1289,58.696657224151096,29.02788475807173
2243,/media/marda/TWOTB1/xBD/hurricanes/images/florence/hurricane-florence_00000082_post_disaster.png,23,39,1,74,97,461,500,277,20.28629039451931,18.223363322002218
2244,/media/marda/TWOTB1/xBD/hurricanes/images/florence/hurricane-florence_00000082_post_disaster.png,58,63,1,792,850,901,964,327,24.175794537447214,21.949968117356715
2245,/media/marda/TWOTB1/xBD/hurricanes/images/florence/hurricane-florence_00000313_pre_disaster.png,72,70,1,367,439,464,534,1628,53.00555364432616,40.85125051934403
2246,/media/marda/TWOTB1/xBD/hurricanes/images/florence/hurricane-florence_00000313_pre_disaster.png,35,48,1,426,461,503,551,205,34.21516016481987,8.802167403837663
2247,/media/marda/TWOTB1/xBD/hurricanes/images/florence/hurricane-florence_00000313_pre_disaster.png,73,74,1,456,529,526,600,1435,56.80192867760505,34.23115142766797
2248,/media/marda/TWOTB1/xBD/hurricanes/images/florence/hurricane-florence_00000313_pre_disaster.png,33,36,1,426,459,588,624,144,14.421733334426877,13.272913901368826
2249,/media/marda/TWOTB1/xBD/hurricanes/images/florence/hurricane-florence_00000313_pre_disaster.png,80,75,1,445,525,605,680,1417,66.03687350240023,28.632626474193444
2250,/media/marda/TWOTB1/xBD/hurricanes/images/florence/hurricane-florence_00000313_pre_disaster.png,53,57,1,563,616,630,687,499,33.615684757506735,19.739023505567964
2251,/media/marda/TWOTB1/xBD/hurricanes/images/florence/hurricane-florence_00000313_pre_disaster.png,55,59,1,578,633,661,720,590,29.995816907654067,27.211462447378942
2252,/media/marda/TWOTB1/xBD/hurricanes/images/florence/hurricane-florence_00000313_pre_disaster.png,71,66,1,520,591,672,738,950,55.624242677000794,22.80701828647969
2253,/media/marda/TWOTB1/xBD/hurricanes/images/florence/hurricane-florence_00000313_pre_disaster.png,53,51,1,991,1044,698,749,208,23.003664911724748,12.392468056622503
2254,/media/marda/TWOTB1/xBD/hurricanes/images/florence/hurricane-florence_00000313_pre_disaster.png,47,52,1,542,589,714,766,302,25.75961581215708,15.829574630426828
2255,/media/marda/TWOTB1/xBD/hurricanes/images/florence/hurricane-florence_00000313_pre_disaster.png,45,42,1,729,774,757,799,137,17.017002962841616,10.846644597873796
2256,/media/marda/TWOTB1/xBD/hurricanes/images/florence/hurricane-florence_00000313_pre_disaster.png,45,60,1,562,607,795,855,464,28.326733700843302,21.557400803968907
2257,/media/marda/TWOTB1/xBD/hurricanes/images/florence/hurricane-florence_00000313_pre_disaster.png,40,53,1,521,561,818,871,227,24.247926336798983,14.97139893586878
2258,/media/marda/TWOTB1/xBD/hurricanes/images/florence/hurricane-florence_00000313_pre_disaster.png,86,66,1,953,1039,830,896,1001,50.18577725068376,26.648124127121875
2259,/media/marda/TWOTB1/xBD/hurricanes/images/florence/hurricane-florence_00000313_pre_disaster.png,57,56,1,326,383,837,893,488,51.03395135693737,12.692087597644244
2260,/media/marda/TWOTB1/xBD/hurricanes/images/florence/hurricane-florence_00000313_pre_disaster.png,63,66,1,531,594,841,907,971,42.380855986482935,30.109826464310757
2261,/media/marda/TWOTB1/xBD/hurricanes/images/florence/hurricane-florence_00000313_pre_disaster.png,109,135,1,862,971,854,989,5013,103.71555429611757,64.83100821812754
2262,/media/marda/TWOTB1/xBD/hurricanes/images/florence/hurricane-florence_00000313_pre_disaster.png,61,71,1,337,398,880,951,1206,48.92624811076614,32.98971743997481
2263,/media/marda/TWOTB1/xBD/hurricanes/images/florence/hurricane-florence_00000313_pre_disaster.png,28,61,1,109,137,912,973,342,25.140281587787456,18.200935769808652
2264,/media/marda/TWOTB1/xBD/hurricanes/images/florence/hurricane-florence_00000313_pre_disaster.png,74,68,1,685,759,925,993,921,50.10222788329909,24.860053200378925
2265,/media/marda/TWOTB1/xBD/hurricanes/images/florence/hurricane-florence_00000313_pre_disaster.png,84,79,1,812,896,933,1012,1532,53.93529434853482,37.85763447843117
2266,/media/marda/TWOTB1/xBD/hurricanes/images/florence/hurricane-florence_00000313_pre_disaster.png,91,75,1,878,969,967,1042,1416,57.58999128733979,35.88416901586174
2267,/media/marda/TWOTB1/xBD/hurricanes/images/florence/hurricane-florence_00000313_pre_disaster.png,65,62,1,504,569,980,1042,789,43.593202474493445,24.847614394067797
2268,/media/marda/TWOTB1/xBD/hurricanes/images/florence/hurricane-florence_00000292_pre_disaster.png,74,65,1,932,1006,428,493,830,56.343974546730514,19.62476813350011
2269,/media/marda/TWOTB1/xBD/hurricanes/images/florence/hurricane-florence_00000292_pre_disaster.png,57,36,1,909,966,485,521,254,19.277335440536778,17.241913702124954
2270,/media/marda/TWOTB1/xBD/hurricanes/images/florence/hurricane-florence_00000292_pre_disaster.png,74,61,1,877,951,655,716,588,50.25387539360551,15.502686301994562
2271,/media/marda/TWOTB1/xBD/hurricanes/images/florence/hurricane-florence_00000292_pre_disaster.png,58,75,1,546,604,692,767,976,47.52284629606014,27.243520411844422
2272,/media/marda/TWOTB1/xBD/hurricanes/images/florence/hurricane-florence_00000292_pre_disaster.png,46,52,1,452,498,730,782,368,30.852621204256895,15.709597387642885
2273,/media/marda/TWOTB1/xBD/hurricanes/images/florence/hurricane-florence_00000292_pre_disaster.png,39,52,1,468,507,749,801,298,21.539251068578906,18.345363255282127
2274,/media/marda/TWOTB1/xBD/hurricanes/images/florence/hurricane-florence_00000292_pre_disaster.png,78,61,1,720,798,753,814,622,57.44207596724492,14.41853467495914
2275,/media/marda/TWOTB1/xBD/hurricanes/images/florence/hurricane-florence_00000292_pre_disaster.png,46,48,1,726,772,785,833,144,17.658501455166398,10.921924622931495
2276,/media/marda/TWOTB1/xBD/hurricanes/images/florence/hurricane-florence_00000292_pre_disaster.png,72,78,1,891,963,813,891,585,54.57725136144143,14.250565178153801
2277,/media/marda/TWOTB1/xBD/hurricanes/images/florence/hurricane-florence_00000292_pre_disaster.png,46,46,1,742,788,865,911,141,16.419593620753012,11.390392561660661
2278,/media/marda/TWOTB1/xBD/hurricanes/images/florence/hurricane-florence_00000292_pre_disaster.png,51,55,1,733,784,882,937,246,26.316679082793673,12.44399924606281
2279,/media/marda/TWOTB1/xBD/hurricanes/images/florence/hurricane-florence_00000278_post_disaster.png,75,15,1,857,932,0,15,315,36.91614308059958,13.10603278441741
2280,/media/marda/TWOTB1/xBD/hurricanes/images/florence/hurricane-florence_00000278_post_disaster.png,71,33,1,796,867,26,59,741,38.94076081407525,25.251973184065086
2281,/media/marda/TWOTB1/xBD/hurricanes/images/florence/hurricane-florence_00000278_post_disaster.png,42,13,1,761,803,33,46,105,13.560827634255936,10.187903954228096
2282,/media/marda/TWOTB1/xBD/hurricanes/images/florence/hurricane-florence_00000278_post_disaster.png,39,11,1,716,755,37,48,64,11.29914813027723,7.693414490982049
2283,/media/marda/TWOTB1/xBD/hurricanes/images/florence/hurricane-florence_00000278_post_disaster.png,75,38,1,725,800,56,94,1010,45.517137252394505,29.336017270890018
2284,/media/marda/TWOTB1/xBD/hurricanes/images/florence/hurricane-florence_00000278_post_disaster.png,80,42,1,650,730,89,131,1137,54.418863938299516,27.801466608694003
2285,/media/marda/TWOTB1/xBD/hurricanes/images/florence/hurricane-florence_00000278_post_disaster.png,66,38,1,977,1043,104,142,585,31.504439528320898,25.21674731378124
2286,/media/marda/TWOTB1/xBD/hurricanes/images/florence/hurricane-florence_00000278_post_disaster.png,75,46,1,581,656,121,167,1132,53.25499968532685,28.369847270954583
2287,/media/marda/TWOTB1/xBD/hurricanes/images/florence/hurricane-florence_00000278_post_disaster.png,58,37,1,512,570,164,201,750,34.33653020253455,28.59570003971828
2288,/media/marda/TWOTB1/xBD/hurricanes/images/florence/hurricane-florence_00000278_post_disaster.png,85,66,1,839,924,166,232,1314,66.59402850738584,34.414718530720755
2289,/media/marda/TWOTB1/xBD/hurricanes/images/florence/hurricane-florence_00000278_post_disaster.png,77,43,1,761,838,195,238,950,48.22247215560462,26.176835845468545
2290,/media/marda/TWOTB1/xBD/hurricanes/images/florence/hurricane-florence_00000278_post_disaster.png,64,43,1,440,504,196,239,941,49.08629359682577,25.593270464766036
2291,/media/marda/TWOTB1/xBD/hurricanes/images/florence/hurricane-florence_00000278_post_disaster.png,71,47,1,692,763,223,270,1012,42.90041531266107,32.447696310853395
2292,/media/marda/TWOTB1/xBD/hurricanes/images/florence/hurricane-florence_00000278_post_disaster.png,62,48,1,369,431,227,275,1018,47.071500627252526,28.63653737480069
2293,/media/marda/TWOTB1/xBD/hurricanes/images/florence/hurricane-florence_00000278_post_disaster.png,49,26,1,810,859,237,263,221,17.74209853079069,16.56912582956142
2294,/media/marda/TWOTB1/xBD/hurricanes/images/florence/hurricane-florence_00000278_post_disaster.png,63,50,1,290,353,264,314,1123,54.82025423780547,27.34558456983233
2295,/media/marda/TWOTB1/xBD/hurricanes/images/florence/hurricane-florence_00000278_post_disaster.png,67,41,1,628,695,265,306,737,42.45084556173918,23.150746195449592
2296,/media/marda/TWOTB1/xBD/hurricanes/images/florence/hurricane-florence_00000278_post_disaster.png,45,33,1,577,622,266,299,322,22.76786697563335,18.90254045834747
2297,/media/marda/TWOTB1/xBD/hurricanes/images/florence/hurricane-florence_00000278_post_disaster.png,53,24,1,722,775,276,300,322,28.24201118964423,15.071006130453139
2298,/media/marda/TWOTB1/xBD/hurricanes/images/florence/hurricane-florence_00000278_post_disaster.png,75,48,1,542,617,294,342,1126,53.92449248966748,28.128647622302104
2299,/media/marda/TWOTB1/xBD/hurricanes/images/florence/hurricane-florence_00000278_post_disaster.png,62,46,1,458,520,338,384,761,47.85983855981262,21.13162404479329
2300,/media/marda/TWOTB1/xBD/hurricanes/images/florence/hurricane-florence_00000278_post_disaster.png,45,58,1,160,205,354,412,1134,43.60954079863284,35.13815761021312
2301,/media/marda/TWOTB1/xBD/hurricanes/images/florence/hurricane-florence_00000278_post_disaster.png,40,37,1,472,512,371,408,315,22.364151328714314,18.84046450311946
2302,/media/marda/TWOTB1/xBD/hurricanes/images/florence/hurricane-florence_00000278_post_disaster.png,53,47,1,396,449,391,438,770,38.94844800977286,26.157900071215018
2303,/media/marda/TWOTB1/xBD/hurricanes/images/florence/hurricane-florence_00000278_post_disaster.png,66,71,1,227,293,474,545,1680,56.60395687893107,40.18060279734881
2304,/media/marda/TWOTB1/xBD/hurricanes/images/florence/hurricane-florence_00000278_post_disaster.png,47,56,1,296,343,494,550,669,31.831255894344125,28.064515507122113
2305,/media/marda/TWOTB1/xBD/hurricanes/images/florence/hurricane-florence_00000417_post_disaster.png,131,30,1,825,956,0,30,1195,91.5682228716877,23.454276944623793
2306,/media/marda/TWOTB1/xBD/hurricanes/images/florence/hurricane-florence_00000417_post_disaster.png,137,53,1,798,935,16,69,2743,117.13041453126856,31.12535856890058
2307,/media/marda/TWOTB1/xBD/hurricanes/images/florence/hurricane-florence_00000417_post_disaster.png,138,54,1,781,919,63,117,2923,119.42162768999584,32.528435135548115
2308,/media/marda/TWOTB1/xBD/hurricanes/images/florence/hurricane-florence_00000417_post_disaster.png,44,9,1,880,924,68,77,70,9.696674760533577,9.188758028081663
2309,/media/marda/TWOTB1/xBD/hurricanes/images/florence/hurricane-florence_00000417_post_disaster.png,43,8,1,875,918,79,87,52,8.70613168114442,7.632596254777482
2310,/media/marda/TWOTB1/xBD/hurricanes/images/florence/hurricane-florence_00000417_post_disaster.png,48,17,1,769,817,135,152,165,18.51962617184771,11.872600939414392
2311,/media/marda/TWOTB1/xBD/hurricanes/images/florence/hurricane-florence_00000417_post_disaster.png,92,102,1,210,302,348,450,2872,106.79670248854305,35.83944185680542
2312,/media/marda/TWOTB1/xBD/hurricanes/images/florence/hurricane-florence_00000417_post_disaster.png,56,58,1,519,575,427,485,764,42.36162327673504,24.04785024195374
2313,/media/marda/TWOTB1/xBD/hurricanes/images/florence/hurricane-florence_00000417_post_disaster.png,55,47,1,490,545,482,529,544,38.57667801331843,18.83770869806321
2314,/media/marda/TWOTB1/xBD/hurricanes/images/florence/hurricane-florence_00000417_post_disaster.png,53,45,1,469,522,499,544,385,38.28195158923888,13.437473939655783
2315,/media/marda/TWOTB1/xBD/hurricanes/images/florence/hurricane-florence_00000417_post_disaster.png,56,53,1,536,592,509,562,690,32.95000049076508,27.538094839812967
2316,/media/marda/TWOTB1/xBD/hurricanes/images/florence/hurricane-florence_00000417_post_disaster.png,91,107,1,432,523,513,620,2856,87.37102106608589,49.93929210374756
2317,/media/marda/TWOTB1/xBD/hurricanes/images/florence/hurricane-florence_00000417_post_disaster.png,81,75,1,350,431,569,644,1770,65.22705805005467,38.71514339943724
2318,/media/marda/TWOTB1/xBD/hurricanes/images/florence/hurricane-florence_00000417_post_disaster.png,41,44,1,427,468,589,633,314,21.159049480202427,19.84177156857965
2319,/media/marda/TWOTB1/xBD/hurricanes/images/florence/hurricane-florence_00000417_post_disaster.png,90,96,1,430,520,624,720,2378,74.17563485317443,46.487102426932374
2320,/media/marda/TWOTB1/xBD/hurricanes/images/florence/hurricane-florence_00000417_post_disaster.png,59,68,1,269,328,662,730,989,56.12814785573231,23.255661784264856
2321,/media/marda/TWOTB1/xBD/hurricanes/images/florence/hurricane-florence_00000417_post_disaster.png,34,37,1,559,593,663,700,96,11.89276563867621,10.91466141466861
2322,/media/marda/TWOTB1/xBD/hurricanes/images/florence/hurricane-florence_00000417_post_disaster.png,34,37,1,575,609,671,708,94,11.922422293417393,10.554040058245041
2323,/media/marda/TWOTB1/xBD/hurricanes/images/florence/hurricane-florence_00000417_post_disaster.png,51,47,1,629,680,673,720,325,23.65399880550017,18.344080957896743
2324,/media/marda/TWOTB1/xBD/hurricanes/images/florence/hurricane-florence_00000417_post_disaster.png,58,61,1,499,557,682,743,777,38.53915201145792,26.705199284812117
2325,/media/marda/TWOTB1/xBD/hurricanes/images/florence/hurricane-florence_00000417_post_disaster.png,29,46,1,296,325,723,769,166,15.799099719716741,13.822244293336883
2326,/media/marda/TWOTB1/xBD/hurricanes/images/florence/hurricane-florence_00000417_post_disaster.png,75,78,1,550,625,725,803,1144,59.89065047310522,25.46925903408846
2327,/media/marda/TWOTB1/xBD/hurricanes/images/florence/hurricane-florence_00000417_post_disaster.png,84,95,1,402,486,784,879,1675,80.76808502597154,27.548817254580456
2328,/media/marda/TWOTB1/xBD/hurricanes/images/florence/hurricane-florence_00000417_post_disaster.png,47,52,1,704,751,795,847,188,18.663809023795825,13.495566599059877
2329,/media/marda/TWOTB1/xBD/hurricanes/images/florence/hurricane-florence_00000417_post_disaster.png,55,56,1,680,735,802,858,376,28.267048553073373,17.57843756509453
2330,/media/marda/TWOTB1/xBD/hurricanes/images/florence/hurricane-florence_00000417_post_disaster.png,76,79,1,653,729,835,914,1318,47.37304935443852,37.13496080420713
2331,/media/marda/TWOTB1/xBD/hurricanes/images/florence/hurricane-florence_00000417_post_disaster.png,58,66,1,483,541,881,947,668,35.427106021535906,26.991457057444933
2332,/media/marda/TWOTB1/xBD/hurricanes/images/florence/hurricane-florence_00000417_post_disaster.png,77,94,1,452,529,890,984,1695,52.28554791044908,43.26472173921092
2333,/media/marda/TWOTB1/xBD/hurricanes/images/florence/hurricane-florence_00000417_post_disaster.png,40,52,1,614,654,936,988,127,14.89355721107665,11.48589975092355
2334,/media/marda/TWOTB1/xBD/hurricanes/images/florence/hurricane-florence_00000417_post_disaster.png,53,70,1,437,490,951,1021,602,40.196779398855064,19.829044665858046
2335,/media/marda/TWOTB1/xBD/hurricanes/images/florence/hurricane-florence_00000417_post_disaster.png,70,76,1,475,545,965,1041,1175,44.57612218874193,35.97216019334395
2336,/media/marda/TWOTB1/xBD/hurricanes/images/florence/hurricane-florence_00000417_post_disaster.png,101,75,1,566,667,966,1041,1529,65.44248377993625,36.55126265267652
2337,/media/marda/TWOTB1/xBD/hurricanes/images/florence/hurricane-florence_00000010_post_disaster.png,61,31,1,263,324,0,31,987,47.323667669536555,29.32154618968827
2338,/media/marda/TWOTB1/xBD/hurricanes/images/florence/hurricane-florence_00000010_post_disaster.png,85,29,1,441,526,0,29,1100,62.6340775431939,26.148829844067585
2339,/media/marda/TWOTB1/xBD/hurricanes/images/florence/hurricane-florence_00000010_post_disaster.png,88,53,1,942,1030,11,64,1612,49.9916991987093,45.9179985753295
2340,/media/marda/TWOTB1/xBD/hurricanes/images/florence/hurricane-florence_00000010_post_disaster.png,73,56,1,803,876,13,69,1471,56.07270688455571,35.011843340247665
2341,/media/marda/TWOTB1/xBD/hurricanes/images/florence/hurricane-florence_00000010_post_disaster.png,81,46,1,377,458,18,64,2407,74.76363429451085,43.1772616432671
2342,/media/marda/TWOTB1/xBD/hurricanes/images/florence/hurricane-florence_00000010_post_disaster.png,78,38,1,628,706,31,69,1545,55.24926999790414,37.23402658262626
2343,/media/marda/TWOTB1/xBD/hurricanes/images/florence/hurricane-florence_00000010_post_disaster.png,57,44,1,225,282,83,127,1621,48.28118395444827,44.260208503226465
2344,/media/marda/TWOTB1/xBD/hurricanes/images/florence/hurricane-florence_00000010_post_disaster.png,89,56,1,640,729,83,139,1966,63.124195427020055,45.97624254768161
2345,/media/marda/TWOTB1/xBD/hurricanes/images/florence/hurricane-florence_00000010_post_disaster.png,95,69,1,501,596,91,160,2382,69.45663101190225,56.388131558587254
2346,/media/marda/TWOTB1/xBD/hurricanes/images/florence/hurricane-florence_00000010_post_disaster.png,97,70,1,829,926,97,167,2202,63.82307505293925,47.68585555246726
2347,/media/marda/TWOTB1/xBD/hurricanes/images/florence/hurricane-florence_00000010_post_disaster.png,66,52,1,357,423,122,174,2034,55.98691419481864,50.08418665349497
2348,/media/marda/TWOTB1/xBD/hurricanes/images/florence/hurricane-florence_00000010_post_disaster.png,80,58,1,216,296,148,206,2013,66.363863232743,44.05738496326887
2349,/media/marda/TWOTB1/xBD/hurricanes/images/florence/hurricane-florence_00000010_post_disaster.png,82,50,1,660,742,152,202,1782,58.21110162172789,47.297399879675645
2350,/media/marda/TWOTB1/xBD/hurricanes/images/florence/hurricane-florence_00000010_post_disaster.png,81,83,1,413,494,160,243,2539,71.09612885962686,53.252763566267895
2351,/media/marda/TWOTB1/xBD/hurricanes/images/florence/hurricane-florence_00000010_post_disaster.png,83,59,1,245,328,205,264,1743,70.19017483505388,37.84963571293558
2352,/media/marda/TWOTB1/xBD/hurricanes/images/florence/hurricane-florence_00000010_post_disaster.png,72,58,1,453,525,215,273,1451,48.20231400304757,40.4503534493317
2353,/media/marda/TWOTB1/xBD/hurricanes/images/florence/hurricane-florence_00000010_post_disaster.png,90,71,1,619,709,217,288,2074,59.11163734037515,50.69058978313501
2354,/media/marda/TWOTB1/xBD/hurricanes/images/florence/hurricane-florence_00000010_post_disaster.png,65,66,1,298,363,234,300,1652,50.377172184073096,43.7173387848752
2355,/media/marda/TWOTB1/xBD/hurricanes/images/florence/hurricane-florence_00000010_post_disaster.png,85,55,1,515,600,242,297,1584,61.34795600412511,36.834356627245036
2356,/media/marda/TWOTB1/xBD/hurricanes/images/florence/hurricane-florence_00000010_post_disaster.png,19,18,1,263,282,256,274,54,10.062461072716959,7.216662004929232
2357,/media/marda/TWOTB1/xBD/hurricanes/images/florence/hurricane-florence_00000010_post_disaster.png,75,66,1,343,418,278,344,1994,56.202502803972635,48.13204744980702
2358,/media/marda/TWOTB1/xBD/hurricanes/images/florence/hurricane-florence_00000010_post_disaster.png,89,74,1,545,634,300,374,2464,75.66508419869783,44.21982315601935
2359,/media/marda/TWOTB1/xBD/hurricanes/images/florence/hurricane-florence_00000010_post_disaster.png,77,76,1,391,468,323,399,2031,58.21747810886674,51.447841232691154
2360,/media/marda/TWOTB1/xBD/hurricanes/images/florence/hurricane-florence_00000010_post_disaster.png,103,103,1,6,109,372,475,5495,113.98886034525374,72.36581147728671
2361,/media/marda/TWOTB1/xBD/hurricanes/images/florence/hurricane-florence_00000010_post_disaster.png,75,82,1,436,511,374,456,2408,62.87501742153275,52.67857332077988
2362,/media/marda/TWOTB1/xBD/hurricanes/images/florence/hurricane-florence_00000010_post_disaster.png,94,66,1,942,1036,374,440,1699,47.85295570199535,46.374495986130114
2363,/media/marda/TWOTB1/xBD/hurricanes/images/florence/hurricane-florence_00000010_post_disaster.png,87,70,1,510,597,379,449,2258,68.2200183097748,45.67636269364156
2364,/media/marda/TWOTB1/xBD/hurricanes/images/florence/hurricane-florence_00000010_post_disaster.png,107,112,1,118,225,486,598,5190,122.25180953997503,62.52895832600648
2365,/media/marda/TWOTB1/xBD/hurricanes/images/florence/hurricane-florence_00000010_post_disaster.png,105,145,1,0,105,522,667,6068,133.89687868265273,86.20941321659427
2366,/media/marda/TWOTB1/xBD/hurricanes/images/florence/hurricane-florence_00000010_post_disaster.png,51,49,1,111,162,522,571,820,53.47470330657601,20.472674358453823
2367,/media/marda/TWOTB1/xBD/hurricanes/images/florence/hurricane-florence_00000010_post_disaster.png,52,46,1,159,211,589,635,909,54.41121823897246,23.58834273232493
2368,/media/marda/TWOTB1/xBD/hurricanes/images/florence/hurricane-florence_00000010_post_disaster.png,101,142,1,229,330,601,743,6269,132.65128737430288,88.23745470855337
2369,/media/marda/TWOTB1/xBD/hurricanes/images/florence/hurricane-florence_00000010_post_disaster.png,117,106,1,841,958,615,721,3318,77.9928588599681,56.744960360619736
2370,/media/marda/TWOTB1/xBD/hurricanes/images/florence/hurricane-florence_00000010_post_disaster.png,22,49,1,118,140,627,676,375,26.241752343248113,19.064122772022408
2371,/media/marda/TWOTB1/xBD/hurricanes/images/florence/hurricane-florence_00000010_post_disaster.png,23,58,1,175,198,631,689,611,38.169254526827885,21.36958509781394
2372,/media/marda/TWOTB1/xBD/hurricanes/images/florence/hurricane-florence_00000010_post_disaster.png,109,133,1,0,109,664,797,5695,130.86501336475382,81.50936665055674
2373,/media/marda/TWOTB1/xBD/hurricanes/images/florence/hurricane-florence_00000010_post_disaster.png,30,58,1,115,145,689,747,464,29.93453457940221,20.485406142948804
2374,/media/marda/TWOTB1/xBD/hurricanes/images/florence/hurricane-florence_00000010_post_disaster.png,40,64,1,91,131,713,777,637,37.9971885555627,22.389217604513316
2375,/media/marda/TWOTB1/xBD/hurricanes/images/florence/hurricane-florence_00000010_post_disaster.png,133,114,1,95,228,714,828,5257,142.32365853031544,68.48046197924509
2376,/media/marda/TWOTB1/xBD/hurricanes/images/florence/hurricane-florence_00000010_post_disaster.png,115,106,1,929,1044,722,828,3103,68.11437539061212,60.6320383559472
2377,/media/marda/TWOTB1/xBD/hurricanes/images/florence/hurricane-florence_00000010_post_disaster.png,35,63,1,35,70,768,831,563,36.85410590704125,20.401158783250477
2378,/media/marda/TWOTB1/xBD/hurricanes/images/florence/hurricane-florence_00000010_post_disaster.png,129,112,1,653,782,774,886,1704,129.46767440671204,25.16707217747079
2379,/media/marda/TWOTB1/xBD/hurricanes/images/florence/hurricane-florence_00000010_post_disaster.png,102,151,1,17,119,782,933,5685,135.45583030105217,80.43918182118173
2380,/media/marda/TWOTB1/xBD/hurricanes/images/florence/hurricane-florence_00000010_post_disaster.png,33,50,1,2,35,785,835,532,35.622194589763886,19.966581440900715
2381,/media/marda/TWOTB1/xBD/hurricanes/images/florence/hurricane-florence_00000010_post_disaster.png,85,97,1,599,684,863,960,607,94.29895669980716,8.598359077779962
2382,/media/marda/TWOTB1/xBD/hurricanes/images/florence/hurricane-florence_00000010_post_disaster.png,101,95,1,839,940,883,978,2151,59.97532371319572,47.59723180621021
2383,/media/marda/TWOTB1/xBD/hurricanes/images/florence/hurricane-florence_00000010_post_disaster.png,217,147,1,677,894,894,1041,11266,167.9622250949766,93.97877787862622
2384,/media/marda/TWOTB1/xBD/hurricanes/images/florence/hurricane-florence_00000010_post_disaster.png,68,112,1,556,624,929,1041,614,96.76579995964437,8.469154771136054
2385,/media/marda/TWOTB1/xBD/hurricanes/images/florence/hurricane-florence_00000010_post_disaster.png,75,75,1,898,973,936,1011,663,43.30716299010292,20.43568363157885
2386,/media/marda/TWOTB1/xBD/hurricanes/images/florence/hurricane-florence_00000010_post_disaster.png,93,89,1,595,688,952,1041,1269,79.94011306724167,21.327442111394635
2387,/media/marda/TWOTB1/xBD/hurricanes/images/florence/hurricane-florence_00000010_post_disaster.png,66,66,1,585,651,975,1041,626,42.999426613399514,19.943035049725193
2388,/media/marda/TWOTB1/xBD/hurricanes/images/florence/hurricane-florence_00000262_pre_disaster.png,10,10,1,22,32,58,68,55,10.978012591907374,6.875247243255334
2389,/media/marda/TWOTB1/xBD/hurricanes/images/florence/hurricane-florence_00000262_pre_disaster.png,56,59,1,54,110,106,165,1633,53.26035890615144,40.28771136031094
2390,/media/marda/TWOTB1/xBD/hurricanes/images/florence/hurricane-florence_00000262_pre_disaster.png,24,37,1,0,24,107,144,509,30.23744611709205,22.674234727208024
2391,/media/marda/TWOTB1/xBD/hurricanes/images/florence/hurricane-florence_00000262_pre_disaster.png,32,13,1,636,668,182,195,37,7.650931640555551,6.525512243686533
2392,/media/marda/TWOTB1/xBD/hurricanes/images/florence/hurricane-florence_00000262_pre_disaster.png,64,41,1,671,735,186,227,739,32.83413548411417,29.928710225374367
2393,/media/marda/TWOTB1/xBD/hurricanes/images/florence/hurricane-florence_00000262_pre_disaster.png,76,64,1,725,801,212,276,1346,58.53425827574325,32.636101540489584
2394,/media/marda/TWOTB1/xBD/hurricanes/images/florence/hurricane-florence_00000262_pre_disaster.png,79,65,1,830,909,452,517,1169,50.88765220995082,31.30714151873531
2395,/media/marda/TWOTB1/xBD/hurricanes/images/florence/hurricane-florence_00000262_pre_disaster.png,58,56,1,478,536,469,525,871,39.61124821352977,29.830921432012072
2396,/media/marda/TWOTB1/xBD/hurricanes/images/florence/hurricane-florence_00000262_pre_disaster.png,41,54,1,334,375,564,618,525,28.997148194379044,24.188274548180647
2397,/media/marda/TWOTB1/xBD/hurricanes/images/florence/hurricane-florence_00000262_pre_disaster.png,68,62,1,691,759,579,641,950,39.325928463937885,32.439694807483974
2398,/media/marda/TWOTB1/xBD/hurricanes/images/florence/hurricane-florence_00000262_pre_disaster.png,57,62,1,354,411,587,649,878,39.395658628906965,29.800674353695843
2399,/media/marda/TWOTB1/xBD/hurricanes/images/florence/hurricane-florence_00000262_pre_disaster.png,33,49,1,225,258,659,708,272,23.89220054148761,16.174642752290758
2400,/media/marda/TWOTB1/xBD/hurricanes/images/florence/hurricane-florence_00000262_pre_disaster.png,47,64,1,229,276,702,766,665,40.42372380726843,21.89830866331748
2401,/media/marda/TWOTB1/xBD/hurricanes/images/florence/hurricane-florence_00000262_pre_disaster.png,64,79,1,392,456,791,870,1212,53.011765284730004,30.011379520929463
2402,/media/marda/TWOTB1/xBD/hurricanes/images/florence/hurricane-florence_00000262_pre_disaster.png,25,52,1,59,84,834,886,252,27.208531196040155,12.144514358142425
2403,/media/marda/TWOTB1/xBD/hurricanes/images/florence/hurricane-florence_00000262_pre_disaster.png,48,65,1,351,399,834,899,630,31.041936265173778,27.31629775181947
2404,/media/marda/TWOTB1/xBD/hurricanes/images/florence/hurricane-florence_00000262_pre_disaster.png,57,79,1,12,69,838,917,1285,60.606290786232805,28.168569735287825
2405,/media/marda/TWOTB1/xBD/hurricanes/images/florence/hurricane-florence_00000262_pre_disaster.png,28,45,1,444,472,850,895,78,11.332782776391486,9.282581814420764
2406,/media/marda/TWOTB1/xBD/hurricanes/images/florence/hurricane-florence_00000262_pre_disaster.png,32,47,1,448,480,861,908,106,17.42185665269129,8.146514790136111
2407,/media/marda/TWOTB1/xBD/hurricanes/images/florence/hurricane-florence_00000262_pre_disaster.png,16,44,1,106,122,868,912,66,12.70055433196397,7.020359772922754
2408,/media/marda/TWOTB1/xBD/hurricanes/images/florence/hurricane-florence_00000262_pre_disaster.png,29,46,1,380,409,876,922,96,14.409452491389272,9.326893522887694
2409,/media/marda/TWOTB1/xBD/hurricanes/images/florence/hurricane-florence_00000262_pre_disaster.png,47,76,1,196,243,965,1041,776,43.55959906078751,23.709419578877853
2410,/media/marda/TWOTB1/xBD/hurricanes/images/florence/hurricane-florence_00000262_pre_disaster.png,40,54,1,541,581,990,1044,151,19.21760985965251,10.595525295897414
2411,/media/marda/TWOTB1/xBD/hurricanes/images/florence/hurricane-florence_00000377_post_disaster.png,49,29,1,570,619,0,29,604,33.890288021857046,23.922419547691714
2412,/media/marda/TWOTB1/xBD/hurricanes/images/florence/hurricane-florence_00000377_post_disaster.png,56,23,1,381,437,40,63,824,47.427259473634074,23.20727017375535
2413,/media/marda/TWOTB1/xBD/hurricanes/images/florence/hurricane-florence_00000377_post_disaster.png,52,34,1,231,283,46,80,1184,48.63467692314997,33.15486753561202
2414,/media/marda/TWOTB1/xBD/hurricanes/images/florence/hurricane-florence_00000377_post_disaster.png,54,26,1,332,386,47,73,968,48.62978059475145,26.580996933599398
2415,/media/marda/TWOTB1/xBD/hurricanes/images/florence/hurricane-florence_00000377_post_disaster.png,49,31,1,286,335,50,81,1037,43.41402060132932,31.899092046175433
2416,/media/marda/TWOTB1/xBD/hurricanes/images/florence/hurricane-florence_00000377_post_disaster.png,24,34,1,84,108,54,88,620,36.70732959984076,22.419662273509562
2417,/media/marda/TWOTB1/xBD/hurricanes/images/florence/hurricane-florence_00000377_post_disaster.png,52,31,1,179,231,58,89,1230,49.97036984848455,32.90052299931462
2418,/media/marda/TWOTB1/xBD/hurricanes/images/florence/hurricane-florence_00000377_post_disaster.png,35,29,1,5,40,63,92,1015,40.39801975344831,33.46640106136302
2419,/media/marda/TWOTB1/xBD/hurricanes/images/florence/hurricane-florence_00000377_post_disaster.png,50,12,1,557,607,63,75,360,34.62176579359676,13.808210118138652
2420,/media/marda/TWOTB1/xBD/hurricanes/images/florence/hurricane-florence_00000377_post_disaster.png,33,24,1,334,367,90,114,461,26.78273817653348,22.9731630789477
2421,/media/marda/TWOTB1/xBD/hurricanes/images/florence/hurricane-florence_00000377_post_disaster.png,58,24,1,513,571,92,116,875,43.909745251287276,26.567124615479216
2422,/media/marda/TWOTB1/xBD/hurricanes/images/florence/hurricane-florence_00000377_post_disaster.png,28,19,1,208,236,98,117,274,22.609635637475368,16.177766894672903
2423,/media/marda/TWOTB1/xBD/hurricanes/images/florence/hurricane-florence_00000377_post_disaster.png,33,13,1,552,585,100,113,105,13.67524499029191,10.060664565904693
2424,/media/marda/TWOTB1/xBD/hurricanes/images/florence/hurricane-florence_00000377_post_disaster.png,36,15,1,581,617,100,115,131,15.567764923163423,11.241817116071733
2425,/media/marda/TWOTB1/xBD/hurricanes/images/florence/hurricane-florence_00000377_post_disaster.png,19,20,1,188,207,122,142,196,17.393639130980063,15.019418556474657
2426,/media/marda/TWOTB1/xBD/hurricanes/images/florence/hurricane-florence_00000377_post_disaster.png,52,45,1,553,605,132,177,931,40.39247673570766,30.745953674801513
2427,/media/marda/TWOTB1/xBD/hurricanes/images/florence/hurricane-florence_00000377_post_disaster.png,53,32,1,415,468,150,182,859,41.098356969209334,28.1132077966255
2428,/media/marda/TWOTB1/xBD/hurricanes/images/florence/hurricane-florence_00000377_post_disaster.png,59,30,1,354,413,157,187,947,47.62008807652804,26.32600488898349
2429,/media/marda/TWOTB1/xBD/hurricanes/images/florence/hurricane-florence_00000377_post_disaster.png,49,38,1,511,560,164,202,727,34.7631022406197,27.936503289356157
2430,/media/marda/TWOTB1/xBD/hurricanes/images/florence/hurricane-florence_00000377_post_disaster.png,53,31,1,257,310,165,196,784,46.34423845409619,25.327207605168446
2431,/media/marda/TWOTB1/xBD/hurricanes/images/florence/hurricane-florence_00000377_post_disaster.png,37,37,1,111,148,168,205,940,38.144428417329586,32.72331779862911
2432,/media/marda/TWOTB1/xBD/hurricanes/images/florence/hurricane-florence_00000377_post_disaster.png,48,35,1,159,207,168,203,1141,47.74844100886309,32.48827032937037
2433,/media/marda/TWOTB1/xBD/hurricanes/images/florence/hurricane-florence_00000377_post_disaster.png,51,26,1,206,257,169,195,845,47.4337752322154,23.430677914014247
2434,/media/marda/TWOTB1/xBD/hurricanes/images/florence/hurricane-florence_00000377_post_disaster.png,31,28,1,76,107,180,208,611,32.16646709800255,25.119525552051105
2435,/media/marda/TWOTB1/xBD/hurricanes/images/florence/hurricane-florence_00000377_post_disaster.png,30,47,1,16,46,182,229,1044,46.09314199684785,30.012730237938907
2436,/media/marda/TWOTB1/xBD/hurricanes/images/florence/hurricane-florence_00000377_post_disaster.png,45,28,1,442,487,254,282,580,33.46640106136302,23.065125189341593
2437,/media/marda/TWOTB1/xBD/hurricanes/images/florence/hurricane-florence_00000377_post_disaster.png,63,37,1,382,445,256,293,1080,55.242407689687326,26.044124219558544
2438,/media/marda/TWOTB1/xBD/hurricanes/images/florence/hurricane-florence_00000377_post_disaster.png,40,34,1,311,351,265,299,504,30.911351826076526,23.623671062249297
2439,/media/marda/TWOTB1/xBD/hurricanes/images/florence/hurricane-florence_00000377_post_disaster.png,30,59,1,0,30,274,333,1318,58.42481901138143,30.398601714502433
2440,/media/marda/TWOTB1/xBD/hurricanes/images/florence/hurricane-florence_00000377_post_disaster.png,43,37,1,197,240,274,311,846,38.982099717551975,28.892987823036695
2441,/media/marda/TWOTB1/xBD/hurricanes/images/florence/hurricane-florence_00000377_post_disaster.png,47,33,1,121,168,280,313,944,48.35981227349405,25.854153517101643
2442,/media/marda/TWOTB1/xBD/hurricanes/images/florence/hurricane-florence_00000377_post_disaster.png,65,45,1,539,604,292,337,908,46.3834002619293,25.701423318549168
2443,/media/marda/TWOTB1/xBD/hurricanes/images/florence/hurricane-florence_00000377_post_disaster.png,98,70,1,946,1044,295,365,1979,71.30976352039086,39.02812471634982
2444,/media/marda/TWOTB1/xBD/hurricanes/images/florence/hurricane-florence_00000377_post_disaster.png,78,51,1,443,521,298,349,1969,65.03574676870004,40.11018034507134
2445,/media/marda/TWOTB1/xBD/hurricanes/images/florence/hurricane-florence_00000377_post_disaster.png,24,23,1,192,216,308,331,192,20.18308890363965,12.64250870968435
2446,/media/marda/TWOTB1/xBD/hurricanes/images/florence/hurricane-florence_00000377_post_disaster.png,23,25,1,263,286,311,336,185,16.84434786890041,14.526727502356323
2447,/media/marda/TWOTB1/xBD/hurricanes/images/florence/hurricane-florence_00000377_post_disaster.png,31,29,1,210,241,326,355,318,26.154918190566736,16.290318261849496
2448,/media/marda/TWOTB1/xBD/hurricanes/images/florence/hurricane-florence_00000377_post_disaster.png,32,28,1,282,314,329,357,310,25.522469334145374,16.246796539542387
2449,/media/marda/TWOTB1/xBD/hurricanes/images/florence/hurricane-florence_00000377_post_disaster.png,51,45,1,111,162,337,382,1072,50.37843819374921,28.34536782358513
2450,/media/marda/TWOTB1/xBD/hurricanes/images/florence/hurricane-florence_00000377_post_disaster.png,54,41,1,173,227,344,385,1056,53.610440071483325,26.238899161508797
2451,/media/marda/TWOTB1/xBD/hurricanes/images/florence/hurricane-florence_00000377_post_disaster.png,65,72,1,416,481,345,417,1895,67.2096161016118,40.40314760611174
2452,/media/marda/TWOTB1/xBD/hurricanes/images/florence/hurricane-florence_00000377_post_disaster.png,47,47,1,581,628,350,397,763,38.32929260171225,26.595322235818948
2453,/media/marda/TWOTB1/xBD/hurricanes/images/florence/hurricane-florence_00000377_post_disaster.png,52,41,1,245,297,354,395,959,48.72282508622455,26.088937907673326
2454,/media/marda/TWOTB1/xBD/hurricanes/images/florence/hurricane-florence_00000377_post_disaster.png,62,41,1,310,372,361,402,1075,55.89111284014519,25.688528032944067
2455,/media/marda/TWOTB1/xBD/hurricanes/images/florence/hurricane-florence_00000377_post_disaster.png,56,82,1,576,632,393,475,1489,69.41359636707833,29.142269471646603
2456,/media/marda/TWOTB1/xBD/hurricanes/images/florence/hurricane-florence_00000377_post_disaster.png,39,49,1,101,140,440,489,812,39.53432178989706,27.974983989815
2457,/media/marda/TWOTB1/xBD/hurricanes/images/florence/hurricane-florence_00000377_post_disaster.png,50,44,1,169,219,449,493,998,48.43237223869642,27.030541715201036
2458,/media/marda/TWOTB1/xBD/hurricanes/images/florence/hurricane-florence_00000377_post_disaster.png,97,64,1,910,1007,455,519,1311,65.87374303375404,25.992519525871863
2459,/media/marda/TWOTB1/xBD/hurricanes/images/florence/hurricane-florence_00000377_post_disaster.png,53,53,1,235,288,456,509,1172,46.06088800849482,34.66583221122185
2460,/media/marda/TWOTB1/xBD/hurricanes/images/florence/hurricane-florence_00000377_post_disaster.png,52,44,1,300,352,463,507,852,42.90584316052618,26.32823946815641
2461,/media/marda/TWOTB1/xBD/hurricanes/images/florence/hurricane-florence_00000377_post_disaster.png,21,30,1,136,157,478,508,194,18.71480342922614,13.927035512715396
2462,/media/marda/TWOTB1/xBD/hurricanes/images/florence/hurricane-florence_00000377_post_disaster.png,47,44,1,444,491,488,532,729,34.90971860433069,27.76578493776989
2463,/media/marda/TWOTB1/xBD/hurricanes/images/florence/hurricane-florence_00000377_post_disaster.png,57,56,1,619,676,497,553,767,35.99985606850798,28.68630919492867
2464,/media/marda/TWOTB1/xBD/hurricanes/images/florence/hurricane-florence_00000377_post_disaster.png,60,61,1,506,566,500,561,820,41.36248529855241,26.22176082799346
2465,/media/marda/TWOTB1/xBD/hurricanes/images/florence/hurricane-florence_00000377_post_disaster.png,24,33,1,259,283,504,537,150,17.02243528887729,11.870122490821073
2466,/media/marda/TWOTB1/xBD/hurricanes/images/florence/hurricane-florence_00000377_post_disaster.png,32,34,1,326,358,504,538,193,21.693764745384943,11.937725891471167
2467,/media/marda/TWOTB1/xBD/hurricanes/images/florence/hurricane-florence_00000377_post_disaster.png,35,46,1,2,37,508,554,621,34.869674052155574,24.170112723268492
2468,/media/marda/TWOTB1/xBD/hurricanes/images/florence/hurricane-florence_00000377_post_disaster.png,44,54,1,298,342,525,579,773,34.66501254220139,29.80978836447567
2469,/media/marda/TWOTB1/xBD/hurricanes/images/florence/hurricane-florence_00000377_post_disaster.png,36,37,1,477,513,532,569,152,17.252196996915334,11.731686767165847
2470,/media/marda/TWOTB1/xBD/hurricanes/images/florence/hurricane-florence_00000377_post_disaster.png,58,58,1,409,467,547,605,771,35.11726739336447,30.836432322251255
2471,/media/marda/TWOTB1/xBD/hurricanes/images/florence/hurricane-florence_00000377_post_disaster.png,58,56,1,627,685,557,613,885,37.11264054475563,32.15119726556322
2472,/media/marda/TWOTB1/xBD/hurricanes/images/florence/hurricane-florence_00000377_post_disaster.png,44,38,1,355,399,564,602,320,35.051208314150045,12.216778246250465
2473,/media/marda/TWOTB1/xBD/hurricanes/images/florence/hurricane-florence_00000377_post_disaster.png,54,56,1,529,583,566,622,912,36.84079487215717,33.73850881983159
2474,/media/marda/TWOTB1/xBD/hurricanes/images/florence/hurricane-florence_00000377_post_disaster.png,41,49,1,84,125,573,622,767,43.151462665479315,23.531417820619097
2475,/media/marda/TWOTB1/xBD/hurricanes/images/florence/hurricane-florence_00000377_post_disaster.png,80,51,1,154,234,587,638,1360,79.32138680253266,27.009013948630585
2476,/media/marda/TWOTB1/xBD/hurricanes/images/florence/hurricane-florence_00000377_post_disaster.png,58,64,1,623,681,597,661,789,39.69508668933529,27.02076504695358
2477,/media/marda/TWOTB1/xBD/hurricanes/images/florence/hurricane-florence_00000377_post_disaster.png,53,57,1,287,340,605,662,876,46.76412811700818,25.57140813527557
2478,/media/marda/TWOTB1/xBD/hurricanes/images/florence/hurricane-florence_00000377_post_disaster.png,58,53,1,484,542,631,684,817,43.83471320374995,24.80619445467783
2479,/media/marda/TWOTB1/xBD/hurricanes/images/florence/hurricane-florence_00000377_post_disaster.png,56,52,1,404,460,634,686,725,43.5961879203603,22.32842075930462
2480,/media/marda/TWOTB1/xBD/hurricanes/images/florence/hurricane-florence_00000377_post_disaster.png,39,52,1,76,115,670,722,825,40.8390609685546,26.766496180034615
2481,/media/marda/TWOTB1/xBD/hurricanes/images/florence/hurricane-florence_00000377_post_disaster.png,51,57,1,351,402,729,786,769,40.019999216338555,25.668252882673904
2482,/media/marda/TWOTB1/xBD/hurricanes/images/florence/hurricane-florence_00000377_post_disaster.png,46,49,1,470,516,741,790,549,32.35451019547922,22.714307569707838
2483,/media/marda/TWOTB1/xBD/hurricanes/images/florence/hurricane-florence_00000377_post_disaster.png,68,90,1,163,231,791,881,2760,62.08439240594304,56.639211562111036
2484,/media/marda/TWOTB1/xBD/hurricanes/images/florence/hurricane-florence_00000377_post_disaster.png,49,66,1,176,225,868,934,996,44.86726177634815,31.739749272359955
2485,/media/marda/TWOTB1/xBD/hurricanes/images/florence/hurricane-florence_00000377_post_disaster.png,28,82,1,58,86,889,971,1004,50.25811715455958,26.64245445049152
2486,/media/marda/TWOTB1/xBD/hurricanes/images/florence/hurricane-florence_00000377_post_disaster.png,49,79,1,46,95,962,1041,1373,54.109222746634664,36.74910559633231
2487,/media/marda/TWOTB1/xBD/hurricanes/images/florence/hurricane-florence_00000377_post_disaster.png,32,66,1,103,135,975,1041,713,34.305516724240356,27.742987883846293
2488,/media/marda/TWOTB1/xBD/hurricanes/images/florence/hurricane-florence_00000377_post_disaster.png,59,36,1,514,573,20,56,1134,44.83606936342625,34.89839342218286
2489,/media/marda/TWOTB1/xBD/hurricanes/images/florence/hurricane-florence_00000377_post_disaster.png,65,27,1,434,499,37,64,1124,54.98421801446888,27.137641356751264
2490,/media/marda/TWOTB1/xBD/hurricanes/images/florence/hurricane-florence_00000377_post_disaster.png,54,36,1,256,310,263,299,978,47.14843158938372,27.08231761666095
2491,/media/marda/TWOTB1/xBD/hurricanes/images/florence/hurricane-florence_00000377_post_disaster.png,37,56,1,97,134,503,559,869,38.709415623266224,30.335533019016033
2492,/media/marda/TWOTB1/xBD/hurricanes/images/florence/hurricane-florence_00000376_pre_disaster.png,57,26,1,831,888,0,26,384,31.302830887735663,18.8630236041365
2493,/media/marda/TWOTB1/xBD/hurricanes/images/florence/hurricane-florence_00000376_pre_disaster.png,93,56,1,870,963,0,56,1681,54.640256384051185,43.757115067386444
2494,/media/marda/TWOTB1/xBD/hurricanes/images/florence/hurricane-florence_00000376_pre_disaster.png,52,34,1,752,804,104,138,372,30.01089471671626,16.552034745497323
2495,/media/marda/TWOTB1/xBD/hurricanes/images/florence/hurricane-florence_00000376_pre_disaster.png,63,42,1,618,681,157,199,819,35.30592619541068,30.795126288007754
2496,/media/marda/TWOTB1/xBD/hurricanes/images/florence/hurricane-florence_00000376_pre_disaster.png,93,61,1,746,839,163,224,1773,59.71449770878777,41.45119607598435
2497,/media/marda/TWOTB1/xBD/hurricanes/images/florence/hurricane-florence_00000376_pre_disaster.png,63,43,1,584,647,177,220,917,37.966710616206576,31.946593671112016
2498,/media/marda/TWOTB1/xBD/hurricanes/images/florence/hurricane-florence_00000376_pre_disaster.png,39,24,1,567,606,253,277,177,17.34080638924983,13.334207064158884
2499,/media/marda/TWOTB1/xBD/hurricanes/images/florence/hurricane-florence_00000376_pre_disaster.png,41,27,1,492,533,275,302,271,20.6878184829829,16.866594942912318
2500,/media/marda/TWOTB1/xBD/hurricanes/images/florence/hurricane-florence_00000376_pre_disaster.png,96,77,1,557,653,318,395,2476,77.34104344134619,43.70162451243699
2501,/media/marda/TWOTB1/xBD/hurricanes/images/florence/hurricane-florence_00000376_pre_disaster.png,39,47,1,489,528,654,701,321,22.549739497202772,18.905302758564872
2502,/media/marda/TWOTB1/xBD/hurricanes/images/florence/hurricane-florence_00000376_pre_disaster.png,41,42,1,588,629,675,717,158,16.45725052312773,12.66473710783417
2503,/media/marda/TWOTB1/xBD/hurricanes/images/florence/hurricane-florence_00000376_pre_disaster.png,45,74,1,549,594,678,752,745,54.53846628128256,18.24856389490587
2504,/media/marda/TWOTB1/xBD/hurricanes/images/florence/hurricane-florence_00000376_pre_disaster.png,48,55,1,599,647,706,761,314,27.350250220517424,15.17380879502995
2505,/media/marda/TWOTB1/xBD/hurricanes/images/florence/hurricane-florence_00000376_pre_disaster.png,65,83,1,456,521,732,815,1456,52.80592587314323,40.47889928387257
2506,/media/marda/TWOTB1/xBD/hurricanes/images/florence/hurricane-florence_00000376_pre_disaster.png,35,43,1,502,537,795,838,115,16.413455359779874,9.507354390172871
2507,/media/marda/TWOTB1/xBD/hurricanes/images/florence/hurricane-florence_00000376_pre_disaster.png,42,68,1,491,533,803,871,669,37.48905592782873,23.918632669364555
2508,/media/marda/TWOTB1/xBD/hurricanes/images/florence/hurricane-florence_00000376_pre_disaster.png,55,78,1,383,438,824,902,741,53.34515877072829,18.687524467206252
2509,/media/marda/TWOTB1/xBD/hurricanes/images/florence/hurricane-florence_00000376_pre_disaster.png,76,81,1,414,490,872,953,1418,55.96945939583534,35.9582471878614
2510,/media/marda/TWOTB1/xBD/hurricanes/images/florence/hurricane-florence_00000376_pre_disaster.png,61,79,1,640,701,900,979,821,42.41105855755486,25.840299890090023
2511,/media/marda/TWOTB1/xBD/hurricanes/images/florence/hurricane-florence_00000376_pre_disaster.png,51,66,1,289,340,906,972,692,38.57996975346415,25.07792753749286
2512,/media/marda/TWOTB1/xBD/hurricanes/images/florence/hurricane-florence_00000376_pre_disaster.png,46,65,1,290,336,977,1042,610,35.34805755656123,22.650934885012607
2513,/media/marda/TWOTB1/xBD/hurricanes/images/florence/hurricane-florence_00000148_post_disaster.png,56,28,1,764,820,132,160,365,26.587465619408206,18.072241423458465
2514,/media/marda/TWOTB1/xBD/hurricanes/images/florence/hurricane-florence_00000148_post_disaster.png,45,43,1,761,806,589,632,181,18.418272682994516,14.088457661092285
2515,/media/marda/TWOTB1/xBD/hurricanes/images/florence/hurricane-florence_00000148_post_disaster.png,61,40,1,802,863,747,787,342,32.92153515284303,13.800769087148828
2516,/media/marda/TWOTB1/xBD/hurricanes/images/florence/hurricane-florence_00000148_post_disaster.png,56,65,1,787,843,891,956,631,32.54368617724705,25.878077469880484
2517,/media/marda/TWOTB1/xBD/hurricanes/images/florence/hurricane-florence_00000148_post_disaster.png,48,70,1,181,229,936,1006,1179,45.04240704130275,34.47843186322143
2518,/media/marda/TWOTB1/xBD/hurricanes/images/florence/hurricane-florence_00000148_post_disaster.png,36,52,1,258,294,991,1043,266,32.17974994159219,11.2743108041564
2519,/media/marda/TWOTB1/xBD/hurricanes/images/florence/hurricane-florence_00000097_post_disaster.png,57,32,1,159,216,477,509,524,53.85444814967031,12.865873800477914
2520,/media/marda/TWOTB1/xBD/hurricanes/images/florence/hurricane-florence_00000097_post_disaster.png,60,35,1,238,298,479,514,509,57.6626922576813,11.809110081817826
2521,/media/marda/TWOTB1/xBD/hurricanes/images/florence/hurricane-florence_00000097_post_disaster.png,42,56,1,294,336,503,559,482,44.15195355082146,16.09400856724629
2522,/media/marda/TWOTB1/xBD/hurricanes/images/florence/hurricane-florence_00000097_post_disaster.png,23,54,1,126,149,512,566,463,36.16407762333587,17.50635043078983
2523,/media/marda/TWOTB1/xBD/hurricanes/images/florence/hurricane-florence_00000097_post_disaster.png,47,33,1,131,178,575,608,404,48.71301451757373,11.044378719884104
2524,/media/marda/TWOTB1/xBD/hurricanes/images/florence/hurricane-florence_00000097_post_disaster.png,61,38,1,262,323,585,623,585,57.968485197670375,14.083974474824009
2525,/media/marda/TWOTB1/xBD/hurricanes/images/florence/hurricane-florence_00000097_post_disaster.png,40,43,1,0,40,596,639,528,45.563870887722516,16.671638826721335
2526,/media/marda/TWOTB1/xBD/hurricanes/images/florence/hurricane-florence_00000097_post_disaster.png,46,43,1,254,300,615,658,448,39.00224115720496,17.271444165652987
2527,/media/marda/TWOTB1/xBD/hurricanes/images/florence/hurricane-florence_00000097_post_disaster.png,53,40,1,131,184,628,668,548,55.49890765335127,13.43626802383543
2528,/media/marda/TWOTB1/xBD/hurricanes/images/florence/hurricane-florence_00000097_post_disaster.png,62,42,1,241,303,663,705,655,61.00094581992344,15.552577967918099
2529,/media/marda/TWOTB1/xBD/hurricanes/images/florence/hurricane-florence_00000097_post_disaster.png,55,37,1,127,182,670,707,488,59.052114766555746,11.054799812477595
2530,/media/marda/TWOTB1/xBD/hurricanes/images/florence/hurricane-florence_00000097_post_disaster.png,49,36,1,41,90,686,722,455,57.533831528755634,10.870822006695796
2531,/media/marda/TWOTB1/xBD/hurricanes/images/florence/hurricane-florence_00000097_post_disaster.png,43,71,1,140,183,808,879,1177,45.4307490570697,36.46315285953985
2532,/media/marda/TWOTB1/xBD/hurricanes/images/florence/hurricane-florence_00000097_post_disaster.png,53,76,1,279,332,829,905,1426,50.54346322936674,39.799606470618286
2533,/media/marda/TWOTB1/xBD/hurricanes/images/florence/hurricane-florence_00000097_post_disaster.png,66,64,1,336,402,882,946,1359,60.12802425861285,30.299916686187487
2534,/media/marda/TWOTB1/xBD/hurricanes/images/florence/hurricane-florence_00000227_pre_disaster.png,85,56,1,932,1017,206,262,1367,46.1048433943955,38.6508129058692
2535,/media/marda/TWOTB1/xBD/hurricanes/images/florence/hurricane-florence_00000227_pre_disaster.png,35,40,1,233,268,295,335,535,31.24201820331555,22.863971245306253
2536,/media/marda/TWOTB1/xBD/hurricanes/images/florence/hurricane-florence_00000227_pre_disaster.png,82,60,1,931,1013,300,360,1076,49.625339757424555,28.764257469823193
2537,/media/marda/TWOTB1/xBD/hurricanes/images/florence/hurricane-florence_00000227_pre_disaster.png,35,39,1,319,354,320,359,327,27.61310398759522,15.674030997831505
2538,/media/marda/TWOTB1/xBD/hurricanes/images/florence/hurricane-florence_00000227_pre_disaster.png,30,57,1,0,30,325,382,821,41.183200021647195,26.822800323435672
2539,/media/marda/TWOTB1/xBD/hurricanes/images/florence/hurricane-florence_00000227_pre_disaster.png,75,50,1,416,491,344,394,1020,65.04518822633115,20.934374251880563
2540,/media/marda/TWOTB1/xBD/hurricanes/images/florence/hurricane-florence_00000227_pre_disaster.png,33,32,1,469,502,408,440,172,15.958041398815558,14.439657385525573
2541,/media/marda/TWOTB1/xBD/hurricanes/images/florence/hurricane-florence_00000227_pre_disaster.png,76,53,1,449,525,421,474,902,65.57235891324846,18.35881362455475
2542,/media/marda/TWOTB1/xBD/hurricanes/images/florence/hurricane-florence_00000227_pre_disaster.png,29,36,1,363,392,442,478,180,19.195273803899948,12.482708312028642
2543,/media/marda/TWOTB1/xBD/hurricanes/images/florence/hurricane-florence_00000227_pre_disaster.png,68,56,1,900,968,446,502,638,40.149419592706174,20.987268860738766
2544,/media/marda/TWOTB1/xBD/hurricanes/images/florence/hurricane-florence_00000227_pre_disaster.png,52,30,1,956,1008,488,518,124,15.144447084572278,10.873099213123547
2545,/media/marda/TWOTB1/xBD/hurricanes/images/florence/hurricane-florence_00000227_pre_disaster.png,62,78,1,375,437,492,570,1546,59.66977716416848,35.15320803478361
2546,/media/marda/TWOTB1/xBD/hurricanes/images/florence/hurricane-florence_00000227_pre_disaster.png,62,41,1,924,986,499,540,295,22.36508931419068,17.46773343367256
2547,/media/marda/TWOTB1/xBD/hurricanes/images/florence/hurricane-florence_00000227_pre_disaster.png,34,42,1,380,414,605,647,174,19.58556842769897,11.901572045140203
2548,/media/marda/TWOTB1/xBD/hurricanes/images/florence/hurricane-florence_00000227_pre_disaster.png,66,74,1,418,484,614,688,1247,52.45349830462049,33.06468836550857
2549,/media/marda/TWOTB1/xBD/hurricanes/images/florence/hurricane-florence_00000227_pre_disaster.png,44,45,1,353,397,616,661,300,29.83604992255455,13.734756905058598
2550,/media/marda/TWOTB1/xBD/hurricanes/images/florence/hurricane-florence_00000227_pre_disaster.png,52,67,1,152,204,620,687,1112,40.4841353792035,36.49405349376649
2551,/media/marda/TWOTB1/xBD/hurricanes/images/florence/hurricane-florence_00000227_pre_disaster.png,33,49,1,334,367,626,675,285,21.177519266812446,17.859460670597844
2552,/media/marda/TWOTB1/xBD/hurricanes/images/florence/hurricane-florence_00000227_pre_disaster.png,53,58,1,360,413,659,717,802,40.08024655023589,26.161912855985808
2553,/media/marda/TWOTB1/xBD/hurricanes/images/florence/hurricane-florence_00000227_pre_disaster.png,59,68,1,180,239,672,740,1120,54.305335016008954,27.51341003322153
2554,/media/marda/TWOTB1/xBD/hurricanes/images/florence/hurricane-florence_00000227_pre_disaster.png,59,75,1,285,344,732,807,1184,49.43857902247621,32.83063123738402
2555,/media/marda/TWOTB1/xBD/hurricanes/images/florence/hurricane-florence_00000227_pre_disaster.png,47,72,1,243,290,739,811,887,41.16027008675819,29.54959950718619
2556,/media/marda/TWOTB1/xBD/hurricanes/images/florence/hurricane-florence_00000227_pre_disaster.png,61,55,1,883,944,764,819,364,23.261848680652307,20.92288139664099
2557,/media/marda/TWOTB1/xBD/hurricanes/images/florence/hurricane-florence_00000227_pre_disaster.png,85,78,1,828,913,789,867,1181,53.653107850095765,31.1127590237545
2558,/media/marda/TWOTB1/xBD/hurricanes/images/florence/hurricane-florence_00000323_post_disaster.png,47,44,1,745,792,751,795,296,21.42758678171418,18.37582097331432
2559,/media/marda/TWOTB1/xBD/hurricanes/images/florence/hurricane-florence_00000323_post_disaster.png,59,66,1,835,894,947,1013,416,25.917797735406236,21.448350084456106
2560,/media/marda/TWOTB1/xBD/hurricanes/images/florence/hurricane-florence_00000131_post_disaster.png,45,10,1,483,528,0,10,186,27.9017366136082,9.16284106170074
2561,/media/marda/TWOTB1/xBD/hurricanes/images/florence/hurricane-florence_00000131_post_disaster.png,40,17,1,490,530,28,45,222,20.055525593722336,14.652196360226046
2562,/media/marda/TWOTB1/xBD/hurricanes/images/florence/hurricane-florence_00000131_post_disaster.png,31,15,1,442,473,85,100,170,15.563325001844806,13.949893328749583
2563,/media/marda/TWOTB1/xBD/hurricanes/images/florence/hurricane-florence_00000131_post_disaster.png,42,27,1,469,511,86,113,384,25.039092289315207,20.433056211604764
2564,/media/marda/TWOTB1/xBD/hurricanes/images/florence/hurricane-florence_00000463_post_disaster.png,48,28,1,567,615,0,28,288,35.253548260596475,10.899531937544307
2565,/media/marda/TWOTB1/xBD/hurricanes/images/florence/hurricane-florence_00000463_post_disaster.png,44,15,1,620,664,51,66,127,21.758758502825543,7.828865172240488
2566,/media/marda/TWOTB1/xBD/hurricanes/images/florence/hurricane-florence_00000463_post_disaster.png,67,10,1,565,632,147,157,218,50.33752033148814,5.632837839691454
2567,/media/marda/TWOTB1/xBD/hurricanes/images/florence/hurricane-florence_00000463_post_disaster.png,66,11,1,565,631,157,168,211,48.67536607424849,5.657266592827832
2568,/media/marda/TWOTB1/xBD/hurricanes/images/florence/hurricane-florence_00000463_post_disaster.png,35,13,1,615,650,157,170,81,11.843711478326757,9.169653303382603
2569,/media/marda/TWOTB1/xBD/hurricanes/images/florence/hurricane-florence_00000463_post_disaster.png,58,42,1,980,1038,742,784,235,21.083505441638618,14.7504800917472
2570,/media/marda/TWOTB1/xBD/hurricanes/images/florence/hurricane-florence_00000463_post_disaster.png,58,49,1,954,1012,799,848,230,21.60654247074682,14.273159045974557
2571,/media/marda/TWOTB1/xBD/hurricanes/images/florence/hurricane-florence_00000096_post_disaster.png,7,18,1,0,7,0,18,84,16.19476278938256,7.745202489089008
2572,/media/marda/TWOTB1/xBD/hurricanes/images/florence/hurricane-florence_00000096_post_disaster.png,32,23,1,28,60,0,23,553,32.128878012060554,23.16633677213635
2573,/media/marda/TWOTB1/xBD/hurricanes/images/florence/hurricane-florence_00000096_post_disaster.png,41,16,1,138,179,0,16,322,39.927407849671106,12.604013903726866
2574,/media/marda/TWOTB1/xBD/hurricanes/images/florence/hurricane-florence_00000096_post_disaster.png,96,20,1,880,976,0,20,806,61.44289889194978,18.130093164389375
2575,/media/marda/TWOTB1/xBD/hurricanes/images/florence/hurricane-florence_00000096_post_disaster.png,63,68,1,467,530,15,83,1901,69.62246246545962,36.28507549034344
2576,/media/marda/TWOTB1/xBD/hurricanes/images/florence/hurricane-florence_00000096_post_disaster.png,47,17,1,756,803,15,32,181,18.729467240982466,12.93811818514702
2577,/media/marda/TWOTB1/xBD/hurricanes/images/florence/hurricane-florence_00000096_post_disaster.png,98,80,1,268,366,21,101,3762,84.77687509127122,67.32437047727774
2578,/media/marda/TWOTB1/xBD/hurricanes/images/florence/hurricane-florence_00000096_post_disaster.png,84,53,1,781,865,31,84,1728,59.100574348474034,39.743077125585785
2579,/media/marda/TWOTB1/xBD/hurricanes/images/florence/hurricane-florence_00000096_post_disaster.png,14,32,1,0,14,34,66,330,32.889586781879544,13.662180394965468
2580,/media/marda/TWOTB1/xBD/hurricanes/images/florence/hurricane-florence_00000096_post_disaster.png,49,32,1,581,630,35,67,587,30.90423577407456,25.293675998398214
2581,/media/marda/TWOTB1/xBD/hurricanes/images/florence/hurricane-florence_00000096_post_disaster.png,86,75,1,636,722,38,113,2126,86.07270845555863,35.17976687139267
2582,/media/marda/TWOTB1/xBD/hurricanes/images/florence/hurricane-florence_00000096_post_disaster.png,44,31,1,169,213,55,86,833,37.67071854291256,29.174240337211945
2583,/media/marda/TWOTB1/xBD/hurricanes/images/florence/hurricane-florence_00000096_post_disaster.png,65,60,1,588,653,70,130,1538,61.80256047134128,33.847165484493004
2584,/media/marda/TWOTB1/xBD/hurricanes/images/florence/hurricane-florence_00000096_post_disaster.png,39,20,1,408,447,72,92,281,23.667154555770672,15.891315947290703
2585,/media/marda/TWOTB1/xBD/hurricanes/images/florence/hurricane-florence_00000096_post_disaster.png,20,18,1,98,118,73,91,154,16.586615008239114,12.4615680878732
2586,/media/marda/TWOTB1/xBD/hurricanes/images/florence/hurricane-florence_00000096_post_disaster.png,146,79,1,417,563,80,159,6025,146.39811977899103,72.55915786130295
2587,/media/marda/TWOTB1/xBD/hurricanes/images/florence/hurricane-florence_00000096_post_disaster.png,30,39,1,0,30,81,120,820,36.94509246865523,29.83723144723909
2588,/media/marda/TWOTB1/xBD/hurricanes/images/florence/hurricane-florence_00000096_post_disaster.png,87,44,1,910,997,99,143,1604,52.63806542576178,40.37790969063339
2589,/media/marda/TWOTB1/xBD/hurricanes/images/florence/hurricane-florence_00000096_post_disaster.png,82,79,1,284,366,107,186,2994,77.20542647408077,62.19354204833152
2590,/media/marda/TWOTB1/xBD/hurricanes/images/florence/hurricane-florence_00000096_post_disaster.png,54,56,1,0,54,114,170,1775,61.430163750269486,38.52072543582072
2591,/media/marda/TWOTB1/xBD/hurricanes/images/florence/hurricane-florence_00000096_post_disaster.png,89,39,1,954,1043,121,160,928,60.40685080478835,21.744088539208843
2592,/media/marda/TWOTB1/xBD/hurricanes/images/florence/hurricane-florence_00000096_post_disaster.png,45,33,1,199,244,131,164,658,34.8418931119125,25.3923025693248
2593,/media/marda/TWOTB1/xBD/hurricanes/images/florence/hurricane-florence_00000096_post_disaster.png,89,52,1,786,875,144,196,1867,56.00177789019113,43.42591639519934
2594,/media/marda/TWOTB1/xBD/hurricanes/images/florence/hurricane-florence_00000096_post_disaster.png,65,51,1,700,765,153,204,1227,49.836750272284476,32.523981764789184
2595,/media/marda/TWOTB1/xBD/hurricanes/images/florence/hurricane-florence_00000096_post_disaster.png,64,54,1,8,72,163,217,2101,63.70233423219724,44.25583016194863
2596,/media/marda/TWOTB1/xBD/hurricanes/images/florence/hurricane-florence_00000096_post_disaster.png,84,58,1,928,1012,165,223,2010,54.4409712902449,48.82634660112723
2597,/media/marda/TWOTB1/xBD/hurricanes/images/florence/hurricane-florence_00000096_post_disaster.png,53,32,1,753,806,184,216,473,26.926839798930544,23.258312058341968
2598,/media/marda/TWOTB1/xBD/hurricanes/images/florence/hurricane-florence_00000096_post_disaster.png,42,22,1,686,728,192,214,180,18.50257174731255,12.983295030409748
2599,/media/marda/TWOTB1/xBD/hurricanes/images/florence/hurricane-florence_00000096_post_disaster.png,78,40,1,816,894,193,233,1233,47.10413396785174,34.65527978003239
2600,/media/marda/TWOTB1/xBD/hurricanes/images/florence/hurricane-florence_00000096_post_disaster.png,12,20,1,42,54,209,229,108,12.945326353241867,11.152091413363339
2601,/media/marda/TWOTB1/xBD/hurricanes/images/florence/hurricane-florence_00000096_post_disaster.png,34,36,1,8,42,210,246,618,34.2154664256216,24.11986477355619
2602,/media/marda/TWOTB1/xBD/hurricanes/images/florence/hurricane-florence_00000096_post_disaster.png,37,41,1,146,183,221,262,599,38.1717928271206,21.717048480248845
2603,/media/marda/TWOTB1/xBD/hurricanes/images/florence/hurricane-florence_00000096_post_disaster.png,57,26,1,792,849,223,249,315,27.6514485293853,15.255646784132612
2604,/media/marda/TWOTB1/xBD/hurricanes/images/florence/hurricane-florence_00000096_post_disaster.png,76,55,1,649,725,227,282,1484,52.837908112965295,38.212962677053454
2605,/media/marda/TWOTB1/xBD/hurricanes/images/florence/hurricane-florence_00000096_post_disaster.png,55,58,1,49,104,228,286,1646,50.4191915073427,47.32554746039462
2606,/media/marda/TWOTB1/xBD/hurricanes/images/florence/hurricane-florence_00000096_post_disaster.png,34,36,1,108,142,236,272,543,29.171080942430006,24.86719815935209
2607,/media/marda/TWOTB1/xBD/hurricanes/images/florence/hurricane-florence_00000096_post_disaster.png,118,129,1,491,609,239,368,7404,120.98220504865247,87.17725830203638
2608,/media/marda/TWOTB1/xBD/hurricanes/images/florence/hurricane-florence_00000096_post_disaster.png,93,49,1,818,911,242,291,1603,63.450214492504664,34.198731765005185
2609,/media/marda/TWOTB1/xBD/hurricanes/images/florence/hurricane-florence_00000096_post_disaster.png,63,59,1,396,459,248,307,1588,48.902507178719134,42.82867551930023
2610,/media/marda/TWOTB1/xBD/hurricanes/images/florence/hurricane-florence_00000096_post_disaster.png,72,43,1,330,402,261,304,1223,63.95181598201761,25.105326394043907
2611,/media/marda/TWOTB1/xBD/hurricanes/images/florence/hurricane-florence_00000096_post_disaster.png,74,53,1,969,1043,275,328,1167,45.22251286746535,34.00634613723947
2612,/media/marda/TWOTB1/xBD/hurricanes/images/florence/hurricane-florence_00000096_post_disaster.png,74,69,1,206,280,286,355,1994,64.58783791019033,49.324864273066424
2613,/media/marda/TWOTB1/xBD/hurricanes/images/florence/hurricane-florence_00000096_post_disaster.png,81,49,1,646,727,287,336,1290,57.4728205478531,30.552611582738756
2614,/media/marda/TWOTB1/xBD/hurricanes/images/florence/hurricane-florence_00000096_post_disaster.png,147,95,1,659,806,301,396,6451,119.90426026552547,72.30912574963793
2615,/media/marda/TWOTB1/xBD/hurricanes/images/florence/hurricane-florence_00000096_post_disaster.png,45,64,1,124,169,305,369,1306,56.505297857625195,30.936490164411957
2616,/media/marda/TWOTB1/xBD/hurricanes/images/florence/hurricane-florence_00000096_post_disaster.png,49,44,1,39,88,330,374,1056,52.446334119534804,26.706569201248808
2617,/media/marda/TWOTB1/xBD/hurricanes/images/florence/hurricane-florence_00000096_post_disaster.png,26,31,1,94,120,335,366,305,25.1255357686678,15.91216780193065
2618,/media/marda/TWOTB1/xBD/hurricanes/images/florence/hurricane-florence_00000096_post_disaster.png,62,50,1,244,306,348,398,1296,54.29794684671567,31.658664288767387
2619,/media/marda/TWOTB1/xBD/hurricanes/images/florence/hurricane-florence_00000096_post_disaster.png,57,47,1,986,1043,350,397,395,33.31952936374169,16.29075574160564
2620,/media/marda/TWOTB1/xBD/hurricanes/images/florence/hurricane-florence_00000096_post_disaster.png,25,37,1,122,147,353,390,331,24.712161912456413,17.69150271422608
2621,/media/marda/TWOTB1/xBD/hurricanes/images/florence/hurricane-florence_00000096_post_disaster.png,85,57,1,871,956,375,432,1544,52.70632452321198,38.90876528008289
2622,/media/marda/TWOTB1/xBD/hurricanes/images/florence/hurricane-florence_00000096_post_disaster.png,33,37,1,219,252,380,417,412,25.951379795115816,20.94435380912364
2623,/media/marda/TWOTB1/xBD/hurricanes/images/florence/hurricane-florence_00000096_post_disaster.png,58,52,1,258,316,382,434,1415,51.22287448407805,36.309860981076284
2624,/media/marda/TWOTB1/xBD/hurricanes/images/florence/hurricane-florence_00000096_post_disaster.png,47,63,1,59,106,395,458,1444,48.26870921750161,39.99299606817722
2625,/media/marda/TWOTB1/xBD/hurricanes/images/florence/hurricane-florence_00000096_post_disaster.png,65,45,1,822,887,395,440,623,32.55184731412827,25.536702539210882
2626,/media/marda/TWOTB1/xBD/hurricanes/images/florence/hurricane-florence_00000096_post_disaster.png,75,57,1,378,453,397,454,1553,59.11866007512813,34.95501020149203
2627,/media/marda/TWOTB1/xBD/hurricanes/images/florence/hurricane-florence_00000096_post_disaster.png,69,46,1,581,650,397,443,884,48.57856357917671,24.141144346379434
2628,/media/marda/TWOTB1/xBD/hurricanes/images/florence/hurricane-florence_00000096_post_disaster.png,73,67,1,708,781,401,468,1587,49.27450614704499,42.66018746697272
2629,/media/marda/TWOTB1/xBD/hurricanes/images/florence/hurricane-florence_00000096_post_disaster.png,30,35,1,229,259,407,442,268,22.75952558084828,15.745299079277816
2630,/media/marda/TWOTB1/xBD/hurricanes/images/florence/hurricane-florence_00000096_post_disaster.png,75,87,1,547,622,427,514,2360,68.45291453799456,46.130119782841696
2631,/media/marda/TWOTB1/xBD/hurricanes/images/florence/hurricane-florence_00000096_post_disaster.png,47,48,1,392,439,438,486,742,32.36853019418855,30.482141577811575
2632,/media/marda/TWOTB1/xBD/hurricanes/images/florence/hurricane-florence_00000096_post_disaster.png,35,41,1,79,114,448,489,569,34.95190242877517,21.27942906503637
2633,/media/marda/TWOTB1/xBD/hurricanes/images/florence/hurricane-florence_00000096_post_disaster.png,80,56,1,260,340,458,514,1655,75.32116453796723,30.915724239440603
2634,/media/marda/TWOTB1/xBD/hurricanes/images/florence/hurricane-florence_00000096_post_disaster.png,66,60,1,492,558,471,531,1502,49.07489633203319,40.54814697216954
2635,/media/marda/TWOTB1/xBD/hurricanes/images/florence/hurricane-florence_00000096_post_disaster.png,46,49,1,90,136,480,529,1001,47.14929921541691,28.34607704670438
2636,/media/marda/TWOTB1/xBD/hurricanes/images/florence/hurricane-florence_00000096_post_disaster.png,22,34,1,248,270,484,518,168,18.64933910388475,11.883805229188026
2637,/media/marda/TWOTB1/xBD/hurricanes/images/florence/hurricane-florence_00000096_post_disaster.png,130,141,1,848,978,487,628,7976,122.16460033568958,86.52477674445205
2638,/media/marda/TWOTB1/xBD/hurricanes/images/florence/hurricane-florence_00000096_post_disaster.png,63,62,1,437,500,490,552,1424,45.111191260625645,42.62928584520772
2639,/media/marda/TWOTB1/xBD/hurricanes/images/florence/hurricane-florence_00000096_post_disaster.png,144,88,1,696,840,490,578,5108,125.98610427052134,53.59405035087565
2640,/media/marda/TWOTB1/xBD/hurricanes/images/florence/hurricane-florence_00000096_post_disaster.png,59,69,1,395,454,506,575,1397,50.936889183810116,36.342825624191626
2641,/media/marda/TWOTB1/xBD/hurricanes/images/florence/hurricane-florence_00000096_post_disaster.png,65,56,1,90,155,522,578,1511,63.92707080579451,31.066996113402844
2642,/media/marda/TWOTB1/xBD/hurricanes/images/florence/hurricane-florence_00000096_post_disaster.png,54,61,1,292,346,534,595,1110,45.784351561588664,34.18901374076633
2643,/media/marda/TWOTB1/xBD/hurricanes/images/florence/hurricane-florence_00000096_post_disaster.png,86,63,1,719,805,553,616,1525,60.20981333608999,33.46259470131481
2644,/media/marda/TWOTB1/xBD/hurricanes/images/florence/hurricane-florence_00000096_post_disaster.png,55,76,1,110,165,564,640,1814,54.817000705716836,46.06514963980417
2645,/media/marda/TWOTB1/xBD/hurricanes/images/florence/hurricane-florence_00000096_post_disaster.png,49,50,1,171,220,572,622,819,44.80381497690787,23.904909212058623
2646,/media/marda/TWOTB1/xBD/hurricanes/images/florence/hurricane-florence_00000096_post_disaster.png,73,73,1,816,889,593,666,1409,49.35083397872745,37.66628827687979
2647,/media/marda/TWOTB1/xBD/hurricanes/images/florence/hurricane-florence_00000096_post_disaster.png,155,211,1,269,424,607,818,13069,198.51320499533836,118.41499335860294
2648,/media/marda/TWOTB1/xBD/hurricanes/images/florence/hurricane-florence_00000096_post_disaster.png,116,81,1,126,242,647,728,3233,121.46251304717457,35.24884575131249
2649,/media/marda/TWOTB1/xBD/hurricanes/images/florence/hurricane-florence_00000096_post_disaster.png,46,74,1,257,303,647,721,1245,51.22833139206333,32.40396115123611
2650,/media/marda/TWOTB1/xBD/hurricanes/images/florence/hurricane-florence_00000096_post_disaster.png,107,139,1,534,641,671,810,6103,123.99734052144919,67.09784065750982
2651,/media/marda/TWOTB1/xBD/hurricanes/images/florence/hurricane-florence_00000096_post_disaster.png,29,45,1,295,324,691,736,213,18.872472721368204,15.144245342637573
2652,/media/marda/TWOTB1/xBD/hurricanes/images/florence/hurricane-florence_00000096_post_disaster.png,54,40,1,944,998,694,734,136,18.285784755126368,9.946368628779489
2653,/media/marda/TWOTB1/xBD/hurricanes/images/florence/hurricane-florence_00000096_post_disaster.png,119,134,1,763,882,713,847,4744,117.32316771621866,67.2846952072236
2654,/media/marda/TWOTB1/xBD/hurricanes/images/florence/hurricane-florence_00000096_post_disaster.png,67,72,1,976,1043,713,785,904,41.87088866753194,29.055201758523403
2655,/media/marda/TWOTB1/xBD/hurricanes/images/florence/hurricane-florence_00000096_post_disaster.png,60,66,1,851,911,733,799,760,38.199553627447415,26.547052309442538
2656,/media/marda/TWOTB1/xBD/hurricanes/images/florence/hurricane-florence_00000096_post_disaster.png,59,66,1,156,215,742,808,1125,56.246930869210956,28.563161508309253
2657,/media/marda/TWOTB1/xBD/hurricanes/images/florence/hurricane-florence_00000096_post_disaster.png,40,50,1,207,247,748,798,409,34.11287427505825,15.842649103324938
2658,/media/marda/TWOTB1/xBD/hurricanes/images/florence/hurricane-florence_00000096_post_disaster.png,122,97,1,157,279,762,859,4775,127.37085034247526,49.70136407582612
2659,/media/marda/TWOTB1/xBD/hurricanes/images/florence/hurricane-florence_00000096_post_disaster.png,153,190,1,316,469,785,975,11476,177.06775859487465,115.72523371754588
2660,/media/marda/TWOTB1/xBD/hurricanes/images/florence/hurricane-florence_00000096_post_disaster.png,85,232,1,99,184,788,1020,5397,235.80211723868214,31.720308884124393
2661,/media/marda/TWOTB1/xBD/hurricanes/images/florence/hurricane-florence_00000096_post_disaster.png,59,78,1,302,361,815,893,1456,47.283856807332015,40.54797418795112
2662,/media/marda/TWOTB1/xBD/hurricanes/images/florence/hurricane-florence_00000096_post_disaster.png,125,195,1,204,329,820,1015,7204,180.3923436360948,90.25255445050495
2663,/media/marda/TWOTB1/xBD/hurricanes/images/florence/hurricane-florence_00000096_post_disaster.png,20,69,1,86,106,826,895,310,41.6108467828194,9.991554719297486
2664,/media/marda/TWOTB1/xBD/hurricanes/images/florence/hurricane-florence_00000096_post_disaster.png,75,87,1,207,282,835,922,2541,65.45304765877685,51.95774085252523
2665,/media/marda/TWOTB1/xBD/hurricanes/images/florence/hurricane-florence_00000096_post_disaster.png,44,60,1,332,376,854,914,629,34.22118129358959,24.18004188407688
2666,/media/marda/TWOTB1/xBD/hurricanes/images/florence/hurricane-florence_00000096_post_disaster.png,70,82,1,925,995,860,942,1119,53.88978498428485,27.829900148199993
2667,/media/marda/TWOTB1/xBD/hurricanes/images/florence/hurricane-florence_00000096_post_disaster.png,79,118,1,880,959,870,988,2204,89.39191397449702,36.47666506907994
2668,/media/marda/TWOTB1/xBD/hurricanes/images/florence/hurricane-florence_00000096_post_disaster.png,82,103,1,710,792,898,1001,2411,67.42807095280949,47.564824924221845
2669,/media/marda/TWOTB1/xBD/hurricanes/images/florence/hurricane-florence_00000096_post_disaster.png,22,73,1,107,129,911,984,326,41.04844806307333,10.634202429257343
2670,/media/marda/TWOTB1/xBD/hurricanes/images/florence/hurricane-florence_00000096_post_disaster.png,59,89,1,685,744,912,1001,1156,52.24255568835645,29.087923414365168
2671,/media/marda/TWOTB1/xBD/hurricanes/images/florence/hurricane-florence_00000096_post_disaster.png,56,79,1,650,706,918,997,934,43.9945285645006,28.330749183898398
2672,/media/marda/TWOTB1/xBD/hurricanes/images/florence/hurricane-florence_00000096_post_disaster.png,93,80,1,810,903,938,1018,1802,63.851131720910125,37.286099955911
2673,/media/marda/TWOTB1/xBD/hurricanes/images/florence/hurricane-florence_00000096_post_disaster.png,140,73,1,351,491,968,1041,2631,126.38968251290788,31.228571943345063
2674,/media/marda/TWOTB1/xBD/hurricanes/images/florence/hurricane-florence_00000096_post_disaster.png,141,70,1,530,671,971,1041,2885,123.91703307844254,32.081539997991825
2675,/media/marda/TWOTB1/xBD/hurricanes/images/florence/hurricane-florence_00000096_post_disaster.png,71,62,1,967,1038,981,1043,511,31.785074973594188,21.720532207299748
2676,/media/marda/TWOTB1/xBD/hurricanes/images/florence/hurricane-florence_00000416_pre_disaster.png,36,15,1,288,324,0,15,236,22.853100254685007,14.18459123939288
2677,/media/marda/TWOTB1/xBD/hurricanes/images/florence/hurricane-florence_00000416_pre_disaster.png,46,17,1,322,368,0,17,309,28.158694560224372,15.571775002064879
2678,/media/marda/TWOTB1/xBD/hurricanes/images/florence/hurricane-florence_00000416_pre_disaster.png,51,39,1,352,403,25,64,830,38.68058437886447,29.071521041093035
2679,/media/marda/TWOTB1/xBD/hurricanes/images/florence/hurricane-florence_00000416_pre_disaster.png,52,49,1,230,282,46,95,1004,50.36787985506485,26.59211206214491
2680,/media/marda/TWOTB1/xBD/hurricanes/images/florence/hurricane-florence_00000416_pre_disaster.png,74,37,1,387,461,49,86,835,64.55119604076049,23.54759832368672
2681,/media/marda/TWOTB1/xBD/hurricanes/images/florence/hurricane-florence_00000416_pre_disaster.png,40,34,1,314,354,99,133,498,36.298238817211406,18.247119403307526
2682,/media/marda/TWOTB1/xBD/hurricanes/images/florence/hurricane-florence_00000416_pre_disaster.png,43,49,1,177,220,99,148,648,53.48198760429757,16.084765410631192
2683,/media/marda/TWOTB1/xBD/hurricanes/images/florence/hurricane-florence_00000416_pre_disaster.png,19,51,1,0,19,143,194,536,46.81286628571189,16.678060099333663
2684,/media/marda/TWOTB1/xBD/hurricanes/images/florence/hurricane-florence_00000416_pre_disaster.png,48,43,1,280,328,151,194,871,35.973110456566694,32.09308476322604
2685,/media/marda/TWOTB1/xBD/hurricanes/images/florence/hurricane-florence_00000416_pre_disaster.png,41,53,1,68,109,178,231,1021,49.61752710534969,27.456048485990667
2686,/media/marda/TWOTB1/xBD/hurricanes/images/florence/hurricane-florence_00000416_pre_disaster.png,45,22,1,774,819,182,204,186,16.92922163675769,14.691907388570678
2687,/media/marda/TWOTB1/xBD/hurricanes/images/florence/hurricane-florence_00000416_pre_disaster.png,59,49,1,773,832,199,248,761,41.254367961424855,24.347456150337617
2688,/media/marda/TWOTB1/xBD/hurricanes/images/florence/hurricane-florence_00000416_pre_disaster.png,66,49,1,419,485,218,267,1137,50.87098851673878,29.824652074746766
2689,/media/marda/TWOTB1/xBD/hurricanes/images/florence/hurricane-florence_00000416_pre_disaster.png,57,48,1,621,678,223,271,804,39.43575436129464,26.909759039670263
2690,/media/marda/TWOTB1/xBD/hurricanes/images/florence/hurricane-florence_00000416_pre_disaster.png,49,20,1,912,961,248,268,88,11.498393255151187,10.339673755798097
2691,/media/marda/TWOTB1/xBD/hurricanes/images/florence/hurricane-florence_00000416_pre_disaster.png,79,37,1,654,733,255,292,590,58.45200194216621,13.482547854400094
2692,/media/marda/TWOTB1/xBD/hurricanes/images/florence/hurricane-florence_00000416_pre_disaster.png,52,41,1,508,560,256,297,640,32.14559738813654,26.68289813597522
2693,/media/marda/TWOTB1/xBD/hurricanes/images/florence/hurricane-florence_00000416_pre_disaster.png,42,23,1,702,744,260,283,110,12.582975987187607,11.907465035444066
2694,/media/marda/TWOTB1/xBD/hurricanes/images/florence/hurricane-florence_00000416_pre_disaster.png,9,19,1,63,72,266,285,91,11.676102129852477,10.380515499762831
2695,/media/marda/TWOTB1/xBD/hurricanes/images/florence/hurricane-florence_00000416_pre_disaster.png,77,41,1,906,983,275,316,745,40.34057046156922,24.493002211293824
2696,/media/marda/TWOTB1/xBD/hurricanes/images/florence/hurricane-florence_00000416_pre_disaster.png,60,46,1,781,841,290,336,662,36.04229768609484,24.688449698785423
2697,/media/marda/TWOTB1/xBD/hurricanes/images/florence/hurricane-florence_00000416_pre_disaster.png,70,43,1,822,892,308,351,686,38.057922857437745,23.91760866450962
2698,/media/marda/TWOTB1/xBD/hurricanes/images/florence/hurricane-florence_00000416_pre_disaster.png,49,50,1,411,460,313,363,740,41.104214742290075,23.52392489514231
2699,/media/marda/TWOTB1/xBD/hurricanes/images/florence/hurricane-florence_00000416_pre_disaster.png,46,39,1,998,1044,318,357,89,27.080816278217767,4.998211974913417
2700,/media/marda/TWOTB1/xBD/hurricanes/images/florence/hurricane-florence_00000416_pre_disaster.png,49,25,1,925,974,332,357,103,12.573246142868122,10.99809375379906
2701,/media/marda/TWOTB1/xBD/hurricanes/images/florence/hurricane-florence_00000416_pre_disaster.png,57,53,1,724,781,337,390,593,45.39445089673702,17.40483912377906
2702,/media/marda/TWOTB1/xBD/hurricanes/images/florence/hurricane-florence_00000416_pre_disaster.png,76,49,1,902,978,342,391,833,38.696723307330274,28.81478366674658
2703,/media/marda/TWOTB1/xBD/hurricanes/images/florence/hurricane-florence_00000416_pre_disaster.png,61,50,1,325,386,373,423,1020,47.889000338997356,28.519801390755035
2704,/media/marda/TWOTB1/xBD/hurricanes/images/florence/hurricane-florence_00000416_pre_disaster.png,55,23,1,980,1035,382,405,151,17.376546712918437,11.584987409038568
2705,/media/marda/TWOTB1/xBD/hurricanes/images/florence/hurricane-florence_00000416_pre_disaster.png,74,47,1,847,921,397,444,707,41.25602623888751,22.75738839193358
2706,/media/marda/TWOTB1/xBD/hurricanes/images/florence/hurricane-florence_00000416_pre_disaster.png,72,54,1,548,620,404,458,973,51.71698493910948,25.00110549088597
2707,/media/marda/TWOTB1/xBD/hurricanes/images/florence/hurricane-florence_00000416_pre_disaster.png,64,27,1,980,1044,411,438,261,30.10176703061328,11.546373648504723
2708,/media/marda/TWOTB1/xBD/hurricanes/images/florence/hurricane-florence_00000416_pre_disaster.png,113,122,1,628,741,458,580,4683,107.27053857966604,68.6154884742649
2709,/media/marda/TWOTB1/xBD/hurricanes/images/florence/hurricane-florence_00000416_pre_disaster.png,107,64,1,705,812,528,592,1829,80.25221518656755,31.790836686273735
2710,/media/marda/TWOTB1/xBD/hurricanes/images/florence/hurricane-florence_00000416_pre_disaster.png,49,35,1,856,905,530,565,143,16.218292403495404,11.822190757720248
2711,/media/marda/TWOTB1/xBD/hurricanes/images/florence/hurricane-florence_00000416_pre_disaster.png,67,49,1,818,885,555,604,559,33.75008239979438,22.115526618498816
2712,/media/marda/TWOTB1/xBD/hurricanes/images/florence/hurricane-florence_00000416_pre_disaster.png,62,69,1,805,867,619,688,615,49.377841429576115,16.632269141243754
2713,/media/marda/TWOTB1/xBD/hurricanes/images/florence/hurricane-florence_00000416_pre_disaster.png,66,53,1,895,961,660,713,702,32.17244667571757,28.862744577363554
2714,/media/marda/TWOTB1/xBD/hurricanes/images/florence/hurricane-florence_00000416_pre_disaster.png,77,77,1,765,842,672,749,1369,53.361779692831696,35.05139952137691
2715,/media/marda/TWOTB1/xBD/hurricanes/images/florence/hurricane-florence_00000416_pre_disaster.png,66,61,1,820,886,681,742,694,35.18630151731623,26.32624469224409
2716,/media/marda/TWOTB1/xBD/hurricanes/images/florence/hurricane-florence_00000416_pre_disaster.png,44,39,1,817,861,720,759,102,13.114478286580463,10.4717485690948
2717,/media/marda/TWOTB1/xBD/hurricanes/images/florence/hurricane-florence_00000416_pre_disaster.png,48,43,1,846,894,726,769,172,16.354047455194817,14.17452732391778
2718,/media/marda/TWOTB1/xBD/hurricanes/images/florence/hurricane-florence_00000416_pre_disaster.png,66,56,1,805,871,733,789,713,36.271196828649416,26.469884263538546
2719,/media/marda/TWOTB1/xBD/hurricanes/images/florence/hurricane-florence_00000416_pre_disaster.png,64,61,1,858,922,744,805,512,28.15275714353682,24.300444866005776
2720,/media/marda/TWOTB1/xBD/hurricanes/images/florence/hurricane-florence_00000416_pre_disaster.png,60,67,1,710,770,801,868,697,32.345041324119705,28.586011887054983
2721,/media/marda/TWOTB1/xBD/hurricanes/images/florence/hurricane-florence_00000416_pre_disaster.png,47,60,1,757,804,815,875,336,26.962400889566705,17.26475423293964
2722,/media/marda/TWOTB1/xBD/hurricanes/images/florence/hurricane-florence_00000416_pre_disaster.png,66,63,1,699,765,844,907,783,39.6475278816222,26.222570745965026
2723,/media/marda/TWOTB1/xBD/hurricanes/images/florence/hurricane-florence_00000416_pre_disaster.png,74,92,1,813,887,862,954,1653,63.90489554877378,38.168292936210165
2724,/media/marda/TWOTB1/xBD/hurricanes/images/florence/hurricane-florence_00000416_pre_disaster.png,54,66,1,684,738,875,941,682,33.666572303416814,27.066028020502273
2725,/media/marda/TWOTB1/xBD/hurricanes/images/florence/hurricane-florence_00000416_pre_disaster.png,47,45,1,865,912,877,922,162,16.96106735753306,12.823101553923104
2726,/media/marda/TWOTB1/xBD/hurricanes/images/florence/hurricane-florence_00000416_pre_disaster.png,84,64,1,882,966,902,966,900,52.140670157937706,23.053916341719937
2727,/media/marda/TWOTB1/xBD/hurricanes/images/florence/hurricane-florence_00000416_pre_disaster.png,79,102,1,510,589,921,1023,1966,64.92579489807405,40.32523929416855
2728,/media/marda/TWOTB1/xBD/hurricanes/images/florence/hurricane-florence_00000416_pre_disaster.png,55,61,1,751,806,938,999,495,28.216477968322998,23.25407858590593
2729,/media/marda/TWOTB1/xBD/hurricanes/images/florence/hurricane-florence_00000416_pre_disaster.png,75,57,1,826,901,956,1013,517,46.71173702458686,17.068638563105164
2730,/media/marda/TWOTB1/xBD/hurricanes/images/florence/hurricane-florence_00000260_post_disaster.png,40,7,1,386,426,0,7,132,29.779205093191244,6.028372618933926
2731,/media/marda/TWOTB1/xBD/hurricanes/images/florence/hurricane-florence_00000260_post_disaster.png,63,37,1,665,728,1,38,655,36.87353110917392,23.70455783851302
2732,/media/marda/TWOTB1/xBD/hurricanes/images/florence/hurricane-florence_00000260_post_disaster.png,32,26,1,348,380,8,34,329,27.23024364217497,16.818996603194684
2733,/media/marda/TWOTB1/xBD/hurricanes/images/florence/hurricane-florence_00000260_post_disaster.png,57,29,1,964,1021,21,50,379,29.8125970611214,17.70488029487596
2734,/media/marda/TWOTB1/xBD/hurricanes/images/florence/hurricane-florence_00000260_post_disaster.png,65,32,1,703,768,47,79,445,43.735185651022526,13.49812594461022
2735,/media/marda/TWOTB1/xBD/hurricanes/images/florence/hurricane-florence_00000260_post_disaster.png,82,46,1,561,643,57,103,1877,61.089502497987716,41.17402051964416
2736,/media/marda/TWOTB1/xBD/hurricanes/images/florence/hurricane-florence_00000260_post_disaster.png,70,37,1,957,1027,66,103,699,35.49082374775256,26.30877867663679
2737,/media/marda/TWOTB1/xBD/hurricanes/images/florence/hurricane-florence_00000260_post_disaster.png,49,41,1,535,584,91,132,888,43.93713324587793,27.80917823679873
2738,/media/marda/TWOTB1/xBD/hurricanes/images/florence/hurricane-florence_00000260_post_disaster.png,67,41,1,637,704,99,140,654,53.768887255542126,16.148413901243774
2739,/media/marda/TWOTB1/xBD/hurricanes/images/florence/hurricane-florence_00000260_post_disaster.png,59,31,1,841,900,172,203,298,31.445552169465714,12.673618550543845
2740,/media/marda/TWOTB1/xBD/hurricanes/images/florence/hurricane-florence_00000260_post_disaster.png,113,71,1,800,913,188,259,1765,93.34790832258058,26.793850991388915
2741,/media/marda/TWOTB1/xBD/hurricanes/images/florence/hurricane-florence_00000260_post_disaster.png,57,36,1,555,612,189,225,614,38.5090625462575,20.810868573308632
2742,/media/marda/TWOTB1/xBD/hurricanes/images/florence/hurricane-florence_00000260_post_disaster.png,51,43,1,574,625,259,302,611,33.30718886830291,24.503255101778166
2743,/media/marda/TWOTB1/xBD/hurricanes/images/florence/hurricane-florence_00000260_post_disaster.png,70,70,1,387,457,264,334,1724,60.885736433184526,41.041218858875354
2744,/media/marda/TWOTB1/xBD/hurricanes/images/florence/hurricane-florence_00000260_post_disaster.png,50,29,1,714,764,277,306,230,18.829477415006686,16.384202288350178
2745,/media/marda/TWOTB1/xBD/hurricanes/images/florence/hurricane-florence_00000260_post_disaster.png,52,58,1,220,272,292,350,632,63.92671430236482,13.211173633504862
2746,/media/marda/TWOTB1/xBD/hurricanes/images/florence/hurricane-florence_00000260_post_disaster.png,37,35,1,376,413,299,334,273,22.46317536097971,16.251432226273803
2747,/media/marda/TWOTB1/xBD/hurricanes/images/florence/hurricane-florence_00000260_post_disaster.png,65,60,1,685,750,321,381,909,47.386141301404614,26.264805820963186
2748,/media/marda/TWOTB1/xBD/hurricanes/images/florence/hurricane-florence_00000260_post_disaster.png,60,72,1,385,445,368,440,1334,62.5227588721063,28.647644574346515
2749,/media/marda/TWOTB1/xBD/hurricanes/images/florence/hurricane-florence_00000260_post_disaster.png,26,27,1,329,355,386,413,104,12.379898549942624,11.353059413522624
2750,/media/marda/TWOTB1/xBD/hurricanes/images/florence/hurricane-florence_00000260_post_disaster.png,103,105,1,436,539,626,731,3705,73.84845633648195,66.68631013828744
2751,/media/marda/TWOTB1/xBD/hurricanes/images/florence/hurricane-florence_00000260_post_disaster.png,68,78,1,532,600,687,765,1307,46.10477092306877,37.50179233078333
2752,/media/marda/TWOTB1/xBD/hurricanes/images/florence/hurricane-florence_00000260_post_disaster.png,62,79,1,585,647,738,817,674,61.05736418356882,14.741377611487788
2753,/media/marda/TWOTB1/xBD/hurricanes/images/florence/hurricane-florence_00000260_post_disaster.png,74,77,1,919,993,853,930,834,46.43838327700718,24.411033877358395
2754,/media/marda/TWOTB1/xBD/hurricanes/images/florence/hurricane-florence_00000260_post_disaster.png,53,84,1,410,463,930,1014,555,55.058907654897965,13.61842862319804
2755,/media/marda/TWOTB1/xBD/hurricanes/images/florence/hurricane-florence_00000260_post_disaster.png,55,65,1,236,291,377,442,1148,54.98171471766688,27.869847794772284
2756,/media/marda/TWOTB1/xBD/hurricanes/images/florence/hurricane-florence_00000522_post_disaster.png,91,32,1,516,607,0,32,1601,76.54353268415693,27.911665695975405
2757,/media/marda/TWOTB1/xBD/hurricanes/images/florence/hurricane-florence_00000522_post_disaster.png,34,16,1,507,541,17,33,161,16.242225925866418,13.351291792946979
2758,/media/marda/TWOTB1/xBD/hurricanes/images/florence/hurricane-florence_00000522_post_disaster.png,31,18,1,431,462,29,47,158,17.69208056106116,12.002232149069702
2759,/media/marda/TWOTB1/xBD/hurricanes/images/florence/hurricane-florence_00000522_post_disaster.png,53,54,1,437,490,48,102,782,61.18687799452869,17.053634859861795
2760,/media/marda/TWOTB1/xBD/hurricanes/images/florence/hurricane-florence_00000522_post_disaster.png,31,34,1,276,307,141,175,374,29.87754782583415,16.44574265082682
2761,/media/marda/TWOTB1/xBD/hurricanes/images/florence/hurricane-florence_00000522_post_disaster.png,62,54,1,298,360,153,207,1213,51.476572928238475,31.37223025362079
2762,/media/marda/TWOTB1/xBD/hurricanes/images/florence/hurricane-florence_00000522_post_disaster.png,50,45,1,34,84,409,454,1171,54.01501834861368,29.09107411141544
2763,/media/marda/TWOTB1/xBD/hurricanes/images/florence/hurricane-florence_00000522_post_disaster.png,64,61,1,114,178,442,503,1450,63.85578415034511,30.887854635068752
2764,/media/marda/TWOTB1/xBD/hurricanes/images/florence/hurricane-florence_00000522_post_disaster.png,176,83,1,747,923,776,859,5491,161.7770005198399,46.25591160078407
2765,/media/marda/TWOTB1/xBD/hurricanes/images/florence/hurricane-florence_00000522_post_disaster.png,37,76,1,187,224,809,885,672,47.83999940466624,18.76099046116657
2766,/media/marda/TWOTB1/xBD/hurricanes/images/florence/hurricane-florence_00000522_post_disaster.png,41,38,1,820,861,818,856,43,8.812134722060538,6.181773080346047
2767,/media/marda/TWOTB1/xBD/hurricanes/images/florence/hurricane-florence_00000522_post_disaster.png,171,80,1,687,858,848,928,5549,159.77602879946875,46.95523508971008
2768,/media/marda/TWOTB1/xBD/hurricanes/images/florence/hurricane-florence_00000522_post_disaster.png,37,43,1,758,795,891,934,50,9.33098103299551,6.833212492077066
2769,/media/marda/TWOTB1/xBD/hurricanes/images/florence/hurricane-florence_00000522_post_disaster.png,38,42,1,683,721,895,937,58,12.860558729893109,5.838458590674225
2770,/media/marda/TWOTB1/xBD/hurricanes/images/florence/hurricane-florence_00000522_post_disaster.png,80,85,1,963,1043,924,1009,1681,49.63758252103732,44.849643069987614
2771,/media/marda/TWOTB1/xBD/hurricanes/images/florence/hurricane-florence_00000522_post_disaster.png,46,49,1,954,1000,929,978,86,13.784700119133522,9.085638969635886
2772,/media/marda/TWOTB1/xBD/hurricanes/images/florence/hurricane-florence_00000522_post_disaster.png,65,55,1,817,882,953,1008,360,35.87022619632653,13.321511742047377
2773,/media/marda/TWOTB1/xBD/hurricanes/images/florence/hurricane-florence_00000522_post_disaster.png,144,97,1,899,1043,851,948,4498,122.59069343439843,48.77304513411593
2774,/media/marda/TWOTB1/xBD/hurricanes/images/florence/hurricane-florence_00000522_post_disaster.png,48,50,1,882,930,889,939,124,14.252246693146574,12.011501559454631
2775,/media/marda/TWOTB1/xBD/hurricanes/images/florence/hurricane-florence_00000035_post_disaster.png,45,38,1,307,352,0,38,702,38.00676130160949,24.32353938437654
2776,/media/marda/TWOTB1/xBD/hurricanes/images/florence/hurricane-florence_00000035_post_disaster.png,56,24,1,353,409,0,24,535,36.690159673787505,21.445388606911354
2777,/media/marda/TWOTB1/xBD/hurricanes/images/florence/hurricane-florence_00000035_post_disaster.png,48,41,1,235,283,55,96,885,36.91220066059833,31.97291115624661
2778,/media/marda/TWOTB1/xBD/hurricanes/images/florence/hurricane-florence_00000035_post_disaster.png,43,52,1,84,127,144,196,1197,43.61831530257718,36.49160323842477
2779,/media/marda/TWOTB1/xBD/hurricanes/images/florence/hurricane-florence_00000035_post_disaster.png,67,34,1,649,716,183,217,1123,45.11528531458438,32.737702102547686
2780,/media/marda/TWOTB1/xBD/hurricanes/images/florence/hurricane-florence_00000035_post_disaster.png,40,54,1,0,40,192,246,1463,49.476324901203746,38.79058101585181
2781,/media/marda/TWOTB1/xBD/hurricanes/images/florence/hurricane-florence_00000035_post_disaster.png,27,32,1,54,81,241,273,461,30.017775616193962,20.140200964457904
2782,/media/marda/TWOTB1/xBD/hurricanes/images/florence/hurricane-florence_00000035_post_disaster.png,43,36,1,344,387,276,312,480,29.667703709673486,21.486235799163335
2783,/media/marda/TWOTB1/xBD/hurricanes/images/florence/hurricane-florence_00000035_post_disaster.png,45,34,1,268,313,319,353,553,35.632107484715625,20.162052790033776
2784,/media/marda/TWOTB1/xBD/hurricanes/images/florence/hurricane-florence_00000035_post_disaster.png,41,32,1,300,341,364,396,236,32.06925365460787,9.817154850487672
2785,/media/marda/TWOTB1/xBD/hurricanes/images/florence/hurricane-florence_00000035_post_disaster.png,34,48,1,78,112,368,416,705,33.93809822527196,27.29674066433491
2786,/media/marda/TWOTB1/xBD/hurricanes/images/florence/hurricane-florence_00000035_post_disaster.png,40,44,1,577,617,734,778,280,20.310432364561105,18.337844509271566
2787,/media/marda/TWOTB1/xBD/hurricanes/images/florence/hurricane-florence_00000035_post_disaster.png,22,59,1,0,22,908,967,335,22.27688535010855,19.799146502344723
2788,/media/marda/TWOTB1/xBD/hurricanes/images/florence/hurricane-florence_00000034_post_disaster.png,55,32,1,337,392,0,32,878,41.357330608847434,29.03285106257171
2789,/media/marda/TWOTB1/xBD/hurricanes/images/florence/hurricane-florence_00000034_post_disaster.png,48,37,1,391,439,8,45,720,37.279783545299075,25.313009475212386
2790,/media/marda/TWOTB1/xBD/hurricanes/images/florence/hurricane-florence_00000034_post_disaster.png,59,38,1,463,522,51,89,1004,40.43716690322661,32.59430372277191
2791,/media/marda/TWOTB1/xBD/hurricanes/images/florence/hurricane-florence_00000034_post_disaster.png,73,51,1,496,569,87,138,1465,47.54281673312811,41.09804642051406
2792,/media/marda/TWOTB1/xBD/hurricanes/images/florence/hurricane-florence_00000034_post_disaster.png,54,48,1,324,378,127,175,1011,44.117581104062076,30.26936116564215
2793,/media/marda/TWOTB1/xBD/hurricanes/images/florence/hurricane-florence_00000034_post_disaster.png,66,42,1,605,671,167,209,1055,38.58349190314797,35.70221594275343
2794,/media/marda/TWOTB1/xBD/hurricanes/images/florence/hurricane-florence_00000034_post_disaster.png,52,22,1,896,948,167,189,176,16.204554295657523,14.571256328408277
2795,/media/marda/TWOTB1/xBD/hurricanes/images/florence/hurricane-florence_00000034_post_disaster.png,75,40,1,941,1016,168,208,1018,39.76968421237212,33.576262294480635
2796,/media/marda/TWOTB1/xBD/hurricanes/images/florence/hurricane-florence_00000034_post_disaster.png,51,35,1,747,798,191,226,638,33.490564985183646,25.340128542671273
2797,/media/marda/TWOTB1/xBD/hurricanes/images/florence/hurricane-florence_00000034_post_disaster.png,83,38,1,864,947,194,232,1149,53.266952510793196,28.09650934705273
2798,/media/marda/TWOTB1/xBD/hurricanes/images/florence/hurricane-florence_00000034_post_disaster.png,59,29,1,688,747,197,226,399,33.09066667774484,15.940533590624952
2799,/media/marda/TWOTB1/xBD/hurricanes/images/florence/hurricane-florence_00000034_post_disaster.png,48,24,1,915,963,197,221,144,16.65174273028209,11.62600139725357
2800,/media/marda/TWOTB1/xBD/hurricanes/images/florence/hurricane-florence_00000034_post_disaster.png,58,43,1,818,876,198,241,888,40.144450524822894,29.331130342148565
2801,/media/marda/TWOTB1/xBD/hurricanes/images/florence/hurricane-florence_00000034_post_disaster.png,75,75,1,954,1029,395,470,1575,63.22830852530126,32.864135452095745
2802,/media/marda/TWOTB1/xBD/hurricanes/images/florence/hurricane-florence_00000034_post_disaster.png,69,53,1,681,750,410,463,1263,46.14766286016688,35.68653014729109
2803,/media/marda/TWOTB1/xBD/hurricanes/images/florence/hurricane-florence_00000034_post_disaster.png,77,51,1,836,913,468,519,1168,46.31256019675052,34.57712836168592
2804,/media/marda/TWOTB1/xBD/hurricanes/images/florence/hurricane-florence_00000034_post_disaster.png,76,68,1,946,1022,561,629,1158,47.840986910196854,32.19046863384967
2805,/media/marda/TWOTB1/xBD/hurricanes/images/florence/hurricane-florence_00000034_post_disaster.png,45,60,1,37,82,569,629,991,47.41498335800814,27.45326912540277
2806,/media/marda/TWOTB1/xBD/hurricanes/images/florence/hurricane-florence_00000034_post_disaster.png,87,86,1,956,1043,855,941,1557,50.11743617108129,40.890447088750136
2807,/media/marda/TWOTB1/xBD/hurricanes/images/florence/hurricane-florence_00000061_pre_disaster.png,48,26,1,700,748,202,228,246,19.043653982770724,17.263287990479032
2808,/media/marda/TWOTB1/xBD/hurricanes/images/florence/hurricane-florence_00000061_pre_disaster.png,79,47,1,721,800,206,253,1173,51.35376213488042,31.800889284407305
2809,/media/marda/TWOTB1/xBD/hurricanes/images/florence/hurricane-florence_00000061_pre_disaster.png,41,27,1,665,706,216,243,156,19.133595403714416,10.927539309269218
2810,/media/marda/TWOTB1/xBD/hurricanes/images/florence/hurricane-florence_00000061_pre_disaster.png,56,55,1,404,460,280,335,1214,48.650527026077086,33.099054969087874
2811,/media/marda/TWOTB1/xBD/hurricanes/images/florence/hurricane-florence_00000061_pre_disaster.png,30,27,1,379,409,322,349,142,17.379297331154678,10.943621026731892
2812,/media/marda/TWOTB1/xBD/hurricanes/images/florence/hurricane-florence_00000061_pre_disaster.png,42,51,1,243,285,342,393,848,36.931976093306496,30.667191097385583
2813,/media/marda/TWOTB1/xBD/hurricanes/images/florence/hurricane-florence_00000061_pre_disaster.png,92,80,1,854,946,790,870,1746,57.97548019434702,39.26765226554888
2814,/media/marda/TWOTB1/xBD/hurricanes/images/florence/hurricane-florence_00000061_pre_disaster.png,65,57,1,839,904,855,912,485,33.81800184541738,19.178177767590217
2815,/media/marda/TWOTB1/xBD/hurricanes/images/florence/hurricane-florence_00000527_post_disaster.png,63,58,1,479,542,48,106,1465,57.60346182059759,33.916881531724314
2816,/media/marda/TWOTB1/xBD/hurricanes/images/florence/hurricane-florence_00000527_post_disaster.png,40,24,1,584,624,65,89,264,23.263404698113753,15.188355152768736
2817,/media/marda/TWOTB1/xBD/hurricanes/images/florence/hurricane-florence_00000527_post_disaster.png,52,39,1,359,411,246,285,957,42.33928985926721,30.166150811297495
2818,/media/marda/TWOTB1/xBD/hurricanes/images/florence/hurricane-florence_00000527_post_disaster.png,58,51,1,189,247,294,345,1522,55.24087966122968,36.278513534353856
2819,/media/marda/TWOTB1/xBD/hurricanes/images/florence/hurricane-florence_00000527_post_disaster.png,44,57,1,434,478,316,373,1037,50.93586329051443,27.095023997693804
2820,/media/marda/TWOTB1/xBD/hurricanes/images/florence/hurricane-florence_00000527_post_disaster.png,76,62,1,236,312,384,446,1982,67.05815066916155,43.96684967732098
2821,/media/marda/TWOTB1/xBD/hurricanes/images/florence/hurricane-florence_00000527_post_disaster.png,21,29,1,206,227,405,434,130,14.072364061419032,12.429485911281288
2822,/media/marda/TWOTB1/xBD/hurricanes/images/florence/hurricane-florence_00000527_post_disaster.png,100,76,1,605,705,693,769,2274,81.22287644890218,37.293254659276926
2823,/media/marda/TWOTB1/xBD/hurricanes/images/florence/hurricane-florence_00000527_post_disaster.png,88,64,1,682,770,737,801,1271,66.14117669447305,25.642332580604045
2824,/media/marda/TWOTB1/xBD/hurricanes/images/florence/hurricane-florence_00000527_post_disaster.png,86,70,1,790,876,814,884,898,63.63105803181584,19.641832277421976
2825,/media/marda/TWOTB1/xBD/hurricanes/images/florence/hurricane-florence_00000527_post_disaster.png,55,47,1,814,869,878,925,261,24.902326538140503,13.908612663409208
2826,/media/marda/TWOTB1/xBD/hurricanes/images/florence/hurricane-florence_00000527_post_disaster.png,67,67,1,823,890,894,961,917,39.12240273327905,31.254572609434934
2827,/media/marda/TWOTB1/xBD/hurricanes/images/florence/hurricane-florence_00000527_post_disaster.png,90,66,1,693,783,715,781,1274,64.56608973079875,26.333265598759606
2828,/media/marda/TWOTB1/xBD/hurricanes/images/florence/hurricane-florence_00000521_post_disaster.png,32,18,1,510,542,53,71,130,18.810287415656713,9.323448761474605
2829,/media/marda/TWOTB1/xBD/hurricanes/images/florence/hurricane-florence_00000130_pre_disaster.png,31,64,1,17,48,924,988,499,27.975749224860234,23.664668707384497
2830,/media/marda/TWOTB1/xBD/hurricanes/images/florence/hurricane-florence_00000130_pre_disaster.png,13,46,1,98,111,924,970,58,9.40637645035564,8.342860200143672
2831,/media/marda/TWOTB1/xBD/hurricanes/images/florence/hurricane-florence_00000130_pre_disaster.png,33,71,1,50,83,940,1011,612,35.59927760187271,22.78375572924735
2832,/media/marda/TWOTB1/xBD/hurricanes/images/florence/hurricane-florence_00000080_post_disaster.png,50,51,1,861,911,852,903,187,16.242220227462887,15.425313262030846
2833,/media/marda/TWOTB1/xBD/hurricanes/images/florence/hurricane-florence_00000080_post_disaster.png,44,45,1,793,837,856,901,79,11.194571103769642,9.565732643015199
2834,/media/marda/TWOTB1/xBD/hurricanes/images/florence/hurricane-florence_00000080_post_disaster.png,90,85,1,764,854,869,954,1564,61.761133084443124,37.091898122520575
2835,/media/marda/TWOTB1/xBD/hurricanes/images/florence/hurricane-florence_00000080_post_disaster.png,76,113,1,693,769,881,994,1966,81.57911462356036,38.186844753756404
2836,/media/marda/TWOTB1/xBD/hurricanes/images/florence/hurricane-florence_00000080_post_disaster.png,40,55,1,661,701,884,939,197,18.80266220444999,14.066280222791017
2837,/media/marda/TWOTB1/xBD/hurricanes/images/florence/hurricane-florence_00000048_pre_disaster.png,50,57,1,55,105,27,84,1428,59.11490115194969,32.213191087006464
2838,/media/marda/TWOTB1/xBD/hurricanes/images/florence/hurricane-florence_00000048_pre_disaster.png,52,46,1,95,147,98,144,1140,40.98416886424853,37.25317689884272
2839,/media/marda/TWOTB1/xBD/hurricanes/images/florence/hurricane-florence_00000048_pre_disaster.png,52,17,1,819,871,100,117,153,20.679019046218635,9.947378769401757
2840,/media/marda/TWOTB1/xBD/hurricanes/images/florence/hurricane-florence_00000048_pre_disaster.png,50,22,1,822,872,113,135,222,18.372095933043052,15.853595015783455
2841,/media/marda/TWOTB1/xBD/hurricanes/images/florence/hurricane-florence_00000048_pre_disaster.png,68,35,1,837,905,127,162,745,37.078028451554395,26.622563074516332
2842,/media/marda/TWOTB1/xBD/hurricanes/images/florence/hurricane-florence_00000048_pre_disaster.png,53,34,1,991,1044,167,201,317,32.045014292454496,13.293562594403806
2843,/media/marda/TWOTB1/xBD/hurricanes/images/florence/hurricane-florence_00000048_pre_disaster.png,69,43,1,820,889,175,218,1003,41.62143490661008,32.27594501742541
2844,/media/marda/TWOTB1/xBD/hurricanes/images/florence/hurricane-florence_00000048_pre_disaster.png,97,42,1,937,1034,202,244,1320,64.34170524908447,27.17903278830065
2845,/media/marda/TWOTB1/xBD/hurricanes/images/florence/hurricane-florence_00000048_pre_disaster.png,47,44,1,371,418,296,340,551,29.722846628150094,24.518495377536325
2846,/media/marda/TWOTB1/xBD/hurricanes/images/florence/hurricane-florence_00000048_pre_disaster.png,93,56,1,584,677,411,467,1583,78.84235414260321,26.577122543435074
2847,/media/marda/TWOTB1/xBD/hurricanes/images/florence/hurricane-florence_00000048_pre_disaster.png,83,66,1,892,975,457,523,1523,56.52612012147668,36.61948331430955
2848,/media/marda/TWOTB1/xBD/hurricanes/images/florence/hurricane-florence_00000048_pre_disaster.png,40,27,1,677,717,461,488,103,15.338656118981161,9.074622781095094
2849,/media/marda/TWOTB1/xBD/hurricanes/images/florence/hurricane-florence_00000048_pre_disaster.png,36,24,1,636,672,484,508,60,13.129567844765273,6.187173415734562
2850,/media/marda/TWOTB1/xBD/hurricanes/images/florence/hurricane-florence_00000048_pre_disaster.png,57,39,1,987,1044,493,532,216,19.808230544545907,16.7129783713487
2851,/media/marda/TWOTB1/xBD/hurricanes/images/florence/hurricane-florence_00000048_pre_disaster.png,57,45,1,651,708,502,547,530,34.2588089988067,20.572255099735315
2852,/media/marda/TWOTB1/xBD/hurricanes/images/florence/hurricane-florence_00000048_pre_disaster.png,70,45,1,961,1031,512,557,517,31.64085605318583,22.232598213799147
2853,/media/marda/TWOTB1/xBD/hurricanes/images/florence/hurricane-florence_00000048_pre_disaster.png,91,61,1,844,935,520,581,1348,61.152692411575025,30.094149995932597
2854,/media/marda/TWOTB1/xBD/hurricanes/images/florence/hurricane-florence_00000048_pre_disaster.png,51,29,1,877,928,525,554,93,18.84473770022277,6.713702627344354
2855,/media/marda/TWOTB1/xBD/hurricanes/images/florence/hurricane-florence_00000048_pre_disaster.png,50,34,1,953,1003,533,567,146,15.099192969997954,13.027394282501419
2856,/media/marda/TWOTB1/xBD/hurricanes/images/florence/hurricane-florence_00000048_pre_disaster.png,66,51,1,668,734,538,589,862,41.12609113554211,27.987718734129356
2857,/media/marda/TWOTB1/xBD/hurricanes/images/florence/hurricane-florence_00000048_pre_disaster.png,65,52,1,890,955,555,607,573,30.676781218133875,24.841822849266343
2858,/media/marda/TWOTB1/xBD/hurricanes/images/florence/hurricane-florence_00000048_pre_disaster.png,69,68,1,923,992,558,626,1054,51.73334155596273,27.59006607639583
2859,/media/marda/TWOTB1/xBD/hurricanes/images/florence/hurricane-florence_00000048_pre_disaster.png,80,60,1,834,914,584,644,1262,45.771035272995604,36.798948469258704
2860,/media/marda/TWOTB1/xBD/hurricanes/images/florence/hurricane-florence_00000444_post_disaster.png,48,15,1,271,319,0,15,454,41.57735444762905,14.716991389719126
2861,/media/marda/TWOTB1/xBD/hurricanes/images/florence/hurricane-florence_00000444_post_disaster.png,30,8,1,360,390,0,8,123,20.275252679609235,8.105237872867418
2862,/media/marda/TWOTB1/xBD/hurricanes/images/florence/hurricane-florence_00000444_post_disaster.png,58,21,1,275,333,62,83,717,54.88134546266903,18.71725594759189
2863,/media/marda/TWOTB1/xBD/hurricanes/images/florence/hurricane-florence_00000444_post_disaster.png,36,18,1,373,409,62,80,278,22.2846484586738,16.721981309063395
2864,/media/marda/TWOTB1/xBD/hurricanes/images/florence/hurricane-florence_00000444_post_disaster.png,47,13,1,836,883,75,88,130,15.324123014368583,11.310659448242117
2865,/media/marda/TWOTB1/xBD/hurricanes/images/florence/hurricane-florence_00000444_post_disaster.png,21,12,1,316,337,91,103,108,13.808210118138652,10.327955589886445
2866,/media/marda/TWOTB1/xBD/hurricanes/images/florence/hurricane-florence_00000444_post_disaster.png,68,45,1,737,805,92,137,1345,45.02141612418372,39.2294553779279
2867,/media/marda/TWOTB1/xBD/hurricanes/images/florence/hurricane-florence_00000444_post_disaster.png,90,36,1,903,993,142,178,1180,60.22691428627522,26.214292945755236
2868,/media/marda/TWOTB1/xBD/hurricanes/images/florence/hurricane-florence_00000444_post_disaster.png,80,27,1,537,617,180,207,702,64.24297324071829,14.567876443516525
2869,/media/marda/TWOTB1/xBD/hurricanes/images/florence/hurricane-florence_00000444_post_disaster.png,69,29,1,870,939,194,223,641,36.7595487949355,22.873962485948454
2870,/media/marda/TWOTB1/xBD/hurricanes/images/florence/hurricane-florence_00000444_post_disaster.png,63,65,1,685,748,209,274,1590,59.682155272917626,35.34322931558708
2871,/media/marda/TWOTB1/xBD/hurricanes/images/florence/hurricane-florence_00000444_post_disaster.png,29,23,1,560,589,227,250,92,15.058743794383954,8.242991007002859
2872,/media/marda/TWOTB1/xBD/hurricanes/images/florence/hurricane-florence_00000444_post_disaster.png,331,88,1,492,823,953,1041,9014,344.8690390846546,34.719982105792326
2873,/media/marda/TWOTB1/xBD/hurricanes/images/florence/hurricane-florence_00000444_post_disaster.png,59,49,1,823,882,994,1043,125,24.20521864265949,7.958242925486116
2874,/media/marda/TWOTB1/xBD/hurricanes/images/florence/hurricane-florence_00000444_post_disaster.png,44,33,1,577,621,286,319,406,24.975614240740192,21.83602884891982
2875,/media/marda/TWOTB1/xBD/hurricanes/images/florence/hurricane-florence_00000070_pre_disaster.png,50,44,1,367,417,133,177,795,38.92617661947216,27.07298235744209
2876,/media/marda/TWOTB1/xBD/hurricanes/images/florence/hurricane-florence_00000070_pre_disaster.png,59,60,1,157,216,237,297,1483,48.32522388600307,40.84816609249385
2877,/media/marda/TWOTB1/xBD/hurricanes/images/florence/hurricane-florence_00000070_pre_disaster.png,72,56,1,256,328,315,371,1783,64.61192458125724,37.2210170461151
2878,/media/marda/TWOTB1/xBD/hurricanes/images/florence/hurricane-florence_00000070_pre_disaster.png,40,50,1,332,372,331,381,707,38.654275220681114,24.26703817709374
2879,/media/marda/TWOTB1/xBD/hurricanes/images/florence/hurricane-florence_00000070_pre_disaster.png,89,103,1,767,856,828,931,2220,61.533132383838876,48.87047904521717
2880,/media/marda/TWOTB1/xBD/hurricanes/images/florence/hurricane-florence_00000070_pre_disaster.png,59,71,1,500,559,863,934,790,39.71043130853852,26.274427348420144
2881,/media/marda/TWOTB1/xBD/hurricanes/images/florence/hurricane-florence_00000070_pre_disaster.png,53,50,1,441,494,873,923,448,39.63764204788158,15.031085942762207
2882,/media/marda/TWOTB1/xBD/hurricanes/images/florence/hurricane-florence_00000070_pre_disaster.png,68,79,1,470,538,890,969,1214,46.422024500571254,37.14749507290567
2883,/media/marda/TWOTB1/xBD/hurricanes/images/florence/hurricane-florence_00000070_pre_disaster.png,46,68,1,163,209,892,960,839,39.80555840482611,27.762178239839812
2884,/media/marda/TWOTB1/xBD/hurricanes/images/florence/hurricane-florence_00000070_pre_disaster.png,62,61,1,982,1044,893,954,517,27.79290200391381,24.821378656568395
2885,/media/marda/TWOTB1/xBD/hurricanes/images/florence/hurricane-florence_00000070_pre_disaster.png,41,66,1,445,486,898,964,374,27.679404673326,18.85970039343987
2886,/media/marda/TWOTB1/xBD/hurricanes/images/florence/hurricane-florence_00000070_pre_disaster.png,25,68,1,127,152,902,970,366,34.3814610383268,14.241183649311045
2887,/media/marda/TWOTB1/xBD/hurricanes/images/florence/hurricane-florence_00000070_pre_disaster.png,44,67,1,354,398,904,971,554,30.661994401868466,23.70618800386267
2888,/media/marda/TWOTB1/xBD/hurricanes/images/florence/hurricane-florence_00000070_pre_disaster.png,22,56,1,112,134,912,968,256,20.404148305720454,16.823897724740842
2889,/media/marda/TWOTB1/xBD/hurricanes/images/florence/hurricane-florence_00000070_pre_disaster.png,63,89,1,375,438,951,1040,1359,54.14750848934471,33.16305614820452
2890,/media/marda/TWOTB1/xBD/hurricanes/images/florence/hurricane-florence_00000256_post_disaster.png,73,40,1,954,1027,0,40,868,45.93892123590374,25.287392271694312
2891,/media/marda/TWOTB1/xBD/hurricanes/images/florence/hurricane-florence_00000256_post_disaster.png,74,52,1,970,1044,131,183,1260,46.02071826732065,35.96052615411918
2892,/media/marda/TWOTB1/xBD/hurricanes/images/florence/hurricane-florence_00000256_post_disaster.png,58,38,1,930,988,574,612,248,21.55963540712529,15.416554557049276
2893,/media/marda/TWOTB1/xBD/hurricanes/images/florence/hurricane-florence_00000256_post_disaster.png,54,45,1,841,895,669,714,296,21.951683972192015,17.59695397483908
2894,/media/marda/TWOTB1/xBD/hurricanes/images/florence/hurricane-florence_00000256_post_disaster.png,101,76,1,938,1039,775,851,1537,67.2704903169036,30.43444361618064
2895,/media/marda/TWOTB1/xBD/hurricanes/images/florence/hurricane-florence_00000256_post_disaster.png,67,64,1,883,950,840,904,615,29.619419968360354,27.540651565719987
2896,/media/marda/TWOTB1/xBD/hurricanes/images/florence/hurricane-florence_00000256_post_disaster.png,62,54,1,823,885,874,928,318,30.000515907434,14.175762210333957
2897,/media/marda/TWOTB1/xBD/hurricanes/images/florence/hurricane-florence_00000256_post_disaster.png,64,61,1,944,1008,910,971,439,25.620138938068795,22.560340777960707
2898,/media/marda/TWOTB1/xBD/hurricanes/images/florence/hurricane-florence_00000256_post_disaster.png,73,85,1,971,1044,915,1000,1038,44.62720107468776,31.614211735840875
2899,/media/marda/TWOTB1/xBD/hurricanes/images/florence/hurricane-florence_00000256_post_disaster.png,56,56,1,935,991,945,1001,260,19.194442310167382,18.040713647156473
2900,/media/marda/TWOTB1/xBD/hurricanes/images/florence/hurricane-florence_00000256_post_disaster.png,81,80,1,784,865,961,1041,1524,50.20322828515237,40.641385668216415
2901,/media/marda/TWOTB1/xBD/hurricanes/images/florence/hurricane-florence_00000162_pre_disaster.png,57,52,1,892,949,436,488,409,37.781107864976896,15.969654453856258
2902,/media/marda/TWOTB1/xBD/hurricanes/images/florence/hurricane-florence_00000162_pre_disaster.png,48,32,1,914,962,499,531,72,11.620367469828654,8.331356690875289
2903,/media/marda/TWOTB1/xBD/hurricanes/images/florence/hurricane-florence_00000162_pre_disaster.png,43,72,1,15,58,512,584,1039,55.15090517977588,25.05942580704323
2904,/media/marda/TWOTB1/xBD/hurricanes/images/florence/hurricane-florence_00000162_pre_disaster.png,80,62,1,883,963,563,625,1049,46.82758083458402,32.9224111676019
2905,/media/marda/TWOTB1/xBD/hurricanes/images/florence/hurricane-florence_00000162_pre_disaster.png,59,47,1,876,935,636,683,289,27.130202196231878,14.133013614772201
2906,/media/marda/TWOTB1/xBD/hurricanes/images/florence/hurricane-florence_00000162_pre_disaster.png,49,44,1,797,846,865,909,97,16.576334420439508,7.785541590245974
2907,/media/marda/TWOTB1/xBD/hurricanes/images/florence/hurricane-florence_00000162_pre_disaster.png,55,57,1,767,822,907,964,323,25.285785323335862,16.74010191429329
2908,/media/marda/TWOTB1/xBD/hurricanes/images/florence/hurricane-florence_00000042_post_disaster.png,60,14,1,706,766,0,14,369,33.99391910380539,14.343443478870064
2909,/media/marda/TWOTB1/xBD/hurricanes/images/florence/hurricane-florence_00000042_post_disaster.png,64,59,1,675,739,37,96,1512,60.930244585634995,32.98070476923345
2910,/media/marda/TWOTB1/xBD/hurricanes/images/florence/hurricane-florence_00000042_post_disaster.png,39,14,1,637,676,51,65,152,16.005068936516796,12.622714473991547
2911,/media/marda/TWOTB1/xBD/hurricanes/images/florence/hurricane-florence_00000042_post_disaster.png,56,47,1,655,711,119,166,1005,43.83026326440241,30.170434657837603
2912,/media/marda/TWOTB1/xBD/hurricanes/images/florence/hurricane-florence_00000042_post_disaster.png,57,61,1,586,643,524,585,930,39.40109201828352,31.449250925434097
2913,/media/marda/TWOTB1/xBD/hurricanes/images/florence/hurricane-florence_00000042_post_disaster.png,36,36,1,525,561,535,571,169,15.559209751916791,14.488416513601013
2914,/media/marda/TWOTB1/xBD/hurricanes/images/florence/hurricane-florence_00000042_post_disaster.png,28,31,1,404,432,586,617,100,12.927375575025053,10.345383547372501
2915,/media/marda/TWOTB1/xBD/hurricanes/images/florence/hurricane-florence_00000042_post_disaster.png,55,57,1,348,403,591,648,758,46.43435483023289,23.560440604598874
2916,/media/marda/TWOTB1/xBD/hurricanes/images/florence/hurricane-florence_00000042_post_disaster.png,66,62,1,387,453,618,680,1349,54.00297196387003,33.618264119067135
2917,/media/marda/TWOTB1/xBD/hurricanes/images/florence/hurricane-florence_00000042_post_disaster.png,73,51,1,541,614,630,681,662,57.52170086890324,15.313734126967
2918,/media/marda/TWOTB1/xBD/hurricanes/images/florence/hurricane-florence_00000042_post_disaster.png,55,42,1,479,534,657,699,480,39.3880040609584,16.497373443623342
2919,/media/marda/TWOTB1/xBD/hurricanes/images/florence/hurricane-florence_00000042_post_disaster.png,82,64,1,286,368,687,751,1263,75.14901737806287,28.0771023118689
2920,/media/marda/TWOTB1/xBD/hurricanes/images/florence/hurricane-florence_00000042_post_disaster.png,57,74,1,274,331,742,816,1116,48.514458803751616,30.40252583647342
2921,/media/marda/TWOTB1/xBD/hurricanes/images/florence/hurricane-florence_00000042_post_disaster.png,61,80,1,206,267,803,883,1081,62.97393048077855,24.932499016592068
2922,/media/marda/TWOTB1/xBD/hurricanes/images/florence/hurricane-florence_00000060_post_disaster.png,57,84,1,686,743,310,394,1414,78.18975689318258,24.257076951527157
2923,/media/marda/TWOTB1/xBD/hurricanes/images/florence/hurricane-florence_00000060_post_disaster.png,49,75,1,554,603,466,541,1352,63.233092058382475,28.432166996816964
2924,/media/marda/TWOTB1/xBD/hurricanes/images/florence/hurricane-florence_00000060_post_disaster.png,23,51,1,82,105,535,586,599,34.53321898073835,22.88438215682743
2925,/media/marda/TWOTB1/xBD/hurricanes/images/florence/hurricane-florence_00000060_post_disaster.png,57,60,1,68,125,620,680,1148,63.50128740851828,27.91376211954661
2926,/media/marda/TWOTB1/xBD/hurricanes/images/florence/hurricane-florence_00000060_post_disaster.png,40,63,1,314,354,642,705,843,42.99254813581366,26.71580965187045
2927,/media/marda/TWOTB1/xBD/hurricanes/images/florence/hurricane-florence_00000060_post_disaster.png,17,37,1,237,254,659,696,117,14.966629547095765,10.327955589886445
2928,/media/marda/TWOTB1/xBD/hurricanes/images/florence/hurricane-florence_00000060_post_disaster.png,12,37,1,11,23,674,711,121,15.029164614374526,11.216385012593996
2929,/media/marda/TWOTB1/xBD/hurricanes/images/florence/hurricane-florence_00000060_post_disaster.png,47,50,1,1,48,722,772,881,52.1231261562538,22.388669146341247
2930,/media/marda/TWOTB1/xBD/hurricanes/images/florence/hurricane-florence_00000060_post_disaster.png,59,53,1,217,276,725,778,1027,55.246779060239454,24.830055719671748
2931,/media/marda/TWOTB1/xBD/hurricanes/images/florence/hurricane-florence_00000219_post_disaster.png,47,59,1,623,670,692,751,464,30.141299099644915,20.259455419358016
2932,/media/marda/TWOTB1/xBD/hurricanes/images/florence/hurricane-florence_00000219_post_disaster.png,44,50,1,616,660,728,778,285,20.419523032225925,18.69153405697185
2933,/media/marda/TWOTB1/xBD/hurricanes/images/florence/hurricane-florence_00000219_post_disaster.png,45,46,1,627,672,756,802,242,21.38436009913766,15.1758054939504
2934,/media/marda/TWOTB1/xBD/hurricanes/images/florence/hurricane-florence_00000219_post_disaster.png,41,49,1,559,600,838,887,253,21.208231322435005,16.013279264529505
2935,/media/marda/TWOTB1/xBD/hurricanes/images/florence/hurricane-florence_00000427_post_disaster.png,58,87,1,150,208,771,858,1833,59.78340971381779,41.58480525115622
2936,/media/marda/TWOTB1/xBD/hurricanes/images/florence/hurricane-florence_00000333_pre_disaster.png,94,51,1,942,1036,170,221,1308,54.83725205121367,31.70800221741335
2937,/media/marda/TWOTB1/xBD/hurricanes/images/florence/hurricane-florence_00000171_post_disaster.png,71,52,1,452,523,483,535,1069,51.89959734732778,27.77681670718077
2938,/media/marda/TWOTB1/xBD/hurricanes/images/florence/hurricane-florence_00000171_post_disaster.png,55,49,1,361,416,485,534,882,45.23363326939825,29.56452327915323
2939,/media/marda/TWOTB1/xBD/hurricanes/images/florence/hurricane-florence_00000183_post_disaster.png,50,38,1,182,232,28,66,824,42.11967295127078,26.256348254850426
2940,/media/marda/TWOTB1/xBD/hurricanes/images/florence/hurricane-florence_00000183_post_disaster.png,35,27,1,436,471,208,235,181,16.35164075764641,14.808651806714769
2941,/media/marda/TWOTB1/xBD/hurricanes/images/florence/hurricane-florence_00000183_post_disaster.png,66,52,1,439,505,223,275,1274,46.39600076435855,35.92602590201763
2942,/media/marda/TWOTB1/xBD/hurricanes/images/florence/hurricane-florence_00000183_post_disaster.png,32,31,1,243,275,229,260,261,24.102448413013516,14.549854907245699
2943,/media/marda/TWOTB1/xBD/hurricanes/images/florence/hurricane-florence_00000183_post_disaster.png,83,74,1,917,1000,531,605,1097,50.66438728184117,34.62604101124455
2944,/media/marda/TWOTB1/xBD/hurricanes/images/florence/hurricane-florence_00000183_post_disaster.png,79,63,1,962,1041,577,640,860,44.23126203903295,26.10467760546867
2945,/media/marda/TWOTB1/xBD/hurricanes/images/florence/hurricane-florence_00000183_post_disaster.png,70,59,1,841,911,653,712,629,37.54011994226685,22.362246889068466
2946,/media/marda/TWOTB1/xBD/hurricanes/images/florence/hurricane-florence_00000183_post_disaster.png,61,50,1,918,979,682,732,313,27.512541063191186,15.060916157927126
2947,/media/marda/TWOTB1/xBD/hurricanes/images/florence/hurricane-florence_00000141_pre_disaster.png,43,40,1,420,463,73,113,757,40.18343105081443,24.90233846028779
2948,/media/marda/TWOTB1/xBD/hurricanes/images/florence/hurricane-florence_00000141_pre_disaster.png,49,25,1,451,500,148,173,584,36.88656687419144,21.23052165813727
2949,/media/marda/TWOTB1/xBD/hurricanes/images/florence/hurricane-florence_00000141_pre_disaster.png,43,61,1,444,487,216,277,1379,60.07729490881606,30.616034472887588
2950,/media/marda/TWOTB1/xBD/hurricanes/images/florence/hurricane-florence_00000141_pre_disaster.png,57,47,1,555,612,484,531,853,36.81580479149665,31.051924396370918
2951,/media/marda/TWOTB1/xBD/hurricanes/images/florence/hurricane-florence_00000141_pre_disaster.png,71,54,1,630,701,516,570,1192,50.25983197156285,31.753612726000753
2952,/media/marda/TWOTB1/xBD/hurricanes/images/florence/hurricane-florence_00000141_pre_disaster.png,57,41,1,838,895,538,579,433,26.118935254618656,22.06059951141501
2953,/media/marda/TWOTB1/xBD/hurricanes/images/florence/hurricane-florence_00000141_pre_disaster.png,41,79,1,377,418,757,836,915,54.69780307729841,22.33242076282757
2954,/media/marda/TWOTB1/xBD/hurricanes/images/florence/hurricane-florence_00000141_pre_disaster.png,58,60,1,136,194,822,882,1257,57.16699836923655,29.03034753736428
2955,/media/marda/TWOTB1/xBD/hurricanes/images/florence/hurricane-florence_00000027_post_disaster.png,42,53,1,122,164,463,516,630,40.44293868666956,20.805939731811016
2956,/media/marda/TWOTB1/xBD/hurricanes/images/florence/hurricane-florence_00000498_pre_disaster.png,66,33,1,832,898,210,243,427,34.76359751957965,16.422939887018963
2957,/media/marda/TWOTB1/xBD/hurricanes/images/florence/hurricane-florence_00000498_pre_disaster.png,74,61,1,795,869,239,300,1055,56.77085716545838,24.799348327426927
2958,/media/marda/TWOTB1/xBD/hurricanes/images/florence/hurricane-florence_00000498_pre_disaster.png,48,19,1,994,1042,245,264,55,10.34577969160451,7.014192195795645
2959,/media/marda/TWOTB1/xBD/hurricanes/images/florence/hurricane-florence_00000498_pre_disaster.png,56,20,1,983,1039,255,275,94,15.330061555135417,8.266201723960073
2960,/media/marda/TWOTB1/xBD/hurricanes/images/florence/hurricane-florence_00000498_pre_disaster.png,60,27,1,926,986,272,299,202,24.816537841922404,11.058136222005814
2961,/media/marda/TWOTB1/xBD/hurricanes/images/florence/hurricane-florence_00000498_pre_disaster.png,58,22,1,923,981,295,317,142,24.592108943853074,7.739782557132333
2962,/media/marda/TWOTB1/xBD/hurricanes/images/florence/hurricane-florence_00000498_pre_disaster.png,86,41,1,872,958,306,347,606,60.26226942503595,13.394719349031538
2963,/media/marda/TWOTB1/xBD/hurricanes/images/florence/hurricane-florence_00000498_pre_disaster.png,39,36,1,468,507,423,459,170,26.87363905055158,8.472608927322232
2964,/media/marda/TWOTB1/xBD/hurricanes/images/florence/hurricane-florence_00000498_pre_disaster.png,52,42,1,458,510,449,491,570,35.997276531743836,22.180538716362882
2965,/media/marda/TWOTB1/xBD/hurricanes/images/florence/hurricane-florence_00000498_pre_disaster.png,62,72,1,571,633,645,717,1051,46.5900400179323,31.927278345026416
2966,/media/marda/TWOTB1/xBD/hurricanes/images/florence/hurricane-florence_00000498_pre_disaster.png,75,75,1,892,967,659,734,1367,52.00974923090684,35.40067757335397
2967,/media/marda/TWOTB1/xBD/hurricanes/images/florence/hurricane-florence_00000498_pre_disaster.png,33,38,1,510,543,679,717,102,11.95837011969403,11.436839845387206
2968,/media/marda/TWOTB1/xBD/hurricanes/images/florence/hurricane-florence_00000498_pre_disaster.png,37,46,1,514,551,695,741,175,16.707526070998043,14.0700495747492
2969,/media/marda/TWOTB1/xBD/hurricanes/images/florence/hurricane-florence_00000498_pre_disaster.png,39,42,1,559,598,697,739,136,18.73194439589606,9.722449478137724
2970,/media/marda/TWOTB1/xBD/hurricanes/images/florence/hurricane-florence_00000498_pre_disaster.png,60,49,1,935,995,704,753,260,22.21040339826109,15.624127671710086
2971,/media/marda/TWOTB1/xBD/hurricanes/images/florence/hurricane-florence_00000498_pre_disaster.png,35,40,1,545,580,706,746,92,15.438645073891067,8.032062174900908
2972,/media/marda/TWOTB1/xBD/hurricanes/images/florence/hurricane-florence_00000498_pre_disaster.png,63,53,1,906,969,706,759,468,25.864722505958575,23.923438464796345
2973,/media/marda/TWOTB1/xBD/hurricanes/images/florence/hurricane-florence_00000498_pre_disaster.png,30,37,1,535,565,713,750,54,8.967361710167031,7.956198941682753
2974,/media/marda/TWOTB1/xBD/hurricanes/images/florence/hurricane-florence_00000498_pre_disaster.png,50,72,1,554,604,969,1041,750,33.9697768027044,29.07270749110469
2975,/media/marda/TWOTB1/xBD/hurricanes/images/florence/hurricane-florence_00000498_pre_disaster.png,69,61,1,608,677,983,1044,602,43.540235250508395,22.31870476435253
2976,/media/marda/TWOTB1/xBD/hurricanes/images/florence/hurricane-florence_00000401_pre_disaster.png,45,20,1,180,225,14,34,685,43.96345462343421,20.832285059592007
2977,/media/marda/TWOTB1/xBD/hurricanes/images/florence/hurricane-florence_00000401_pre_disaster.png,14,18,1,178,192,196,214,110,14.236069060978641,10.442386154521275
2978,/media/marda/TWOTB1/xBD/hurricanes/images/florence/hurricane-florence_00000401_pre_disaster.png,43,40,1,188,231,220,260,659,39.663471259859314,23.922324090178122
2979,/media/marda/TWOTB1/xBD/hurricanes/images/florence/hurricane-florence_00000401_pre_disaster.png,36,49,1,207,243,273,322,755,42.12473895354693,23.854023093442144
2980,/media/marda/TWOTB1/xBD/hurricanes/images/florence/hurricane-florence_00000401_pre_disaster.png,23,39,1,194,217,296,335,282,27.028335068104855,14.262358879990249
2981,/media/marda/TWOTB1/xBD/hurricanes/images/florence/hurricane-florence_00000401_pre_disaster.png,40,44,1,195,235,345,389,745,38.00656090173705,27.404560860591292
2982,/media/marda/TWOTB1/xBD/hurricanes/images/florence/hurricane-florence_00000137_post_disaster.png,39,39,1,730,769,766,805,93,12.027651394952851,10.420312555266552
2983,/media/marda/TWOTB1/xBD/hurricanes/images/florence/hurricane-florence_00000137_post_disaster.png,57,73,1,160,217,837,910,1010,53.10636421977667,25.341919992039692
2984,/media/marda/TWOTB1/xBD/hurricanes/images/florence/hurricane-florence_00000137_post_disaster.png,22,40,1,366,388,858,898,80,11.489125293076057,9.16515138991168
2985,/media/marda/TWOTB1/xBD/hurricanes/images/florence/hurricane-florence_00000137_post_disaster.png,39,61,1,240,279,859,920,388,34.39138495493173,15.005118048650425
2986,/media/marda/TWOTB1/xBD/hurricanes/images/florence/hurricane-florence_00000137_post_disaster.png,5,56,1,0,5,987,1043,72,18.375121012973857,5.181578419657504
2987,/media/marda/TWOTB1/xBD/hurricanes/images/florence/hurricane-florence_00000043_pre_disaster.png,86,25,1,734,820,0,25,1041,59.537007364975004,23.79416732518268
2988,/media/marda/TWOTB1/xBD/hurricanes/images/florence/hurricane-florence_00000066_post_disaster.png,21,15,1,10,31,39,54,196,23.186195211740472,11.356757684558142
2989,/media/marda/TWOTB1/xBD/hurricanes/images/florence/hurricane-florence_00000066_post_disaster.png,19,20,1,17,36,56,76,288,19.838265756518428,19.44071199214171
2990,/media/marda/TWOTB1/xBD/hurricanes/images/florence/hurricane-florence_00000066_post_disaster.png,95,38,1,866,961,57,95,1272,67.97847483194786,24.692864523804158
2991,/media/marda/TWOTB1/xBD/hurricanes/images/florence/hurricane-florence_00000066_post_disaster.png,101,59,1,802,903,81,140,2623,69.87246286004176,49.68842528910725
2992,/media/marda/TWOTB1/xBD/hurricanes/images/florence/hurricane-florence_00000066_post_disaster.png,70,42,1,882,952,120,162,1131,39.46131080740165,38.33832113740295
2993,/media/marda/TWOTB1/xBD/hurricanes/images/florence/hurricane-florence_00000066_post_disaster.png,50,27,1,912,962,161,188,322,26.5329983228432,16.1245154965971
2994,/media/marda/TWOTB1/xBD/hurricanes/images/florence/hurricane-florence_00000066_post_disaster.png,54,21,1,128,182,189,210,550,56.974849226297664,12.894720949594898
2995,/media/marda/TWOTB1/xBD/hurricanes/images/florence/hurricane-florence_00000066_post_disaster.png,50,35,1,196,246,197,232,759,46.940020829680506,21.444872029400283
2996,/media/marda/TWOTB1/xBD/hurricanes/images/florence/hurricane-florence_00000066_post_disaster.png,76,35,1,548,624,232,267,1082,58.965620800964786,24.48792057031125
2997,/media/marda/TWOTB1/xBD/hurricanes/images/florence/hurricane-florence_00000066_post_disaster.png,18,20,1,202,220,259,279,97,11.806746093884524,11.10837264244379
2998,/media/marda/TWOTB1/xBD/hurricanes/images/florence/hurricane-florence_00000066_post_disaster.png,28,44,1,184,212,355,399,533,34.04910534964269,20.772047995234615
2999,/media/marda/TWOTB1/xBD/hurricanes/images/florence/hurricane-florence_00000066_post_disaster.png,59,73,1,578,637,426,499,1449,58.36059007242263,34.76068173314256
3000,/media/marda/TWOTB1/xBD/hurricanes/images/florence/hurricane-florence_00000066_post_disaster.png,72,56,1,525,597,446,502,805,59.00948495700516,18.499510969933482
3001,/media/marda/TWOTB1/xBD/hurricanes/images/florence/hurricane-florence_00000066_post_disaster.png,51,63,1,495,546,531,594,532,48.763950601674544,14.452935437438654
3002,/media/marda/TWOTB1/xBD/hurricanes/images/florence/hurricane-florence_00000066_post_disaster.png,44,41,1,604,648,765,806,195,22.030140497707954,11.764560147460415
3003,/media/marda/TWOTB1/xBD/hurricanes/images/florence/hurricane-florence_00000066_post_disaster.png,50,65,1,602,652,780,845,822,39.33924618120163,27.562287522284784
3004,/media/marda/TWOTB1/xBD/hurricanes/images/florence/hurricane-florence_00000502_post_disaster.png,33,48,1,117,150,783,831,359,30.347327251712958,15.82361577835188
3005,/media/marda/TWOTB1/xBD/hurricanes/images/florence/hurricane-florence_00000502_post_disaster.png,14,42,1,128,142,827,869,59,10.520271756090729,7.6020007092589
3006,/media/marda/TWOTB1/xBD/hurricanes/images/florence/hurricane-florence_00000502_post_disaster.png,5,56,1,0,5,880,936,76,23.355095246312747,4.623428504109546
3007,/media/marda/TWOTB1/xBD/hurricanes/images/florence/hurricane-florence_00000046_post_disaster.png,63,51,1,156,219,0,51,1641,58.462887711000164,39.1596033840621
3008,/media/marda/TWOTB1/xBD/hurricanes/images/florence/hurricane-florence_00000046_post_disaster.png,65,43,1,279,344,0,43,1361,46.76232315866169,38.664823013313494
3009,/media/marda/TWOTB1/xBD/hurricanes/images/florence/hurricane-florence_00000046_post_disaster.png,105,64,1,512,617,0,64,2864,81.27859528481962,49.308770100091394
3010,/media/marda/TWOTB1/xBD/hurricanes/images/florence/hurricane-florence_00000046_post_disaster.png,69,27,1,624,693,0,27,635,39.715264024265565,24.16777295180027
3011,/media/marda/TWOTB1/xBD/hurricanes/images/florence/hurricane-florence_00000046_post_disaster.png,114,80,1,656,770,0,80,3596,95.7739089050019,50.54261742898856
3012,/media/marda/TWOTB1/xBD/hurricanes/images/florence/hurricane-florence_00000046_post_disaster.png,52,11,1,737,789,0,11,153,21.54332328795979,10.493241988559669
3013,/media/marda/TWOTB1/xBD/hurricanes/images/florence/hurricane-florence_00000046_post_disaster.png,53,6,1,849,902,0,6,69,19.121284378007218,6.096652716580893
3014,/media/marda/TWOTB1/xBD/hurricanes/images/florence/hurricane-florence_00000046_post_disaster.png,55,40,1,34,89,14,54,1691,55.60492963663846,40.97209067266034
3015,/media/marda/TWOTB1/xBD/hurricanes/images/florence/hurricane-florence_00000046_post_disaster.png,56,44,1,324,380,26,70,1034,37.3174602296682,36.97283872903689
3016,/media/marda/TWOTB1/xBD/hurricanes/images/florence/hurricane-florence_00000046_post_disaster.png,58,62,1,194,252,40,102,1707,57.91149041325545,39.759034012140894
3017,/media/marda/TWOTB1/xBD/hurricanes/images/florence/hurricane-florence_00000046_post_disaster.png,65,50,1,370,435,40,90,1430,48.553134809515555,38.75647671709741
3018,/media/marda/TWOTB1/xBD/hurricanes/images/florence/hurricane-florence_00000046_post_disaster.png,107,89,1,568,675,48,137,3515,92.92187584385073,52.01891968452766
3019,/media/marda/TWOTB1/xBD/hurricanes/images/florence/hurricane-florence_00000046_post_disaster.png,121,93,1,714,835,51,144,3730,98.09270465476106,52.48727224079897
3020,/media/marda/TWOTB1/xBD/hurricanes/images/florence/hurricane-florence_00000046_post_disaster.png,61,54,1,414,475,62,116,1224,47.57323942620407,35.465956839818574
3021,/media/marda/TWOTB1/xBD/hurricanes/images/florence/hurricane-florence_00000046_post_disaster.png,58,46,1,44,102,63,109,1774,58.15766211995271,40.422063281549626
3022,/media/marda/TWOTB1/xBD/hurricanes/images/florence/hurricane-florence_00000046_post_disaster.png,55,54,1,229,284,81,135,1305,48.91006505839199,37.71290324613034
3023,/media/marda/TWOTB1/xBD/hurricanes/images/florence/hurricane-florence_00000046_post_disaster.png,81,61,1,443,524,85,146,1797,58.072197158497254,41.98419793914811
3024,/media/marda/TWOTB1/xBD/hurricanes/images/florence/hurricane-florence_00000046_post_disaster.png,57,59,1,272,329,106,165,1368,49.98788628738083,38.84436571752966
3025,/media/marda/TWOTB1/xBD/hurricanes/images/florence/hurricane-florence_00000046_post_disaster.png,64,57,1,58,122,107,164,1855,61.82184254922008,40.31383856943901
3026,/media/marda/TWOTB1/xBD/hurricanes/images/florence/hurricane-florence_00000046_post_disaster.png,109,94,1,625,734,120,214,3524,93.00565436821991,51.961855872799674
3027,/media/marda/TWOTB1/xBD/hurricanes/images/florence/hurricane-florence_00000046_post_disaster.png,83,62,1,470,553,125,187,1780,58.22667831964517,42.01309754578546
3028,/media/marda/TWOTB1/xBD/hurricanes/images/florence/hurricane-florence_00000046_post_disaster.png,56,57,1,323,379,137,194,1250,48.79422974389069,35.56449918922539
3029,/media/marda/TWOTB1/xBD/hurricanes/images/florence/hurricane-florence_00000046_post_disaster.png,14,34,1,0,14,148,182,246,26.799792207047126,13.960965434472872
3030,/media/marda/TWOTB1/xBD/hurricanes/images/florence/hurricane-florence_00000046_post_disaster.png,65,56,1,81,146,158,214,1630,54.893278364582834,39.979097542387535
3031,/media/marda/TWOTB1/xBD/hurricanes/images/florence/hurricane-florence_00000046_post_disaster.png,48,31,1,586,634,161,192,416,24.567442974150232,22.646880674648287
3032,/media/marda/TWOTB1/xBD/hurricanes/images/florence/hurricane-florence_00000046_post_disaster.png,59,58,1,364,423,172,230,1365,50.81555215255753,36.39696842558751
3033,/media/marda/TWOTB1/xBD/hurricanes/images/florence/hurricane-florence_00000046_post_disaster.png,85,59,1,819,904,181,240,1506,58.66760476605589,36.24882115314608
3034,/media/marda/TWOTB1/xBD/hurricanes/images/florence/hurricane-florence_00000046_post_disaster.png,21,52,1,0,21,186,238,708,46.77711711649655,20.61291075005072
3035,/media/marda/TWOTB1/xBD/hurricanes/images/florence/hurricane-florence_00000046_post_disaster.png,64,56,1,111,175,202,258,1453,51.14370635231942,38.284993781316054
3036,/media/marda/TWOTB1/xBD/hurricanes/images/florence/hurricane-florence_00000046_post_disaster.png,88,60,1,776,864,210,270,1545,53.84947023762592,41.93805743561336
3037,/media/marda/TWOTB1/xBD/hurricanes/images/florence/hurricane-florence_00000046_post_disaster.png,62,59,1,395,457,219,278,1410,52.111235998978415,37.854763806114505
3038,/media/marda/TWOTB1/xBD/hurricanes/images/florence/hurricane-florence_00000046_post_disaster.png,52,60,1,0,52,230,290,1503,47.82405899813127,41.534922446290814
3039,/media/marda/TWOTB1/xBD/hurricanes/images/florence/hurricane-florence_00000046_post_disaster.png,67,67,1,151,218,233,300,1833,58.64454038912104,42.21807634883081
3040,/media/marda/TWOTB1/xBD/hurricanes/images/florence/hurricane-florence_00000046_post_disaster.png,89,56,1,738,827,239,295,1423,51.87364291015818,38.6940334511559
3041,/media/marda/TWOTB1/xBD/hurricanes/images/florence/hurricane-florence_00000046_post_disaster.png,57,69,1,193,250,261,330,1633,54.43242616939496,39.86809635971552
3042,/media/marda/TWOTB1/xBD/hurricanes/images/florence/hurricane-florence_00000046_post_disaster.png,52,64,1,34,86,264,328,1445,48.38406463933416,41.25426880311347
3043,/media/marda/TWOTB1/xBD/hurricanes/images/florence/hurricane-florence_00000046_post_disaster.png,90,61,1,706,796,266,327,1695,54.39357064512418,41.89602282023767
3044,/media/marda/TWOTB1/xBD/hurricanes/images/florence/hurricane-florence_00000046_post_disaster.png,50,21,1,994,1044,266,287,121,13.959638606753206,11.546629440370303
3045,/media/marda/TWOTB1/xBD/hurricanes/images/florence/hurricane-florence_00000046_post_disaster.png,69,56,1,405,474,274,330,1590,56.824028530079104,37.71748798007889
3046,/media/marda/TWOTB1/xBD/hurricanes/images/florence/hurricane-florence_00000046_post_disaster.png,66,49,1,978,1044,291,340,732,37.410285805853725,26.94150956008514
3047,/media/marda/TWOTB1/xBD/hurricanes/images/florence/hurricane-florence_00000046_post_disaster.png,54,69,1,68,122,295,364,1587,52.427646126889385,41.06057118840121
3048,/media/marda/TWOTB1/xBD/hurricanes/images/florence/hurricane-florence_00000046_post_disaster.png,56,60,1,241,297,295,355,1405,43.40165227965317,42.88366693187351
3049,/media/marda/TWOTB1/xBD/hurricanes/images/florence/hurricane-florence_00000046_post_disaster.png,58,72,1,343,401,307,379,1908,57.66196802328264,44.7965645773539
3050,/media/marda/TWOTB1/xBD/hurricanes/images/florence/hurricane-florence_00000046_post_disaster.png,92,64,1,674,766,309,373,1706,62.33961006124893,39.23049226061157
3051,/media/marda/TWOTB1/xBD/hurricanes/images/florence/hurricane-florence_00000046_post_disaster.png,57,53,1,295,352,319,372,1439,47.98178494155948,40.164255171190675
3052,/media/marda/TWOTB1/xBD/hurricanes/images/florence/hurricane-florence_00000046_post_disaster.png,77,59,1,419,496,322,381,1746,59.003429740190256,39.99969679080688
3053,/media/marda/TWOTB1/xBD/hurricanes/images/florence/hurricane-florence_00000046_post_disaster.png,87,62,1,955,1042,323,385,1299,47.834443561546706,36.60877187522758
3054,/media/marda/TWOTB1/xBD/hurricanes/images/florence/hurricane-florence_00000046_post_disaster.png,58,64,1,103,161,329,393,1506,47.5135339553263,41.8433634134734
3055,/media/marda/TWOTB1/xBD/hurricanes/images/florence/hurricane-florence_00000046_post_disaster.png,91,67,1,638,729,339,406,1826,58.17218146059503,43.65693997063399
3056,/media/marda/TWOTB1/xBD/hurricanes/images/florence/hurricane-florence_00000046_post_disaster.png,59,69,1,142,201,356,425,1769,52.29389873071354,44.55993859797961
3057,/media/marda/TWOTB1/xBD/hurricanes/images/florence/hurricane-florence_00000046_post_disaster.png,81,68,1,600,681,361,429,1727,55.157213021310746,42.179534043444484
3058,/media/marda/TWOTB1/xBD/hurricanes/images/florence/hurricane-florence_00000046_post_disaster.png,51,67,1,197,248,383,450,1359,49.05391464263227,37.42043389213061
3059,/media/marda/TWOTB1/xBD/hurricanes/images/florence/hurricane-florence_00000046_post_disaster.png,27,70,1,0,27,387,457,971,52.914052654412046,25.539481187161737
3060,/media/marda/TWOTB1/xBD/hurricanes/images/florence/hurricane-florence_00000046_post_disaster.png,76,61,1,561,637,389,450,1369,53.66404951938019,36.92392840881803
3061,/media/marda/TWOTB1/xBD/hurricanes/images/florence/hurricane-florence_00000046_post_disaster.png,91,64,1,887,978,390,454,1440,53.34011415675129,36.3013360357344
3062,/media/marda/TWOTB1/xBD/hurricanes/images/florence/hurricane-florence_00000046_post_disaster.png,70,71,1,518,588,399,470,1749,54.041582175032005,43.39861887734448
3063,/media/marda/TWOTB1/xBD/hurricanes/images/florence/hurricane-florence_00000046_post_disaster.png,55,70,1,238,293,407,477,1470,47.39640077896992,41.90296223929658
3064,/media/marda/TWOTB1/xBD/hurricanes/images/florence/hurricane-florence_00000046_post_disaster.png,71,71,1,471,542,411,482,2034,58.733361511198716,45.82817751282708
3065,/media/marda/TWOTB1/xBD/hurricanes/images/florence/hurricane-florence_00000046_post_disaster.png,57,72,1,288,345,413,485,1768,58.97450862480284,40.49886854125594
3066,/media/marda/TWOTB1/xBD/hurricanes/images/florence/hurricane-florence_00000046_post_disaster.png,87,62,1,852,939,417,479,1407,50.378749461799416,37.69196869411527
3067,/media/marda/TWOTB1/xBD/hurricanes/images/florence/hurricane-florence_00000046_post_disaster.png,55,68,1,336,391,424,492,1758,52.92990071061564,44.62662464190747
3068,/media/marda/TWOTB1/xBD/hurricanes/images/florence/hurricane-florence_00000046_post_disaster.png,51,63,1,387,438,424,487,1560,52.13869678202111,39.21085198331041
3069,/media/marda/TWOTB1/xBD/hurricanes/images/florence/hurricane-florence_00000046_post_disaster.png,48,74,1,7,55,429,503,1452,51.52043411262275,37.62390314936602
3070,/media/marda/TWOTB1/xBD/hurricanes/images/florence/hurricane-florence_00000046_post_disaster.png,79,65,1,821,900,433,498,1241,48.5598335444609,33.82266096030129
3071,/media/marda/TWOTB1/xBD/hurricanes/images/florence/hurricane-florence_00000046_post_disaster.png,74,67,1,790,864,450,517,1161,44.181295856125416,35.438661567392174
3072,/media/marda/TWOTB1/xBD/hurricanes/images/florence/hurricane-florence_00000046_post_disaster.png,82,66,1,749,831,470,536,1487,54.57669593030415,36.21546222645178
3073,/media/marda/TWOTB1/xBD/hurricanes/images/florence/hurricane-florence_00000046_post_disaster.png,55,79,1,32,87,473,552,1693,54.99248827361415,41.73422066987932
3074,/media/marda/TWOTB1/xBD/hurricanes/images/florence/hurricane-florence_00000046_post_disaster.png,75,73,1,714,789,490,563,1390,50.88750733557552,36.388260066637706
3075,/media/marda/TWOTB1/xBD/hurricanes/images/florence/hurricane-florence_00000046_post_disaster.png,77,77,1,452,529,493,570,1904,59.99352459266521,43.072119886349206
3076,/media/marda/TWOTB1/xBD/hurricanes/images/florence/hurricane-florence_00000046_post_disaster.png,75,75,1,325,400,498,573,1858,55.32693415117079,44.912673753069704
3077,/media/marda/TWOTB1/xBD/hurricanes/images/florence/hurricane-florence_00000046_post_disaster.png,56,70,1,82,138,499,569,1620,51.59575213350816,42.1183729937436
3078,/media/marda/TWOTB1/xBD/hurricanes/images/florence/hurricane-florence_00000046_post_disaster.png,84,70,1,960,1044,500,570,1319,52.17647441641831,33.53060120852581
3079,/media/marda/TWOTB1/xBD/hurricanes/images/florence/hurricane-florence_00000046_post_disaster.png,56,83,1,129,185,504,587,1822,59.581637222105975,41.10204926399009
3080,/media/marda/TWOTB1/xBD/hurricanes/images/florence/hurricane-florence_00000046_post_disaster.png,79,73,1,673,752,512,585,1636,54.458739529965804,39.43987863285498
3081,/media/marda/TWOTB1/xBD/hurricanes/images/florence/hurricane-florence_00000046_post_disaster.png,80,77,1,873,953,519,596,1538,51.76436577575511,38.906716863636824
3082,/media/marda/TWOTB1/xBD/hurricanes/images/florence/hurricane-florence_00000046_post_disaster.png,58,82,1,174,232,529,611,1737,54.86429965562378,42.598227558115944
3083,/media/marda/TWOTB1/xBD/hurricanes/images/florence/hurricane-florence_00000046_post_disaster.png,69,72,1,287,356,531,603,1731,55.65725474358447,42.00916145896886
3084,/media/marda/TWOTB1/xBD/hurricanes/images/florence/hurricane-florence_00000046_post_disaster.png,77,73,1,640,717,536,609,1417,48.52151464580903,39.84782640527304
3085,/media/marda/TWOTB1/xBD/hurricanes/images/florence/hurricane-florence_00000046_post_disaster.png,52,77,1,242,294,538,615,2196,61.86532115544921,46.81087624292124
3086,/media/marda/TWOTB1/xBD/hurricanes/images/florence/hurricane-florence_00000046_post_disaster.png,84,75,1,430,514,541,616,1823,59.05841125780364,41.320191558689345
3087,/media/marda/TWOTB1/xBD/hurricanes/images/florence/hurricane-florence_00000046_post_disaster.png,79,72,1,840,919,541,613,1306,51.867104821818394,33.100507340218385
3088,/media/marda/TWOTB1/xBD/hurricanes/images/florence/hurricane-florence_00000046_post_disaster.png,61,55,1,983,1044,542,597,432,31.590859269594393,20.009230144929862
3089,/media/marda/TWOTB1/xBD/hurricanes/images/florence/hurricane-florence_00000046_post_disaster.png,80,75,1,803,883,558,633,1524,51.08615047571984,39.09131064117712
3090,/media/marda/TWOTB1/xBD/hurricanes/images/florence/hurricane-florence_00000046_post_disaster.png,78,74,1,605,683,564,638,1553,52.17209916226178,39.24643445187101
3091,/media/marda/TWOTB1/xBD/hurricanes/images/florence/hurricane-florence_00000046_post_disaster.png,74,83,1,396,470,578,661,1867,55.6220698968124,45.107702954175664
3092,/media/marda/TWOTB1/xBD/hurricanes/images/florence/hurricane-florence_00000046_post_disaster.png,77,75,1,770,847,578,653,1360,51.80221961475588,34.893667935826734
3093,/media/marda/TWOTB1/xBD/hurricanes/images/florence/hurricane-florence_00000046_post_disaster.png,44,87,1,30,74,589,676,1767,59.1577788095734,40.69115389207784
3094,/media/marda/TWOTB1/xBD/hurricanes/images/florence/hurricane-florence_00000046_post_disaster.png,73,73,1,578,651,597,670,1383,48.49732905421502,37.50056527775069
3095,/media/marda/TWOTB1/xBD/hurricanes/images/florence/hurricane-florence_00000046_post_disaster.png,45,75,1,78,123,603,678,1419,50.04556648013508,37.25964533880742
3096,/media/marda/TWOTB1/xBD/hurricanes/images/florence/hurricane-florence_00000046_post_disaster.png,77,72,1,723,800,603,675,1294,43.246436937756144,39.500730508223086
3097,/media/marda/TWOTB1/xBD/hurricanes/images/florence/hurricane-florence_00000046_post_disaster.png,73,91,1,357,430,608,699,2241,60.289830465056625,48.792847518127886
3098,/media/marda/TWOTB1/xBD/hurricanes/images/florence/hurricane-florence_00000046_post_disaster.png,51,76,1,115,166,625,701,1525,52.21786024328682,38.53928677283014
3099,/media/marda/TWOTB1/xBD/hurricanes/images/florence/hurricane-florence_00000046_post_disaster.png,73,70,1,554,627,628,698,1298,48.37924447963544,35.99479866966903
3100,/media/marda/TWOTB1/xBD/hurricanes/images/florence/hurricane-florence_00000046_post_disaster.png,80,81,1,687,767,630,711,1672,52.463445105464096,41.65582570861059
3101,/media/marda/TWOTB1/xBD/hurricanes/images/florence/hurricane-florence_00000046_post_disaster.png,61,89,1,319,380,632,721,2068,61.72778826855625,43.79561608622786
3102,/media/marda/TWOTB1/xBD/hurricanes/images/florence/hurricane-florence_00000046_post_disaster.png,56,87,1,160,216,642,729,1879,60.21306057472064,42.576169500962465
3103,/media/marda/TWOTB1/xBD/hurricanes/images/florence/hurricane-florence_00000046_post_disaster.png,56,84,1,272,328,648,732,2037,58.9034994987437,45.93369732596659
3104,/media/marda/TWOTB1/xBD/hurricanes/images/florence/hurricane-florence_00000046_post_disaster.png,49,73,1,222,271,650,723,1663,50.17692095075354,43.14100036964766
3105,/media/marda/TWOTB1/xBD/hurricanes/images/florence/hurricane-florence_00000046_post_disaster.png,80,71,1,653,733,663,734,1254,46.3403418494433,36.65188351968124
3106,/media/marda/TWOTB1/xBD/hurricanes/images/florence/hurricane-florence_00000046_post_disaster.png,77,74,1,524,601,664,738,1597,55.86169514793392,37.4611922277424
3107,/media/marda/TWOTB1/xBD/hurricanes/images/florence/hurricane-florence_00000046_post_disaster.png,60,80,1,32,92,687,767,1874,60.633952927050736,41.53289888776287
3108,/media/marda/TWOTB1/xBD/hurricanes/images/florence/hurricane-florence_00000046_post_disaster.png,80,77,1,627,707,698,775,1460,51.89997630539484,36.99400705289098
3109,/media/marda/TWOTB1/xBD/hurricanes/images/florence/hurricane-florence_00000046_post_disaster.png,72,76,1,501,573,700,776,1339,46.24379671217656,38.074552604454304
3110,/media/marda/TWOTB1/xBD/hurricanes/images/florence/hurricane-florence_00000046_post_disaster.png,75,75,1,921,996,710,785,1456,49.91793775087763,38.21409805925217
3111,/media/marda/TWOTB1/xBD/hurricanes/images/florence/hurricane-florence_00000046_post_disaster.png,75,69,1,965,1040,712,781,1308,44.21284532919951,38.83186846571722
3112,/media/marda/TWOTB1/xBD/hurricanes/images/florence/hurricane-florence_00000046_post_disaster.png,74,76,1,883,957,717,793,1323,52.07180100266897,33.56136910969168
3113,/media/marda/TWOTB1/xBD/hurricanes/images/florence/hurricane-florence_00000046_post_disaster.png,74,81,1,466,540,723,804,1437,61.12651684117387,31.403206015616284
3114,/media/marda/TWOTB1/xBD/hurricanes/images/florence/hurricane-florence_00000046_post_disaster.png,78,79,1,840,918,729,808,1582,50.9172482373693,40.76878306954132
3115,/media/marda/TWOTB1/xBD/hurricanes/images/florence/hurricane-florence_00000046_post_disaster.png,71,77,1,604,675,730,807,1236,49.25804049278821,34.19538762460413
3116,/media/marda/TWOTB1/xBD/hurricanes/images/florence/hurricane-florence_00000046_post_disaster.png,59,76,1,74,133,738,814,1770,59.588784900253565,40.620690938226716
3117,/media/marda/TWOTB1/xBD/hurricanes/images/florence/hurricane-florence_00000046_post_disaster.png,73,80,1,804,877,740,820,1274,47.827632731284766,36.30273031976512
3118,/media/marda/TWOTB1/xBD/hurricanes/images/florence/hurricane-florence_00000046_post_disaster.png,68,79,1,429,497,755,834,1404,52.42316878733705,35.69983546178169
3119,/media/marda/TWOTB1/xBD/hurricanes/images/florence/hurricane-florence_00000046_post_disaster.png,76,78,1,765,841,757,835,1317,52.055495713631856,33.60792437405784
3120,/media/marda/TWOTB1/xBD/hurricanes/images/florence/hurricane-florence_00000046_post_disaster.png,72,73,1,729,801,783,856,1207,42.830091277768545,37.05598367701834
3121,/media/marda/TWOTB1/xBD/hurricanes/images/florence/hurricane-florence_00000046_post_disaster.png,74,90,1,690,764,787,877,1495,54.49193504789328,36.09701676863597
3122,/media/marda/TWOTB1/xBD/hurricanes/images/florence/hurricane-florence_00000046_post_disaster.png,60,75,1,391,451,788,863,1223,46.11835057522391,35.425277968287375
3123,/media/marda/TWOTB1/xBD/hurricanes/images/florence/hurricane-florence_00000046_post_disaster.png,64,85,1,355,419,793,878,1409,54.80670122874743,34.09386714845191
3124,/media/marda/TWOTB1/xBD/hurricanes/images/florence/hurricane-florence_00000046_post_disaster.png,72,85,1,548,620,794,879,1498,52.16384801962603,37.37062962622628
3125,/media/marda/TWOTB1/xBD/hurricanes/images/florence/hurricane-florence_00000046_post_disaster.png,75,85,1,658,733,807,892,1500,51.6979180472612,38.20482427100884
3126,/media/marda/TWOTB1/xBD/hurricanes/images/florence/hurricane-florence_00000046_post_disaster.png,64,82,1,980,1044,808,890,1171,54.06830769130675,28.776277901029296
3127,/media/marda/TWOTB1/xBD/hurricanes/images/florence/hurricane-florence_00000046_post_disaster.png,76,80,1,934,1010,814,894,1503,50.26748507970808,39.170031179579475
3128,/media/marda/TWOTB1/xBD/hurricanes/images/florence/hurricane-florence_00000046_post_disaster.png,63,83,1,322,385,816,899,1403,48.45909893927253,38.11965731642147
3129,/media/marda/TWOTB1/xBD/hurricanes/images/florence/hurricane-florence_00000046_post_disaster.png,40,92,1,0,40,820,912,1860,60.458597137947166,40.70956571696465
3130,/media/marda/TWOTB1/xBD/hurricanes/images/florence/hurricane-florence_00000046_post_disaster.png,77,84,1,892,969,821,905,1447,49.704797620495235,38.10893862724328
3131,/media/marda/TWOTB1/xBD/hurricanes/images/florence/hurricane-florence_00000046_post_disaster.png,65,81,1,516,581,822,903,1112,43.844617809634215,34.36527073501828
3132,/media/marda/TWOTB1/xBD/hurricanes/images/florence/hurricane-florence_00000046_post_disaster.png,78,83,1,852,930,834,917,1457,50.34616992758186,37.82696064036706
3133,/media/marda/TWOTB1/xBD/hurricanes/images/florence/hurricane-florence_00000046_post_disaster.png,63,84,1,293,356,838,922,1504,52.52787088045973,37.3712873741722
3134,/media/marda/TWOTB1/xBD/hurricanes/images/florence/hurricane-florence_00000046_post_disaster.png,67,85,1,481,548,845,930,1312,49.73622457047805,35.13060558781964
3135,/media/marda/TWOTB1/xBD/hurricanes/images/florence/hurricane-florence_00000046_post_disaster.png,83,83,1,808,891,852,935,1636,54.016796493995905,39.50221218250083
3136,/media/marda/TWOTB1/xBD/hurricanes/images/florence/hurricane-florence_00000046_post_disaster.png,78,77,1,583,661,868,945,1350,52.88066252929453,34.049138784985686
3137,/media/marda/TWOTB1/xBD/hurricanes/images/florence/hurricane-florence_00000046_post_disaster.png,76,88,1,773,849,868,956,1400,50.026604526595776,38.022673777263996
3138,/media/marda/TWOTB1/xBD/hurricanes/images/florence/hurricane-florence_00000046_post_disaster.png,61,79,1,264,325,869,948,1274,46.877783986359944,35.8612001386257
3139,/media/marda/TWOTB1/xBD/hurricanes/images/florence/hurricane-florence_00000046_post_disaster.png,93,104,1,405,498,871,975,2688,81.94964703813406,47.52939922375557
3140,/media/marda/TWOTB1/xBD/hurricanes/images/florence/hurricane-florence_00000046_post_disaster.png,74,89,1,739,813,884,973,1500,51.71119363297917,37.837005069218804
3141,/media/marda/TWOTB1/xBD/hurricanes/images/florence/hurricane-florence_00000046_post_disaster.png,61,91,1,232,293,886,977,1600,56.983384835284134,36.93443950385479
3142,/media/marda/TWOTB1/xBD/hurricanes/images/florence/hurricane-florence_00000046_post_disaster.png,74,78,1,599,673,899,977,1096,48.26569422239514,30.944706285834318
3143,/media/marda/TWOTB1/xBD/hurricanes/images/florence/hurricane-florence_00000046_post_disaster.png,73,90,1,703,776,902,992,1317,47.975076297996836,37.2118245249142
3144,/media/marda/TWOTB1/xBD/hurricanes/images/florence/hurricane-florence_00000046_post_disaster.png,66,89,1,373,439,908,997,1560,50.85615169350571,39.920062473057875
3145,/media/marda/TWOTB1/xBD/hurricanes/images/florence/hurricane-florence_00000046_post_disaster.png,60,87,1,212,272,916,1003,1390,50.6508653629491,37.29680312302092
3146,/media/marda/TWOTB1/xBD/hurricanes/images/florence/hurricane-florence_00000046_post_disaster.png,74,78,1,935,1009,930,1008,1128,41.5559668020259,35.89476601320427
3147,/media/marda/TWOTB1/xBD/hurricanes/images/florence/hurricane-florence_00000046_post_disaster.png,71,82,1,623,694,931,1013,1223,49.26776291987764,33.52065766802149
3148,/media/marda/TWOTB1/xBD/hurricanes/images/florence/hurricane-florence_00000046_post_disaster.png,78,85,1,885,963,931,1016,1182,43.11791978101963,37.36127127332628
3149,/media/marda/TWOTB1/xBD/hurricanes/images/florence/hurricane-florence_00000046_post_disaster.png,63,88,1,340,403,932,1020,1462,49.377337986370065,38.834978283743716
3150,/media/marda/TWOTB1/xBD/hurricanes/images/florence/hurricane-florence_00000046_post_disaster.png,61,84,1,184,245,947,1031,1445,51.04660612332376,37.03632758110568
3151,/media/marda/TWOTB1/xBD/hurricanes/images/florence/hurricane-florence_00000046_post_disaster.png,76,82,1,851,927,948,1030,1118,42.23845042042217,34.81914989833996
3152,/media/marda/TWOTB1/xBD/hurricanes/images/florence/hurricane-florence_00000046_post_disaster.png,68,80,1,976,1044,951,1031,790,38.724867566850676,26.90425762463436
3153,/media/marda/TWOTB1/xBD/hurricanes/images/florence/hurricane-florence_00000046_post_disaster.png,112,83,1,785,897,958,1041,1796,72.19487469408126,40.1323755139974
3154,/media/marda/TWOTB1/xBD/hurricanes/images/florence/hurricane-florence_00000046_post_disaster.png,69,81,1,305,374,960,1041,1491,52.814618854224776,36.8764883849204
3155,/media/marda/TWOTB1/xBD/hurricanes/images/florence/hurricane-florence_00000046_post_disaster.png,77,74,1,630,707,967,1041,1298,54.461348087410755,31.44432696755781
3156,/media/marda/TWOTB1/xBD/hurricanes/images/florence/hurricane-florence_00000046_post_disaster.png,62,61,1,160,222,980,1041,759,48.592720442121575,23.062250481540303
3157,/media/marda/TWOTB1/xBD/hurricanes/images/florence/hurricane-florence_00000046_post_disaster.png,44,54,1,289,333,989,1043,251,30.401130128113685,12.491825137914118
3158,/media/marda/TWOTB1/xBD/hurricanes/images/florence/hurricane-florence_00000046_post_disaster.png,65,49,1,746,811,994,1043,176,40.81279553673368,7.995131358236064
3159,/media/marda/TWOTB1/xBD/hurricanes/images/florence/hurricane-florence_00000046_post_disaster.png,56,92,1,56,112,797,889,1605,53.27590667100416,40.63453430481085
3160,/media/marda/TWOTB1/xBD/hurricanes/images/florence/hurricane-florence_00000389_pre_disaster.png,55,34,1,989,1044,0,34,409,37.009255390409685,14.759109133469888
3161,/media/marda/TWOTB1/xBD/hurricanes/images/florence/hurricane-florence_00000389_pre_disaster.png,68,46,1,726,794,11,57,1416,49.028510802579476,38.8046742764967
3162,/media/marda/TWOTB1/xBD/hurricanes/images/florence/hurricane-florence_00000389_pre_disaster.png,48,10,1,933,981,12,22,75,12.663203401899144,8.031332506150656
3163,/media/marda/TWOTB1/xBD/hurricanes/images/florence/hurricane-florence_00000389_pre_disaster.png,41,13,1,795,836,58,71,86,12.183453869834992,9.4644255042248
3164,/media/marda/TWOTB1/xBD/hurricanes/images/florence/hurricane-florence_00000389_pre_disaster.png,64,28,1,912,976,130,158,296,29.671218122388826,13.329275378535185
3165,/media/marda/TWOTB1/xBD/hurricanes/images/florence/hurricane-florence_00000389_pre_disaster.png,60,24,1,700,760,148,172,388,34.24319493963006,15.151453047048685
3166,/media/marda/TWOTB1/xBD/hurricanes/images/florence/hurricane-florence_00000389_pre_disaster.png,48,23,1,931,979,166,189,186,19.536005339136214,12.621995918688514
3167,/media/marda/TWOTB1/xBD/hurricanes/images/florence/hurricane-florence_00000389_pre_disaster.png,59,38,1,668,727,185,223,566,35.18700486117054,21.203743676213485
3168,/media/marda/TWOTB1/xBD/hurricanes/images/florence/hurricane-florence_00000389_pre_disaster.png,92,61,1,827,919,191,252,1806,57.58305733580185,46.64849378754811
3169,/media/marda/TWOTB1/xBD/hurricanes/images/florence/hurricane-florence_00000389_pre_disaster.png,70,31,1,913,983,197,228,635,34.487060050590685,24.20489583897313
3170,/media/marda/TWOTB1/xBD/hurricanes/images/florence/hurricane-florence_00000389_pre_disaster.png,39,24,1,654,693,212,236,128,15.019355330788803,11.387228172277307
3171,/media/marda/TWOTB1/xBD/hurricanes/images/florence/hurricane-florence_00000389_pre_disaster.png,71,41,1,687,758,227,268,935,47.75468502917329,26.181066968468965
3172,/media/marda/TWOTB1/xBD/hurricanes/images/florence/hurricane-florence_00000389_pre_disaster.png,64,54,1,208,272,295,349,1535,59.365182392185986,34.48786847248472
3173,/media/marda/TWOTB1/xBD/hurricanes/images/florence/hurricane-florence_00000389_pre_disaster.png,36,42,1,139,175,316,358,694,34.56213968153522,26.54561212452872
3174,/media/marda/TWOTB1/xBD/hurricanes/images/florence/hurricane-florence_00000389_pre_disaster.png,42,49,1,432,474,333,382,594,38.01374651947878,20.890590843945457
3175,/media/marda/TWOTB1/xBD/hurricanes/images/florence/hurricane-florence_00000389_pre_disaster.png,40,25,1,490,530,339,364,156,23.90521981270403,8.742877192534428
3176,/media/marda/TWOTB1/xBD/hurricanes/images/florence/hurricane-florence_00000389_pre_disaster.png,34,24,1,490,524,354,378,84,13.557637102737477,8.33809387832792
3177,/media/marda/TWOTB1/xBD/hurricanes/images/florence/hurricane-florence_00000389_pre_disaster.png,56,51,1,162,218,363,414,1265,51.11418911727809,33.85783749165441
3178,/media/marda/TWOTB1/xBD/hurricanes/images/florence/hurricane-florence_00000389_pre_disaster.png,62,54,1,475,537,375,429,1161,42.63088763284068,38.20131368991504
3179,/media/marda/TWOTB1/xBD/hurricanes/images/florence/hurricane-florence_00000389_pre_disaster.png,33,28,1,243,276,385,413,257,26.668616025532287,12.805164969687025
3180,/media/marda/TWOTB1/xBD/hurricanes/images/florence/hurricane-florence_00000389_pre_disaster.png,78,72,1,795,873,501,573,1458,49.00671123343164,43.36533174123345
3181,/media/marda/TWOTB1/xBD/hurricanes/images/florence/hurricane-florence_00000389_pre_disaster.png,54,51,1,855,909,551,602,471,32.2720045348423,19.454147755916807
3182,/media/marda/TWOTB1/xBD/hurricanes/images/florence/hurricane-florence_00000389_pre_disaster.png,32,69,1,274,306,572,641,726,53.95780874801451,17.831107781025704
3183,/media/marda/TWOTB1/xBD/hurricanes/images/florence/hurricane-florence_00000389_pre_disaster.png,31,75,1,210,241,584,659,753,62.95205703526775,15.828855640517919
3184,/media/marda/TWOTB1/xBD/hurricanes/images/florence/hurricane-florence_00000389_pre_disaster.png,106,76,1,842,948,608,684,2153,76.75005591620369,37.31251758594608
3185,/media/marda/TWOTB1/xBD/hurricanes/images/florence/hurricane-florence_00000389_pre_disaster.png,42,45,1,436,478,633,678,459,29.437789515190314,20.727767752865926
3186,/media/marda/TWOTB1/xBD/hurricanes/images/florence/hurricane-florence_00000389_pre_disaster.png,61,42,1,376,437,635,677,596,53.79158729377406,14.749429593344889
3187,/media/marda/TWOTB1/xBD/hurricanes/images/florence/hurricane-florence_00000389_pre_disaster.png,42,74,1,288,330,647,721,800,57.02384366784995,21.020274221441756
3188,/media/marda/TWOTB1/xBD/hurricanes/images/florence/hurricane-florence_00000389_pre_disaster.png,31,74,1,223,254,661,735,752,55.45973727965737,18.613822494613284
3189,/media/marda/TWOTB1/xBD/hurricanes/images/florence/hurricane-florence_00000389_pre_disaster.png,16,34,1,197,213,671,705,58,9.772922914889326,8.115989652806284
3190,/media/marda/TWOTB1/xBD/hurricanes/images/florence/hurricane-florence_00000389_pre_disaster.png,28,42,1,453,481,693,735,131,13.828733122955157,12.551279890872008
3191,/media/marda/TWOTB1/xBD/hurricanes/images/florence/hurricane-florence_00000389_pre_disaster.png,97,69,1,520,617,701,770,1546,81.46488501257136,25.130901015896324
3192,/media/marda/TWOTB1/xBD/hurricanes/images/florence/hurricane-florence_00000389_pre_disaster.png,17,39,1,201,218,707,746,93,12.73833831214266,9.70285629912083
3193,/media/marda/TWOTB1/xBD/hurricanes/images/florence/hurricane-florence_00000389_pre_disaster.png,45,76,1,308,353,733,809,780,57.32959884655053,21.108694363943883
3194,/media/marda/TWOTB1/xBD/hurricanes/images/florence/hurricane-florence_00000389_pre_disaster.png,41,52,1,525,566,806,858,273,20.35850258112763,17.622355310265494
3195,/media/marda/TWOTB1/xBD/hurricanes/images/florence/hurricane-florence_00000389_pre_disaster.png,34,80,1,334,368,810,890,675,53.96117873959793,16.554856991027833
3196,/media/marda/TWOTB1/xBD/hurricanes/images/florence/hurricane-florence_00000389_pre_disaster.png,40,80,1,256,296,893,973,727,47.613739880443674,25.423033169380805
3197,/media/marda/TWOTB1/xBD/hurricanes/images/florence/hurricane-florence_00000389_pre_disaster.png,63,63,1,322,385,910,973,632,57.13810083920671,14.776678751470314
3198,/media/marda/TWOTB1/xBD/hurricanes/images/florence/hurricane-florence_00000389_pre_disaster.png,31,77,1,11,42,935,1012,1028,43.13485135876692,31.049497345586595
3199,/media/marda/TWOTB1/xBD/hurricanes/images/florence/hurricane-florence_00000389_pre_disaster.png,61,62,1,265,326,964,1026,626,57.22379291280808,14.609938542812941
3200,/media/marda/TWOTB1/xBD/hurricanes/images/florence/hurricane-florence_00000329_pre_disaster.png,47,77,1,10,57,620,697,1325,49.59519206067914,36.01941529783811
3201,/media/marda/TWOTB1/xBD/hurricanes/images/florence/hurricane-florence_00000329_pre_disaster.png,35,57,1,99,134,648,705,678,32.416478078807955,27.53263536746614
3202,/media/marda/TWOTB1/xBD/hurricanes/images/florence/hurricane-florence_00000329_pre_disaster.png,26,50,1,57,83,667,717,374,22.587596240403293,22.126533932982667
3203,/media/marda/TWOTB1/xBD/hurricanes/images/florence/hurricane-florence_00000329_pre_disaster.png,37,58,1,318,355,792,850,326,26.098914315785716,16.684384041965526
3204,/media/marda/TWOTB1/xBD/hurricanes/images/florence/hurricane-florence_00000329_pre_disaster.png,76,89,1,233,309,832,921,2040,65.20571940179352,41.25837914558154
3205,/media/marda/TWOTB1/xBD/hurricanes/images/florence/hurricane-florence_00000030_post_disaster.png,62,36,1,849,911,35,71,727,35.81931994403313,26.982776059011055
3206,/media/marda/TWOTB1/xBD/hurricanes/images/florence/hurricane-florence_00000030_post_disaster.png,43,12,1,832,875,64,76,76,10.476137305484787,9.8375232119728
3207,/media/marda/TWOTB1/xBD/hurricanes/images/florence/hurricane-florence_00000030_post_disaster.png,68,46,1,889,957,341,387,774,35.62903602251698,28.897295390426557
3208,/media/marda/TWOTB1/xBD/hurricanes/images/florence/hurricane-florence_00000030_post_disaster.png,53,31,1,862,915,355,386,316,21.395080820149122,19.628926113809424
3209,/media/marda/TWOTB1/xBD/hurricanes/images/florence/hurricane-florence_00000030_post_disaster.png,65,68,1,933,998,827,895,723,34.631198216921895,27.912400868270154
3210,/media/marda/TWOTB1/xBD/hurricanes/images/florence/hurricane-florence_00000030_post_disaster.png,101,76,1,875,976,872,948,1847,70.34657107144439,34.88617107937151
3211,/media/marda/TWOTB1/xBD/hurricanes/images/florence/hurricane-florence_00000030_post_disaster.png,60,49,1,973,1033,994,1043,159,23.759013261268436,8.85875419383625
3212,/media/marda/TWOTB1/xBD/hurricanes/images/florence/hurricane-florence_00000374_pre_disaster.png,86,25,1,213,299,0,25,1012,73.53625731973538,20.619452403669527
3213,/media/marda/TWOTB1/xBD/hurricanes/images/florence/hurricane-florence_00000374_pre_disaster.png,148,40,1,896,1044,0,40,2707,123.57513677315632,37.55106612405759
3214,/media/marda/TWOTB1/xBD/hurricanes/images/florence/hurricane-florence_00000374_pre_disaster.png,142,127,1,243,385,18,145,9772,135.7345149970615,97.13745362665868
3215,/media/marda/TWOTB1/xBD/hurricanes/images/florence/hurricane-florence_00000374_pre_disaster.png,76,38,1,802,878,31,69,1079,41.30338606105049,34.39960844384552
3216,/media/marda/TWOTB1/xBD/hurricanes/images/florence/hurricane-florence_00000374_pre_disaster.png,60,35,1,741,801,44,79,791,33.82735531590339,31.22645400235514
3217,/media/marda/TWOTB1/xBD/hurricanes/images/florence/hurricane-florence_00000374_pre_disaster.png,125,80,1,919,1044,58,138,4142,97.51857718516192,60.85040010346374
3218,/media/marda/TWOTB1/xBD/hurricanes/images/florence/hurricane-florence_00000374_pre_disaster.png,66,28,1,822,888,83,111,609,35.659071659742935,22.57646404477732
3219,/media/marda/TWOTB1/xBD/hurricanes/images/florence/hurricane-florence_00000374_pre_disaster.png,81,74,1,56,137,96,170,3789,73.4645794085461,68.0537941767652
3220,/media/marda/TWOTB1/xBD/hurricanes/images/florence/hurricane-florence_00000374_pre_disaster.png,90,43,1,806,896,105,148,1388,60.633866076060045,30.229948879504384
3221,/media/marda/TWOTB1/xBD/hurricanes/images/florence/hurricane-florence_00000374_pre_disaster.png,49,30,1,642,691,113,143,438,24.840212318674045,23.1846990601905
3222,/media/marda/TWOTB1/xBD/hurricanes/images/florence/hurricane-florence_00000374_pre_disaster.png,229,173,1,597,826,124,297,20660,184.52420940548475,152.0144180615699
3223,/media/marda/TWOTB1/xBD/hurricanes/images/florence/hurricane-florence_00000374_pre_disaster.png,51,32,1,486,537,134,166,602,32.15502130001213,24.744638634462117
3224,/media/marda/TWOTB1/xBD/hurricanes/images/florence/hurricane-florence_00000374_pre_disaster.png,55,48,1,412,467,158,206,944,43.55067255864696,31.08651764232299
3225,/media/marda/TWOTB1/xBD/hurricanes/images/florence/hurricane-florence_00000374_pre_disaster.png,83,78,1,961,1044,168,246,2116,78.53368334085309,35.46840589412421
3226,/media/marda/TWOTB1/xBD/hurricanes/images/florence/hurricane-florence_00000374_pre_disaster.png,64,54,1,505,569,184,238,1426,49.96366631949321,39.28125785819511
3227,/media/marda/TWOTB1/xBD/hurricanes/images/florence/hurricane-florence_00000374_pre_disaster.png,28,23,1,422,450,199,222,124,13.902321555621084,12.616085837427928
3228,/media/marda/TWOTB1/xBD/hurricanes/images/florence/hurricane-florence_00000374_pre_disaster.png,55,78,1,318,373,211,289,1713,73.04124446917638,32.0732540860517
3229,/media/marda/TWOTB1/xBD/hurricanes/images/florence/hurricane-florence_00000374_pre_disaster.png,43,31,1,427,470,218,249,408,26.51794466204066,21.11849304615077
3230,/media/marda/TWOTB1/xBD/hurricanes/images/florence/hurricane-florence_00000374_pre_disaster.png,52,39,1,394,446,239,278,525,31.585940084155894,22.695552799860828
3231,/media/marda/TWOTB1/xBD/hurricanes/images/florence/hurricane-florence_00000374_pre_disaster.png,34,22,1,496,530,246,268,138,14.230298063479495,13.07470429443246
3232,/media/marda/TWOTB1/xBD/hurricanes/images/florence/hurricane-florence_00000374_pre_disaster.png,36,32,1,443,479,249,281,287,23.738491613628078,16.21745474604539
3233,/media/marda/TWOTB1/xBD/hurricanes/images/florence/hurricane-florence_00000374_pre_disaster.png,115,132,1,414,529,278,410,7757,124.78547772095588,87.91017526955987
3234,/media/marda/TWOTB1/xBD/hurricanes/images/florence/hurricane-florence_00000374_pre_disaster.png,101,64,1,515,616,298,362,2609,79.67559156799376,44.52384453392119
3235,/media/marda/TWOTB1/xBD/hurricanes/images/florence/hurricane-florence_00000374_pre_disaster.png,212,132,1,0,212,303,435,10519,235.58732095364675,68.27415757840316
3236,/media/marda/TWOTB1/xBD/hurricanes/images/florence/hurricane-florence_00000374_pre_disaster.png,65,50,1,350,415,323,373,1138,52.620060816328554,28.859579684835634
3237,/media/marda/TWOTB1/xBD/hurricanes/images/florence/hurricane-florence_00000374_pre_disaster.png,34,31,1,410,444,330,361,229,19.982187238310036,15.183945595654206
3238,/media/marda/TWOTB1/xBD/hurricanes/images/florence/hurricane-florence_00000374_pre_disaster.png,97,88,1,849,946,366,454,2940,75.10206044095402,52.079514411444805
3239,/media/marda/TWOTB1/xBD/hurricanes/images/florence/hurricane-florence_00000374_pre_disaster.png,88,84,1,716,804,375,459,2656,77.80791755398016,45.49172829007753
3240,/media/marda/TWOTB1/xBD/hurricanes/images/florence/hurricane-florence_00000374_pre_disaster.png,29,37,1,98,127,398,435,325,25.12769652071382,17.27142439693383
3241,/media/marda/TWOTB1/xBD/hurricanes/images/florence/hurricane-florence_00000374_pre_disaster.png,63,63,1,355,418,411,474,1441,45.15511536513212,42.45809432207905
3242,/media/marda/TWOTB1/xBD/hurricanes/images/florence/hurricane-florence_00000374_pre_disaster.png,123,146,1,906,1029,432,578,5737,131.40069039504615,62.99674348212642
3243,/media/marda/TWOTB1/xBD/hurricanes/images/florence/hurricane-florence_00000374_pre_disaster.png,124,89,1,497,621,441,530,4373,105.14187999445046,55.30332601929289
3244,/media/marda/TWOTB1/xBD/hurricanes/images/florence/hurricane-florence_00000374_pre_disaster.png,84,96,1,621,705,463,559,3006,80.85117453010639,49.87580866949736
3245,/media/marda/TWOTB1/xBD/hurricanes/images/florence/hurricane-florence_00000374_pre_disaster.png,110,95,1,394,504,474,569,4725,89.14185978539874,70.09032344539335
3246,/media/marda/TWOTB1/xBD/hurricanes/images/florence/hurricane-florence_00000374_pre_disaster.png,75,63,1,0,75,479,542,1898,84.8001919251371,29.583715959306296
3247,/media/marda/TWOTB1/xBD/hurricanes/images/florence/hurricane-florence_00000374_pre_disaster.png,87,85,1,69,156,483,568,3761,80.33414936793754,62.11100450566871
3248,/media/marda/TWOTB1/xBD/hurricanes/images/florence/hurricane-florence_00000374_pre_disaster.png,83,98,1,550,633,500,598,2828,80.71616875812076,46.72838806271674
3249,/media/marda/TWOTB1/xBD/hurricanes/images/florence/hurricane-florence_00000374_pre_disaster.png,50,51,1,36,86,535,586,812,54.69122380422338,19.688262101001012
3250,/media/marda/TWOTB1/xBD/hurricanes/images/florence/hurricane-florence_00000374_pre_disaster.png,71,51,1,813,884,535,586,740,41.280760614127125,23.830415916817525
3251,/media/marda/TWOTB1/xBD/hurricanes/images/florence/hurricane-florence_00000374_pre_disaster.png,115,97,1,614,729,537,634,4237,84.21349410340154,66.93150853443565
3252,/media/marda/TWOTB1/xBD/hurricanes/images/florence/hurricane-florence_00000374_pre_disaster.png,128,188,1,226,354,543,731,11735,183.60362325175603,84.59992604977876
3253,/media/marda/TWOTB1/xBD/hurricanes/images/florence/hurricane-florence_00000374_pre_disaster.png,82,60,1,418,500,546,606,1603,70.74316722302028,29.626187086071177
3254,/media/marda/TWOTB1/xBD/hurricanes/images/florence/hurricane-florence_00000374_pre_disaster.png,110,112,1,480,590,557,669,5461,86.58274600614655,83.72373986328662
3255,/media/marda/TWOTB1/xBD/hurricanes/images/florence/hurricane-florence_00000374_pre_disaster.png,78,62,1,859,937,559,621,1258,44.76896218885429,37.06129347491627
3256,/media/marda/TWOTB1/xBD/hurricanes/images/florence/hurricane-florence_00000374_pre_disaster.png,76,81,1,804,880,571,652,1544,67.34359230825555,30.29387861969835
3257,/media/marda/TWOTB1/xBD/hurricanes/images/florence/hurricane-florence_00000374_pre_disaster.png,80,83,1,765,845,583,666,1915,66.55509556648279,37.995690722514084
3258,/media/marda/TWOTB1/xBD/hurricanes/images/florence/hurricane-florence_00000374_pre_disaster.png,173,214,1,88,261,591,805,16669,198.61290854343406,121.98740180175034
3259,/media/marda/TWOTB1/xBD/hurricanes/images/florence/hurricane-florence_00000374_pre_disaster.png,32,77,1,58,90,604,681,889,59.14632100917138,19.837486370048786
3260,/media/marda/TWOTB1/xBD/hurricanes/images/florence/hurricane-florence_00000374_pre_disaster.png,311,168,1,438,749,610,778,20407,327.244699269086,87.81694700633939
3261,/media/marda/TWOTB1/xBD/hurricanes/images/florence/hurricane-florence_00000374_pre_disaster.png,121,98,1,853,974,641,739,3577,79.93446751243398,67.7340816392582
3262,/media/marda/TWOTB1/xBD/hurricanes/images/florence/hurricane-florence_00000374_pre_disaster.png,70,79,1,824,894,668,747,1146,59.91760498483697,25.392554034783586
3263,/media/marda/TWOTB1/xBD/hurricanes/images/florence/hurricane-florence_00000374_pre_disaster.png,101,78,1,789,890,709,787,1823,67.33252992334806,40.921181052502725
3264,/media/marda/TWOTB1/xBD/hurricanes/images/florence/hurricane-florence_00000374_pre_disaster.png,93,97,1,664,757,715,812,2342,71.04478155174053,53.80622385099435
3265,/media/marda/TWOTB1/xBD/hurricanes/images/florence/hurricane-florence_00000374_pre_disaster.png,257,172,1,128,385,717,889,16585,284.3720509323443,80.36248779113653
3266,/media/marda/TWOTB1/xBD/hurricanes/images/florence/hurricane-florence_00000374_pre_disaster.png,82,93,1,599,681,742,835,2320,61.540194842251175,50.938308625267204
3267,/media/marda/TWOTB1/xBD/hurricanes/images/florence/hurricane-florence_00000374_pre_disaster.png,54,47,1,938,992,743,790,229,19.568933401035988,15.526801313643334
3268,/media/marda/TWOTB1/xBD/hurricanes/images/florence/hurricane-florence_00000374_pre_disaster.png,137,129,1,485,622,756,885,7664,122.97891862856707,81.81505415365305
3269,/media/marda/TWOTB1/xBD/hurricanes/images/florence/hurricane-florence_00000374_pre_disaster.png,106,107,1,705,811,772,879,4099,78.78517881024634,69.02389398126277
3270,/media/marda/TWOTB1/xBD/hurricanes/images/florence/hurricane-florence_00000374_pre_disaster.png,89,103,1,642,731,802,905,2424,73.26743594246668,46.810057673456775
3271,/media/marda/TWOTB1/xBD/hurricanes/images/florence/hurricane-florence_00000374_pre_disaster.png,76,75,1,968,1044,808,883,1267,42.72718824436061,39.15968896844434
3272,/media/marda/TWOTB1/xBD/hurricanes/images/florence/hurricane-florence_00000374_pre_disaster.png,37,92,1,10,47,816,908,1476,59.640805956044,33.310427153386804
3273,/media/marda/TWOTB1/xBD/hurricanes/images/florence/hurricane-florence_00000374_pre_disaster.png,145,188,1,304,449,821,1009,10925,169.64735919628603,90.07543648440956
3274,/media/marda/TWOTB1/xBD/hurricanes/images/florence/hurricane-florence_00000374_pre_disaster.png,176,139,1,499,675,823,962,9127,150.16720965643788,83.5893299130074
3275,/media/marda/TWOTB1/xBD/hurricanes/images/florence/hurricane-florence_00000374_pre_disaster.png,76,81,1,927,1003,828,909,1304,46.90036515895196,36.826968711866854
3276,/media/marda/TWOTB1/xBD/hurricanes/images/florence/hurricane-florence_00000374_pre_disaster.png,84,77,1,837,921,841,918,1356,48.75874554919177,37.456284656121774
3277,/media/marda/TWOTB1/xBD/hurricanes/images/florence/hurricane-florence_00000374_pre_disaster.png,185,146,1,127,312,855,1001,10510,185.94405023752137,79.28123979010392
3278,/media/marda/TWOTB1/xBD/hurricanes/images/florence/hurricane-florence_00000374_pre_disaster.png,63,63,1,979,1042,860,923,469,29.301534016525725,21.688210068749065
3279,/media/marda/TWOTB1/xBD/hurricanes/images/florence/hurricane-florence_00000374_pre_disaster.png,53,53,1,913,966,877,930,223,20.846661501390656,14.312327316514477
3280,/media/marda/TWOTB1/xBD/hurricanes/images/florence/hurricane-florence_00000374_pre_disaster.png,83,80,1,853,936,878,958,1330,50.11549229185572,38.58177033876593
3281,/media/marda/TWOTB1/xBD/hurricanes/images/florence/hurricane-florence_00000374_pre_disaster.png,82,95,1,747,829,882,977,1933,62.10291725702615,41.41905553954742
3282,/media/marda/TWOTB1/xBD/hurricanes/images/florence/hurricane-florence_00000374_pre_disaster.png,57,54,1,929,986,902,956,222,21.25478446178986,13.90656266011059
3283,/media/marda/TWOTB1/xBD/hurricanes/images/florence/hurricane-florence_00000374_pre_disaster.png,50,65,1,289,339,904,969,669,41.14405844467088,21.71671493180007
3284,/media/marda/TWOTB1/xBD/hurricanes/images/florence/hurricane-florence_00000374_pre_disaster.png,101,125,1,709,810,910,1035,3445,97.94920830090162,47.304362252591794
3285,/media/marda/TWOTB1/xBD/hurricanes/images/florence/hurricane-florence_00000374_pre_disaster.png,51,83,1,606,657,923,1006,788,48.63758141924781,22.13702243701281
3286,/media/marda/TWOTB1/xBD/hurricanes/images/florence/hurricane-florence_00000374_pre_disaster.png,75,114,1,58,133,928,1042,3515,93.1978440546622,56.568370244424955
3287,/media/marda/TWOTB1/xBD/hurricanes/images/florence/hurricane-florence_00000374_pre_disaster.png,115,108,1,530,645,934,1042,4734,87.91468251700996,71.98519643715156
3288,/media/marda/TWOTB1/xBD/hurricanes/images/florence/hurricane-florence_00000374_pre_disaster.png,99,92,1,253,352,950,1042,3306,90.69875295248893,50.499009443057325
3289,/media/marda/TWOTB1/xBD/hurricanes/images/florence/hurricane-florence_00000374_pre_disaster.png,93,75,1,894,987,967,1042,1419,60.50311215071998,31.68581244878253
3290,/media/marda/TWOTB1/xBD/hurricanes/images/florence/hurricane-florence_00000374_pre_disaster.png,42,66,1,2,44,976,1042,862,40.15688952772996,29.12570646089441
3291,/media/marda/TWOTB1/xBD/hurricanes/images/florence/hurricane-florence_00000374_pre_disaster.png,63,61,1,436,499,981,1042,793,45.12649237832184,24.00546076893391
3292,/media/marda/TWOTB1/xBD/hurricanes/images/florence/hurricane-florence_00000374_pre_disaster.png,41,58,1,624,665,986,1044,209,18.683129152267366,15.77289260232673
3293,/media/marda/TWOTB1/xBD/hurricanes/images/florence/hurricane-florence_00000374_pre_disaster.png,29,55,1,202,231,989,1044,228,20.07565072863175,15.16772785724286
3294,/media/marda/TWOTB1/xBD/hurricanes/images/florence/hurricane-florence_00000290_pre_disaster.png,59,42,1,829,888,170,212,766,38.481402314683265,26.878463087537774
3295,/media/marda/TWOTB1/xBD/hurricanes/images/florence/hurricane-florence_00000290_pre_disaster.png,44,27,1,345,389,173,200,437,35.69785165422855,16.122404380352897
3296,/media/marda/TWOTB1/xBD/hurricanes/images/florence/hurricane-florence_00000290_pre_disaster.png,23,12,1,477,500,184,196,56,9.16515138991168,8.0
3297,/media/marda/TWOTB1/xBD/hurricanes/images/florence/hurricane-florence_00000290_pre_disaster.png,63,46,1,453,516,202,248,1052,54.917504712479605,27.353318324516767
3298,/media/marda/TWOTB1/xBD/hurricanes/images/florence/hurricane-florence_00000290_pre_disaster.png,44,23,1,513,557,205,228,283,24.60672921656504,15.127296167911016
3299,/media/marda/TWOTB1/xBD/hurricanes/images/florence/hurricane-florence_00000290_pre_disaster.png,67,40,1,751,818,209,249,387,43.93859405436242,13.626759838075927
3300,/media/marda/TWOTB1/xBD/hurricanes/images/florence/hurricane-florence_00000290_pre_disaster.png,30,28,1,484,514,237,265,180,24.061051417605427,11.175684683102771
3301,/media/marda/TWOTB1/xBD/hurricanes/images/florence/hurricane-florence_00000290_pre_disaster.png,73,37,1,851,924,274,311,747,40.55990469928966,24.473142934896465
3302,/media/marda/TWOTB1/xBD/hurricanes/images/florence/hurricane-florence_00000290_pre_disaster.png,75,55,1,712,787,307,362,754,55.752490718285465,18.05414954432622
3303,/media/marda/TWOTB1/xBD/hurricanes/images/florence/hurricane-florence_00000290_pre_disaster.png,83,121,1,814,897,384,505,3002,113.68255269515397,40.913345332354616
3304,/media/marda/TWOTB1/xBD/hurricanes/images/florence/hurricane-florence_00000290_pre_disaster.png,49,31,1,615,664,392,423,256,23.401153728839358,14.410224108136825
3305,/media/marda/TWOTB1/xBD/hurricanes/images/florence/hurricane-florence_00000290_pre_disaster.png,50,68,1,351,401,402,470,1093,56.75126722248613,25.544746619261048
3306,/media/marda/TWOTB1/xBD/hurricanes/images/florence/hurricane-florence_00000290_pre_disaster.png,53,56,1,907,960,419,475,518,44.259903521171985,15.660003642320767
3307,/media/marda/TWOTB1/xBD/hurricanes/images/florence/hurricane-florence_00000290_pre_disaster.png,48,36,1,757,805,421,457,209,17.74125677087857,15.75600738517834
3308,/media/marda/TWOTB1/xBD/hurricanes/images/florence/hurricane-florence_00000290_pre_disaster.png,45,38,1,999,1044,423,461,62,22.76927370113844,4.12390411045642
3309,/media/marda/TWOTB1/xBD/hurricanes/images/florence/hurricane-florence_00000290_pre_disaster.png,52,76,1,526,578,429,505,1279,65.2832207346209,25.68796253207211
3310,/media/marda/TWOTB1/xBD/hurricanes/images/florence/hurricane-florence_00000290_pre_disaster.png,32,28,1,570,602,432,460,104,12.557465586724494,11.20542445997343
3311,/media/marda/TWOTB1/xBD/hurricanes/images/florence/hurricane-florence_00000290_pre_disaster.png,47,38,1,573,620,454,492,355,24.533733245494858,19.50772052743152
3312,/media/marda/TWOTB1/xBD/hurricanes/images/florence/hurricane-florence_00000290_pre_disaster.png,74,50,1,774,848,463,513,910,44.608331639217084,26.829906454449556
3313,/media/marda/TWOTB1/xBD/hurricanes/images/florence/hurricane-florence_00000290_pre_disaster.png,60,50,1,648,708,464,514,643,35.5276787328426,27.932732951995796
3314,/media/marda/TWOTB1/xBD/hurricanes/images/florence/hurricane-florence_00000290_pre_disaster.png,36,28,1,638,674,466,494,80,10.770942727627036,10.042748267191516
3315,/media/marda/TWOTB1/xBD/hurricanes/images/florence/hurricane-florence_00000290_pre_disaster.png,74,50,1,709,783,484,534,953,47.29603166012778,26.6364846228256
3316,/media/marda/TWOTB1/xBD/hurricanes/images/florence/hurricane-florence_00000290_pre_disaster.png,56,80,1,290,346,493,573,1307,61.25089437805017,28.79174927483723
3317,/media/marda/TWOTB1/xBD/hurricanes/images/florence/hurricane-florence_00000290_pre_disaster.png,67,74,1,657,724,501,575,1472,52.563161600785136,36.93757017827285
3318,/media/marda/TWOTB1/xBD/hurricanes/images/florence/hurricane-florence_00000290_pre_disaster.png,67,54,1,595,662,523,577,886,44.45428335155039,26.524423017860105
3319,/media/marda/TWOTB1/xBD/hurricanes/images/florence/hurricane-florence_00000290_pre_disaster.png,45,55,1,348,393,530,585,646,33.41398166308445,25.682634814201474
3320,/media/marda/TWOTB1/xBD/hurricanes/images/florence/hurricane-florence_00000290_pre_disaster.png,71,53,1,946,1017,535,588,641,34.94759410405922,25.701425385758885
3321,/media/marda/TWOTB1/xBD/hurricanes/images/florence/hurricane-florence_00000290_pre_disaster.png,56,52,1,537,593,541,593,790,36.9389862830228,28.0484532117071
3322,/media/marda/TWOTB1/xBD/hurricanes/images/florence/hurricane-florence_00000290_pre_disaster.png,59,56,1,300,359,550,606,498,57.59632691418996,11.539197798509003
3323,/media/marda/TWOTB1/xBD/hurricanes/images/florence/hurricane-florence_00000290_pre_disaster.png,48,38,1,907,955,557,595,104,18.679593494181027,7.356135379433423
3324,/media/marda/TWOTB1/xBD/hurricanes/images/florence/hurricane-florence_00000290_pre_disaster.png,34,43,1,351,385,600,643,256,19.857210184341387,16.83929360643251
3325,/media/marda/TWOTB1/xBD/hurricanes/images/florence/hurricane-florence_00000290_pre_disaster.png,60,69,1,397,457,610,679,1125,43.28562436206676,36.04640162422857
3326,/media/marda/TWOTB1/xBD/hurricanes/images/florence/hurricane-florence_00000290_pre_disaster.png,38,50,1,364,402,621,671,366,22.867691136113276,21.361615225832868
3327,/media/marda/TWOTB1/xBD/hurricanes/images/florence/hurricane-florence_00000290_pre_disaster.png,42,62,1,99,141,632,694,718,40.926714460880405,23.3279353176262
3328,/media/marda/TWOTB1/xBD/hurricanes/images/florence/hurricane-florence_00000290_pre_disaster.png,52,63,1,333,385,661,724,504,51.45325157516933,13.05389490472495
3329,/media/marda/TWOTB1/xBD/hurricanes/images/florence/hurricane-florence_00000290_pre_disaster.png,32,44,1,210,242,702,746,174,24.892137858346608,9.862332659537905
3330,/media/marda/TWOTB1/xBD/hurricanes/images/florence/hurricane-florence_00000290_pre_disaster.png,18,44,1,190,208,708,752,168,17.4649906139092,12.847534271978763
3331,/media/marda/TWOTB1/xBD/hurricanes/images/florence/hurricane-florence_00000290_pre_disaster.png,39,57,1,206,245,730,787,504,26.9875389665153,24.490212292921953
3332,/media/marda/TWOTB1/xBD/hurricanes/images/florence/hurricane-florence_00000290_pre_disaster.png,47,71,1,221,268,751,822,883,43.470014310633175,26.607103711296215
3333,/media/marda/TWOTB1/xBD/hurricanes/images/florence/hurricane-florence_00000290_pre_disaster.png,43,65,1,105,148,760,825,647,44.456517093659066,19.60918319670055
3334,/media/marda/TWOTB1/xBD/hurricanes/images/florence/hurricane-florence_00000290_pre_disaster.png,61,78,1,105,166,798,876,1597,56.963603310580055,36.30173497902343
3335,/media/marda/TWOTB1/xBD/hurricanes/images/florence/hurricane-florence_00000290_pre_disaster.png,30,93,1,0,30,917,1010,883,48.660176375445836,27.619158473402756
3336,/media/marda/TWOTB1/xBD/hurricanes/images/florence/hurricane-florence_00000416_post_disaster.png,36,15,1,288,324,0,15,236,22.853100254685007,14.18459123939288
3337,/media/marda/TWOTB1/xBD/hurricanes/images/florence/hurricane-florence_00000416_post_disaster.png,46,17,1,322,368,0,17,309,28.158694560224372,15.571775002064879
3338,/media/marda/TWOTB1/xBD/hurricanes/images/florence/hurricane-florence_00000416_post_disaster.png,51,39,1,352,403,25,64,830,38.68058437886447,29.071521041093035
3339,/media/marda/TWOTB1/xBD/hurricanes/images/florence/hurricane-florence_00000416_post_disaster.png,52,49,1,230,282,46,95,1004,50.36787985506485,26.59211206214491
3340,/media/marda/TWOTB1/xBD/hurricanes/images/florence/hurricane-florence_00000416_post_disaster.png,74,37,1,387,461,49,86,835,64.55119604076049,23.54759832368672
3341,/media/marda/TWOTB1/xBD/hurricanes/images/florence/hurricane-florence_00000416_post_disaster.png,40,34,1,314,354,99,133,498,36.298238817211406,18.247119403307526
3342,/media/marda/TWOTB1/xBD/hurricanes/images/florence/hurricane-florence_00000416_post_disaster.png,43,49,1,177,220,99,148,648,53.48198760429757,16.084765410631192
3343,/media/marda/TWOTB1/xBD/hurricanes/images/florence/hurricane-florence_00000416_post_disaster.png,19,51,1,0,19,143,194,536,46.81286628571189,16.678060099333663
3344,/media/marda/TWOTB1/xBD/hurricanes/images/florence/hurricane-florence_00000416_post_disaster.png,48,43,1,280,328,151,194,871,35.973110456566694,32.09308476322604
3345,/media/marda/TWOTB1/xBD/hurricanes/images/florence/hurricane-florence_00000416_post_disaster.png,41,53,1,68,109,178,231,1021,49.61752710534969,27.456048485990667
3346,/media/marda/TWOTB1/xBD/hurricanes/images/florence/hurricane-florence_00000416_post_disaster.png,45,22,1,774,819,182,204,186,16.92922163675769,14.691907388570678
3347,/media/marda/TWOTB1/xBD/hurricanes/images/florence/hurricane-florence_00000416_post_disaster.png,59,49,1,773,832,199,248,761,41.254367961424855,24.347456150337617
3348,/media/marda/TWOTB1/xBD/hurricanes/images/florence/hurricane-florence_00000416_post_disaster.png,66,49,1,419,485,218,267,1137,50.87098851673878,29.824652074746766
3349,/media/marda/TWOTB1/xBD/hurricanes/images/florence/hurricane-florence_00000416_post_disaster.png,57,48,1,621,678,223,271,804,39.43575436129464,26.909759039670263
3350,/media/marda/TWOTB1/xBD/hurricanes/images/florence/hurricane-florence_00000416_post_disaster.png,49,20,1,912,961,248,268,88,11.498393255151187,10.339673755798097
3351,/media/marda/TWOTB1/xBD/hurricanes/images/florence/hurricane-florence_00000416_post_disaster.png,79,37,1,654,733,255,292,590,58.45200194216621,13.482547854400094
3352,/media/marda/TWOTB1/xBD/hurricanes/images/florence/hurricane-florence_00000416_post_disaster.png,52,41,1,508,560,256,297,640,32.14559738813654,26.68289813597522
3353,/media/marda/TWOTB1/xBD/hurricanes/images/florence/hurricane-florence_00000416_post_disaster.png,42,23,1,702,744,260,283,110,12.582975987187607,11.907465035444066
3354,/media/marda/TWOTB1/xBD/hurricanes/images/florence/hurricane-florence_00000416_post_disaster.png,9,19,1,63,72,266,285,91,11.676102129852477,10.380515499762831
3355,/media/marda/TWOTB1/xBD/hurricanes/images/florence/hurricane-florence_00000416_post_disaster.png,77,41,1,906,983,275,316,745,40.34057046156922,24.493002211293824
3356,/media/marda/TWOTB1/xBD/hurricanes/images/florence/hurricane-florence_00000416_post_disaster.png,60,46,1,781,841,290,336,662,36.04229768609484,24.688449698785423
3357,/media/marda/TWOTB1/xBD/hurricanes/images/florence/hurricane-florence_00000416_post_disaster.png,70,43,1,822,892,308,351,686,38.057922857437745,23.91760866450962
3358,/media/marda/TWOTB1/xBD/hurricanes/images/florence/hurricane-florence_00000416_post_disaster.png,49,50,1,411,460,313,363,740,41.104214742290075,23.52392489514231
3359,/media/marda/TWOTB1/xBD/hurricanes/images/florence/hurricane-florence_00000416_post_disaster.png,46,41,1,998,1044,317,358,98,29.048396984149914,5.077726102516723
3360,/media/marda/TWOTB1/xBD/hurricanes/images/florence/hurricane-florence_00000416_post_disaster.png,49,25,1,925,974,332,357,103,12.573246142868122,10.99809375379906
3361,/media/marda/TWOTB1/xBD/hurricanes/images/florence/hurricane-florence_00000416_post_disaster.png,57,53,1,724,781,337,390,593,45.39445089673702,17.40483912377906
3362,/media/marda/TWOTB1/xBD/hurricanes/images/florence/hurricane-florence_00000416_post_disaster.png,76,49,1,902,978,342,391,833,38.696723307330274,28.81478366674658
3363,/media/marda/TWOTB1/xBD/hurricanes/images/florence/hurricane-florence_00000416_post_disaster.png,61,50,1,325,386,373,423,1020,47.889000338997356,28.519801390755035
3364,/media/marda/TWOTB1/xBD/hurricanes/images/florence/hurricane-florence_00000416_post_disaster.png,55,23,1,980,1035,382,405,151,17.376546712918437,11.584987409038568
3365,/media/marda/TWOTB1/xBD/hurricanes/images/florence/hurricane-florence_00000416_post_disaster.png,74,47,1,847,921,397,444,707,41.25602623888751,22.75738839193358
3366,/media/marda/TWOTB1/xBD/hurricanes/images/florence/hurricane-florence_00000416_post_disaster.png,72,54,1,548,620,404,458,973,51.71698493910948,25.00110549088597
3367,/media/marda/TWOTB1/xBD/hurricanes/images/florence/hurricane-florence_00000416_post_disaster.png,64,28,1,980,1044,411,439,262,30.204377384969476,11.60156671079915
3368,/media/marda/TWOTB1/xBD/hurricanes/images/florence/hurricane-florence_00000416_post_disaster.png,113,122,1,628,741,458,580,4683,107.27053857966604,68.6154884742649
3369,/media/marda/TWOTB1/xBD/hurricanes/images/florence/hurricane-florence_00000416_post_disaster.png,49,35,1,856,905,530,565,143,16.218292403495404,11.822190757720248
3370,/media/marda/TWOTB1/xBD/hurricanes/images/florence/hurricane-florence_00000416_post_disaster.png,67,49,1,818,885,555,604,559,33.75008239979438,22.115526618498816
3371,/media/marda/TWOTB1/xBD/hurricanes/images/florence/hurricane-florence_00000416_post_disaster.png,62,69,1,805,867,619,688,615,49.377841429576115,16.632269141243754
3372,/media/marda/TWOTB1/xBD/hurricanes/images/florence/hurricane-florence_00000416_post_disaster.png,66,53,1,895,961,660,713,702,32.17244667571757,28.862744577363554
3373,/media/marda/TWOTB1/xBD/hurricanes/images/florence/hurricane-florence_00000416_post_disaster.png,77,77,1,765,842,672,749,1369,53.361779692831696,35.05139952137691
3374,/media/marda/TWOTB1/xBD/hurricanes/images/florence/hurricane-florence_00000416_post_disaster.png,66,61,1,820,886,681,742,694,35.18630151731623,26.32624469224409
3375,/media/marda/TWOTB1/xBD/hurricanes/images/florence/hurricane-florence_00000416_post_disaster.png,44,39,1,817,861,720,759,102,13.114478286580463,10.4717485690948
3376,/media/marda/TWOTB1/xBD/hurricanes/images/florence/hurricane-florence_00000416_post_disaster.png,48,43,1,846,894,726,769,172,16.354047455194817,14.17452732391778
3377,/media/marda/TWOTB1/xBD/hurricanes/images/florence/hurricane-florence_00000416_post_disaster.png,66,56,1,805,871,733,789,713,36.271196828649416,26.469884263538546
3378,/media/marda/TWOTB1/xBD/hurricanes/images/florence/hurricane-florence_00000416_post_disaster.png,64,61,1,858,922,744,805,512,28.15275714353682,24.300444866005776
3379,/media/marda/TWOTB1/xBD/hurricanes/images/florence/hurricane-florence_00000416_post_disaster.png,60,67,1,710,770,801,868,697,32.345041324119705,28.586011887054983
3380,/media/marda/TWOTB1/xBD/hurricanes/images/florence/hurricane-florence_00000416_post_disaster.png,47,60,1,757,804,815,875,336,26.962400889566705,17.26475423293964
3381,/media/marda/TWOTB1/xBD/hurricanes/images/florence/hurricane-florence_00000416_post_disaster.png,66,63,1,699,765,844,907,783,39.6475278816222,26.222570745965026
3382,/media/marda/TWOTB1/xBD/hurricanes/images/florence/hurricane-florence_00000416_post_disaster.png,74,92,1,813,887,862,954,1653,63.90489554877378,38.168292936210165
3383,/media/marda/TWOTB1/xBD/hurricanes/images/florence/hurricane-florence_00000416_post_disaster.png,54,66,1,684,738,875,941,682,33.666572303416814,27.066028020502273
3384,/media/marda/TWOTB1/xBD/hurricanes/images/florence/hurricane-florence_00000416_post_disaster.png,47,45,1,865,912,877,922,162,16.96106735753306,12.823101553923104
3385,/media/marda/TWOTB1/xBD/hurricanes/images/florence/hurricane-florence_00000416_post_disaster.png,84,64,1,882,966,902,966,900,52.140670157937706,23.053916341719937
3386,/media/marda/TWOTB1/xBD/hurricanes/images/florence/hurricane-florence_00000416_post_disaster.png,79,102,1,510,589,921,1023,1966,64.92579489807405,40.32523929416855
3387,/media/marda/TWOTB1/xBD/hurricanes/images/florence/hurricane-florence_00000416_post_disaster.png,55,61,1,751,806,938,999,495,28.216477968322998,23.25407858590593
3388,/media/marda/TWOTB1/xBD/hurricanes/images/florence/hurricane-florence_00000416_post_disaster.png,75,57,1,826,901,956,1013,517,46.71173702458686,17.068638563105164
3389,/media/marda/TWOTB1/xBD/hurricanes/images/florence/hurricane-florence_00000416_post_disaster.png,107,64,1,705,812,528,592,1829,80.25221518656755,31.790836686273735
3390,/media/marda/TWOTB1/xBD/hurricanes/images/florence/hurricane-florence_00000452_post_disaster.png,61,57,1,458,519,506,563,660,49.55739879686972,22.936840265918285
3391,/media/marda/TWOTB1/xBD/hurricanes/images/florence/hurricane-florence_00000452_post_disaster.png,38,38,1,430,468,567,605,248,21.559635407125292,15.41655455704928
3392,/media/marda/TWOTB1/xBD/hurricanes/images/florence/hurricane-florence_00000452_post_disaster.png,45,7,1,845,890,0,7,87,14.385224916288328,7.997219152629088
3393,/media/marda/TWOTB1/xBD/hurricanes/images/florence/hurricane-florence_00000452_post_disaster.png,67,25,1,976,1043,0,25,654,32.258782612366375,26.97471606341712
3394,/media/marda/TWOTB1/xBD/hurricanes/images/florence/hurricane-florence_00000452_post_disaster.png,56,43,1,735,791,25,68,673,44.39683629150922,22.9397687797462
3395,/media/marda/TWOTB1/xBD/hurricanes/images/florence/hurricane-florence_00000452_post_disaster.png,53,17,1,923,976,37,54,242,18.910408801890497,17.07192037556706
3396,/media/marda/TWOTB1/xBD/hurricanes/images/florence/hurricane-florence_00000452_post_disaster.png,63,35,1,866,929,40,75,929,38.61898127896699,31.970286491067807
3397,/media/marda/TWOTB1/xBD/hurricanes/images/florence/hurricane-florence_00000452_post_disaster.png,46,12,1,930,976,79,91,120,13.808210118138652,11.489125293076057
3398,/media/marda/TWOTB1/xBD/hurricanes/images/florence/hurricane-florence_00000452_post_disaster.png,52,22,1,716,768,174,196,330,26.029393699380975,16.808301567003358
3399,/media/marda/TWOTB1/xBD/hurricanes/images/florence/hurricane-florence_00000452_post_disaster.png,49,28,1,994,1043,282,310,150,21.299645018112876,9.568901590983936
3400,/media/marda/TWOTB1/xBD/hurricanes/images/florence/hurricane-florence_00000452_post_disaster.png,80,40,1,931,1011,286,326,1026,45.27886357672811,30.212545204329267
3401,/media/marda/TWOTB1/xBD/hurricanes/images/florence/hurricane-florence_00000452_post_disaster.png,62,61,1,501,563,583,644,1234,42.95701894016661,38.11124856790701
3402,/media/marda/TWOTB1/xBD/hurricanes/images/florence/hurricane-florence_00000452_post_disaster.png,29,35,1,465,494,613,648,89,13.612357932426352,8.737471228999578
3403,/media/marda/TWOTB1/xBD/hurricanes/images/florence/hurricane-florence_00000452_post_disaster.png,33,40,1,457,490,629,669,174,16.633760868279694,14.06243715111645
3404,/media/marda/TWOTB1/xBD/hurricanes/images/florence/hurricane-florence_00000452_post_disaster.png,92,54,1,873,965,872,926,1219,67.01476223759244,24.24392606805315
3405,/media/marda/TWOTB1/xBD/hurricanes/images/florence/hurricane-florence_00000452_post_disaster.png,58,57,1,985,1043,934,991,346,22.514490046541383,20.4562857760167
3406,/media/marda/TWOTB1/xBD/hurricanes/images/florence/hurricane-florence_00000452_post_disaster.png,69,57,1,946,1015,949,1006,571,36.455111598639625,20.730353376592166
3407,/media/marda/TWOTB1/xBD/hurricanes/images/florence/hurricane-florence_00000538_pre_disaster.png,34,31,1,428,462,336,367,172,17.252271231466445,13.347217407822727
3408,/media/marda/TWOTB1/xBD/hurricanes/images/florence/hurricane-florence_00000538_pre_disaster.png,14,43,1,90,104,810,853,78,11.627857549469228,9.041581375319053
3409,/media/marda/TWOTB1/xBD/hurricanes/images/florence/hurricane-florence_00000538_pre_disaster.png,5,48,1,0,5,949,997,60,13.808210118138652,5.656854249492381
3410,/media/marda/TWOTB1/xBD/hurricanes/images/florence/hurricane-florence_00000528_post_disaster.png,67,25,1,394,461,0,25,680,52.719531648826866,20.09671718345738
3411,/media/marda/TWOTB1/xBD/hurricanes/images/florence/hurricane-florence_00000528_post_disaster.png,45,41,1,179,224,161,202,712,37.64637128651701,25.156054472851693
3412,/media/marda/TWOTB1/xBD/hurricanes/images/florence/hurricane-florence_00000528_post_disaster.png,55,56,1,99,154,220,276,1110,58.43570686456846,25.236658283013227
3413,/media/marda/TWOTB1/xBD/hurricanes/images/florence/hurricane-florence_00000528_post_disaster.png,25,66,1,0,25,320,386,679,50.19818130007838,21.844783588287218
3414,/media/marda/TWOTB1/xBD/hurricanes/images/florence/hurricane-florence_00000528_post_disaster.png,52,65,1,119,171,369,434,1051,63.10873197913479,22.013566012151077
3415,/media/marda/TWOTB1/xBD/hurricanes/images/florence/hurricane-florence_00000528_post_disaster.png,31,41,1,341,372,654,695,157,16.162286258326187,13.048791084379928
3416,/media/marda/TWOTB1/xBD/hurricanes/images/florence/hurricane-florence_00000528_post_disaster.png,56,62,1,285,341,659,721,971,39.75827504855292,32.23940578008159
3417,/media/marda/TWOTB1/xBD/hurricanes/images/florence/hurricane-florence_00000528_post_disaster.png,36,49,1,364,400,704,753,253,25.30859513815956,13.161157995977646
3418,/media/marda/TWOTB1/xBD/hurricanes/images/florence/hurricane-florence_00000528_post_disaster.png,54,70,1,379,433,778,848,816,43.796428152022926,24.557127265636908
3419,/media/marda/TWOTB1/xBD/hurricanes/images/florence/hurricane-florence_00000528_post_disaster.png,78,75,1,927,1005,907,982,892,36.604576908825464,32.43596829684345
3420,/media/marda/TWOTB1/xBD/hurricanes/images/florence/hurricane-florence_00000528_post_disaster.png,62,87,1,304,366,948,1035,1386,54.113864352036565,34.31805383111577
3421,/media/marda/TWOTB1/xBD/hurricanes/images/florence/hurricane-florence_00000060_pre_disaster.png,57,84,1,686,743,310,394,1414,78.18975689318258,24.257076951527157
3422,/media/marda/TWOTB1/xBD/hurricanes/images/florence/hurricane-florence_00000060_pre_disaster.png,49,75,1,554,603,466,541,1352,63.233092058382475,28.432166996816964
3423,/media/marda/TWOTB1/xBD/hurricanes/images/florence/hurricane-florence_00000060_pre_disaster.png,23,51,1,82,105,535,586,599,34.53321898073835,22.88438215682743
3424,/media/marda/TWOTB1/xBD/hurricanes/images/florence/hurricane-florence_00000060_pre_disaster.png,57,60,1,68,125,620,680,1148,63.50128740851828,27.91376211954661
3425,/media/marda/TWOTB1/xBD/hurricanes/images/florence/hurricane-florence_00000060_pre_disaster.png,40,63,1,314,354,642,705,843,42.99254813581366,26.71580965187045
3426,/media/marda/TWOTB1/xBD/hurricanes/images/florence/hurricane-florence_00000060_pre_disaster.png,24,49,1,235,259,659,708,302,27.80684019636196,15.602922411760959
3427,/media/marda/TWOTB1/xBD/hurricanes/images/florence/hurricane-florence_00000060_pre_disaster.png,12,37,1,11,23,674,711,121,15.029164614374526,11.216385012593996
3428,/media/marda/TWOTB1/xBD/hurricanes/images/florence/hurricane-florence_00000060_pre_disaster.png,47,50,1,1,48,722,772,881,52.1231261562538,22.388669146341247
3429,/media/marda/TWOTB1/xBD/hurricanes/images/florence/hurricane-florence_00000060_pre_disaster.png,59,53,1,217,276,725,778,1027,55.246779060239454,24.830055719671748
3430,/media/marda/TWOTB1/xBD/hurricanes/images/florence/hurricane-florence_00000301_post_disaster.png,46,52,1,123,169,131,183,1158,51.07925187620649,32.89913837604835
3431,/media/marda/TWOTB1/xBD/hurricanes/images/florence/hurricane-florence_00000301_post_disaster.png,20,16,1,202,222,161,177,91,13.876997068485343,8.820878193401512
3432,/media/marda/TWOTB1/xBD/hurricanes/images/florence/hurricane-florence_00000301_post_disaster.png,17,17,1,184,201,164,181,97,12.161914027985116,10.709144938800144
3433,/media/marda/TWOTB1/xBD/hurricanes/images/florence/hurricane-florence_00000301_post_disaster.png,38,33,1,225,263,168,201,855,34.278731231990356,33.241919588601746
3434,/media/marda/TWOTB1/xBD/hurricanes/images/florence/hurricane-florence_00000301_post_disaster.png,24,24,1,270,294,202,226,127,14.241183660455258,11.944672574926955
3435,/media/marda/TWOTB1/xBD/hurricanes/images/florence/hurricane-florence_00000301_post_disaster.png,64,40,1,535,599,232,272,917,45.44896818021805,27.118980026623824
3436,/media/marda/TWOTB1/xBD/hurricanes/images/florence/hurricane-florence_00000301_post_disaster.png,13,72,1,0,13,466,538,677,62.54004211664144,14.442131607548713
3437,/media/marda/TWOTB1/xBD/hurricanes/images/florence/hurricane-florence_00000301_post_disaster.png,74,73,1,165,239,518,591,2482,70.69010539777142,47.80281532775482
3438,/media/marda/TWOTB1/xBD/hurricanes/images/florence/hurricane-florence_00000301_post_disaster.png,42,57,1,173,215,574,631,997,37.55810310005373,34.86386787163585
3439,/media/marda/TWOTB1/xBD/hurricanes/images/florence/hurricane-florence_00000301_post_disaster.png,38,61,1,10,48,610,671,1216,42.92464297181391,36.882169090861204
3440,/media/marda/TWOTB1/xBD/hurricanes/images/florence/hurricane-florence_00000301_post_disaster.png,23,47,1,3,26,749,796,358,25.07231440847476,18.9231031994611
3441,/media/marda/TWOTB1/xBD/hurricanes/images/florence/hurricane-florence_00000301_post_disaster.png,24,40,1,170,194,756,796,184,22.15230794534029,11.169967047755005
3442,/media/marda/TWOTB1/xBD/hurricanes/images/florence/hurricane-florence_00000301_post_disaster.png,91,80,1,667,758,860,940,2259,67.8930591089584,44.062252114386574
3443,/media/marda/TWOTB1/xBD/hurricanes/images/florence/hurricane-florence_00000301_post_disaster.png,29,53,1,230,259,867,920,311,20.520907795975372,20.113329084453408
3444,/media/marda/TWOTB1/xBD/hurricanes/images/florence/hurricane-florence_00000301_post_disaster.png,26,57,1,131,157,947,1004,250,19.8936081599013,16.825553969492606
3445,/media/marda/TWOTB1/xBD/hurricanes/images/florence/hurricane-florence_00000301_post_disaster.png,12,46,1,49,61,949,995,120,13.808210118138652,11.489125293076057
3446,/media/marda/TWOTB1/xBD/hurricanes/images/florence/hurricane-florence_00000301_post_disaster.png,24,62,1,128,152,979,1041,472,28.76800716609313,21.776530075097103
3447,/media/marda/TWOTB1/xBD/hurricanes/images/florence/hurricane-florence_00000262_post_disaster.png,10,10,1,22,32,58,68,55,10.978012591907374,6.875247243255334
3448,/media/marda/TWOTB1/xBD/hurricanes/images/florence/hurricane-florence_00000262_post_disaster.png,56,59,1,54,110,106,165,1633,53.26035890615144,40.28771136031094
3449,/media/marda/TWOTB1/xBD/hurricanes/images/florence/hurricane-florence_00000262_post_disaster.png,24,37,1,0,24,107,144,509,30.23744611709205,22.674234727208024
3450,/media/marda/TWOTB1/xBD/hurricanes/images/florence/hurricane-florence_00000262_post_disaster.png,32,13,1,636,668,182,195,37,7.650931640555551,6.525512243686533
3451,/media/marda/TWOTB1/xBD/hurricanes/images/florence/hurricane-florence_00000262_post_disaster.png,64,41,1,671,735,186,227,739,32.83413548411417,29.928710225374367
3452,/media/marda/TWOTB1/xBD/hurricanes/images/florence/hurricane-florence_00000262_post_disaster.png,76,64,1,725,801,212,276,1346,58.53425827574325,32.636101540489584
3453,/media/marda/TWOTB1/xBD/hurricanes/images/florence/hurricane-florence_00000262_post_disaster.png,79,65,1,830,909,452,517,1169,50.88765220995082,31.30714151873531
3454,/media/marda/TWOTB1/xBD/hurricanes/images/florence/hurricane-florence_00000262_post_disaster.png,58,56,1,478,536,469,525,871,39.61124821352977,29.830921432012072
3455,/media/marda/TWOTB1/xBD/hurricanes/images/florence/hurricane-florence_00000262_post_disaster.png,41,54,1,334,375,564,618,525,28.997148194379044,24.188274548180647
3456,/media/marda/TWOTB1/xBD/hurricanes/images/florence/hurricane-florence_00000262_post_disaster.png,68,62,1,691,759,579,641,950,39.325928463937885,32.439694807483974
3457,/media/marda/TWOTB1/xBD/hurricanes/images/florence/hurricane-florence_00000262_post_disaster.png,57,62,1,354,411,587,649,878,39.395658628906965,29.800674353695843
3458,/media/marda/TWOTB1/xBD/hurricanes/images/florence/hurricane-florence_00000262_post_disaster.png,33,49,1,225,258,659,708,272,23.89220054148761,16.174642752290758
3459,/media/marda/TWOTB1/xBD/hurricanes/images/florence/hurricane-florence_00000262_post_disaster.png,47,64,1,229,276,702,766,665,40.42372380726843,21.89830866331748
3460,/media/marda/TWOTB1/xBD/hurricanes/images/florence/hurricane-florence_00000262_post_disaster.png,64,79,1,392,456,791,870,1212,53.011765284730004,30.011379520929463
3461,/media/marda/TWOTB1/xBD/hurricanes/images/florence/hurricane-florence_00000262_post_disaster.png,25,52,1,59,84,834,886,252,27.208531196040155,12.144514358142425
3462,/media/marda/TWOTB1/xBD/hurricanes/images/florence/hurricane-florence_00000262_post_disaster.png,48,65,1,351,399,834,899,630,31.041936265173778,27.31629775181947
3463,/media/marda/TWOTB1/xBD/hurricanes/images/florence/hurricane-florence_00000262_post_disaster.png,57,79,1,12,69,838,917,1285,60.606290786232805,28.168569735287825
3464,/media/marda/TWOTB1/xBD/hurricanes/images/florence/hurricane-florence_00000262_post_disaster.png,28,45,1,444,472,850,895,78,11.332782776391486,9.282581814420764
3465,/media/marda/TWOTB1/xBD/hurricanes/images/florence/hurricane-florence_00000262_post_disaster.png,32,47,1,448,480,861,908,106,17.42185665269129,8.146514790136111
3466,/media/marda/TWOTB1/xBD/hurricanes/images/florence/hurricane-florence_00000262_post_disaster.png,16,44,1,106,122,868,912,66,12.70055433196397,7.020359772922754
3467,/media/marda/TWOTB1/xBD/hurricanes/images/florence/hurricane-florence_00000262_post_disaster.png,29,46,1,380,409,876,922,96,14.409452491389272,9.326893522887694
3468,/media/marda/TWOTB1/xBD/hurricanes/images/florence/hurricane-florence_00000262_post_disaster.png,47,76,1,196,243,965,1041,776,43.55959906078751,23.709419578877853
3469,/media/marda/TWOTB1/xBD/hurricanes/images/florence/hurricane-florence_00000262_post_disaster.png,40,53,1,541,581,990,1043,135,18.683202820937215,9.903855554696579
3470,/media/marda/TWOTB1/xBD/hurricanes/images/florence/hurricane-florence_00000466_pre_disaster.png,56,71,1,49,105,500,571,1608,48.67271703477596,44.801181493945585
3471,/media/marda/TWOTB1/xBD/hurricanes/images/florence/hurricane-florence_00000466_pre_disaster.png,69,90,1,360,429,568,658,2059,65.07604443752055,47.072299070719964
3472,/media/marda/TWOTB1/xBD/hurricanes/images/florence/hurricane-florence_00000466_pre_disaster.png,60,73,1,305,365,631,704,1264,48.179926649897546,34.862058323738935
3473,/media/marda/TWOTB1/xBD/hurricanes/images/florence/hurricane-florence_00000466_pre_disaster.png,23,98,1,0,23,770,868,1006,76.32334035659764,22.25121580665255
3474,/media/marda/TWOTB1/xBD/hurricanes/images/florence/hurricane-florence_00000528_pre_disaster.png,67,25,1,394,461,0,25,680,52.719531648826866,20.09671718345738
3475,/media/marda/TWOTB1/xBD/hurricanes/images/florence/hurricane-florence_00000528_pre_disaster.png,45,41,1,179,224,161,202,712,37.64637128651701,25.156054472851693
3476,/media/marda/TWOTB1/xBD/hurricanes/images/florence/hurricane-florence_00000528_pre_disaster.png,55,56,1,99,154,220,276,1110,58.43570686456846,25.236658283013227
3477,/media/marda/TWOTB1/xBD/hurricanes/images/florence/hurricane-florence_00000528_pre_disaster.png,25,66,1,0,25,320,386,679,50.19818130007838,21.844783588287218
3478,/media/marda/TWOTB1/xBD/hurricanes/images/florence/hurricane-florence_00000528_pre_disaster.png,52,65,1,119,171,369,434,1051,63.10873197913479,22.013566012151077
3479,/media/marda/TWOTB1/xBD/hurricanes/images/florence/hurricane-florence_00000528_pre_disaster.png,31,41,1,341,372,654,695,157,16.162286258326187,13.048791084379928
3480,/media/marda/TWOTB1/xBD/hurricanes/images/florence/hurricane-florence_00000528_pre_disaster.png,56,62,1,285,341,659,721,971,39.75827504855292,32.23940578008159
3481,/media/marda/TWOTB1/xBD/hurricanes/images/florence/hurricane-florence_00000528_pre_disaster.png,36,49,1,364,400,704,753,253,25.30859513815956,13.161157995977646
3482,/media/marda/TWOTB1/xBD/hurricanes/images/florence/hurricane-florence_00000528_pre_disaster.png,54,70,1,379,433,778,848,816,43.796428152022926,24.557127265636908
3483,/media/marda/TWOTB1/xBD/hurricanes/images/florence/hurricane-florence_00000528_pre_disaster.png,78,75,1,927,1005,907,982,892,36.604576908825464,32.43596829684345
3484,/media/marda/TWOTB1/xBD/hurricanes/images/florence/hurricane-florence_00000528_pre_disaster.png,62,87,1,304,366,948,1035,1386,54.113864352036565,34.31805383111577
3485,/media/marda/TWOTB1/xBD/hurricanes/images/florence/hurricane-florence_00000085_post_disaster.png,34,46,1,160,194,379,425,811,35.58456549079584,30.10685899542782
3486,/media/marda/TWOTB1/xBD/hurricanes/images/florence/hurricane-florence_00000085_post_disaster.png,52,73,1,167,219,425,498,1684,56.354221156420145,41.80876002413216
3487,/media/marda/TWOTB1/xBD/hurricanes/images/florence/hurricane-florence_00000085_post_disaster.png,51,57,1,698,749,571,628,342,41.86488639880054,10.868527891352699
3488,/media/marda/TWOTB1/xBD/hurricanes/images/florence/hurricane-florence_00000085_post_disaster.png,85,55,1,809,894,571,626,1232,54.68126677531752,30.91245269027395
3489,/media/marda/TWOTB1/xBD/hurricanes/images/florence/hurricane-florence_00000085_post_disaster.png,15,66,1,1,16,604,670,552,47.281871295780675,15.560233820636821
3490,/media/marda/TWOTB1/xBD/hurricanes/images/florence/hurricane-florence_00000085_post_disaster.png,47,38,1,881,928,623,661,134,14.702825732570746,12.29027241661756
3491,/media/marda/TWOTB1/xBD/hurricanes/images/florence/hurricane-florence_00000085_post_disaster.png,23,78,1,172,195,665,743,817,61.05782302417951,17.844930111441414
3492,/media/marda/TWOTB1/xBD/hurricanes/images/florence/hurricane-florence_00000085_post_disaster.png,22,72,1,2,24,687,759,770,51.45906332844397,20.264110531214914
3493,/media/marda/TWOTB1/xBD/hurricanes/images/florence/hurricane-florence_00000085_post_disaster.png,35,63,1,179,214,745,808,808,37.39372033779771,28.969986037672065
3494,/media/marda/TWOTB1/xBD/hurricanes/images/florence/hurricane-florence_00000085_post_disaster.png,21,39,1,217,238,745,784,143,14.966629547095765,12.649110640673518
3495,/media/marda/TWOTB1/xBD/hurricanes/images/florence/hurricane-florence_00000085_post_disaster.png,19,45,1,221,240,776,821,145,18.81471791010743,10.317030121785622
3496,/media/marda/TWOTB1/xBD/hurricanes/images/florence/hurricane-florence_00000085_post_disaster.png,33,81,1,189,222,824,905,1021,52.80104231125134,25.628626356931786
3497,/media/marda/TWOTB1/xBD/hurricanes/images/florence/hurricane-florence_00000085_post_disaster.png,36,52,1,337,373,827,879,354,25.04757022299998,18.920987231834207
3498,/media/marda/TWOTB1/xBD/hurricanes/images/florence/hurricane-florence_00000085_post_disaster.png,34,67,1,245,279,832,899,681,36.66057222705541,25.025006433272335
3499,/media/marda/TWOTB1/xBD/hurricanes/images/florence/hurricane-florence_00000085_post_disaster.png,34,52,1,414,448,859,911,304,20.616483742476596,19.66474733747909
3500,/media/marda/TWOTB1/xBD/hurricanes/images/florence/hurricane-florence_00000085_post_disaster.png,95,88,1,342,437,870,958,2887,89.35602465014185,50.57213543195508
3501,/media/marda/TWOTB1/xBD/hurricanes/images/florence/hurricane-florence_00000085_post_disaster.png,22,44,1,429,451,886,930,35,7.41491867322567,6.505774628622548
3502,/media/marda/TWOTB1/xBD/hurricanes/images/florence/hurricane-florence_00000085_post_disaster.png,48,62,1,458,506,894,956,573,35.255562874992364,21.676113349325025
3503,/media/marda/TWOTB1/xBD/hurricanes/images/florence/hurricane-florence_00000085_post_disaster.png,32,53,1,427,459,895,948,205,17.01788580407101,16.08523802162421
3504,/media/marda/TWOTB1/xBD/hurricanes/images/florence/hurricane-florence_00000085_post_disaster.png,60,109,1,569,629,932,1041,1596,74.39730187906395,31.639719099315258
3505,/media/marda/TWOTB1/xBD/hurricanes/images/florence/hurricane-florence_00000085_post_disaster.png,42,61,1,531,573,947,1008,416,26.00935382277413,21.414670798500154
3506,/media/marda/TWOTB1/xBD/hurricanes/images/florence/hurricane-florence_00000085_post_disaster.png,45,47,1,407,452,996,1043,137,28.52483790112542,6.582402933841166
3507,/media/marda/TWOTB1/xBD/hurricanes/images/florence/hurricane-florence_00000319_pre_disaster.png,42,57,1,391,433,746,803,615,29.883169119897396,27.104580769036932
3508,/media/marda/TWOTB1/xBD/hurricanes/images/florence/hurricane-florence_00000319_pre_disaster.png,26,62,1,214,240,902,964,354,27.01194831409318,17.52814890993804
3509,/media/marda/TWOTB1/xBD/hurricanes/images/florence/hurricane-florence_00000319_pre_disaster.png,27,58,1,425,452,975,1033,203,24.649215584161286,11.436584156286546
3510,/media/marda/TWOTB1/xBD/hurricanes/images/florence/hurricane-florence_00000150_pre_disaster.png,47,51,1,542,589,691,742,315,26.580065827034286,15.847866897820126
3511,/media/marda/TWOTB1/xBD/hurricanes/images/florence/hurricane-florence_00000150_pre_disaster.png,62,67,1,605,667,707,774,670,42.67019248028093,20.894374329976923
3512,/media/marda/TWOTB1/xBD/hurricanes/images/florence/hurricane-florence_00000150_pre_disaster.png,61,66,1,560,621,740,806,877,35.008930452683224,33.582764099834925
3513,/media/marda/TWOTB1/xBD/hurricanes/images/florence/hurricane-florence_00000150_pre_disaster.png,54,59,1,41,95,757,816,1124,59.18442302320697,25.352724455365923
3514,/media/marda/TWOTB1/xBD/hurricanes/images/florence/hurricane-florence_00000150_pre_disaster.png,55,62,1,531,586,797,859,609,35.9264712855036,22.3787261770335
3515,/media/marda/TWOTB1/xBD/hurricanes/images/florence/hurricane-florence_00000150_pre_disaster.png,73,67,1,566,639,813,880,1257,55.41027857996539,30.770647532266032
3516,/media/marda/TWOTB1/xBD/hurricanes/images/florence/hurricane-florence_00000150_pre_disaster.png,44,59,1,337,381,852,911,481,33.89249697412015,18.832945627865907
3517,/media/marda/TWOTB1/xBD/hurricanes/images/florence/hurricane-florence_00000086_pre_disaster.png,51,43,1,158,209,0,43,1371,46.462687968924364,39.869962591901555
3518,/media/marda/TWOTB1/xBD/hurricanes/images/florence/hurricane-florence_00000086_pre_disaster.png,16,25,1,0,16,106,131,189,18.196784741910587,14.114724494411524
3519,/media/marda/TWOTB1/xBD/hurricanes/images/florence/hurricane-florence_00000086_pre_disaster.png,37,40,1,31,68,166,206,718,37.8542004373035,26.26725064154199
3520,/media/marda/TWOTB1/xBD/hurricanes/images/florence/hurricane-florence_00000086_pre_disaster.png,51,58,1,993,1044,625,683,308,38.12649648406089,10.689576436745378
3521,/media/marda/TWOTB1/xBD/hurricanes/images/florence/hurricane-florence_00000086_pre_disaster.png,49,67,1,817,866,891,958,443,35.02219570171285,16.8141998128631
3522,/media/marda/TWOTB1/xBD/hurricanes/images/florence/hurricane-florence_00000086_pre_disaster.png,81,72,1,917,998,908,980,1482,50.42496975604461,39.22104944283571
3523,/media/marda/TWOTB1/xBD/hurricanes/images/florence/hurricane-florence_00000086_pre_disaster.png,63,66,1,981,1044,965,1031,392,31.211702399977604,16.86910246234181
3524,/media/marda/TWOTB1/xBD/hurricanes/images/florence/hurricane-florence_00000102_post_disaster.png,52,117,1,330,382,771,888,1313,102.77733934642353,17.050662501976568
3525,/media/marda/TWOTB1/xBD/hurricanes/images/florence/hurricane-florence_00000102_post_disaster.png,39,44,1,384,423,777,821,185,27.7346486705401,8.95245216227174
3526,/media/marda/TWOTB1/xBD/hurricanes/images/florence/hurricane-florence_00000102_post_disaster.png,53,103,1,388,441,788,891,1195,78.71356894845506,20.266510138421907
3527,/media/marda/TWOTB1/xBD/hurricanes/images/florence/hurricane-florence_00000102_post_disaster.png,62,46,1,552,614,803,849,423,46.3925213565907,12.205537564127596
3528,/media/marda/TWOTB1/xBD/hurricanes/images/florence/hurricane-florence_00000102_post_disaster.png,55,54,1,245,300,821,875,524,51.08209059050954,13.70106775197458
3529,/media/marda/TWOTB1/xBD/hurricanes/images/florence/hurricane-florence_00000102_post_disaster.png,45,47,1,592,637,826,873,291,23.99809450776505,16.115090477365356
3530,/media/marda/TWOTB1/xBD/hurricanes/images/florence/hurricane-florence_00000102_post_disaster.png,69,50,1,829,898,826,876,438,41.34533130878063,14.169181399257898
3531,/media/marda/TWOTB1/xBD/hurricanes/images/florence/hurricane-florence_00000102_post_disaster.png,26,48,1,227,253,832,880,171,17.190004631705822,13.549860152570728
3532,/media/marda/TWOTB1/xBD/hurricanes/images/florence/hurricane-florence_00000102_post_disaster.png,52,49,1,851,903,880,929,248,22.088285973970084,14.869932979378245
3533,/media/marda/TWOTB1/xBD/hurricanes/images/florence/hurricane-florence_00000102_post_disaster.png,30,50,1,397,427,951,1001,140,15.15002979337867,12.462640714803157
3534,/media/marda/TWOTB1/xBD/hurricanes/images/florence/hurricane-florence_00000500_pre_disaster.png,37,12,1,314,351,0,12,167,22.277555679122116,11.056698536411755
3535,/media/marda/TWOTB1/xBD/hurricanes/images/florence/hurricane-florence_00000500_pre_disaster.png,52,50,1,293,345,22,72,1019,45.62202733013475,34.24241884054834
3536,/media/marda/TWOTB1/xBD/hurricanes/images/florence/hurricane-florence_00000500_pre_disaster.png,91,56,1,606,697,450,506,1828,69.98299987334482,34.715657614535466
3537,/media/marda/TWOTB1/xBD/hurricanes/images/florence/hurricane-florence_00000500_pre_disaster.png,89,66,1,715,804,548,614,1998,60.97369138758567,44.18017867041496
3538,/media/marda/TWOTB1/xBD/hurricanes/images/florence/hurricane-florence_00000500_pre_disaster.png,58,49,1,587,645,613,662,590,39.02564942050676,20.18411968126677
3539,/media/marda/TWOTB1/xBD/hurricanes/images/florence/hurricane-florence_00000500_pre_disaster.png,55,38,1,764,819,618,656,288,27.745515116068457,13.747027250571927
3540,/media/marda/TWOTB1/xBD/hurricanes/images/florence/hurricane-florence_00000500_pre_disaster.png,78,81,1,765,843,825,906,1497,49.09350010493932,39.93884552616616
3541,/media/marda/TWOTB1/xBD/hurricanes/images/florence/hurricane-florence_00000500_pre_disaster.png,82,76,1,962,1044,877,953,1322,46.98892427220287,39.403066574170914
3542,/media/marda/TWOTB1/xBD/hurricanes/images/florence/hurricane-florence_00000376_post_disaster.png,57,26,1,831,888,0,26,384,31.302830887735663,18.8630236041365
3543,/media/marda/TWOTB1/xBD/hurricanes/images/florence/hurricane-florence_00000376_post_disaster.png,93,56,1,870,963,0,56,1688,54.725155965536,43.78707107327
3544,/media/marda/TWOTB1/xBD/hurricanes/images/florence/hurricane-florence_00000376_post_disaster.png,52,34,1,752,804,104,138,372,30.01089471671626,16.552034745497323
3545,/media/marda/TWOTB1/xBD/hurricanes/images/florence/hurricane-florence_00000376_post_disaster.png,63,42,1,618,681,157,199,819,35.30592619541068,30.795126288007754
3546,/media/marda/TWOTB1/xBD/hurricanes/images/florence/hurricane-florence_00000376_post_disaster.png,93,61,1,746,839,163,224,1773,59.71449770878777,41.45119607598435
3547,/media/marda/TWOTB1/xBD/hurricanes/images/florence/hurricane-florence_00000376_post_disaster.png,63,43,1,584,647,177,220,917,37.966710616206576,31.946593671112016
3548,/media/marda/TWOTB1/xBD/hurricanes/images/florence/hurricane-florence_00000376_post_disaster.png,39,24,1,567,606,253,277,177,17.34080638924983,13.334207064158884
3549,/media/marda/TWOTB1/xBD/hurricanes/images/florence/hurricane-florence_00000376_post_disaster.png,41,27,1,492,533,275,302,271,20.6878184829829,16.866594942912318
3550,/media/marda/TWOTB1/xBD/hurricanes/images/florence/hurricane-florence_00000376_post_disaster.png,96,77,1,557,653,318,395,2476,77.34104344134619,43.70162451243699
3551,/media/marda/TWOTB1/xBD/hurricanes/images/florence/hurricane-florence_00000376_post_disaster.png,39,47,1,489,528,654,701,321,22.549739497202772,18.905302758564872
3552,/media/marda/TWOTB1/xBD/hurricanes/images/florence/hurricane-florence_00000376_post_disaster.png,41,42,1,588,629,675,717,158,16.45725052312773,12.66473710783417
3553,/media/marda/TWOTB1/xBD/hurricanes/images/florence/hurricane-florence_00000376_post_disaster.png,45,74,1,549,594,678,752,745,54.53846628128256,18.24856389490587
3554,/media/marda/TWOTB1/xBD/hurricanes/images/florence/hurricane-florence_00000376_post_disaster.png,48,55,1,599,647,706,761,314,27.350250220517424,15.17380879502995
3555,/media/marda/TWOTB1/xBD/hurricanes/images/florence/hurricane-florence_00000376_post_disaster.png,65,83,1,456,521,732,815,1456,52.80592587314323,40.47889928387257
3556,/media/marda/TWOTB1/xBD/hurricanes/images/florence/hurricane-florence_00000376_post_disaster.png,35,43,1,502,537,795,838,115,16.413455359779874,9.507354390172871
3557,/media/marda/TWOTB1/xBD/hurricanes/images/florence/hurricane-florence_00000376_post_disaster.png,42,68,1,491,533,803,871,669,37.48905592782873,23.918632669364555
3558,/media/marda/TWOTB1/xBD/hurricanes/images/florence/hurricane-florence_00000376_post_disaster.png,55,78,1,383,438,824,902,741,53.34515877072829,18.687524467206252
3559,/media/marda/TWOTB1/xBD/hurricanes/images/florence/hurricane-florence_00000376_post_disaster.png,76,81,1,414,490,872,953,1418,55.96945939583534,35.9582471878614
3560,/media/marda/TWOTB1/xBD/hurricanes/images/florence/hurricane-florence_00000376_post_disaster.png,61,79,1,640,701,900,979,821,42.41105855755486,25.840299890090023
3561,/media/marda/TWOTB1/xBD/hurricanes/images/florence/hurricane-florence_00000376_post_disaster.png,51,66,1,289,340,906,972,692,38.57996975346415,25.07792753749286
3562,/media/marda/TWOTB1/xBD/hurricanes/images/florence/hurricane-florence_00000376_post_disaster.png,46,64,1,290,336,977,1041,585,34.659353872451184,22.18865846348117
3563,/media/marda/TWOTB1/xBD/hurricanes/images/florence/hurricane-florence_00000091_post_disaster.png,253,71,1,278,531,0,71,8250,243.01116861622586,47.274600775659756
3564,/media/marda/TWOTB1/xBD/hurricanes/images/florence/hurricane-florence_00000091_post_disaster.png,82,38,1,546,628,0,38,1084,58.62349735025538,27.28556053391395
3565,/media/marda/TWOTB1/xBD/hurricanes/images/florence/hurricane-florence_00000091_post_disaster.png,46,10,1,657,703,0,10,106,20.67663437688532,8.226832806655029
3566,/media/marda/TWOTB1/xBD/hurricanes/images/florence/hurricane-florence_00000091_post_disaster.png,78,25,1,965,1043,0,25,761,41.334261293103474,25.018382429535905
3567,/media/marda/TWOTB1/xBD/hurricanes/images/florence/hurricane-florence_00000091_post_disaster.png,33,49,1,144,177,25,74,931,50.58468530478874,24.116053806973174
3568,/media/marda/TWOTB1/xBD/hurricanes/images/florence/hurricane-florence_00000091_post_disaster.png,63,36,1,980,1043,35,71,644,37.05140918792441,23.11568248979665
3569,/media/marda/TWOTB1/xBD/hurricanes/images/florence/hurricane-florence_00000091_post_disaster.png,68,45,1,704,772,58,103,1198,46.034326695799926,36.03770356395495
3570,/media/marda/TWOTB1/xBD/hurricanes/images/florence/hurricane-florence_00000091_post_disaster.png,14,11,1,45,59,79,90,118,14.874188292193846,10.531936866066244
3571,/media/marda/TWOTB1/xBD/hurricanes/images/florence/hurricane-florence_00000091_post_disaster.png,55,32,1,988,1043,87,119,307,30.555578635489667,14.453142960288487
3572,/media/marda/TWOTB1/xBD/hurricanes/images/florence/hurricane-florence_00000091_post_disaster.png,61,35,1,588,649,91,126,803,37.404137146040696,29.367348232911134
3573,/media/marda/TWOTB1/xBD/hurricanes/images/florence/hurricane-florence_00000091_post_disaster.png,37,46,1,160,197,99,145,952,46.96627998862811,26.97884011323259
3574,/media/marda/TWOTB1/xBD/hurricanes/images/florence/hurricane-florence_00000091_post_disaster.png,79,45,1,779,858,103,148,1374,51.16992684252004,36.46274095842974
3575,/media/marda/TWOTB1/xBD/hurricanes/images/florence/hurricane-florence_00000091_post_disaster.png,17,16,1,16,33,110,126,152,18.33716886770674,11.072771611399018
3576,/media/marda/TWOTB1/xBD/hurricanes/images/florence/hurricane-florence_00000091_post_disaster.png,79,47,1,715,794,113,160,1338,48.49817868953623,36.20750104713268
3577,/media/marda/TWOTB1/xBD/hurricanes/images/florence/hurricane-florence_00000091_post_disaster.png,50,48,1,486,536,124,172,963,44.70381684768568,28.916697191475947
3578,/media/marda/TWOTB1/xBD/hurricanes/images/florence/hurricane-florence_00000091_post_disaster.png,45,34,1,65,110,134,168,830,46.5361294288981,23.676139578540436
3579,/media/marda/TWOTB1/xBD/hurricanes/images/florence/hurricane-florence_00000091_post_disaster.png,24,41,1,16,40,141,182,569,38.90368241998538,19.230335583999082
3580,/media/marda/TWOTB1/xBD/hurricanes/images/florence/hurricane-florence_00000091_post_disaster.png,53,38,1,602,655,143,181,611,33.04108521154911,24.702956422528505
3581,/media/marda/TWOTB1/xBD/hurricanes/images/florence/hurricane-florence_00000091_post_disaster.png,49,45,1,401,450,151,196,935,41.71183166975794,29.221884223186
3582,/media/marda/TWOTB1/xBD/hurricanes/images/florence/hurricane-florence_00000091_post_disaster.png,74,37,1,798,872,155,192,824,40.7113315804596,28.893158349861622
3583,/media/marda/TWOTB1/xBD/hurricanes/images/florence/hurricane-florence_00000091_post_disaster.png,7,30,1,0,7,161,191,153,26.980459561394685,7.586055928407552
3584,/media/marda/TWOTB1/xBD/hurricanes/images/florence/hurricane-florence_00000091_post_disaster.png,45,43,1,363,408,164,207,857,40.90044176701659,27.38266031303097
3585,/media/marda/TWOTB1/xBD/hurricanes/images/florence/hurricane-florence_00000091_post_disaster.png,29,15,1,437,466,166,181,93,12.846195950743343,9.787361947745703
3586,/media/marda/TWOTB1/xBD/hurricanes/images/florence/hurricane-florence_00000091_post_disaster.png,52,46,1,495,547,172,218,851,42.665954439121485,26.53070439418099
3587,/media/marda/TWOTB1/xBD/hurricanes/images/florence/hurricane-florence_00000091_post_disaster.png,41,39,1,306,347,176,215,698,35.110547450814714,26.43478333777896
3588,/media/marda/TWOTB1/xBD/hurricanes/images/florence/hurricane-florence_00000091_post_disaster.png,55,44,1,616,671,194,238,813,39.65379922896788,27.6811485303624
3589,/media/marda/TWOTB1/xBD/hurricanes/images/florence/hurricane-florence_00000091_post_disaster.png,26,25,1,351,377,196,221,171,17.469200466617092,12.8717333796918
3590,/media/marda/TWOTB1/xBD/hurricanes/images/florence/hurricane-florence_00000091_post_disaster.png,57,33,1,816,873,198,231,405,23.793496613132373,22.699042458285618
3591,/media/marda/TWOTB1/xBD/hurricanes/images/florence/hurricane-florence_00000091_post_disaster.png,37,52,1,191,228,200,252,807,45.705912252317674,23.416261610181245
3592,/media/marda/TWOTB1/xBD/hurricanes/images/florence/hurricane-florence_00000091_post_disaster.png,52,50,1,513,565,221,271,842,44.924003308385835,24.839648919498952
3593,/media/marda/TWOTB1/xBD/hurricanes/images/florence/hurricane-florence_00000091_post_disaster.png,77,43,1,814,891,222,265,1051,45.887293056525806,30.343592997256852
3594,/media/marda/TWOTB1/xBD/hurricanes/images/florence/hurricane-florence_00000091_post_disaster.png,41,43,1,320,361,227,270,699,36.09004857338836,25.696280715674636
3595,/media/marda/TWOTB1/xBD/hurricanes/images/florence/hurricane-florence_00000091_post_disaster.png,50,46,1,100,150,236,282,1119,45.760627871757066,32.85104492858859
3596,/media/marda/TWOTB1/xBD/hurricanes/images/florence/hurricane-florence_00000091_post_disaster.png,58,42,1,627,685,240,282,750,34.61350557516854,30.815195930615488
3597,/media/marda/TWOTB1/xBD/hurricanes/images/florence/hurricane-florence_00000091_post_disaster.png,43,40,1,53,96,250,290,880,44.521283897176595,25.940814135224123
3598,/media/marda/TWOTB1/xBD/hurricanes/images/florence/hurricane-florence_00000091_post_disaster.png,40,51,1,203,243,252,303,864,42.69728988075193,26.831027476282056
3599,/media/marda/TWOTB1/xBD/hurricanes/images/florence/hurricane-florence_00000091_post_disaster.png,30,23,1,366,396,253,276,166,18.10371188337111,12.342225004495624
3600,/media/marda/TWOTB1/xBD/hurricanes/images/florence/hurricane-florence_00000091_post_disaster.png,23,27,1,154,177,263,290,217,17.343962755587825,16.82379268084835
3601,/media/marda/TWOTB1/xBD/hurricanes/images/florence/hurricane-florence_00000091_post_disaster.png,36,24,1,441,477,264,288,191,19.34017197798771,13.246603676806414
3602,/media/marda/TWOTB1/xBD/hurricanes/images/florence/hurricane-florence_00000091_post_disaster.png,45,40,1,0,45,266,306,974,47.5651744035309,26.715307931666178
3603,/media/marda/TWOTB1/xBD/hurricanes/images/florence/hurricane-florence_00000091_post_disaster.png,53,50,1,524,577,269,319,875,41.29068679039529,28.155078988830272
3604,/media/marda/TWOTB1/xBD/hurricanes/images/florence/hurricane-florence_00000091_post_disaster.png,84,51,1,792,876,271,322,1294,54.337468447543436,32.46615690599926
3605,/media/marda/TWOTB1/xBD/hurricanes/images/florence/hurricane-florence_00000091_post_disaster.png,50,51,1,331,381,276,327,932,39.25312038133163,33.75478332143212
3606,/media/marda/TWOTB1/xBD/hurricanes/images/florence/hurricane-florence_00000091_post_disaster.png,54,47,1,633,687,278,325,736,35.91226700930904,27.23372718783308
3607,/media/marda/TWOTB1/xBD/hurricanes/images/florence/hurricane-florence_00000091_post_disaster.png,76,62,1,838,914,295,357,1430,46.77435261647498,40.49670305696859
3608,/media/marda/TWOTB1/xBD/hurricanes/images/florence/hurricane-florence_00000091_post_disaster.png,39,51,1,218,257,300,351,767,39.06969392373883,25.975450116246154
3609,/media/marda/TWOTB1/xBD/hurricanes/images/florence/hurricane-florence_00000091_post_disaster.png,37,32,1,384,421,312,344,294,22.521883613964466,17.512151319630018
3610,/media/marda/TWOTB1/xBD/hurricanes/images/florence/hurricane-florence_00000091_post_disaster.png,65,73,1,664,729,319,392,1426,64.42337044157023,29.475493807555477
3611,/media/marda/TWOTB1/xBD/hurricanes/images/florence/hurricane-florence_00000091_post_disaster.png,20,40,1,64,84,320,360,323,28.920370103346155,14.78706757561136
3612,/media/marda/TWOTB1/xBD/hurricanes/images/florence/hurricane-florence_00000091_post_disaster.png,53,49,1,351,404,328,377,918,38.20180377709047,31.619672366663398
3613,/media/marda/TWOTB1/xBD/hurricanes/images/florence/hurricane-florence_00000091_post_disaster.png,66,44,1,767,833,330,374,852,39.55914225116585,28.195456798359025
3614,/media/marda/TWOTB1/xBD/hurricanes/images/florence/hurricane-florence_00000091_post_disaster.png,30,34,1,122,152,337,371,406,27.253734523482027,19.780097358140733
3615,/media/marda/TWOTB1/xBD/hurricanes/images/florence/hurricane-florence_00000091_post_disaster.png,63,43,1,719,782,342,385,730,34.54999671606689,28.086005042654964
3616,/media/marda/TWOTB1/xBD/hurricanes/images/florence/hurricane-florence_00000091_post_disaster.png,38,50,1,234,272,352,402,692,38.71350500972023,24.165009414116152
3617,/media/marda/TWOTB1/xBD/hurricanes/images/florence/hurricane-florence_00000091_post_disaster.png,54,54,1,507,561,376,430,891,43.22958282171835,27.34756934370632
3618,/media/marda/TWOTB1/xBD/hurricanes/images/florence/hurricane-florence_00000091_post_disaster.png,81,56,1,849,930,383,439,1218,47.82271134274704,37.127526356121315
3619,/media/marda/TWOTB1/xBD/hurricanes/images/florence/hurricane-florence_00000091_post_disaster.png,38,36,1,337,375,388,424,378,25.579911232297956,19.757696071307745
3620,/media/marda/TWOTB1/xBD/hurricanes/images/florence/hurricane-florence_00000091_post_disaster.png,55,38,1,562,617,388,426,550,35.49414467480296,20.46327267361944
3621,/media/marda/TWOTB1/xBD/hurricanes/images/florence/hurricane-florence_00000091_post_disaster.png,58,46,1,471,529,397,443,872,41.305521769071625,27.449364353183853
3622,/media/marda/TWOTB1/xBD/hurricanes/images/florence/hurricane-florence_00000091_post_disaster.png,17,33,1,35,52,399,432,205,17.763227687010378,15.45219017368794
3623,/media/marda/TWOTB1/xBD/hurricanes/images/florence/hurricane-florence_00000091_post_disaster.png,34,58,1,248,282,403,461,725,43.19086888676295,22.61466347617356
3624,/media/marda/TWOTB1/xBD/hurricanes/images/florence/hurricane-florence_00000091_post_disaster.png,42,50,1,433,475,404,454,620,35.356946093108,23.3715497782165
3625,/media/marda/TWOTB1/xBD/hurricanes/images/florence/hurricane-florence_00000091_post_disaster.png,43,53,1,394,437,415,468,686,38.726774922367284,23.47155261042227
3626,/media/marda/TWOTB1/xBD/hurricanes/images/florence/hurricane-florence_00000091_post_disaster.png,63,49,1,741,804,418,467,897,41.96192349998073,28.28406858655353
3627,/media/marda/TWOTB1/xBD/hurricanes/images/florence/hurricane-florence_00000091_post_disaster.png,71,45,1,862,933,427,472,704,39.82635649349338,23.168662369779383
3628,/media/marda/TWOTB1/xBD/hurricanes/images/florence/hurricane-florence_00000091_post_disaster.png,46,45,1,354,400,431,476,700,35.83412657817534,25.53288669523194
3629,/media/marda/TWOTB1/xBD/hurricanes/images/florence/hurricane-florence_00000091_post_disaster.png,40,58,1,257,297,451,509,890,42.86472301919629,27.643609798730626
3630,/media/marda/TWOTB1/xBD/hurricanes/images/florence/hurricane-florence_00000091_post_disaster.png,29,57,1,0,29,455,512,782,39.67023390626671,26.327652993510803
3631,/media/marda/TWOTB1/xBD/hurricanes/images/florence/hurricane-florence_00000091_post_disaster.png,43,56,1,169,212,460,516,956,38.558065067213256,33.121930524522554
3632,/media/marda/TWOTB1/xBD/hurricanes/images/florence/hurricane-florence_00000091_post_disaster.png,31,44,1,108,139,464,508,494,30.194958978270783,22.968115519459456
3633,/media/marda/TWOTB1/xBD/hurricanes/images/florence/hurricane-florence_00000091_post_disaster.png,42,46,1,55,97,467,513,927,44.41493469220517,27.533412297864423
3634,/media/marda/TWOTB1/xBD/hurricanes/images/florence/hurricane-florence_00000091_post_disaster.png,52,49,1,685,737,483,532,579,32.052743514770555,24.1664079946132
3635,/media/marda/TWOTB1/xBD/hurricanes/images/florence/hurricane-florence_00000091_post_disaster.png,58,64,1,563,621,487,551,1129,49.11630781108575,30.299064648640318
3636,/media/marda/TWOTB1/xBD/hurricanes/images/florence/hurricane-florence_00000091_post_disaster.png,70,54,1,882,952,488,542,912,38.42061128288739,32.62208672297216
3637,/media/marda/TWOTB1/xBD/hurricanes/images/florence/hurricane-florence_00000091_post_disaster.png,43,35,1,739,782,505,540,141,14.093861960800373,13.43115410008442
3638,/media/marda/TWOTB1/xBD/hurricanes/images/florence/hurricane-florence_00000091_post_disaster.png,63,69,1,414,477,521,590,1181,48.97998114679732,34.6665682777921
3639,/media/marda/TWOTB1/xBD/hurricanes/images/florence/hurricane-florence_00000091_post_disaster.png,55,40,1,857,912,526,566,339,24.647265260609885,18.199325786192887
3640,/media/marda/TWOTB1/xBD/hurricanes/images/florence/hurricane-florence_00000091_post_disaster.png,41,34,1,756,797,538,572,112,12.473477914592326,12.15956211197565
3641,/media/marda/TWOTB1/xBD/hurricanes/images/florence/hurricane-florence_00000091_post_disaster.png,126,127,1,821,947,540,667,6641,106.71429444658604,82.98410446390253
3642,/media/marda/TWOTB1/xBD/hurricanes/images/florence/hurricane-florence_00000091_post_disaster.png,66,52,1,707,773,551,603,796,37.70921354827196,28.34095096488211
3643,/media/marda/TWOTB1/xBD/hurricanes/images/florence/hurricane-florence_00000091_post_disaster.png,38,53,1,293,331,562,615,645,33.47491982076823,25.89522874994208
3644,/media/marda/TWOTB1/xBD/hurricanes/images/florence/hurricane-florence_00000091_post_disaster.png,71,81,1,420,491,585,666,1838,65.52267475511718,37.76643801196341
3645,/media/marda/TWOTB1/xBD/hurricanes/images/florence/hurricane-florence_00000091_post_disaster.png,62,63,1,471,533,586,649,1092,38.855707327466156,37.522051353205924
3646,/media/marda/TWOTB1/xBD/hurricanes/images/florence/hurricane-florence_00000091_post_disaster.png,74,63,1,604,678,596,659,1136,49.55435171719871,30.57104838155602
3647,/media/marda/TWOTB1/xBD/hurricanes/images/florence/hurricane-florence_00000091_post_disaster.png,50,40,1,761,811,620,660,229,21.941200769820785,14.003745390336107
3648,/media/marda/TWOTB1/xBD/hurricanes/images/florence/hurricane-florence_00000091_post_disaster.png,40,50,1,303,343,621,671,490,27.092488285068168,24.077396596772996
3649,/media/marda/TWOTB1/xBD/hurricanes/images/florence/hurricane-florence_00000091_post_disaster.png,33,65,1,107,140,627,692,821,43.298924757941755,25.226460760326205
3650,/media/marda/TWOTB1/xBD/hurricanes/images/florence/hurricane-florence_00000091_post_disaster.png,70,55,1,717,787,631,686,862,44.09198986286654,25.825570826811195
3651,/media/marda/TWOTB1/xBD/hurricanes/images/florence/hurricane-florence_00000091_post_disaster.png,33,51,1,39,72,636,687,593,34.76289482365956,22.518818561876728
3652,/media/marda/TWOTB1/xBD/hurricanes/images/florence/hurricane-florence_00000091_post_disaster.png,48,54,1,592,640,656,710,503,27.621966843495304,23.88912786234696
3653,/media/marda/TWOTB1/xBD/hurricanes/images/florence/hurricane-florence_00000091_post_disaster.png,54,57,1,270,324,664,721,962,47.338449880105586,26.65514983253621
3654,/media/marda/TWOTB1/xBD/hurricanes/images/florence/hurricane-florence_00000091_post_disaster.png,43,59,1,324,367,689,748,618,32.305560336343326,26.055638219536284
3655,/media/marda/TWOTB1/xBD/hurricanes/images/florence/hurricane-florence_00000091_post_disaster.png,61,79,1,602,663,697,776,1239,53.91047034055806,30.235465508409607
3656,/media/marda/TWOTB1/xBD/hurricanes/images/florence/hurricane-florence_00000091_post_disaster.png,54,57,1,652,706,707,764,593,29.455994008000058,26.53304579681795
3657,/media/marda/TWOTB1/xBD/hurricanes/images/florence/hurricane-florence_00000091_post_disaster.png,87,129,1,424,511,719,848,3381,112.28233195720541,43.18847506455694
3658,/media/marda/TWOTB1/xBD/hurricanes/images/florence/hurricane-florence_00000091_post_disaster.png,49,66,1,335,384,732,798,1007,39.84681233780785,32.99265643978371
3659,/media/marda/TWOTB1/xBD/hurricanes/images/florence/hurricane-florence_00000091_post_disaster.png,197,262,1,756,953,753,1015,22951,244.95729809017732,126.2582383464734
3660,/media/marda/TWOTB1/xBD/hurricanes/images/florence/hurricane-florence_00000091_post_disaster.png,54,106,1,274,328,770,876,1927,83.35405934621593,30.804865282276925
3661,/media/marda/TWOTB1/xBD/hurricanes/images/florence/hurricane-florence_00000091_post_disaster.png,59,82,1,318,377,771,853,1418,50.2451364044319,38.2316143274657
3662,/media/marda/TWOTB1/xBD/hurricanes/images/florence/hurricane-florence_00000091_post_disaster.png,8,52,1,0,8,800,852,99,20.18794170763533,7.07593703533058
3663,/media/marda/TWOTB1/xBD/hurricanes/images/florence/hurricane-florence_00000091_post_disaster.png,35,51,1,91,126,818,869,351,36.021739784226924,12.994395261391867
3664,/media/marda/TWOTB1/xBD/hurricanes/images/florence/hurricane-florence_00000091_post_disaster.png,42,57,1,98,140,831,888,532,42.93229858349653,16.43818127679733
3665,/media/marda/TWOTB1/xBD/hurricanes/images/florence/hurricane-florence_00000091_post_disaster.png,38,77,1,1,39,840,917,1028,49.94791787305944,27.659589133561212
3666,/media/marda/TWOTB1/xBD/hurricanes/images/florence/hurricane-florence_00000091_post_disaster.png,109,87,1,623,732,846,933,3009,83.79712209760824,46.66619666539941
3667,/media/marda/TWOTB1/xBD/hurricanes/images/florence/hurricane-florence_00000091_post_disaster.png,45,55,1,103,148,851,906,473,45.62749902377057,14.24506254902281
3668,/media/marda/TWOTB1/xBD/hurricanes/images/florence/hurricane-florence_00000091_post_disaster.png,56,85,1,573,629,893,978,1042,53.144080568974196,26.126159317136985
3669,/media/marda/TWOTB1/xBD/hurricanes/images/florence/hurricane-florence_00000091_post_disaster.png,115,137,1,479,594,896,1033,6217,94.73454690656447,88.01326937616508
3670,/media/marda/TWOTB1/xBD/hurricanes/images/florence/hurricane-florence_00000091_post_disaster.png,92,80,1,248,340,928,1008,1847,92.51014972288003,26.446874402990087
3671,/media/marda/TWOTB1/xBD/hurricanes/images/florence/hurricane-florence_00000091_post_disaster.png,35,67,1,341,376,940,1007,443,32.63931977468683,19.31033802869729
3672,/media/marda/TWOTB1/xBD/hurricanes/images/florence/hurricane-florence_00000091_post_disaster.png,29,68,1,146,175,958,1026,530,31.346975707594105,22.3555634035714
3673,/media/marda/TWOTB1/xBD/hurricanes/images/florence/hurricane-florence_00000091_post_disaster.png,36,64,1,198,234,965,1029,560,27.930472550159237,26.715712892784634
3674,/media/marda/TWOTB1/xBD/hurricanes/images/florence/hurricane-florence_00000091_post_disaster.png,50,65,1,34,84,967,1032,708,57.292286172023104,17.906780069784578
3675,/media/marda/TWOTB1/xBD/hurricanes/images/florence/hurricane-florence_00000091_post_disaster.png,65,74,1,370,435,967,1041,1203,53.33661230809374,32.65404831187662
3676,/media/marda/TWOTB1/xBD/hurricanes/images/florence/hurricane-florence_00000091_post_disaster.png,23,50,1,114,137,969,1019,180,20.03262720002254,11.794831283057052
3677,/media/marda/TWOTB1/xBD/hurricanes/images/florence/hurricane-florence_00000091_post_disaster.png,26,59,1,127,153,981,1040,254,18.940375791877294,18.014642360946766
3678,/media/marda/TWOTB1/xBD/hurricanes/images/florence/hurricane-florence_00000091_post_disaster.png,40,61,1,317,357,982,1043,377,25.73763484293448,21.070265814288227
3679,/media/marda/TWOTB1/xBD/hurricanes/images/florence/hurricane-florence_00000091_post_disaster.png,9,51,1,19,28,986,1037,68,9.966730657295336,9.183816238196995
3680,/media/marda/TWOTB1/xBD/hurricanes/images/florence/hurricane-florence_00000091_post_disaster.png,35,50,1,51,86,993,1043,195,35.34836792736868,8.279057881262093
3681,/media/marda/TWOTB1/xBD/hurricanes/images/florence/hurricane-florence_00000412_pre_disaster.png,76,36,1,593,669,63,99,1720,58.47109929602855,39.2491185986386
3682,/media/marda/TWOTB1/xBD/hurricanes/images/florence/hurricane-florence_00000412_pre_disaster.png,141,120,1,750,891,72,192,5906,150.306329504877,61.763119787682186
3683,/media/marda/TWOTB1/xBD/hurricanes/images/florence/hurricane-florence_00000412_pre_disaster.png,50,15,1,774,824,96,111,202,21.229101112679324,12.476878087419843
3684,/media/marda/TWOTB1/xBD/hurricanes/images/florence/hurricane-florence_00000412_pre_disaster.png,58,21,1,151,209,113,134,611,59.095251300270405,14.625166969301263
3685,/media/marda/TWOTB1/xBD/hurricanes/images/florence/hurricane-florence_00000412_pre_disaster.png,28,24,1,111,139,141,165,412,26.832181562605047,20.94706499001547
3686,/media/marda/TWOTB1/xBD/hurricanes/images/florence/hurricane-florence_00000412_pre_disaster.png,60,50,1,984,1044,141,191,591,46.876997224510774,17.93685982099528
3687,/media/marda/TWOTB1/xBD/hurricanes/images/florence/hurricane-florence_00000412_pre_disaster.png,42,22,1,557,599,180,202,366,25.409684993890842,19.175333763704657
3688,/media/marda/TWOTB1/xBD/hurricanes/images/florence/hurricane-florence_00000412_pre_disaster.png,34,24,1,584,618,181,205,210,22.111774114412956,12.692207107124377
3689,/media/marda/TWOTB1/xBD/hurricanes/images/florence/hurricane-florence_00000412_pre_disaster.png,65,46,1,591,656,191,237,928,43.06935662348948,28.418764967222398
3690,/media/marda/TWOTB1/xBD/hurricanes/images/florence/hurricane-florence_00000412_pre_disaster.png,69,36,1,414,483,234,270,992,59.673340237959295,22.091049543142777
3691,/media/marda/TWOTB1/xBD/hurricanes/images/florence/hurricane-florence_00000412_pre_disaster.png,75,60,1,699,774,236,296,1057,56.224679948224704,25.0834105894339
3692,/media/marda/TWOTB1/xBD/hurricanes/images/florence/hurricane-florence_00000412_pre_disaster.png,61,32,1,781,842,250,282,371,33.75814176165816,14.59119604434635
3693,/media/marda/TWOTB1/xBD/hurricanes/images/florence/hurricane-florence_00000412_pre_disaster.png,78,55,1,926,1004,284,339,996,46.8932782541371,28.36978610891182
3694,/media/marda/TWOTB1/xBD/hurricanes/images/florence/hurricane-florence_00000412_pre_disaster.png,89,75,1,640,729,305,380,1832,66.17469512720258,37.135414731439006
3695,/media/marda/TWOTB1/xBD/hurricanes/images/florence/hurricane-florence_00000412_pre_disaster.png,96,74,1,705,801,359,433,2090,67.11396598655892,42.611296565995225
3696,/media/marda/TWOTB1/xBD/hurricanes/images/florence/hurricane-florence_00000412_pre_disaster.png,55,35,1,776,831,366,401,292,26.387051624360716,14.741467321708662
3697,/media/marda/TWOTB1/xBD/hurricanes/images/florence/hurricane-florence_00000412_pre_disaster.png,67,56,1,603,670,373,429,939,47.34133942917081,26.66263434577822
3698,/media/marda/TWOTB1/xBD/hurricanes/images/florence/hurricane-florence_00000412_pre_disaster.png,47,40,1,663,710,404,444,286,22.568194517040453,16.980705375679694
3699,/media/marda/TWOTB1/xBD/hurricanes/images/florence/hurricane-florence_00000412_pre_disaster.png,62,60,1,567,629,420,480,776,46.6498121452306,22.205255624067018
3700,/media/marda/TWOTB1/xBD/hurricanes/images/florence/hurricane-florence_00000412_pre_disaster.png,57,48,1,641,698,420,468,540,27.871356578288285,25.865968626092776
3701,/media/marda/TWOTB1/xBD/hurricanes/images/florence/hurricane-florence_00000412_pre_disaster.png,45,37,1,676,721,420,457,199,23.840934515996647,10.994898313787964
3702,/media/marda/TWOTB1/xBD/hurricanes/images/florence/hurricane-florence_00000412_pre_disaster.png,61,42,1,851,912,438,480,364,27.818107120910096,17.503325883799924
3703,/media/marda/TWOTB1/xBD/hurricanes/images/florence/hurricane-florence_00000412_pre_disaster.png,56,53,1,525,581,454,507,662,33.98987624369182,26.001847913268115
3704,/media/marda/TWOTB1/xBD/hurricanes/images/florence/hurricane-florence_00000412_pre_disaster.png,71,84,1,469,540,492,576,1514,67.02095656608195,33.3393697459246
3705,/media/marda/TWOTB1/xBD/hurricanes/images/florence/hurricane-florence_00000412_pre_disaster.png,51,43,1,665,716,524,567,294,24.076579350248704,16.344053413574382
3706,/media/marda/TWOTB1/xBD/hurricanes/images/florence/hurricane-florence_00000412_pre_disaster.png,51,56,1,517,568,530,586,537,34.355620688388015,21.660151542106295
3707,/media/marda/TWOTB1/xBD/hurricanes/images/florence/hurricane-florence_00000412_pre_disaster.png,40,39,1,455,495,554,593,211,25.537133190712005,10.999105406395573
3708,/media/marda/TWOTB1/xBD/hurricanes/images/florence/hurricane-florence_00000412_pre_disaster.png,41,43,1,442,483,572,615,319,21.505161959560464,19.5722146598581
3709,/media/marda/TWOTB1/xBD/hurricanes/images/florence/hurricane-florence_00000412_pre_disaster.png,50,58,1,470,520,573,631,460,44.087274862946224,13.936295192893017
3710,/media/marda/TWOTB1/xBD/hurricanes/images/florence/hurricane-florence_00000412_pre_disaster.png,57,68,1,402,459,598,666,925,39.91878575936641,31.078649047604603
3711,/media/marda/TWOTB1/xBD/hurricanes/images/florence/hurricane-florence_00000412_pre_disaster.png,57,69,1,512,569,601,670,633,51.760506809849005,16.33460811728452
3712,/media/marda/TWOTB1/xBD/hurricanes/images/florence/hurricane-florence_00000412_pre_disaster.png,53,60,1,572,625,643,703,467,42.77854396219483,14.501600631316567
3713,/media/marda/TWOTB1/xBD/hurricanes/images/florence/hurricane-florence_00000412_pre_disaster.png,24,40,1,150,174,645,685,161,20.380310410052655,10.479514157887769
3714,/media/marda/TWOTB1/xBD/hurricanes/images/florence/hurricane-florence_00000412_pre_disaster.png,60,75,1,334,394,650,725,1083,54.68205143261495,29.86743713681756
3715,/media/marda/TWOTB1/xBD/hurricanes/images/florence/hurricane-florence_00000412_pre_disaster.png,48,53,1,442,490,663,716,454,29.820827646733225,20.316552151565176
3716,/media/marda/TWOTB1/xBD/hurricanes/images/florence/hurricane-florence_00000412_pre_disaster.png,39,54,1,173,212,683,737,483,35.04802160273315,18.26547657182999
3717,/media/marda/TWOTB1/xBD/hurricanes/images/florence/hurricane-florence_00000412_pre_disaster.png,20,38,1,156,176,684,722,129,13.901789374200392,12.353925132722512
3718,/media/marda/TWOTB1/xBD/hurricanes/images/florence/hurricane-florence_00000412_pre_disaster.png,48,75,1,144,192,701,776,980,48.67087550474221,26.87254421717313
3719,/media/marda/TWOTB1/xBD/hurricanes/images/florence/hurricane-florence_00000412_pre_disaster.png,42,52,1,400,442,704,756,316,24.338628066757938,17.206821394287292
3720,/media/marda/TWOTB1/xBD/hurricanes/images/florence/hurricane-florence_00000412_pre_disaster.png,27,43,1,361,388,712,755,124,13.786389302006455,11.90034000699107
3721,/media/marda/TWOTB1/xBD/hurricanes/images/florence/hurricane-florence_00000412_pre_disaster.png,36,61,1,56,92,719,780,639,32.318894618759735,26.12068734692469
3722,/media/marda/TWOTB1/xBD/hurricanes/images/florence/hurricane-florence_00000412_pre_disaster.png,52,62,1,400,452,735,797,530,41.24130231652292,17.684487130045763
3723,/media/marda/TWOTB1/xBD/hurricanes/images/florence/hurricane-florence_00000412_pre_disaster.png,19,46,1,39,58,736,782,172,16.740792030829112,13.759389068369783
3724,/media/marda/TWOTB1/xBD/hurricanes/images/florence/hurricane-florence_00000412_pre_disaster.png,49,81,1,120,169,780,861,1264,51.71721609989442,34.84580154547946
3725,/media/marda/TWOTB1/xBD/hurricanes/images/florence/hurricane-florence_00000412_pre_disaster.png,20,51,1,52,72,813,864,189,17.187776556295784,14.751689226499726
3726,/media/marda/TWOTB1/xBD/hurricanes/images/florence/hurricane-florence_00000412_pre_disaster.png,53,87,1,55,108,819,906,1494,48.99498209041326,40.0959725799596
3727,/media/marda/TWOTB1/xBD/hurricanes/images/florence/hurricane-florence_00000412_pre_disaster.png,17,46,1,43,60,825,871,119,15.056838058972607,10.97348602861071
3728,/media/marda/TWOTB1/xBD/hurricanes/images/florence/hurricane-florence_00000430_pre_disaster.png,29,7,1,103,132,0,7,115,28.125140785796784,5.7280104898913065
3729,/media/marda/TWOTB1/xBD/hurricanes/images/florence/hurricane-florence_00000430_pre_disaster.png,37,46,1,43,80,24,70,1224,43.66621739233201,36.91377851875059
3730,/media/marda/TWOTB1/xBD/hurricanes/images/florence/hurricane-florence_00000430_pre_disaster.png,58,42,1,33,91,91,133,1384,66.27889008734752,31.217240181208012
3731,/media/marda/TWOTB1/xBD/hurricanes/images/florence/hurricane-florence_00000430_pre_disaster.png,49,53,1,25,74,159,212,1620,55.81149320462119,42.13441877823573
3732,/media/marda/TWOTB1/xBD/hurricanes/images/florence/hurricane-florence_00000430_pre_disaster.png,22,17,1,98,120,166,183,182,19.822087009413767,12.341328547617891
3733,/media/marda/TWOTB1/xBD/hurricanes/images/florence/hurricane-florence_00000430_pre_disaster.png,54,28,1,554,608,184,212,642,35.73903604185602,23.04510301455765
3734,/media/marda/TWOTB1/xBD/hurricanes/images/florence/hurricane-florence_00000430_pre_disaster.png,33,31,1,72,105,196,227,551,33.73022462334187,21.701255435185818
3735,/media/marda/TWOTB1/xBD/hurricanes/images/florence/hurricane-florence_00000430_pre_disaster.png,566,819,1,242,808,209,1028,232591,790.6125606399509,444.9633082252223
3736,/media/marda/TWOTB1/xBD/hurricanes/images/florence/hurricane-florence_00000430_pre_disaster.png,38,24,1,564,602,210,234,210,18.68871416642843,14.396761697897071
3737,/media/marda/TWOTB1/xBD/hurricanes/images/florence/hurricane-florence_00000430_pre_disaster.png,21,26,1,164,185,232,258,155,15.279327510028542,13.59567656988036
3738,/media/marda/TWOTB1/xBD/hurricanes/images/florence/hurricane-florence_00000430_pre_disaster.png,72,64,1,807,879,242,306,1385,56.86015240301273,32.18424039667841
3739,/media/marda/TWOTB1/xBD/hurricanes/images/florence/hurricane-florence_00000430_pre_disaster.png,60,53,1,929,989,402,455,518,38.644502448298994,17.928863024885654
3740,/media/marda/TWOTB1/xBD/hurricanes/images/florence/hurricane-florence_00000430_pre_disaster.png,8,42,1,0,8,430,472,113,25.103481417056752,6.849274843093243
3741,/media/marda/TWOTB1/xBD/hurricanes/images/florence/hurricane-florence_00000430_pre_disaster.png,17,28,1,89,106,437,465,129,15.891855356004536,10.687158351548472
3742,/media/marda/TWOTB1/xBD/hurricanes/images/florence/hurricane-florence_00000430_pre_disaster.png,46,72,1,79,125,452,524,1386,55.48760235636246,35.283864118706845
3743,/media/marda/TWOTB1/xBD/hurricanes/images/florence/hurricane-florence_00000430_pre_disaster.png,44,48,1,118,162,528,576,727,43.047216963790106,22.45273564317786
3744,/media/marda/TWOTB1/xBD/hurricanes/images/florence/hurricane-florence_00000430_pre_disaster.png,38,44,1,135,173,567,611,462,35.14710054448293,18.322731666097972
3745,/media/marda/TWOTB1/xBD/hurricanes/images/florence/hurricane-florence_00000430_pre_disaster.png,52,57,1,128,180,597,654,875,50.965599007313756,24.63056939752119
3746,/media/marda/TWOTB1/xBD/hurricanes/images/florence/hurricane-florence_00000430_pre_disaster.png,19,49,1,46,65,627,676,289,25.665885478370562,14.896644454562335
3747,/media/marda/TWOTB1/xBD/hurricanes/images/florence/hurricane-florence_00000430_pre_disaster.png,42,62,1,1,43,630,692,1098,43.52722143093421,33.70467022074068
3748,/media/marda/TWOTB1/xBD/hurricanes/images/florence/hurricane-florence_00000430_pre_disaster.png,40,57,1,164,204,673,730,633,39.302760460775744,22.132638555086576
3749,/media/marda/TWOTB1/xBD/hurricanes/images/florence/hurricane-florence_00000430_pre_disaster.png,38,75,1,95,133,697,772,1076,46.32958334813304,31.08903320174412
3750,/media/marda/TWOTB1/xBD/hurricanes/images/florence/hurricane-florence_00000430_pre_disaster.png,39,58,1,48,87,703,761,776,40.23792391051051,25.76452800926723
3751,/media/marda/TWOTB1/xBD/hurricanes/images/florence/hurricane-florence_00000430_pre_disaster.png,23,62,1,25,48,717,779,544,35.687649125110056,20.5646883225928
3752,/media/marda/TWOTB1/xBD/hurricanes/images/florence/hurricane-florence_00000430_pre_disaster.png,46,77,1,178,224,723,800,1051,52.29797415857055,32.740259860416444
3753,/media/marda/TWOTB1/xBD/hurricanes/images/florence/hurricane-florence_00000430_pre_disaster.png,21,44,1,117,138,748,792,189,17.014035390767116,14.926076707242533
3754,/media/marda/TWOTB1/xBD/hurricanes/images/florence/hurricane-florence_00000430_pre_disaster.png,90,55,1,625,715,770,825,1146,65.17548676779407,23.753620610666815
3755,/media/marda/TWOTB1/xBD/hurricanes/images/florence/hurricane-florence_00000430_pre_disaster.png,31,116,1,0,31,779,895,1541,91.18360166223026,23.094029013415764
3756,/media/marda/TWOTB1/xBD/hurricanes/images/florence/hurricane-florence_00000430_pre_disaster.png,48,78,1,174,222,788,866,1238,48.93010760732416,34.72311914510857
3757,/media/marda/TWOTB1/xBD/hurricanes/images/florence/hurricane-florence_00000430_pre_disaster.png,72,80,1,833,905,788,868,1184,52.14311382861527,31.366683933015015
3758,/media/marda/TWOTB1/xBD/hurricanes/images/florence/hurricane-florence_00000430_pre_disaster.png,59,58,1,113,172,805,863,853,60.29657995164621,18.931644968289422
3759,/media/marda/TWOTB1/xBD/hurricanes/images/florence/hurricane-florence_00000430_pre_disaster.png,51,54,1,751,802,833,887,383,23.1850841396091,21.113818635024227
3760,/media/marda/TWOTB1/xBD/hurricanes/images/florence/hurricane-florence_00000430_pre_disaster.png,54,96,1,221,275,837,933,1466,72.910031476365,28.652024640551943
3761,/media/marda/TWOTB1/xBD/hurricanes/images/florence/hurricane-florence_00000430_pre_disaster.png,42,60,1,186,228,847,907,631,36.47333644145937,23.110140393945695
3762,/media/marda/TWOTB1/xBD/hurricanes/images/florence/hurricane-florence_00000430_pre_disaster.png,40,49,1,687,727,861,910,140,16.743599635265586,11.27306858559668
3763,/media/marda/TWOTB1/xBD/hurricanes/images/florence/hurricane-florence_00000430_pre_disaster.png,27,60,1,112,139,865,925,426,27.796535108930787,20.30170598781749
3764,/media/marda/TWOTB1/xBD/hurricanes/images/florence/hurricane-florence_00000430_pre_disaster.png,43,63,1,191,234,883,946,728,37.43316018766969,25.843104567487288
3765,/media/marda/TWOTB1/xBD/hurricanes/images/florence/hurricane-florence_00000430_pre_disaster.png,30,51,1,343,373,886,937,164,17.938668543754506,12.315339439555002
3766,/media/marda/TWOTB1/xBD/hurricanes/images/florence/hurricane-florence_00000430_pre_disaster.png,34,109,1,16,50,888,997,1455,80.85642786539788,24.0205102443411
3767,/media/marda/TWOTB1/xBD/hurricanes/images/florence/hurricane-florence_00000430_pre_disaster.png,41,72,1,152,193,890,962,873,38.31002603279344,30.14593071663333
3768,/media/marda/TWOTB1/xBD/hurricanes/images/florence/hurricane-florence_00000430_pre_disaster.png,42,67,1,111,153,908,975,778,38.11516728988885,26.754871597097313
3769,/media/marda/TWOTB1/xBD/hurricanes/images/florence/hurricane-florence_00000430_pre_disaster.png,40,74,1,71,111,915,989,826,40.95502908813872,28.04069157386002
3770,/media/marda/TWOTB1/xBD/hurricanes/images/florence/hurricane-florence_00000430_pre_disaster.png,32,52,1,352,384,916,968,191,19.34017197798771,13.246603676806414
3771,/media/marda/TWOTB1/xBD/hurricanes/images/florence/hurricane-florence_00000430_pre_disaster.png,63,65,1,770,833,939,1004,674,31.277898648219413,28.502677038628143
3772,/media/marda/TWOTB1/xBD/hurricanes/images/florence/hurricane-florence_00000430_pre_disaster.png,65,62,1,783,848,982,1044,526,35.98370217563735,19.372391678651187
3773,/media/marda/TWOTB1/xBD/hurricanes/images/florence/hurricane-florence_00000446_pre_disaster.png,59,53,1,77,136,159,212,1731,62.315021138324504,39.392937186481646
3774,/media/marda/TWOTB1/xBD/hurricanes/images/florence/hurricane-florence_00000446_pre_disaster.png,63,32,1,981,1044,247,279,502,27.468760534825307,24.147070429643083
3775,/media/marda/TWOTB1/xBD/hurricanes/images/florence/hurricane-florence_00000446_pre_disaster.png,73,43,1,776,849,286,329,952,47.68605862383984,26.44276754746
3776,/media/marda/TWOTB1/xBD/hurricanes/images/florence/hurricane-florence_00000446_pre_disaster.png,44,35,1,757,801,341,376,314,24.49439706996072,17.0992148187527
3777,/media/marda/TWOTB1/xBD/hurricanes/images/florence/hurricane-florence_00000446_pre_disaster.png,55,32,1,757,812,376,408,433,28.6122046707406,20.2623131806075
3778,/media/marda/TWOTB1/xBD/hurricanes/images/florence/hurricane-florence_00000446_pre_disaster.png,58,39,1,749,807,420,459,578,32.55516825825895,23.743848959979207
3779,/media/marda/TWOTB1/xBD/hurricanes/images/florence/hurricane-florence_00000446_pre_disaster.png,66,57,1,611,677,823,880,710,43.24983316695316,22.537849072405383
3780,/media/marda/TWOTB1/xBD/hurricanes/images/florence/hurricane-florence_00000446_pre_disaster.png,56,46,1,557,613,825,871,399,38.41637016058757,13.80631186102633
3781,/media/marda/TWOTB1/xBD/hurricanes/images/florence/hurricane-florence_00000457_post_disaster.png,123,49,1,503,626,403,452,2897,113.5788821491544,33.934003022688884
3782,/media/marda/TWOTB1/xBD/hurricanes/images/florence/hurricane-florence_00000457_post_disaster.png,118,49,1,515,633,463,512,2868,110.34281688219116,34.673641040068986
3783,/media/marda/TWOTB1/xBD/hurricanes/images/florence/hurricane-florence_00000457_post_disaster.png,91,54,1,545,636,519,573,1995,76.5843702944869,34.53332782092853
3784,/media/marda/TWOTB1/xBD/hurricanes/images/florence/hurricane-florence_00000457_post_disaster.png,89,107,1,954,1043,898,1005,2245,76.87210422067626,41.08939848415013
3785,/media/marda/TWOTB1/xBD/hurricanes/images/florence/hurricane-florence_00000147_pre_disaster.png,73,43,1,721,794,0,43,1064,40.20730849485063,34.90107494442673
3786,/media/marda/TWOTB1/xBD/hurricanes/images/florence/hurricane-florence_00000147_pre_disaster.png,91,54,1,835,926,65,119,1563,49.25581134171603,43.14457906248148
3787,/media/marda/TWOTB1/xBD/hurricanes/images/florence/hurricane-florence_00000147_pre_disaster.png,64,37,1,760,824,101,138,556,30.665883903572606,24.254561569923805
3788,/media/marda/TWOTB1/xBD/hurricanes/images/florence/hurricane-florence_00000147_pre_disaster.png,59,30,1,816,875,141,171,349,23.402489850224814,19.917285057413707
3789,/media/marda/TWOTB1/xBD/hurricanes/images/florence/hurricane-florence_00000138_pre_disaster.png,10,38,1,60,70,760,798,62,9.724764784040628,8.688697602294345
3790,/media/marda/TWOTB1/xBD/hurricanes/images/florence/hurricane-florence_00000512_post_disaster.png,37,42,1,338,375,661,703,348,27.117424743606172,16.999856568198723
3791,/media/marda/TWOTB1/xBD/hurricanes/images/florence/hurricane-florence_00000512_post_disaster.png,49,53,1,342,391,697,750,695,40.752862125181814,22.786579438790625
3792,/media/marda/TWOTB1/xBD/hurricanes/images/florence/hurricane-florence_00000512_post_disaster.png,59,63,1,807,866,797,860,772,35.50314165687545,28.70555202809615
3793,/media/marda/TWOTB1/xBD/hurricanes/images/florence/hurricane-florence_00000512_post_disaster.png,71,69,1,587,658,804,873,1112,48.60170868917905,32.946301284795226
3794,/media/marda/TWOTB1/xBD/hurricanes/images/florence/hurricane-florence_00000512_post_disaster.png,69,54,1,572,641,871,925,793,53.14015717844191,19.949216892888696
3795,/media/marda/TWOTB1/xBD/hurricanes/images/florence/hurricane-florence_00000113_pre_disaster.png,79,40,1,787,866,5,45,745,55.24288324390725,20.788843267643113
3796,/media/marda/TWOTB1/xBD/hurricanes/images/florence/hurricane-florence_00000113_pre_disaster.png,27,19,1,363,390,27,46,217,21.36502148950535,13.579505908159453
3797,/media/marda/TWOTB1/xBD/hurricanes/images/florence/hurricane-florence_00000113_pre_disaster.png,60,41,1,297,357,67,108,1189,48.49508305432274,34.429741032234965
3798,/media/marda/TWOTB1/xBD/hurricanes/images/florence/hurricane-florence_00000113_pre_disaster.png,33,21,1,420,453,122,143,176,16.563737380455905,14.272565888765032
3799,/media/marda/TWOTB1/xBD/hurricanes/images/florence/hurricane-florence_00000113_pre_disaster.png,47,38,1,391,438,128,166,554,34.47365886771944,21.334750596807776
3800,/media/marda/TWOTB1/xBD/hurricanes/images/florence/hurricane-florence_00000113_pre_disaster.png,62,46,1,543,605,198,244,782,43.11987567475917,24.166000021010483
3801,/media/marda/TWOTB1/xBD/hurricanes/images/florence/hurricane-florence_00000113_pre_disaster.png,42,41,1,220,262,236,277,549,34.89754672732204,20.922023197524148
3802,/media/marda/TWOTB1/xBD/hurricanes/images/florence/hurricane-florence_00000113_pre_disaster.png,62,53,1,706,768,257,310,555,52.83286407703393,14.405719339690515
3803,/media/marda/TWOTB1/xBD/hurricanes/images/florence/hurricane-florence_00000113_pre_disaster.png,42,29,1,561,603,259,288,234,20.548309524429065,15.245774573793371
3804,/media/marda/TWOTB1/xBD/hurricanes/images/florence/hurricane-florence_00000113_pre_disaster.png,58,48,1,506,564,275,323,915,39.530890164522404,31.227654299999227
3805,/media/marda/TWOTB1/xBD/hurricanes/images/florence/hurricane-florence_00000113_pre_disaster.png,48,25,1,574,622,289,314,160,29.507349924681236,7.2330007896041435
3806,/media/marda/TWOTB1/xBD/hurricanes/images/florence/hurricane-florence_00000113_pre_disaster.png,45,26,1,716,761,307,333,103,17.51964615837076,7.931169765776567
3807,/media/marda/TWOTB1/xBD/hurricanes/images/florence/hurricane-florence_00000113_pre_disaster.png,40,28,1,522,562,341,369,188,19.95434050102058,12.638241779892885
3808,/media/marda/TWOTB1/xBD/hurricanes/images/florence/hurricane-florence_00000113_pre_disaster.png,27,24,1,423,450,353,377,107,13.102555717112551,10.98393849037789
3809,/media/marda/TWOTB1/xBD/hurricanes/images/florence/hurricane-florence_00000113_pre_disaster.png,51,29,1,796,847,354,383,158,17.019371264309065,12.432353036492326
3810,/media/marda/TWOTB1/xBD/hurricanes/images/florence/hurricane-florence_00000113_pre_disaster.png,44,51,1,409,453,379,430,856,39.59935929779875,28.436798105627105
3811,/media/marda/TWOTB1/xBD/hurricanes/images/florence/hurricane-florence_00000113_pre_disaster.png,45,41,1,365,410,417,458,288,35.186067780921114,10.99544173986187
3812,/media/marda/TWOTB1/xBD/hurricanes/images/florence/hurricane-florence_00000113_pre_disaster.png,28,36,1,405,433,451,487,175,19.22234066351027,12.274115580908894
3813,/media/marda/TWOTB1/xBD/hurricanes/images/florence/hurricane-florence_00000113_pre_disaster.png,73,61,1,850,923,457,518,839,52.56177292321713,21.29734925934253
3814,/media/marda/TWOTB1/xBD/hurricanes/images/florence/hurricane-florence_00000113_pre_disaster.png,58,43,1,875,933,503,546,272,20.672548120045843,17.728177332298632
3815,/media/marda/TWOTB1/xBD/hurricanes/images/florence/hurricane-florence_00000113_pre_disaster.png,43,63,1,560,603,757,820,681,37.93522117645778,23.812945995067516
3816,/media/marda/TWOTB1/xBD/hurricanes/images/florence/hurricane-florence_00000113_pre_disaster.png,51,74,1,773,824,829,903,832,45.773447497564725,24.251415214633095
3817,/media/marda/TWOTB1/xBD/hurricanes/images/florence/hurricane-florence_00000113_pre_disaster.png,42,65,1,565,607,841,906,659,35.35096158610834,24.90151932074068
3818,/media/marda/TWOTB1/xBD/hurricanes/images/florence/hurricane-florence_00000113_pre_disaster.png,38,84,1,564,602,954,1038,571,52.22891895173368,15.446260677669278
3819,/media/marda/TWOTB1/xBD/hurricanes/images/florence/hurricane-florence_00000113_pre_disaster.png,53,56,1,781,834,988,1044,349,25.463086292446338,18.15687762057085
3820,/media/marda/TWOTB1/xBD/hurricanes/images/florence/hurricane-florence_00000476_post_disaster.png,65,56,1,264,329,119,175,1639,62.450585696200314,37.12767458217762
3821,/media/marda/TWOTB1/xBD/hurricanes/images/florence/hurricane-florence_00000476_post_disaster.png,67,55,1,86,153,140,195,1573,65.4371608831429,37.38248045944768
3822,/media/marda/TWOTB1/xBD/hurricanes/images/florence/hurricane-florence_00000476_post_disaster.png,79,69,1,130,209,407,476,2059,67.2103034337999,42.68571851070546
3823,/media/marda/TWOTB1/xBD/hurricanes/images/florence/hurricane-florence_00000476_post_disaster.png,71,72,1,65,136,426,498,1976,62.5170125381507,45.265571381534485
3824,/media/marda/TWOTB1/xBD/hurricanes/images/florence/hurricane-florence_00000476_post_disaster.png,43,56,1,344,387,746,802,450,25.90166555496627,23.22202271040627
3825,/media/marda/TWOTB1/xBD/hurricanes/images/florence/hurricane-florence_00000476_post_disaster.png,55,85,1,189,244,844,929,1649,48.753638555161224,46.285378705306854
3826,/media/marda/TWOTB1/xBD/hurricanes/images/florence/hurricane-florence_00000476_post_disaster.png,50,86,1,68,118,881,967,1553,54.037372716782066,40.54182445256728
3827,/media/marda/TWOTB1/xBD/hurricanes/images/florence/hurricane-florence_00000476_post_disaster.png,55,95,1,20,75,891,986,1805,61.36472989147154,39.61671429126712
3828,/media/marda/TWOTB1/xBD/hurricanes/images/florence/hurricane-florence_00000535_pre_disaster.png,209,58,1,40,249,623,681,6296,234.36216261083095,35.76802579017676
3829,/media/marda/TWOTB1/xBD/hurricanes/images/florence/hurricane-florence_00000535_pre_disaster.png,17,43,1,9,26,683,726,298,20.890233637553298,19.049422910845475
3830,/media/marda/TWOTB1/xBD/hurricanes/images/florence/hurricane-florence_00000535_pre_disaster.png,11,41,1,16,27,701,742,113,13.1325679529402,11.573363323054615
3831,/media/marda/TWOTB1/xBD/hurricanes/images/florence/hurricane-florence_00000535_pre_disaster.png,34,61,1,2,36,736,797,995,37.75707988661667,35.201375301755235
3832,/media/marda/TWOTB1/xBD/hurricanes/images/florence/hurricane-florence_00000535_pre_disaster.png,23,46,1,37,60,778,824,261,23.633244322677495,14.65687552303179
3833,/media/marda/TWOTB1/xBD/hurricanes/images/florence/hurricane-florence_00000535_pre_disaster.png,94,79,1,608,702,809,888,2053,70.17845385357556,38.190816612224
3834,/media/marda/TWOTB1/xBD/hurricanes/images/florence/hurricane-florence_00000535_pre_disaster.png,56,70,1,62,118,817,887,1399,55.726151925788116,33.47894684231792
3835,/media/marda/TWOTB1/xBD/hurricanes/images/florence/hurricane-florence_00000535_pre_disaster.png,64,78,1,714,778,846,924,1483,50.380620160847805,39.29519489379324
3836,/media/marda/TWOTB1/xBD/hurricanes/images/florence/hurricane-florence_00000535_pre_disaster.png,41,52,1,700,741,873,925,239,22.004202980073288,14.4900849767989
3837,/media/marda/TWOTB1/xBD/hurricanes/images/florence/hurricane-florence_00000535_pre_disaster.png,60,67,1,597,657,880,947,860,36.00133450011335,33.73746296701245
3838,/media/marda/TWOTB1/xBD/hurricanes/images/florence/hurricane-florence_00000535_pre_disaster.png,78,75,1,366,444,909,984,1312,69.98737590673846,25.31761560801026
3839,/media/marda/TWOTB1/xBD/hurricanes/images/florence/hurricane-florence_00000535_pre_disaster.png,49,46,1,747,796,914,960,124,21.857052320362776,7.587900616718068
3840,/media/marda/TWOTB1/xBD/hurricanes/images/florence/hurricane-florence_00000535_pre_disaster.png,43,52,1,590,633,943,995,235,20.52799774246739,15.210204380166319
3841,/media/marda/TWOTB1/xBD/hurricanes/images/florence/hurricane-florence_00000535_pre_disaster.png,69,71,1,701,770,971,1042,1172,43.123560660473814,36.07672384112047
3842,/media/marda/TWOTB1/xBD/hurricanes/images/florence/hurricane-florence_00000535_pre_disaster.png,67,62,1,555,622,974,1036,903,51.45335824822454,23.73675156076047
3843,/media/marda/TWOTB1/xBD/hurricanes/images/florence/hurricane-florence_00000535_pre_disaster.png,44,53,1,643,687,976,1029,244,21.14877148288163,15.441320629973319
3844,/media/marda/TWOTB1/xBD/hurricanes/images/florence/hurricane-florence_00000515_post_disaster.png,168,83,1,875,1043,247,330,5969,153.3339091268803,51.50959023758227
3845,/media/marda/TWOTB1/xBD/hurricanes/images/florence/hurricane-florence_00000515_post_disaster.png,40,15,1,851,891,269,284,49,8.626666160938804,7.18295146259953
3846,/media/marda/TWOTB1/xBD/hurricanes/images/florence/hurricane-florence_00000515_post_disaster.png,154,88,1,889,1043,310,398,5348,133.99271085532047,53.072260467787885
3847,/media/marda/TWOTB1/xBD/hurricanes/images/florence/hurricane-florence_00000515_post_disaster.png,59,54,1,826,885,325,379,690,42.69907789812574,21.58024654923434
3848,/media/marda/TWOTB1/xBD/hurricanes/images/florence/hurricane-florence_00000515_post_disaster.png,41,19,1,866,907,326,345,51,8.876200207006525,7.29293672633238
3849,/media/marda/TWOTB1/xBD/hurricanes/images/florence/hurricane-florence_00000515_post_disaster.png,41,20,1,869,910,336,356,55,8.947498309020478,7.820155752512016
3850,/media/marda/TWOTB1/xBD/hurricanes/images/florence/hurricane-florence_00000515_post_disaster.png,42,19,1,882,924,387,406,48,8.32666399786453,7.301065371269836
3851,/media/marda/TWOTB1/xBD/hurricanes/images/florence/hurricane-florence_00000515_post_disaster.png,164,89,1,879,1043,388,477,5756,149.48031966851076,51.18615192402174
3852,/media/marda/TWOTB1/xBD/hurricanes/images/florence/hurricane-florence_00000515_post_disaster.png,43,23,1,876,919,404,427,54,9.280593078344006,7.402559677721735
3853,/media/marda/TWOTB1/xBD/hurricanes/images/florence/hurricane-florence_00000515_post_disaster.png,47,87,1,0,47,898,985,1342,54.98679338596379,31.81482889014737
3854,/media/marda/TWOTB1/xBD/hurricanes/images/florence/hurricane-florence_00000003_pre_disaster.png,79,63,1,548,627,176,239,2051,65.61559416052924,44.34020169602179
3855,/media/marda/TWOTB1/xBD/hurricanes/images/florence/hurricane-florence_00000003_pre_disaster.png,75,71,1,493,568,188,259,2114,63.30895210293345,45.52218850539659
3856,/media/marda/TWOTB1/xBD/hurricanes/images/florence/hurricane-florence_00000003_pre_disaster.png,79,61,1,608,687,208,269,1550,49.38214798057773,43.52356212195573
3857,/media/marda/TWOTB1/xBD/hurricanes/images/florence/hurricane-florence_00000003_pre_disaster.png,78,69,1,776,854,219,288,1979,62.04433602262911,44.31886862299222
3858,/media/marda/TWOTB1/xBD/hurricanes/images/florence/hurricane-florence_00000003_pre_disaster.png,80,52,1,824,904,225,277,1682,52.8039262490323,44.12139619756935
3859,/media/marda/TWOTB1/xBD/hurricanes/images/florence/hurricane-florence_00000003_pre_disaster.png,73,64,1,685,758,234,298,2021,61.590969248792845,46.62071234422569
3860,/media/marda/TWOTB1/xBD/hurricanes/images/florence/hurricane-florence_00000003_pre_disaster.png,92,67,1,879,971,236,303,1970,62.24398018485737,45.87405103890408
3861,/media/marda/TWOTB1/xBD/hurricanes/images/florence/hurricane-florence_00000003_pre_disaster.png,72,61,1,730,802,237,298,1982,56.612137327869796,47.08556971964669
3862,/media/marda/TWOTB1/xBD/hurricanes/images/florence/hurricane-florence_00000003_pre_disaster.png,78,51,1,479,557,257,308,1853,61.55730734102135,42.15293866754864
3863,/media/marda/TWOTB1/xBD/hurricanes/images/florence/hurricane-florence_00000003_pre_disaster.png,85,55,1,615,700,263,318,2139,63.11491043004657,46.91641548592318
3864,/media/marda/TWOTB1/xBD/hurricanes/images/florence/hurricane-florence_00000003_pre_disaster.png,97,57,1,887,984,299,356,2027,64.94887372933772,43.962479200107154
3865,/media/marda/TWOTB1/xBD/hurricanes/images/florence/hurricane-florence_00000003_pre_disaster.png,81,68,1,489,570,305,373,2006,55.05357174635638,50.97431591116389
3866,/media/marda/TWOTB1/xBD/hurricanes/images/florence/hurricane-florence_00000003_pre_disaster.png,77,77,1,453,530,336,413,2355,62.82643423267958,52.112287643491605
3867,/media/marda/TWOTB1/xBD/hurricanes/images/florence/hurricane-florence_00000003_pre_disaster.png,78,70,1,797,875,342,412,2020,62.51328611823795,45.111072549445026
3868,/media/marda/TWOTB1/xBD/hurricanes/images/florence/hurricane-florence_00000003_pre_disaster.png,86,65,1,845,931,342,407,1726,50.577844724972955,44.97409967761329
3869,/media/marda/TWOTB1/xBD/hurricanes/images/florence/hurricane-florence_00000003_pre_disaster.png,162,76,1,667,829,345,421,5529,151.67392007540434,55.71967567634914
3870,/media/marda/TWOTB1/xBD/hurricanes/images/florence/hurricane-florence_00000003_pre_disaster.png,78,76,1,605,683,354,430,2127,59.29102632515948,49.88560250245714
3871,/media/marda/TWOTB1/xBD/hurricanes/images/florence/hurricane-florence_00000003_pre_disaster.png,7,32,1,0,7,383,415,76,18.464399005426156,6.268864039762474
3872,/media/marda/TWOTB1/xBD/hurricanes/images/florence/hurricane-florence_00000003_pre_disaster.png,93,69,1,557,650,385,454,2071,64.20089333954066,44.63413982256324
3873,/media/marda/TWOTB1/xBD/hurricanes/images/florence/hurricane-florence_00000003_pre_disaster.png,103,114,1,510,613,418,532,3823,103.24784091390438,56.910079940710986
3874,/media/marda/TWOTB1/xBD/hurricanes/images/florence/hurricane-florence_00000003_pre_disaster.png,45,67,1,0,45,421,488,1674,49.686628194674014,45.08409508109334
3875,/media/marda/TWOTB1/xBD/hurricanes/images/florence/hurricane-florence_00000003_pre_disaster.png,24,59,1,0,24,476,535,598,40.90389316172746,19.979516903451128
3876,/media/marda/TWOTB1/xBD/hurricanes/images/florence/hurricane-florence_00000003_pre_disaster.png,88,78,1,496,584,505,583,2328,66.35757360975568,49.40548876149005
3877,/media/marda/TWOTB1/xBD/hurricanes/images/florence/hurricane-florence_00000003_pre_disaster.png,82,68,1,371,453,552,620,2197,69.88903691083091,45.04146058098572
3878,/media/marda/TWOTB1/xBD/hurricanes/images/florence/hurricane-florence_00000003_pre_disaster.png,84,83,1,960,1044,552,635,1787,58.87283418389893,42.04782035116288
3879,/media/marda/TWOTB1/xBD/hurricanes/images/florence/hurricane-florence_00000003_pre_disaster.png,90,118,1,483,573,562,680,4079,105.66522377538679,63.88875826063663
3880,/media/marda/TWOTB1/xBD/hurricanes/images/florence/hurricane-florence_00000003_pre_disaster.png,97,76,1,908,1005,585,661,1704,54.10040255540099,45.677094251680565
3881,/media/marda/TWOTB1/xBD/hurricanes/images/florence/hurricane-florence_00000003_pre_disaster.png,69,77,1,383,452,594,671,1835,57.36173427840319,43.676908042746625
3882,/media/marda/TWOTB1/xBD/hurricanes/images/florence/hurricane-florence_00000003_pre_disaster.png,92,75,1,865,957,607,682,1489,54.05220469445203,38.93514614350084
3883,/media/marda/TWOTB1/xBD/hurricanes/images/florence/hurricane-florence_00000003_pre_disaster.png,89,94,1,817,906,626,720,1982,63.36203020529237,45.37484333647673
3884,/media/marda/TWOTB1/xBD/hurricanes/images/florence/hurricane-florence_00000003_pre_disaster.png,68,73,1,399,467,641,714,1641,55.63218387465038,40.112656117197986
3885,/media/marda/TWOTB1/xBD/hurricanes/images/florence/hurricane-florence_00000003_pre_disaster.png,57,85,1,226,283,649,734,1743,55.54544557486169,44.58152260792608
3886,/media/marda/TWOTB1/xBD/hurricanes/images/florence/hurricane-florence_00000003_pre_disaster.png,85,73,1,792,877,682,755,1533,47.31112175675163,43.16419088659067
3887,/media/marda/TWOTB1/xBD/hurricanes/images/florence/hurricane-florence_00000003_pre_disaster.png,71,81,1,163,234,683,764,2074,61.525768042239356,48.061563065155084
3888,/media/marda/TWOTB1/xBD/hurricanes/images/florence/hurricane-florence_00000003_pre_disaster.png,79,77,1,285,364,684,761,1867,62.47124075815356,42.22365882468065
3889,/media/marda/TWOTB1/xBD/hurricanes/images/florence/hurricane-florence_00000003_pre_disaster.png,128,111,1,893,1021,685,796,3279,106.27298284527376,41.83113205775875
3890,/media/marda/TWOTB1/xBD/hurricanes/images/florence/hurricane-florence_00000003_pre_disaster.png,62,89,1,120,182,702,791,2064,56.441000659361855,49.006765159860166
3891,/media/marda/TWOTB1/xBD/hurricanes/images/florence/hurricane-florence_00000003_pre_disaster.png,83,84,1,757,840,706,790,1557,48.39518056777171,43.25711077863172
3892,/media/marda/TWOTB1/xBD/hurricanes/images/florence/hurricane-florence_00000003_pre_disaster.png,86,89,1,713,799,731,820,1795,51.357350775430035,48.012430945316815
3893,/media/marda/TWOTB1/xBD/hurricanes/images/florence/hurricane-florence_00000003_pre_disaster.png,81,74,1,310,391,741,815,1904,64.89046222133219,41.71928091792412
3894,/media/marda/TWOTB1/xBD/hurricanes/images/florence/hurricane-florence_00000003_pre_disaster.png,79,95,1,673,752,756,851,1982,61.89382529508514,43.50650225001686
3895,/media/marda/TWOTB1/xBD/hurricanes/images/florence/hurricane-florence_00000003_pre_disaster.png,89,80,1,856,945,758,838,1827,52.07556974247431,47.837515314493864
3896,/media/marda/TWOTB1/xBD/hurricanes/images/florence/hurricane-florence_00000003_pre_disaster.png,60,88,1,84,144,761,849,1855,57.44528223986195,47.674305176016475
3897,/media/marda/TWOTB1/xBD/hurricanes/images/florence/hurricane-florence_00000003_pre_disaster.png,59,89,1,261,320,806,895,1862,55.03434679830051,44.87467274596692
3898,/media/marda/TWOTB1/xBD/hurricanes/images/florence/hurricane-florence_00000003_pre_disaster.png,57,79,1,341,398,806,885,1752,51.72250349089745,45.65820151019894
3899,/media/marda/TWOTB1/xBD/hurricanes/images/florence/hurricane-florence_00000003_pre_disaster.png,100,124,1,873,973,808,932,3153,98.25557130208914,45.071179011861375
3900,/media/marda/TWOTB1/xBD/hurricanes/images/florence/hurricane-florence_00000003_pre_disaster.png,51,82,1,95,146,820,902,1612,50.899692236026084,44.81565834621746
3901,/media/marda/TWOTB1/xBD/hurricanes/images/florence/hurricane-florence_00000003_pre_disaster.png,87,85,1,740,827,845,930,1653,51.59427636152415,44.58950446492519
3902,/media/marda/TWOTB1/xBD/hurricanes/images/florence/hurricane-florence_00000003_pre_disaster.png,58,90,1,174,232,853,943,1701,50.08427177236314,45.642832346178736
3903,/media/marda/TWOTB1/xBD/hurricanes/images/florence/hurricane-florence_00000003_pre_disaster.png,56,99,1,48,104,869,968,2067,62.83562283707861,44.38111457584231
3904,/media/marda/TWOTB1/xBD/hurricanes/images/florence/hurricane-florence_00000003_pre_disaster.png,79,93,1,782,861,882,975,1453,52.79107001483805,38.775260569830024
3905,/media/marda/TWOTB1/xBD/hurricanes/images/florence/hurricane-florence_00000003_pre_disaster.png,73,89,1,835,908,892,981,1783,55.39962520454253,44.664354526206345
3906,/media/marda/TWOTB1/xBD/hurricanes/images/florence/hurricane-florence_00000003_pre_disaster.png,61,86,1,127,188,893,979,1566,51.68700164976247,41.79308262419661
3907,/media/marda/TWOTB1/xBD/hurricanes/images/florence/hurricane-florence_00000003_pre_disaster.png,60,103,1,351,411,911,1014,1956,67.74068854451693,41.34813483786029
3908,/media/marda/TWOTB1/xBD/hurricanes/images/florence/hurricane-florence_00000003_pre_disaster.png,60,95,1,402,462,912,1007,2105,61.73112466715475,47.2107744832111
3909,/media/marda/TWOTB1/xBD/hurricanes/images/florence/hurricane-florence_00000003_pre_disaster.png,53,75,1,30,83,934,1009,1333,53.69552285552702,35.62469938036513
3910,/media/marda/TWOTB1/xBD/hurricanes/images/florence/hurricane-florence_00000003_pre_disaster.png,65,92,1,295,360,936,1028,1917,51.29327471497038,50.4381168452381
3911,/media/marda/TWOTB1/xBD/hurricanes/images/florence/hurricane-florence_00000003_pre_disaster.png,62,94,1,236,298,937,1031,1679,51.75177229046214,43.64313707322642
3912,/media/marda/TWOTB1/xBD/hurricanes/images/florence/hurricane-florence_00000003_pre_disaster.png,83,84,1,649,732,958,1042,2186,58.278016017313504,50.07943968863532
3913,/media/marda/TWOTB1/xBD/hurricanes/images/florence/hurricane-florence_00000003_pre_disaster.png,55,59,1,61,116,985,1044,607,46.1727763748774,18.92252319956188
3914,/media/marda/TWOTB1/xBD/hurricanes/images/florence/hurricane-florence_00000427_pre_disaster.png,58,87,1,150,208,771,858,1833,59.78340971381779,41.58480525115622
3915,/media/marda/TWOTB1/xBD/hurricanes/images/florence/hurricane-florence_00000119_post_disaster.png,4,18,1,0,4,0,18,49,19.4210673850145,3.486151698273833
3916,/media/marda/TWOTB1/xBD/hurricanes/images/florence/hurricane-florence_00000119_post_disaster.png,7,13,1,0,7,63,76,49,11.45048093548742,6.510570449573432
3917,/media/marda/TWOTB1/xBD/hurricanes/images/florence/hurricane-florence_00000119_post_disaster.png,19,16,1,5,24,66,82,156,15.808876707322858,13.22109549056407
3918,/media/marda/TWOTB1/xBD/hurricanes/images/florence/hurricane-florence_00000119_post_disaster.png,12,17,1,46,58,70,87,137,17.49579009337517,10.545621462712466
3919,/media/marda/TWOTB1/xBD/hurricanes/images/florence/hurricane-florence_00000119_post_disaster.png,49,25,1,205,254,91,116,821,43.12016710716762,25.584711396262442
3920,/media/marda/TWOTB1/xBD/hurricanes/images/florence/hurricane-florence_00000119_post_disaster.png,27,30,1,14,41,104,134,637,29.542925137570645,28.435906114022096
3921,/media/marda/TWOTB1/xBD/hurricanes/images/florence/hurricane-florence_00000119_post_disaster.png,58,32,1,419,477,135,167,753,44.82348640759236,22.30568225778402
3922,/media/marda/TWOTB1/xBD/hurricanes/images/florence/hurricane-florence_00000119_post_disaster.png,47,23,1,533,580,165,188,355,26.807686301322477,17.55333212693422
3923,/media/marda/TWOTB1/xBD/hurricanes/images/florence/hurricane-florence_00000119_post_disaster.png,67,45,1,723,790,198,243,865,37.107822317178965,30.859664857301166
3924,/media/marda/TWOTB1/xBD/hurricanes/images/florence/hurricane-florence_00000119_post_disaster.png,71,43,1,899,970,284,327,782,33.12489155491074,31.53938522946187
3925,/media/marda/TWOTB1/xBD/hurricanes/images/florence/hurricane-florence_00000367_pre_disaster.png,93,87,1,14,107,22,109,3729,99.12985397534699,52.209809010326694
3926,/media/marda/TWOTB1/xBD/hurricanes/images/florence/hurricane-florence_00000367_pre_disaster.png,79,62,1,918,997,318,380,1472,48.05755315210138,39.72522514976224
3927,/media/marda/TWOTB1/xBD/hurricanes/images/florence/hurricane-florence_00000367_pre_disaster.png,51,53,1,196,247,368,421,904,41.676613488034505,28.62525829552783
3928,/media/marda/TWOTB1/xBD/hurricanes/images/florence/hurricane-florence_00000367_pre_disaster.png,73,60,1,915,988,384,444,1481,51.02494811487413,38.533559163305405
3929,/media/marda/TWOTB1/xBD/hurricanes/images/florence/hurricane-florence_00000367_pre_disaster.png,32,39,1,177,209,430,469,270,26.87409618674996,13.431862982154575
3930,/media/marda/TWOTB1/xBD/hurricanes/images/florence/hurricane-florence_00000367_pre_disaster.png,50,59,1,148,198,445,504,1021,42.50999862834024,32.06473947245327
3931,/media/marda/TWOTB1/xBD/hurricanes/images/florence/hurricane-florence_00000367_pre_disaster.png,32,52,1,163,195,495,547,393,35.178522956935424,14.931239644668068
3932,/media/marda/TWOTB1/xBD/hurricanes/images/florence/hurricane-florence_00000367_pre_disaster.png,90,87,1,571,661,511,598,2165,75.53545511206174,40.321535644264515
3933,/media/marda/TWOTB1/xBD/hurricanes/images/florence/hurricane-florence_00000367_pre_disaster.png,49,56,1,162,211,537,593,584,49.12775145683678,15.850637233553154
3934,/media/marda/TWOTB1/xBD/hurricanes/images/florence/hurricane-florence_00000367_pre_disaster.png,81,86,1,503,584,578,664,1963,67.61437330906493,38.489897304764554
3935,/media/marda/TWOTB1/xBD/hurricanes/images/florence/hurricane-florence_00000367_pre_disaster.png,72,57,1,894,966,620,677,891,39.45223060390899,29.617035300753134
3936,/media/marda/TWOTB1/xBD/hurricanes/images/florence/hurricane-florence_00000367_pre_disaster.png,73,68,1,940,1013,620,688,1102,47.38160308850308,31.124042819928267
3937,/media/marda/TWOTB1/xBD/hurricanes/images/florence/hurricane-florence_00000367_pre_disaster.png,78,78,1,560,638,630,708,1511,50.95720311204909,39.56510858209388
3938,/media/marda/TWOTB1/xBD/hurricanes/images/florence/hurricane-florence_00000367_pre_disaster.png,50,48,1,608,658,630,678,318,22.35305277381219,19.005566733872822
3939,/media/marda/TWOTB1/xBD/hurricanes/images/florence/hurricane-florence_00000367_pre_disaster.png,61,53,1,544,605,680,733,478,44.80966048578631,14.248058159188828
3940,/media/marda/TWOTB1/xBD/hurricanes/images/florence/hurricane-florence_00000367_pre_disaster.png,73,68,1,816,889,692,760,921,41.10239662395347,29.435749913060924
3941,/media/marda/TWOTB1/xBD/hurricanes/images/florence/hurricane-florence_00000367_pre_disaster.png,56,42,1,531,587,706,748,337,40.202771487222236,11.233625833417875
3942,/media/marda/TWOTB1/xBD/hurricanes/images/florence/hurricane-florence_00000367_pre_disaster.png,62,56,1,613,675,712,768,427,42.16189602720443,13.534551817686944
3943,/media/marda/TWOTB1/xBD/hurricanes/images/florence/hurricane-florence_00000367_pre_disaster.png,61,47,1,524,585,724,771,399,43.76020300006949,12.34237256237811
3944,/media/marda/TWOTB1/xBD/hurricanes/images/florence/hurricane-florence_00000367_pre_disaster.png,89,91,1,681,770,726,817,1856,63.744828108418616,41.883510009102906
3945,/media/marda/TWOTB1/xBD/hurricanes/images/florence/hurricane-florence_00000367_pre_disaster.png,58,71,1,582,640,727,798,829,38.32890368250493,29.30984983814445
3946,/media/marda/TWOTB1/xBD/hurricanes/images/florence/hurricane-florence_00000367_pre_disaster.png,54,58,1,656,710,750,808,465,25.15000365714553,24.69063704508249
3947,/media/marda/TWOTB1/xBD/hurricanes/images/florence/hurricane-florence_00000367_pre_disaster.png,50,47,1,967,1017,767,814,256,21.953390820634638,15.530944999265975
3948,/media/marda/TWOTB1/xBD/hurricanes/images/florence/hurricane-florence_00000367_pre_disaster.png,57,56,1,575,632,769,825,399,39.138368711220664,13.610276289730383
3949,/media/marda/TWOTB1/xBD/hurricanes/images/florence/hurricane-florence_00000367_pre_disaster.png,45,60,1,497,542,782,842,698,34.24570630225708,27.226801305423116
3950,/media/marda/TWOTB1/xBD/hurricanes/images/florence/hurricane-florence_00000367_pre_disaster.png,52,71,1,561,613,798,869,568,39.12913757840588,19.37629465896381
3951,/media/marda/TWOTB1/xBD/hurricanes/images/florence/hurricane-florence_00000367_pre_disaster.png,78,84,1,652,730,798,882,1412,48.077479166628464,40.41707245892261
3952,/media/marda/TWOTB1/xBD/hurricanes/images/florence/hurricane-florence_00000367_pre_disaster.png,78,88,1,779,857,807,895,1188,60.23890734984649,26.38188043670038
3953,/media/marda/TWOTB1/xBD/hurricanes/images/florence/hurricane-florence_00000367_pre_disaster.png,37,62,1,184,221,809,871,514,29.350458093666255,23.712609200280127
3954,/media/marda/TWOTB1/xBD/hurricanes/images/florence/hurricane-florence_00000367_pre_disaster.png,72,72,1,71,143,810,882,1441,75.47459068382899,25.315218769519273
3955,/media/marda/TWOTB1/xBD/hurricanes/images/florence/hurricane-florence_00000367_pre_disaster.png,46,63,1,626,672,812,875,344,31.2474753610895,17.322836980999195
3956,/media/marda/TWOTB1/xBD/hurricanes/images/florence/hurricane-florence_00000367_pre_disaster.png,57,52,1,483,540,818,870,396,42.30013794615477,12.515446347630016
3957,/media/marda/TWOTB1/xBD/hurricanes/images/florence/hurricane-florence_00000367_pre_disaster.png,38,44,1,625,663,840,884,99,13.56425491845788,9.83630792587812
3958,/media/marda/TWOTB1/xBD/hurricanes/images/florence/hurricane-florence_00000367_pre_disaster.png,70,58,1,453,523,844,902,555,56.69732968514373,14.119262414249992
3959,/media/marda/TWOTB1/xBD/hurricanes/images/florence/hurricane-florence_00000367_pre_disaster.png,59,62,1,541,600,845,907,485,43.99007013944619,14.719244791014052
3960,/media/marda/TWOTB1/xBD/hurricanes/images/florence/hurricane-florence_00000367_pre_disaster.png,60,74,1,635,695,867,941,812,39.57274040124598,27.383072705128665
3961,/media/marda/TWOTB1/xBD/hurricanes/images/florence/hurricane-florence_00000367_pre_disaster.png,79,75,1,839,918,871,946,979,38.320578230327094,34.085558066149524
3962,/media/marda/TWOTB1/xBD/hurricanes/images/florence/hurricane-florence_00000367_pre_disaster.png,62,54,1,444,506,872,926,575,51.73939138068181,14.860543448316854
3963,/media/marda/TWOTB1/xBD/hurricanes/images/florence/hurricane-florence_00000367_pre_disaster.png,63,55,1,517,580,873,928,564,47.385312075693555,15.77371732802129
3964,/media/marda/TWOTB1/xBD/hurricanes/images/florence/hurricane-florence_00000367_pre_disaster.png,66,74,1,747,813,878,952,873,39.52294886695262,29.485529091651344
3965,/media/marda/TWOTB1/xBD/hurricanes/images/florence/hurricane-florence_00000367_pre_disaster.png,63,65,1,425,488,892,957,838,51.29151509812637,21.74005239857405
3966,/media/marda/TWOTB1/xBD/hurricanes/images/florence/hurricane-florence_00000367_pre_disaster.png,64,78,1,574,638,921,999,1011,42.592941899239975,31.80609427304611
3967,/media/marda/TWOTB1/xBD/hurricanes/images/florence/hurricane-florence_00000367_pre_disaster.png,65,84,1,815,880,929,1013,895,48.81308706822948,24.41124752442148
3968,/media/marda/TWOTB1/xBD/hurricanes/images/florence/hurricane-florence_00000367_pre_disaster.png,66,82,1,714,780,934,1016,933,46.03222662689114,26.613726233415875
3969,/media/marda/TWOTB1/xBD/hurricanes/images/florence/hurricane-florence_00000367_pre_disaster.png,73,79,1,518,591,942,1021,1166,57.57754905868984,27.51094017564788
3970,/media/marda/TWOTB1/xBD/hurricanes/images/florence/hurricane-florence_00000367_pre_disaster.png,50,61,1,466,516,943,1004,395,33.331507641499684,15.760558676173966
3971,/media/marda/TWOTB1/xBD/hurricanes/images/florence/hurricane-florence_00000367_pre_disaster.png,73,78,1,939,1012,945,1023,717,43.1152723915044,22.270895381434418
3972,/media/marda/TWOTB1/xBD/hurricanes/images/florence/hurricane-florence_00000367_pre_disaster.png,41,58,1,432,473,961,1019,293,24.837368953954396,15.827441845070355
3973,/media/marda/TWOTB1/xBD/hurricanes/images/florence/hurricane-florence_00000367_pre_disaster.png,59,78,1,456,515,964,1042,1069,42.17726208536985,34.007277410618975
3974,/media/marda/TWOTB1/xBD/hurricanes/images/florence/hurricane-florence_00000367_pre_disaster.png,54,57,1,779,833,967,1024,275,24.175647064923677,15.057701900121028
3975,/media/marda/TWOTB1/xBD/hurricanes/images/florence/hurricane-florence_00000367_pre_disaster.png,37,57,1,412,449,974,1031,247,19.175244927115024,17.83444497616695
3976,/media/marda/TWOTB1/xBD/hurricanes/images/florence/hurricane-florence_00000367_pre_disaster.png,64,57,1,792,856,987,1044,325,30.122805415978743,15.380753893121932
3977,/media/marda/TWOTB1/xBD/hurricanes/images/florence/hurricane-florence_00000239_post_disaster.png,41,41,1,22,63,58,99,903,38.44875138570964,31.0989900553646
3978,/media/marda/TWOTB1/xBD/hurricanes/images/florence/hurricane-florence_00000239_post_disaster.png,52,50,1,489,541,125,175,1014,48.19674197645577,28.82772619191171
3979,/media/marda/TWOTB1/xBD/hurricanes/images/florence/hurricane-florence_00000239_post_disaster.png,47,49,1,244,291,197,246,1371,46.446631079958706,39.23647607577834
3980,/media/marda/TWOTB1/xBD/hurricanes/images/florence/hurricane-florence_00000239_post_disaster.png,53,51,1,210,263,356,407,1004,39.28234344860685,33.759775361698914
3981,/media/marda/TWOTB1/xBD/hurricanes/images/florence/hurricane-florence_00000239_post_disaster.png,68,70,1,306,374,658,728,1377,54.043350935945305,34.05460071057081
3982,/media/marda/TWOTB1/xBD/hurricanes/images/florence/hurricane-florence_00000239_post_disaster.png,45,63,1,301,346,694,757,641,31.14394048150971,27.27402664011868
3983,/media/marda/TWOTB1/xBD/hurricanes/images/florence/hurricane-florence_00000022_pre_disaster.png,63,12,1,981,1044,0,12,244,26.376611555786962,13.162953479053371
3984,/media/marda/TWOTB1/xBD/hurricanes/images/florence/hurricane-florence_00000022_pre_disaster.png,54,20,1,990,1044,68,88,222,21.03702990654761,14.194367123792595
3985,/media/marda/TWOTB1/xBD/hurricanes/images/florence/hurricane-florence_00000022_pre_disaster.png,50,10,1,991,1041,94,104,60,10.789137896728366,7.513769072017188
3986,/media/marda/TWOTB1/xBD/hurricanes/images/florence/hurricane-florence_00000022_pre_disaster.png,70,72,1,695,765,869,941,974,39.23786751285541,32.724015478297545
3987,/media/marda/TWOTB1/xBD/hurricanes/images/florence/hurricane-florence_00000022_pre_disaster.png,77,114,1,529,606,882,996,1996,86.76525922190174,44.59153667568051
3988,/media/marda/TWOTB1/xBD/hurricanes/images/florence/hurricane-florence_00000022_pre_disaster.png,48,59,1,532,580,972,1031,350,27.51531603835722,16.997611946410313
3989,/media/marda/TWOTB1/xBD/hurricanes/images/florence/hurricane-florence_00000217_post_disaster.png,93,93,1,284,377,0,93,5031,95.67161170938118,69.89792508414119
3990,/media/marda/TWOTB1/xBD/hurricanes/images/florence/hurricane-florence_00000217_post_disaster.png,154,55,1,352,506,0,55,4907,153.25380070498198,50.90633001482434
3991,/media/marda/TWOTB1/xBD/hurricanes/images/florence/hurricane-florence_00000217_post_disaster.png,90,16,1,531,621,0,16,574,61.49038950136333,14.132499459854618
3992,/media/marda/TWOTB1/xBD/hurricanes/images/florence/hurricane-florence_00000217_post_disaster.png,58,17,1,615,673,0,17,444,35.09903809010381,17.216998222315496
3993,/media/marda/TWOTB1/xBD/hurricanes/images/florence/hurricane-florence_00000217_post_disaster.png,75,31,1,729,804,0,31,859,49.92454987951102,27.17370987894402
3994,/media/marda/TWOTB1/xBD/hurricanes/images/florence/hurricane-florence_00000217_post_disaster.png,85,52,1,910,995,6,58,1650,48.39878335214184,44.66440231468387
3995,/media/marda/TWOTB1/xBD/hurricanes/images/florence/hurricane-florence_00000217_post_disaster.png,61,19,1,971,1032,7,26,310,23.058964696814574,17.6869372002982
3996,/media/marda/TWOTB1/xBD/hurricanes/images/florence/hurricane-florence_00000217_post_disaster.png,63,63,1,367,430,30,93,1984,64.44174236013218,44.640648863747494
3997,/media/marda/TWOTB1/xBD/hurricanes/images/florence/hurricane-florence_00000217_post_disaster.png,60,71,1,465,525,50,121,1716,74.86680966081991,30.500926935994876
3998,/media/marda/TWOTB1/xBD/hurricanes/images/florence/hurricane-florence_00000217_post_disaster.png,70,25,1,699,769,56,81,615,45.52743730674944,18.08710110244807
3999,/media/marda/TWOTB1/xBD/hurricanes/images/florence/hurricane-florence_00000217_post_disaster.png,49,31,1,607,656,60,91,559,32.16187011357119,22.93441087714569
4000,/media/marda/TWOTB1/xBD/hurricanes/images/florence/hurricane-florence_00000217_post_disaster.png,38,65,1,175,213,65,130,1126,67.99264189653574,21.785168657152713
4001,/media/marda/TWOTB1/xBD/hurricanes/images/florence/hurricane-florence_00000217_post_disaster.png,53,32,1,247,300,67,99,761,46.14426479311718,26.9866113624241
4002,/media/marda/TWOTB1/xBD/hurricanes/images/florence/hurricane-florence_00000217_post_disaster.png,79,35,1,549,628,67,102,1252,62.50711282583782,26.416040709414247
4003,/media/marda/TWOTB1/xBD/hurricanes/images/florence/hurricane-florence_00000217_post_disaster.png,78,35,1,730,808,67,102,1080,52.323551496210094,27.267697314737465
4004,/media/marda/TWOTB1/xBD/hurricanes/images/florence/hurricane-florence_00000217_post_disaster.png,76,51,1,8,84,69,120,1943,84.4495131098614,32.17095131501723
4005,/media/marda/TWOTB1/xBD/hurricanes/images/florence/hurricane-florence_00000217_post_disaster.png,15,40,1,0,15,89,129,362,40.18214111058165,13.105437214392772
4006,/media/marda/TWOTB1/xBD/hurricanes/images/florence/hurricane-florence_00000217_post_disaster.png,81,62,1,3,84,102,164,1965,90.51223265143712,32.399629462956305
4007,/media/marda/TWOTB1/xBD/hurricanes/images/florence/hurricane-florence_00000217_post_disaster.png,59,53,1,320,379,109,162,1531,45.779353069700996,44.62469489583177
4008,/media/marda/TWOTB1/xBD/hurricanes/images/florence/hurricane-florence_00000217_post_disaster.png,92,64,1,560,652,109,173,2830,72.03426608452503,52.55628619252347
4009,/media/marda/TWOTB1/xBD/hurricanes/images/florence/hurricane-florence_00000217_post_disaster.png,97,58,1,438,535,114,172,2107,78.63257738517176,43.614401195355185
4010,/media/marda/TWOTB1/xBD/hurricanes/images/florence/hurricane-florence_00000217_post_disaster.png,59,54,1,275,334,120,174,1631,47.440587277597444,45.877899029709035
4011,/media/marda/TWOTB1/xBD/hurricanes/images/florence/hurricane-florence_00000217_post_disaster.png,53,32,1,490,543,161,193,666,36.22629182834195,24.137583302710997
4012,/media/marda/TWOTB1/xBD/hurricanes/images/florence/hurricane-florence_00000217_post_disaster.png,25,28,1,43,68,164,192,434,25.023575959908975,22.719995303275983
4013,/media/marda/TWOTB1/xBD/hurricanes/images/florence/hurricane-florence_00000217_post_disaster.png,71,32,1,576,647,167,199,766,53.75846421417671,18.827066968171206
4014,/media/marda/TWOTB1/xBD/hurricanes/images/florence/hurricane-florence_00000217_post_disaster.png,59,41,1,715,774,179,220,725,35.831935708193846,27.01428754934379
4015,/media/marda/TWOTB1/xBD/hurricanes/images/florence/hurricane-florence_00000217_post_disaster.png,15,18,1,63,78,183,201,140,14.109182037822846,13.294174056940513
4016,/media/marda/TWOTB1/xBD/hurricanes/images/florence/hurricane-florence_00000217_post_disaster.png,76,62,1,588,664,195,257,2059,56.88059903180813,48.886279009310584
4017,/media/marda/TWOTB1/xBD/hurricanes/images/florence/hurricane-florence_00000217_post_disaster.png,55,57,1,380,435,216,273,1269,49.05171837256444,34.5228562270843
4018,/media/marda/TWOTB1/xBD/hurricanes/images/florence/hurricane-florence_00000217_post_disaster.png,81,43,1,948,1029,216,259,1237,45.7728278484551,35.30972810381816
4019,/media/marda/TWOTB1/xBD/hurricanes/images/florence/hurricane-florence_00000217_post_disaster.png,69,81,1,293,362,222,303,2884,70.20033265850294,55.559983662330275
4020,/media/marda/TWOTB1/xBD/hurricanes/images/florence/hurricane-florence_00000217_post_disaster.png,89,92,1,37,126,225,317,4059,82.22875896112586,74.06773029061301
4021,/media/marda/TWOTB1/xBD/hurricanes/images/florence/hurricane-florence_00000217_post_disaster.png,52,44,1,480,532,230,274,817,36.91716721204603,30.01334220463229
4022,/media/marda/TWOTB1/xBD/hurricanes/images/florence/hurricane-florence_00000217_post_disaster.png,29,23,1,435,464,236,259,119,13.792418785151163,11.587712480522065
4023,/media/marda/TWOTB1/xBD/hurricanes/images/florence/hurricane-florence_00000217_post_disaster.png,80,82,1,765,845,253,335,2067,79.27083886930684,34.96087658003822
4024,/media/marda/TWOTB1/xBD/hurricanes/images/florence/hurricane-florence_00000217_post_disaster.png,47,50,1,305,352,291,341,962,39.58145910643674,32.44317577329685
4025,/media/marda/TWOTB1/xBD/hurricanes/images/florence/hurricane-florence_00000217_post_disaster.png,72,58,1,507,579,303,361,1562,48.74896886891199,42.47169481421694
4026,/media/marda/TWOTB1/xBD/hurricanes/images/florence/hurricane-florence_00000217_post_disaster.png,53,41,1,743,796,306,347,491,27.581138466299937,23.7717795192911
4027,/media/marda/TWOTB1/xBD/hurricanes/images/florence/hurricane-florence_00000217_post_disaster.png,54,61,1,621,675,313,374,803,52.80647611067689,20.30420485596175
4028,/media/marda/TWOTB1/xBD/hurricanes/images/florence/hurricane-florence_00000217_post_disaster.png,84,56,1,812,896,346,402,1500,53.405062989758655,37.09250874883139
4029,/media/marda/TWOTB1/xBD/hurricanes/images/florence/hurricane-florence_00000217_post_disaster.png,58,45,1,524,582,359,404,776,38.568367847022806,27.03563284091804
4030,/media/marda/TWOTB1/xBD/hurricanes/images/florence/hurricane-florence_00000217_post_disaster.png,96,136,1,345,441,393,529,3997,150.51519646945314,41.384694840439934
4031,/media/marda/TWOTB1/xBD/hurricanes/images/florence/hurricane-florence_00000217_post_disaster.png,54,50,1,656,710,402,452,701,32.53361103759055,28.499682396715425
4032,/media/marda/TWOTB1/xBD/hurricanes/images/florence/hurricane-florence_00000217_post_disaster.png,75,68,1,111,186,411,479,2344,76.29135022482437,41.027750977301636
4033,/media/marda/TWOTB1/xBD/hurricanes/images/florence/hurricane-florence_00000217_post_disaster.png,74,55,1,539,613,420,475,1337,52.208279417563865,34.548389549341834
4034,/media/marda/TWOTB1/xBD/hurricanes/images/florence/hurricane-florence_00000217_post_disaster.png,61,49,1,736,797,432,481,683,31.167565119529907,29.46334690262831
4035,/media/marda/TWOTB1/xBD/hurricanes/images/florence/hurricane-florence_00000217_post_disaster.png,82,59,1,660,742,434,493,1352,59.63716100650278,30.843002126484738
4036,/media/marda/TWOTB1/xBD/hurricanes/images/florence/hurricane-florence_00000217_post_disaster.png,50,53,1,480,530,454,507,722,34.38287829325265,28.053183690526513
4037,/media/marda/TWOTB1/xBD/hurricanes/images/florence/hurricane-florence_00000217_post_disaster.png,39,54,1,18,57,461,515,1002,40.20168590654778,32.89239385387021
4038,/media/marda/TWOTB1/xBD/hurricanes/images/florence/hurricane-florence_00000217_post_disaster.png,78,54,1,544,622,470,524,1274,60.00945858816637,28.43003568242887
4039,/media/marda/TWOTB1/xBD/hurricanes/images/florence/hurricane-florence_00000217_post_disaster.png,16,41,1,0,16,480,521,277,23.864416564201854,15.7636585982527
4040,/media/marda/TWOTB1/xBD/hurricanes/images/florence/hurricane-florence_00000217_post_disaster.png,48,39,1,493,541,487,526,446,28.95017742602206,20.362034221646933
4041,/media/marda/TWOTB1/xBD/hurricanes/images/florence/hurricane-florence_00000217_post_disaster.png,63,53,1,567,630,507,560,863,39.38619640940973,29.179595708422053
4042,/media/marda/TWOTB1/xBD/hurricanes/images/florence/hurricane-florence_00000217_post_disaster.png,73,56,1,678,751,507,563,1097,49.0420600574115,29.779535701640384
4043,/media/marda/TWOTB1/xBD/hurricanes/images/florence/hurricane-florence_00000217_post_disaster.png,48,36,1,395,443,508,544,300,34.76967873770306,11.556859263332534
4044,/media/marda/TWOTB1/xBD/hurricanes/images/florence/hurricane-florence_00000217_post_disaster.png,43,41,1,530,573,514,555,347,22.28877056512922,20.566673662270535
4045,/media/marda/TWOTB1/xBD/hurricanes/images/florence/hurricane-florence_00000217_post_disaster.png,55,50,1,696,751,554,604,588,29.152622821425783,26.803682867242784
4046,/media/marda/TWOTB1/xBD/hurricanes/images/florence/hurricane-florence_00000217_post_disaster.png,42,38,1,729,771,560,598,156,17.26293946128869,12.103873002832703
4047,/media/marda/TWOTB1/xBD/hurricanes/images/florence/hurricane-florence_00000217_post_disaster.png,57,73,1,583,640,565,638,1181,54.76625814096025,28.793918657042482
4048,/media/marda/TWOTB1/xBD/hurricanes/images/florence/hurricane-florence_00000217_post_disaster.png,105,70,1,108,213,573,643,2545,111.02361056887949,30.37862581406331
4049,/media/marda/TWOTB1/xBD/hurricanes/images/florence/hurricane-florence_00000217_post_disaster.png,20,40,1,124,144,637,677,174,16.45315970105202,13.946743792748801
4050,/media/marda/TWOTB1/xBD/hurricanes/images/florence/hurricane-florence_00000217_post_disaster.png,77,68,1,591,668,652,720,1374,60.91262645354499,32.46463278696095
4051,/media/marda/TWOTB1/xBD/hurricanes/images/florence/hurricane-florence_00000217_post_disaster.png,114,70,1,722,836,670,740,2318,91.38408867139475,33.49857771998715
4052,/media/marda/TWOTB1/xBD/hurricanes/images/florence/hurricane-florence_00000217_post_disaster.png,38,48,1,526,564,678,726,288,25.43763326234242,14.990143391145853
4053,/media/marda/TWOTB1/xBD/hurricanes/images/florence/hurricane-florence_00000217_post_disaster.png,91,66,1,868,959,680,746,1460,58.84407399498427,33.10800575099227
4054,/media/marda/TWOTB1/xBD/hurricanes/images/florence/hurricane-florence_00000217_post_disaster.png,105,73,1,139,244,683,756,2529,109.98439814342618,30.442442029323125
4055,/media/marda/TWOTB1/xBD/hurricanes/images/florence/hurricane-florence_00000217_post_disaster.png,86,79,1,434,520,694,773,2004,71.31630461077776,39.940532717884814
4056,/media/marda/TWOTB1/xBD/hurricanes/images/florence/hurricane-florence_00000217_post_disaster.png,25,44,1,12,37,699,743,251,27.284357063532063,12.090190532340646
4057,/media/marda/TWOTB1/xBD/hurricanes/images/florence/hurricane-florence_00000217_post_disaster.png,58,67,1,20,78,720,787,1208,61.11033964111502,27.348528819892536
4058,/media/marda/TWOTB1/xBD/hurricanes/images/florence/hurricane-florence_00000217_post_disaster.png,58,64,1,840,898,734,798,670,36.322781013452406,24.732770638358982
4059,/media/marda/TWOTB1/xBD/hurricanes/images/florence/hurricane-florence_00000217_post_disaster.png,74,67,1,494,568,740,807,1084,49.909201290438666,33.91208864410408
4060,/media/marda/TWOTB1/xBD/hurricanes/images/florence/hurricane-florence_00000217_post_disaster.png,38,70,1,232,270,776,846,782,43.8472278986528,23.789122076410784
4061,/media/marda/TWOTB1/xBD/hurricanes/images/florence/hurricane-florence_00000217_post_disaster.png,25,42,1,216,241,783,825,147,18.114393014302944,10.929913488349547
4062,/media/marda/TWOTB1/xBD/hurricanes/images/florence/hurricane-florence_00000217_post_disaster.png,98,84,1,780,878,801,885,2203,70.59510481950724,40.956711228146915
4063,/media/marda/TWOTB1/xBD/hurricanes/images/florence/hurricane-florence_00000217_post_disaster.png,39,74,1,99,138,819,893,938,41.01612041127148,30.388413756870264
4064,/media/marda/TWOTB1/xBD/hurricanes/images/florence/hurricane-florence_00000217_post_disaster.png,35,85,1,43,78,839,924,1149,56.14315324555576,27.22008387455146
4065,/media/marda/TWOTB1/xBD/hurricanes/images/florence/hurricane-florence_00000217_post_disaster.png,31,57,1,252,283,839,896,386,23.461810964441177,22.00381617482305
4066,/media/marda/TWOTB1/xBD/hurricanes/images/florence/hurricane-florence_00000217_post_disaster.png,72,94,1,665,737,860,954,1851,61.65142235989459,39.47807809748949
4067,/media/marda/TWOTB1/xBD/hurricanes/images/florence/hurricane-florence_00000217_post_disaster.png,91,87,1,894,985,868,955,2050,53.39358024532674,50.92335537640548
4068,/media/marda/TWOTB1/xBD/hurricanes/images/florence/hurricane-florence_00000217_post_disaster.png,33,63,1,264,297,887,950,548,29.020393305672176,24.839652002883092
4069,/media/marda/TWOTB1/xBD/hurricanes/images/florence/hurricane-florence_00000217_post_disaster.png,80,71,1,486,566,896,967,1468,64.3043486653678,30.2010789965767
4070,/media/marda/TWOTB1/xBD/hurricanes/images/florence/hurricane-florence_00000217_post_disaster.png,111,90,1,807,918,920,1010,2702,78.50308622004921,45.43268985299531
4071,/media/marda/TWOTB1/xBD/hurricanes/images/florence/hurricane-florence_00000217_post_disaster.png,64,73,1,272,336,946,1019,1265,52.685432039530326,31.673639079943683
4072,/media/marda/TWOTB1/xBD/hurricanes/images/florence/hurricane-florence_00000217_post_disaster.png,63,60,1,807,870,974,1034,464,31.852325718765442,19.30631362611852
4073,/media/marda/TWOTB1/xBD/hurricanes/images/florence/hurricane-florence_00000217_post_disaster.png,56,61,1,289,345,980,1041,848,45.59593039407812,25.09574372493266
4074,/media/marda/TWOTB1/xBD/hurricanes/images/florence/hurricane-florence_00000372_post_disaster.png,61,83,1,506,567,281,364,1320,70.05634267326732,31.265847977889678
4075,/media/marda/TWOTB1/xBD/hurricanes/images/florence/hurricane-florence_00000372_post_disaster.png,49,47,1,512,561,369,416,384,40.59705664038184,12.638266508191423
4076,/media/marda/TWOTB1/xBD/hurricanes/images/florence/hurricane-florence_00000372_post_disaster.png,67,55,1,681,748,401,456,909,36.006654790987945,33.33308279482198
4077,/media/marda/TWOTB1/xBD/hurricanes/images/florence/hurricane-florence_00000372_post_disaster.png,61,54,1,510,571,436,490,810,37.05463686303285,29.13242115834176
4078,/media/marda/TWOTB1/xBD/hurricanes/images/florence/hurricane-florence_00000372_post_disaster.png,66,75,1,397,463,451,526,1393,61.71718506379366,29.88738162411868
4079,/media/marda/TWOTB1/xBD/hurricanes/images/florence/hurricane-florence_00000372_post_disaster.png,63,56,1,691,754,455,511,701,38.11650533391787,24.670369887011255
4080,/media/marda/TWOTB1/xBD/hurricanes/images/florence/hurricane-florence_00000372_post_disaster.png,85,63,1,767,852,497,560,1055,56.81344947211678,24.81209058917389
4081,/media/marda/TWOTB1/xBD/hurricanes/images/florence/hurricane-florence_00000372_post_disaster.png,60,47,1,784,844,553,600,397,23.675308771406584,22.37010061023263
4082,/media/marda/TWOTB1/xBD/hurricanes/images/florence/hurricane-florence_00000372_post_disaster.png,83,64,1,950,1033,582,646,1176,44.62740442296859,37.744062050475875
4083,/media/marda/TWOTB1/xBD/hurricanes/images/florence/hurricane-florence_00000372_post_disaster.png,34,43,1,335,369,587,630,353,23.65965825957858,19.981565294199722
4084,/media/marda/TWOTB1/xBD/hurricanes/images/florence/hurricane-florence_00000372_post_disaster.png,70,87,1,262,332,616,703,2089,64.18597644586842,45.677771581865635
4085,/media/marda/TWOTB1/xBD/hurricanes/images/florence/hurricane-florence_00000372_post_disaster.png,48,36,1,919,967,627,663,71,10.640750135961955,9.160582595072286
4086,/media/marda/TWOTB1/xBD/hurricanes/images/florence/hurricane-florence_00000372_post_disaster.png,64,52,1,883,947,630,682,466,25.47587950377471,24.276458799196174
4087,/media/marda/TWOTB1/xBD/hurricanes/images/florence/hurricane-florence_00000372_post_disaster.png,44,35,1,849,893,640,675,98,12.23074930052323,10.199906502706389
4088,/media/marda/TWOTB1/xBD/hurricanes/images/florence/hurricane-florence_00000372_post_disaster.png,48,60,1,333,381,652,712,677,31.487144118514056,28.694797859784384
4089,/media/marda/TWOTB1/xBD/hurricanes/images/florence/hurricane-florence_00000372_post_disaster.png,47,39,1,862,909,653,692,181,15.646943399937772,14.748392902063344
4090,/media/marda/TWOTB1/xBD/hurricanes/images/florence/hurricane-florence_00000372_post_disaster.png,48,37,1,900,948,654,691,82,11.27127700223532,9.752161616908111
4091,/media/marda/TWOTB1/xBD/hurricanes/images/florence/hurricane-florence_00000372_post_disaster.png,47,35,1,887,934,669,704,91,11.11542739575001,10.430625872619457
4092,/media/marda/TWOTB1/xBD/hurricanes/images/florence/hurricane-florence_00000372_post_disaster.png,33,37,1,500,533,687,724,133,13.428789240302951,12.624820341082767
4093,/media/marda/TWOTB1/xBD/hurricanes/images/florence/hurricane-florence_00000372_post_disaster.png,32,43,1,406,438,712,755,116,15.381265870160277,10.149032817367099
4094,/media/marda/TWOTB1/xBD/hurricanes/images/florence/hurricane-florence_00000372_post_disaster.png,30,38,1,470,500,735,773,73,13.093188818647922,7.468669011614971
4095,/media/marda/TWOTB1/xBD/hurricanes/images/florence/hurricane-florence_00000372_post_disaster.png,50,56,1,454,504,761,817,554,32.97935001972651,22.360488639399055
4096,/media/marda/TWOTB1/xBD/hurricanes/images/florence/hurricane-florence_00000372_post_disaster.png,31,46,1,271,302,775,821,186,23.881443985120296,10.445931906757554
4097,/media/marda/TWOTB1/xBD/hurricanes/images/florence/hurricane-florence_00000372_post_disaster.png,69,74,1,192,261,777,851,1434,57.61217986850077,38.87175977413057
4098,/media/marda/TWOTB1/xBD/hurricanes/images/florence/hurricane-florence_00000372_post_disaster.png,30,52,1,262,292,784,836,268,20.271468236629158,17.788160555553137
4099,/media/marda/TWOTB1/xBD/hurricanes/images/florence/hurricane-florence_00000372_post_disaster.png,36,50,1,572,608,797,847,149,17.200789416972633,11.591840261317383
4100,/media/marda/TWOTB1/xBD/hurricanes/images/florence/hurricane-florence_00000372_post_disaster.png,79,74,1,943,1022,806,880,698,50.54604124496744,20.444425198895225
4101,/media/marda/TWOTB1/xBD/hurricanes/images/florence/hurricane-florence_00000372_post_disaster.png,50,44,1,907,957,825,869,89,13.428868534410414,8.763139865273665
4102,/media/marda/TWOTB1/xBD/hurricanes/images/florence/hurricane-florence_00000372_post_disaster.png,56,75,1,345,401,882,957,825,45.83656075007167,23.928135937056457
4103,/media/marda/TWOTB1/xBD/hurricanes/images/florence/hurricane-florence_00000372_post_disaster.png,54,93,1,114,168,895,988,1348,62.31382832352051,28.734357871882843
4104,/media/marda/TWOTB1/xBD/hurricanes/images/florence/hurricane-florence_00000372_post_disaster.png,33,58,1,199,232,897,955,297,25.383534537299905,15.444167956856178
4105,/media/marda/TWOTB1/xBD/hurricanes/images/florence/hurricane-florence_00000372_post_disaster.png,29,52,1,339,368,969,1021,133,15.34467112763328,11.640202565500505
4106,/media/marda/TWOTB1/xBD/hurricanes/images/florence/hurricane-florence_00000372_post_disaster.png,34,62,1,358,392,980,1042,176,26.944018730930367,9.078697439019383
4107,/media/marda/TWOTB1/xBD/hurricanes/images/florence/hurricane-florence_00000223_post_disaster.png,89,61,1,426,515,0,61,3493,71.50666338507736,66.14249334431085
4108,/media/marda/TWOTB1/xBD/hurricanes/images/florence/hurricane-florence_00000223_post_disaster.png,44,32,1,109,153,22,54,835,40.42143588231097,27.40338179805443
4109,/media/marda/TWOTB1/xBD/hurricanes/images/florence/hurricane-florence_00000223_post_disaster.png,51,87,1,53,104,67,154,2578,97.46561833828665,35.94291549642129
4110,/media/marda/TWOTB1/xBD/hurricanes/images/florence/hurricane-florence_00000223_post_disaster.png,100,66,1,427,527,144,210,4555,91.9749933019247,66.07622534756327
4111,/media/marda/TWOTB1/xBD/hurricanes/images/florence/hurricane-florence_00000223_post_disaster.png,100,68,1,117,217,177,245,4085,97.0123901440652,58.00150972064896
4112,/media/marda/TWOTB1/xBD/hurricanes/images/florence/hurricane-florence_00000223_post_disaster.png,14,21,1,0,14,197,218,212,17.51974892113652,16.2016159689238
4113,/media/marda/TWOTB1/xBD/hurricanes/images/florence/hurricane-florence_00000223_post_disaster.png,36,37,1,369,405,261,298,468,27.553016299573983,22.614204876291634
4114,/media/marda/TWOTB1/xBD/hurricanes/images/florence/hurricane-florence_00000223_post_disaster.png,59,71,1,0,59,349,420,1980,63.729837323683924,46.445644256565394
4115,/media/marda/TWOTB1/xBD/hurricanes/images/florence/hurricane-florence_00000223_post_disaster.png,19,38,1,116,135,359,397,224,28.841398249280758,10.368772268350563
4116,/media/marda/TWOTB1/xBD/hurricanes/images/florence/hurricane-florence_00000223_post_disaster.png,81,54,1,184,265,372,426,2154,82.96851224162744,34.4708546758846
4117,/media/marda/TWOTB1/xBD/hurricanes/images/florence/hurricane-florence_00000223_post_disaster.png,24,30,1,162,186,373,403,268,20.857220160382273,16.932675727764867
4118,/media/marda/TWOTB1/xBD/hurricanes/images/florence/hurricane-florence_00000223_post_disaster.png,22,29,1,204,226,410,439,126,14.271062275796194,11.913189459907384
4119,/media/marda/TWOTB1/xBD/hurricanes/images/florence/hurricane-florence_00000223_post_disaster.png,146,112,1,487,633,515,627,7038,120.41437547201639,81.02045918720314
4120,/media/marda/TWOTB1/xBD/hurricanes/images/florence/hurricane-florence_00000223_post_disaster.png,48,71,1,169,217,633,704,1427,46.30750203792767,41.30401077726982
4121,/media/marda/TWOTB1/xBD/hurricanes/images/florence/hurricane-florence_00000223_post_disaster.png,65,112,1,237,302,697,809,2703,86.9259873852381,43.085018260524336
4122,/media/marda/TWOTB1/xBD/hurricanes/images/florence/hurricane-florence_00000223_post_disaster.png,60,42,1,773,833,763,805,189,33.92845547774589,7.4704438115621805
4123,/media/marda/TWOTB1/xBD/hurricanes/images/florence/hurricane-florence_00000223_post_disaster.png,70,89,1,115,185,773,862,2278,72.83103355442034,48.58252789539543
4124,/media/marda/TWOTB1/xBD/hurricanes/images/florence/hurricane-florence_00000223_post_disaster.png,155,158,1,554,709,773,931,11829,135.38949633862225,116.8059572144896
4125,/media/marda/TWOTB1/xBD/hurricanes/images/florence/hurricane-florence_00000223_post_disaster.png,56,43,1,780,836,773,816,199,28.704582452135977,9.309911688885968
4126,/media/marda/TWOTB1/xBD/hurricanes/images/florence/hurricane-florence_00000223_post_disaster.png,55,42,1,782,837,784,826,180,28.169881352105907,8.57089573755733
4127,/media/marda/TWOTB1/xBD/hurricanes/images/florence/hurricane-florence_00000223_post_disaster.png,60,46,1,780,840,792,838,161,34.42357944047025,6.286930270656616
4128,/media/marda/TWOTB1/xBD/hurricanes/images/florence/hurricane-florence_00000223_post_disaster.png,60,47,1,783,843,803,850,178,34.45792237263524,6.949537761146359
4129,/media/marda/TWOTB1/xBD/hurricanes/images/florence/hurricane-florence_00000223_post_disaster.png,52,94,1,298,350,881,975,1719,66.15410874445315,37.00220588382764
4130,/media/marda/TWOTB1/xBD/hurricanes/images/florence/hurricane-florence_00000223_post_disaster.png,113,74,1,626,739,897,971,1771,93.08741438090053,25.438343555246895
4131,/media/marda/TWOTB1/xBD/hurricanes/images/florence/hurricane-florence_00000223_post_disaster.png,92,87,1,45,137,923,1010,2532,93.39489386864862,42.05247973718014
4132,/media/marda/TWOTB1/xBD/hurricanes/images/florence/hurricane-florence_00000223_post_disaster.png,55,66,1,266,321,961,1027,815,48.174448758667005,22.50030571908606
4133,/media/marda/TWOTB1/xBD/hurricanes/images/florence/hurricane-florence_00000454_post_disaster.png,41,27,1,0,41,0,27,1053,46.779977425835995,30.03212420353691
4134,/media/marda/TWOTB1/xBD/hurricanes/images/florence/hurricane-florence_00000454_post_disaster.png,71,64,1,673,744,511,575,1387,48.98531687473381,40.367645760202755
4135,/media/marda/TWOTB1/xBD/hurricanes/images/florence/hurricane-florence_00000454_post_disaster.png,14,28,1,0,14,281,309,232,20.505894933776286,15.198486906176646
4136,/media/marda/TWOTB1/xBD/hurricanes/images/florence/hurricane-florence_00000454_post_disaster.png,38,53,1,198,236,401,454,874,38.17030801461362,30.60284280311358
4137,/media/marda/TWOTB1/xBD/hurricanes/images/florence/hurricane-florence_00000454_post_disaster.png,14,32,1,79,93,417,449,184,17.23083959464783,14.447131979741732
4138,/media/marda/TWOTB1/xBD/hurricanes/images/florence/hurricane-florence_00000454_post_disaster.png,37,34,1,102,139,421,455,419,35.312078782528886,16.294986385199365
4139,/media/marda/TWOTB1/xBD/hurricanes/images/florence/hurricane-florence_00000454_post_disaster.png,13,30,1,141,154,424,454,106,13.83295812005685,10.273923594800952
4140,/media/marda/TWOTB1/xBD/hurricanes/images/florence/hurricane-florence_00000454_post_disaster.png,49,37,1,148,197,438,475,726,50.4140513916526,19.245189302330456
4141,/media/marda/TWOTB1/xBD/hurricanes/images/florence/hurricane-florence_00000454_post_disaster.png,69,39,1,726,795,441,480,725,44.661276073579934,21.409687461993958
4142,/media/marda/TWOTB1/xBD/hurricanes/images/florence/hurricane-florence_00000454_post_disaster.png,38,60,1,37,75,453,513,788,43.72850481940232,24.223364918271624
4143,/media/marda/TWOTB1/xBD/hurricanes/images/florence/hurricane-florence_00000454_post_disaster.png,19,34,1,144,163,492,526,123,13.483157630427579,12.25489762108817
4144,/media/marda/TWOTB1/xBD/hurricanes/images/florence/hurricane-florence_00000454_post_disaster.png,14,31,1,158,172,492,523,69,10.849788807813656,8.642458025668533
4145,/media/marda/TWOTB1/xBD/hurricanes/images/florence/hurricane-florence_00000454_post_disaster.png,41,67,1,137,178,506,573,980,43.13694328850686,31.486593016723443
4146,/media/marda/TWOTB1/xBD/hurricanes/images/florence/hurricane-florence_00000454_post_disaster.png,45,70,1,80,125,522,592,1105,54.07819953762964,26.94318919429106
4147,/media/marda/TWOTB1/xBD/hurricanes/images/florence/hurricane-florence_00000454_post_disaster.png,50,38,1,745,795,569,607,287,22.004093306026135,16.928574750037512
4148,/media/marda/TWOTB1/xBD/hurricanes/images/florence/hurricane-florence_00000454_post_disaster.png,24,79,1,0,24,912,991,987,48.56440991379622,27.123712244049532
4149,/media/marda/TWOTB1/xBD/hurricanes/images/florence/hurricane-florence_00000454_post_disaster.png,42,59,1,296,338,938,997,504,32.558242340467714,20.567713425248925
4150,/media/marda/TWOTB1/xBD/hurricanes/images/florence/hurricane-florence_00000454_post_disaster.png,51,82,1,247,298,959,1041,1379,53.2333345892011,37.05665315878237
4151,/media/marda/TWOTB1/xBD/hurricanes/images/florence/hurricane-florence_00000454_post_disaster.png,20,45,1,313,333,966,1011,51,9.072047589439572,7.725698577447143
4152,/media/marda/TWOTB1/xBD/hurricanes/images/florence/hurricane-florence_00000073_post_disaster.png,86,84,1,622,708,504,588,2279,60.344024668695326,49.640692410481954
4153,/media/marda/TWOTB1/xBD/hurricanes/images/florence/hurricane-florence_00000072_post_disaster.png,84,46,1,879,963,78,124,966,57.300180480109134,22.341474180770046
4154,/media/marda/TWOTB1/xBD/hurricanes/images/florence/hurricane-florence_00000072_post_disaster.png,85,59,1,904,989,126,185,1475,48.20568208152106,40.849218277715906
4155,/media/marda/TWOTB1/xBD/hurricanes/images/florence/hurricane-florence_00000072_post_disaster.png,70,55,1,809,879,579,634,789,34.183175303944616,30.860191663352882
4156,/media/marda/TWOTB1/xBD/hurricanes/images/florence/hurricane-florence_00000072_post_disaster.png,96,68,1,905,1001,581,649,1434,63.77438126925974,29.809900185070465
4157,/media/marda/TWOTB1/xBD/hurricanes/images/florence/hurricane-florence_00000072_post_disaster.png,50,39,1,876,926,638,677,123,14.764628370375927,11.205260707931075
4158,/media/marda/TWOTB1/xBD/hurricanes/images/florence/hurricane-florence_00000188_pre_disaster.png,46,20,1,634,680,22,42,399,24.480216169414234,21.50958145910203
4159,/media/marda/TWOTB1/xBD/hurricanes/images/florence/hurricane-florence_00000188_pre_disaster.png,58,36,1,636,694,46,82,732,31.788014347981694,30.51812624598766
4160,/media/marda/TWOTB1/xBD/hurricanes/images/florence/hurricane-florence_00000188_pre_disaster.png,73,69,1,971,1044,192,261,1389,62.662209740313486,31.637630846790515
4161,/media/marda/TWOTB1/xBD/hurricanes/images/florence/hurricane-florence_00000188_pre_disaster.png,53,31,1,862,915,323,354,210,19.40181599315768,14.474405078648406
4162,/media/marda/TWOTB1/xBD/hurricanes/images/florence/hurricane-florence_00000188_pre_disaster.png,58,36,1,986,1044,357,393,276,21.696512095839918,17.41296566863518
4163,/media/marda/TWOTB1/xBD/hurricanes/images/florence/hurricane-florence_00000188_pre_disaster.png,76,53,1,887,963,563,616,660,41.32244439395419,21.289560307944953
4164,/media/marda/TWOTB1/xBD/hurricanes/images/florence/hurricane-florence_00000188_pre_disaster.png,75,67,1,823,898,574,641,966,46.00459588244425,29.833815046025226
4165,/media/marda/TWOTB1/xBD/hurricanes/images/florence/hurricane-florence_00000188_pre_disaster.png,49,44,1,809,858,657,701,182,19.60230648590372,12.462344080996017
4166,/media/marda/TWOTB1/xBD/hurricanes/images/florence/hurricane-florence_00000188_pre_disaster.png,78,69,1,714,792,696,765,1281,45.9450082586667,37.27227092405241
4167,/media/marda/TWOTB1/xBD/hurricanes/images/florence/hurricane-florence_00000188_pre_disaster.png,51,51,1,722,773,780,831,392,24.647018062855306,20.884151468880223
4168,/media/marda/TWOTB1/xBD/hurricanes/images/florence/hurricane-florence_00000251_post_disaster.png,85,45,1,809,894,39,84,1139,54.18356528043794,27.88100811313158
4169,/media/marda/TWOTB1/xBD/hurricanes/images/florence/hurricane-florence_00000251_post_disaster.png,84,28,1,664,748,80,108,623,65.13861828707458,12.77857394469345
4170,/media/marda/TWOTB1/xBD/hurricanes/images/florence/hurricane-florence_00000251_post_disaster.png,85,50,1,943,1028,97,147,826,61.32749032812395,17.986944561342916
4171,/media/marda/TWOTB1/xBD/hurricanes/images/florence/hurricane-florence_00000251_post_disaster.png,40,21,1,735,775,106,127,110,17.745985843135355,8.359425007453542
4172,/media/marda/TWOTB1/xBD/hurricanes/images/florence/hurricane-florence_00000251_post_disaster.png,63,49,1,629,692,167,216,1042,45.37269760652668,31.21081249323372
4173,/media/marda/TWOTB1/xBD/hurricanes/images/florence/hurricane-florence_00000251_post_disaster.png,57,49,1,588,645,262,311,814,41.03460156213437,26.48708592814542
4174,/media/marda/TWOTB1/xBD/hurricanes/images/florence/hurricane-florence_00000251_post_disaster.png,48,40,1,415,463,275,315,680,33.12478914157476,27.955836495322423
4175,/media/marda/TWOTB1/xBD/hurricanes/images/florence/hurricane-florence_00000251_post_disaster.png,71,62,1,742,813,275,337,1133,56.275697499013155,26.877254674649464
4176,/media/marda/TWOTB1/xBD/hurricanes/images/florence/hurricane-florence_00000251_post_disaster.png,34,25,1,589,623,298,323,94,11.493260518926759,10.973404254922524
4177,/media/marda/TWOTB1/xBD/hurricanes/images/florence/hurricane-florence_00000251_post_disaster.png,51,64,1,572,623,338,402,765,55.97857824838553,18.26916059793848
4178,/media/marda/TWOTB1/xBD/hurricanes/images/florence/hurricane-florence_00000251_post_disaster.png,67,51,1,724,791,381,432,907,36.97167862415267,33.014940193802246
4179,/media/marda/TWOTB1/xBD/hurricanes/images/florence/hurricane-florence_00000251_post_disaster.png,58,66,1,526,584,418,484,971,51.18762541592484,25.343003684763357
4180,/media/marda/TWOTB1/xBD/hurricanes/images/florence/hurricane-florence_00000251_post_disaster.png,38,33,1,496,534,426,459,168,16.133671404573633,13.958088328122978
4181,/media/marda/TWOTB1/xBD/hurricanes/images/florence/hurricane-florence_00000251_post_disaster.png,48,32,1,737,785,430,462,168,20.329373991584706,11.132371941222452
4182,/media/marda/TWOTB1/xBD/hurricanes/images/florence/hurricane-florence_00000251_post_disaster.png,54,63,1,498,552,490,553,662,51.77653418577896,17.059347098257692
4183,/media/marda/TWOTB1/xBD/hurricanes/images/florence/hurricane-florence_00000251_post_disaster.png,52,59,1,684,736,491,550,466,47.49090684986954,13.21122121526353
4184,/media/marda/TWOTB1/xBD/hurricanes/images/florence/hurricane-florence_00000251_post_disaster.png,39,54,1,308,347,620,674,448,26.66367294352428,22.04040047433201
4185,/media/marda/TWOTB1/xBD/hurricanes/images/florence/hurricane-florence_00000251_post_disaster.png,71,76,1,609,680,636,712,1062,56.27543443194267,25.18724381401791
4186,/media/marda/TWOTB1/xBD/hurricanes/images/florence/hurricane-florence_00000251_post_disaster.png,69,78,1,311,380,661,739,1498,60.51374436752144,32.66736163384537
4187,/media/marda/TWOTB1/xBD/hurricanes/images/florence/hurricane-florence_00000251_post_disaster.png,56,62,1,529,585,700,762,600,32.723093798710444,24.48671338176682
4188,/media/marda/TWOTB1/xBD/hurricanes/images/florence/hurricane-florence_00000251_post_disaster.png,65,72,1,472,537,739,811,974,46.76781703426764,27.791524351563684
4189,/media/marda/TWOTB1/xBD/hurricanes/images/florence/hurricane-florence_00000251_post_disaster.png,63,71,1,420,483,783,854,932,47.69711689846737,26.076430583386756
4190,/media/marda/TWOTB1/xBD/hurricanes/images/florence/hurricane-florence_00000251_post_disaster.png,38,55,1,387,425,784,839,272,23.295955682532192,15.601991900383789
4191,/media/marda/TWOTB1/xBD/hurricanes/images/florence/hurricane-florence_00000484_pre_disaster.png,52,29,1,892,944,367,396,129,16.83948708387966,10.264419211891083
4192,/media/marda/TWOTB1/xBD/hurricanes/images/florence/hurricane-florence_00000484_pre_disaster.png,56,43,1,980,1036,750,793,118,14.289684737677023,11.09195966021483
4193,/media/marda/TWOTB1/xBD/hurricanes/images/florence/hurricane-florence_00000484_pre_disaster.png,74,73,1,970,1044,785,858,792,45.63635538896286,22.66141328016906
4194,/media/marda/TWOTB1/xBD/hurricanes/images/florence/hurricane-florence_00000484_pre_disaster.png,64,63,1,807,871,813,876,476,34.73705135395551,18.20577129293656
4195,/media/marda/TWOTB1/xBD/hurricanes/images/florence/hurricane-florence_00000484_pre_disaster.png,56,59,1,843,899,859,918,290,27.954201589866724,14.122620723117446
4196,/media/marda/TWOTB1/xBD/hurricanes/images/florence/hurricane-florence_00000484_pre_disaster.png,66,66,1,826,892,876,942,515,37.21598517146359,18.484785926761933
4197,/media/marda/TWOTB1/xBD/hurricanes/images/florence/hurricane-florence_00000484_pre_disaster.png,56,59,1,811,867,917,976,277,26.962213939351614,13.733081139326178
4198,/media/marda/TWOTB1/xBD/hurricanes/images/florence/hurricane-florence_00000484_pre_disaster.png,85,87,1,838,923,923,1010,1358,52.047272537094315,35.32349196232102
4199,/media/marda/TWOTB1/xBD/hurricanes/images/florence/hurricane-florence_00000334_pre_disaster.png,27,16,1,460,487,158,174,103,11.639624337961381,11.278710653075768
4200,/media/marda/TWOTB1/xBD/hurricanes/images/florence/hurricane-florence_00000334_pre_disaster.png,69,44,1,435,504,184,228,1291,51.0734738022323,34.09027375385639
4201,/media/marda/TWOTB1/xBD/hurricanes/images/florence/hurricane-florence_00000334_pre_disaster.png,62,58,1,767,829,581,639,1001,39.66023166050718,33.284101026714
4202,/media/marda/TWOTB1/xBD/hurricanes/images/florence/hurricane-florence_00000334_pre_disaster.png,86,38,1,883,969,611,649,600,60.18848819606476,13.326647482267134
4203,/media/marda/TWOTB1/xBD/hurricanes/images/florence/hurricane-florence_00000334_pre_disaster.png,63,51,1,508,571,630,681,791,46.22732790195937,22.87799138270842
4204,/media/marda/TWOTB1/xBD/hurricanes/images/florence/hurricane-florence_00000334_pre_disaster.png,93,37,1,879,972,654,691,472,66.44261220164226,11.32234835381093
4205,/media/marda/TWOTB1/xBD/hurricanes/images/florence/hurricane-florence_00000334_pre_disaster.png,38,35,1,569,607,670,705,122,18.95806755682773,8.646132600011722
4206,/media/marda/TWOTB1/xBD/hurricanes/images/florence/hurricane-florence_00000334_pre_disaster.png,42,36,1,800,842,704,740,68,11.148694980382976,8.134510929026565
4207,/media/marda/TWOTB1/xBD/hurricanes/images/florence/hurricane-florence_00000334_pre_disaster.png,84,43,1,875,959,718,761,577,57.363323776720236,13.977000072219916
4208,/media/marda/TWOTB1/xBD/hurricanes/images/florence/hurricane-florence_00000334_pre_disaster.png,93,41,1,866,959,746,787,651,68.21673161145154,12.6991255865152
4209,/media/marda/TWOTB1/xBD/hurricanes/images/florence/hurricane-florence_00000334_pre_disaster.png,81,45,1,872,953,788,833,496,54.4006593279843,12.189858626671652
4210,/media/marda/TWOTB1/xBD/hurricanes/images/florence/hurricane-florence_00000146_post_disaster.png,32,46,1,485,517,831,877,96,13.12302077423017,9.854930699525832
4211,/media/marda/TWOTB1/xBD/hurricanes/images/florence/hurricane-florence_00000146_post_disaster.png,48,46,1,833,881,868,914,129,15.911352478910322,10.901074686704312
4212,/media/marda/TWOTB1/xBD/hurricanes/images/florence/hurricane-florence_00000146_post_disaster.png,68,87,1,844,912,893,980,1044,50.58899743092093,27.67833732158822
4213,/media/marda/TWOTB1/xBD/hurricanes/images/florence/hurricane-florence_00000146_post_disaster.png,55,75,1,494,549,900,975,774,34.21895853797386,30.573332200709725
4214,/media/marda/TWOTB1/xBD/hurricanes/images/florence/hurricane-florence_00000023_pre_disaster.png,68,41,1,862,930,249,290,573,29.278050582851012,26.073337394773958
4215,/media/marda/TWOTB1/xBD/hurricanes/images/florence/hurricane-florence_00000023_pre_disaster.png,38,38,1,5,43,455,493,625,40.64851964066152,20.551953666324643
4216,/media/marda/TWOTB1/xBD/hurricanes/images/florence/hurricane-florence_00000023_pre_disaster.png,45,57,1,121,166,465,522,998,40.42384681516395,32.759975595534456
4217,/media/marda/TWOTB1/xBD/hurricanes/images/florence/hurricane-florence_00000269_post_disaster.png,35,35,1,124,159,184,219,453,30.465493048504165,20.00252029097999
4218,/media/marda/TWOTB1/xBD/hurricanes/images/florence/hurricane-florence_00000269_post_disaster.png,13,45,1,0,13,240,285,337,36.89347457599911,12.653058803463905
4219,/media/marda/TWOTB1/xBD/hurricanes/images/florence/hurricane-florence_00000269_post_disaster.png,17,25,1,133,150,351,376,85,11.099797807792255,10.320055928631147
4220,/media/marda/TWOTB1/xBD/hurricanes/images/florence/hurricane-florence_00000269_post_disaster.png,31,37,1,240,271,366,403,296,22.24566494444933,17.91129949953954
4221,/media/marda/TWOTB1/xBD/hurricanes/images/florence/hurricane-florence_00000179_pre_disaster.png,50,41,1,616,666,370,411,379,23.977990421454127,21.137093876088638
4222,/media/marda/TWOTB1/xBD/hurricanes/images/florence/hurricane-florence_00000179_pre_disaster.png,55,25,1,275,330,373,398,409,52.204112763161675,10.472086513258644
4223,/media/marda/TWOTB1/xBD/hurricanes/images/florence/hurricane-florence_00000179_pre_disaster.png,43,61,1,755,798,392,453,606,52.0253130999534,15.534379750855638
4224,/media/marda/TWOTB1/xBD/hurricanes/images/florence/hurricane-florence_00000179_pre_disaster.png,42,66,1,687,729,393,459,725,57.76171352679515,16.72957873912315
4225,/media/marda/TWOTB1/xBD/hurricanes/images/florence/hurricane-florence_00000179_pre_disaster.png,53,32,1,933,986,393,425,180,16.78608069892117,14.382270926092593
4226,/media/marda/TWOTB1/xBD/hurricanes/images/florence/hurricane-florence_00000179_pre_disaster.png,63,43,1,826,889,400,443,510,29.65915879472293,22.9859866812565
4227,/media/marda/TWOTB1/xBD/hurricanes/images/florence/hurricane-florence_00000179_pre_disaster.png,63,44,1,396,459,402,446,995,50.55365085561242,26.862420331135358
4228,/media/marda/TWOTB1/xBD/hurricanes/images/florence/hurricane-florence_00000179_pre_disaster.png,66,30,1,296,362,424,454,643,61.873248606410904,13.868744219781142
4229,/media/marda/TWOTB1/xBD/hurricanes/images/florence/hurricane-florence_00000179_pre_disaster.png,56,32,1,474,530,471,503,486,42.925733154748414,15.125767436224187
4230,/media/marda/TWOTB1/xBD/hurricanes/images/florence/hurricane-florence_00000179_pre_disaster.png,35,29,1,669,704,499,528,85,12.26352014192022,9.285952352826248
4231,/media/marda/TWOTB1/xBD/hurricanes/images/florence/hurricane-florence_00000179_pre_disaster.png,38,30,1,773,811,499,529,95,11.733838864251966,10.725541809830323
4232,/media/marda/TWOTB1/xBD/hurricanes/images/florence/hurricane-florence_00000179_pre_disaster.png,23,66,1,98,121,508,574,696,50.902700235144664,19.56929619207755
4233,/media/marda/TWOTB1/xBD/hurricanes/images/florence/hurricane-florence_00000179_pre_disaster.png,69,41,1,495,564,523,564,971,56.06382930160841,23.089173077207445
4234,/media/marda/TWOTB1/xBD/hurricanes/images/florence/hurricane-florence_00000179_pre_disaster.png,40,38,1,474,514,526,564,302,22.809579308326597,18.01591601692777
4235,/media/marda/TWOTB1/xBD/hurricanes/images/florence/hurricane-florence_00000179_pre_disaster.png,60,40,1,589,649,532,572,666,40.509663339920245,21.924589740386434
4236,/media/marda/TWOTB1/xBD/hurricanes/images/florence/hurricane-florence_00000179_pre_disaster.png,80,35,1,780,860,533,568,549,57.26769026306821,12.857896571484593
4237,/media/marda/TWOTB1/xBD/hurricanes/images/florence/hurricane-florence_00000179_pre_disaster.png,75,33,1,681,756,536,569,589,56.6585676267105,13.837730479887894
4238,/media/marda/TWOTB1/xBD/hurricanes/images/florence/hurricane-florence_00000179_pre_disaster.png,59,36,1,293,352,657,693,478,55.19895525096785,11.546043451657802
4239,/media/marda/TWOTB1/xBD/hurricanes/images/florence/hurricane-florence_00000179_pre_disaster.png,75,53,1,563,638,659,712,1069,58.44873391044038,25.76862024845397
4240,/media/marda/TWOTB1/xBD/hurricanes/images/florence/hurricane-florence_00000179_pre_disaster.png,78,36,1,644,722,661,697,624,60.03332407921454,13.808210118138652
4241,/media/marda/TWOTB1/xBD/hurricanes/images/florence/hurricane-florence_00000179_pre_disaster.png,44,35,1,882,926,664,699,57,9.567991265918021,8.02959978156389
4242,/media/marda/TWOTB1/xBD/hurricanes/images/florence/hurricane-florence_00000179_pre_disaster.png,51,41,1,390,441,669,710,607,41.2952882499803,19.519201334398375
4243,/media/marda/TWOTB1/xBD/hurricanes/images/florence/hurricane-florence_00000179_pre_disaster.png,32,36,1,302,334,673,709,197,22.708787119949818,11.640452942006572
4244,/media/marda/TWOTB1/xBD/hurricanes/images/florence/hurricane-florence_00000179_pre_disaster.png,24,42,1,339,363,675,717,179,19.86978579291968,12.054028338509996
4245,/media/marda/TWOTB1/xBD/hurricanes/images/florence/hurricane-florence_00000179_pre_disaster.png,71,70,1,815,886,683,753,925,45.5969600324434,27.248569403878392
4246,/media/marda/TWOTB1/xBD/hurricanes/images/florence/hurricane-florence_00000179_pre_disaster.png,45,48,1,581,626,691,739,380,24.975337021684556,20.126837912726977
4247,/media/marda/TWOTB1/xBD/hurricanes/images/florence/hurricane-florence_00000179_pre_disaster.png,52,48,1,390,442,754,802,703,42.75513674890584,21.95311849719729
4248,/media/marda/TWOTB1/xBD/hurricanes/images/florence/hurricane-florence_00000179_pre_disaster.png,68,46,1,476,544,755,801,595,56.365221265637246,14.135800099652585
4249,/media/marda/TWOTB1/xBD/hurricanes/images/florence/hurricane-florence_00000179_pre_disaster.png,55,50,1,198,253,849,899,427,52.3663149423389,10.905719163035474
4250,/media/marda/TWOTB1/xBD/hurricanes/images/florence/hurricane-florence_00000179_pre_disaster.png,61,76,1,682,743,944,1020,490,48.13710215283054,13.620878615951355
4251,/media/marda/TWOTB1/xBD/hurricanes/images/florence/hurricane-florence_00000057_pre_disaster.png,22,12,1,387,409,15,27,96,13.808210118138652,9.16515138991168
4252,/media/marda/TWOTB1/xBD/hurricanes/images/florence/hurricane-florence_00000034_pre_disaster.png,55,32,1,337,392,0,32,878,41.357330608847434,29.03285106257171
4253,/media/marda/TWOTB1/xBD/hurricanes/images/florence/hurricane-florence_00000034_pre_disaster.png,48,37,1,391,439,8,45,720,37.279783545299075,25.313009475212386
4254,/media/marda/TWOTB1/xBD/hurricanes/images/florence/hurricane-florence_00000034_pre_disaster.png,59,38,1,463,522,51,89,1004,40.43716690322661,32.59430372277191
4255,/media/marda/TWOTB1/xBD/hurricanes/images/florence/hurricane-florence_00000034_pre_disaster.png,73,51,1,496,569,87,138,1465,47.54281673312811,41.09804642051406
4256,/media/marda/TWOTB1/xBD/hurricanes/images/florence/hurricane-florence_00000034_pre_disaster.png,42,24,1,575,617,112,136,239,19.16080758000005,16.21208486700905
4257,/media/marda/TWOTB1/xBD/hurricanes/images/florence/hurricane-florence_00000034_pre_disaster.png,54,48,1,324,378,127,175,1011,44.117581104062076,30.26936116564215
4258,/media/marda/TWOTB1/xBD/hurricanes/images/florence/hurricane-florence_00000034_pre_disaster.png,32,17,1,615,647,149,166,97,15.017537666917425,8.589242239229483
4259,/media/marda/TWOTB1/xBD/hurricanes/images/florence/hurricane-florence_00000034_pre_disaster.png,66,42,1,605,671,167,209,1055,38.58349190314797,35.70221594275343
4260,/media/marda/TWOTB1/xBD/hurricanes/images/florence/hurricane-florence_00000034_pre_disaster.png,52,22,1,896,948,167,189,176,16.204554295657523,14.571256328408277
4261,/media/marda/TWOTB1/xBD/hurricanes/images/florence/hurricane-florence_00000034_pre_disaster.png,75,40,1,941,1016,168,208,1018,39.76968421237212,33.576262294480635
4262,/media/marda/TWOTB1/xBD/hurricanes/images/florence/hurricane-florence_00000034_pre_disaster.png,51,35,1,747,798,191,226,638,33.490564985183646,25.340128542671273
4263,/media/marda/TWOTB1/xBD/hurricanes/images/florence/hurricane-florence_00000034_pre_disaster.png,42,16,1,849,891,192,208,100,13.032447503702876,10.279849807425624
4264,/media/marda/TWOTB1/xBD/hurricanes/images/florence/hurricane-florence_00000034_pre_disaster.png,83,38,1,864,947,194,232,1149,53.266952510793196,28.09650934705273
4265,/media/marda/TWOTB1/xBD/hurricanes/images/florence/hurricane-florence_00000034_pre_disaster.png,59,29,1,688,747,197,226,399,33.09066667774484,15.940533590624952
4266,/media/marda/TWOTB1/xBD/hurricanes/images/florence/hurricane-florence_00000034_pre_disaster.png,48,24,1,915,963,197,221,144,16.65174273028209,11.62600139725357
4267,/media/marda/TWOTB1/xBD/hurricanes/images/florence/hurricane-florence_00000034_pre_disaster.png,58,43,1,818,876,198,241,888,40.144450524822894,29.331130342148565
4268,/media/marda/TWOTB1/xBD/hurricanes/images/florence/hurricane-florence_00000034_pre_disaster.png,75,75,1,954,1029,395,470,1575,63.22830852530126,32.864135452095745
4269,/media/marda/TWOTB1/xBD/hurricanes/images/florence/hurricane-florence_00000034_pre_disaster.png,69,53,1,681,750,410,463,1263,46.14766286016688,35.68653014729109
4270,/media/marda/TWOTB1/xBD/hurricanes/images/florence/hurricane-florence_00000034_pre_disaster.png,77,51,1,836,913,468,519,1168,46.31256019675052,34.57712836168592
4271,/media/marda/TWOTB1/xBD/hurricanes/images/florence/hurricane-florence_00000034_pre_disaster.png,76,68,1,946,1022,561,629,1158,47.840986910196854,32.19046863384967
4272,/media/marda/TWOTB1/xBD/hurricanes/images/florence/hurricane-florence_00000034_pre_disaster.png,45,60,1,37,82,569,629,991,47.41498335800814,27.45326912540277
4273,/media/marda/TWOTB1/xBD/hurricanes/images/florence/hurricane-florence_00000034_pre_disaster.png,48,54,1,741,789,707,761,279,26.490512327630345,14.107845974710752
4274,/media/marda/TWOTB1/xBD/hurricanes/images/florence/hurricane-florence_00000034_pre_disaster.png,54,39,1,696,750,751,790,219,29.63769479074314,9.938091140981383
4275,/media/marda/TWOTB1/xBD/hurricanes/images/florence/hurricane-florence_00000034_pre_disaster.png,87,86,1,956,1043,855,941,1557,50.11743617108129,40.890447088750136
4276,/media/marda/TWOTB1/xBD/hurricanes/images/florence/hurricane-florence_00000034_pre_disaster.png,53,58,1,959,1012,986,1044,252,20.296774617418524,16.464507061792514
4277,/media/marda/TWOTB1/xBD/hurricanes/images/florence/hurricane-florence_00000382_pre_disaster.png,43,17,1,722,765,19,36,180,17.750245085554962,13.375337887330648
4278,/media/marda/TWOTB1/xBD/hurricanes/images/florence/hurricane-florence_00000382_pre_disaster.png,31,53,1,22,53,301,354,849,39.28342545853078,28.178738349505664
4279,/media/marda/TWOTB1/xBD/hurricanes/images/florence/hurricane-florence_00000382_pre_disaster.png,41,46,1,98,139,317,363,868,37.53837695678955,30.234723637393177
4280,/media/marda/TWOTB1/xBD/hurricanes/images/florence/hurricane-florence_00000382_pre_disaster.png,18,28,1,38,56,350,378,177,17.515131927532494,13.580245380773516
4281,/media/marda/TWOTB1/xBD/hurricanes/images/florence/hurricane-florence_00000382_pre_disaster.png,34,66,1,55,89,429,495,1077,51.803578649753526,27.661322107555797
4282,/media/marda/TWOTB1/xBD/hurricanes/images/florence/hurricane-florence_00000382_pre_disaster.png,21,43,1,85,106,441,484,322,26.35116251161658,17.1368501593388
4283,/media/marda/TWOTB1/xBD/hurricanes/images/florence/hurricane-florence_00000382_pre_disaster.png,217,110,1,284,501,535,645,6199,238.60757348133268,34.601857863905344
4284,/media/marda/TWOTB1/xBD/hurricanes/images/florence/hurricane-florence_00000382_pre_disaster.png,18,30,1,282,300,583,613,65,9.87820619109951,8.476474989341966
4285,/media/marda/TWOTB1/xBD/hurricanes/images/florence/hurricane-florence_00000382_pre_disaster.png,45,80,1,151,196,589,669,1466,55.342000411440395,36.15459098436523
4286,/media/marda/TWOTB1/xBD/hurricanes/images/florence/hurricane-florence_00000382_pre_disaster.png,28,39,1,216,244,621,660,170,19.51557116518995,11.665490069731101
4287,/media/marda/TWOTB1/xBD/hurricanes/images/florence/hurricane-florence_00000382_pre_disaster.png,56,49,1,243,299,674,723,721,54.082471554227915,17.751589847518975
4288,/media/marda/TWOTB1/xBD/hurricanes/images/florence/hurricane-florence_00000382_pre_disaster.png,49,74,1,220,269,736,810,1395,52.019374989527705,38.058129260698884
4289,/media/marda/TWOTB1/xBD/hurricanes/images/florence/hurricane-florence_00000382_pre_disaster.png,54,73,1,158,212,737,810,1314,48.276485448425,35.864176158106936
4290,/media/marda/TWOTB1/xBD/hurricanes/images/florence/hurricane-florence_00000382_pre_disaster.png,20,43,1,211,231,772,815,135,16.75686657656206,10.79851454425366
4291,/media/marda/TWOTB1/xBD/hurricanes/images/florence/hurricane-florence_00000382_pre_disaster.png,32,80,1,196,228,835,915,674,52.22193466548844,18.769451372071526
4292,/media/marda/TWOTB1/xBD/hurricanes/images/florence/hurricane-florence_00000382_pre_disaster.png,62,67,1,796,858,875,942,847,39.416124876725824,28.9809728294382
4293,/media/marda/TWOTB1/xBD/hurricanes/images/florence/hurricane-florence_00000382_pre_disaster.png,44,103,1,196,240,924,1027,901,77.67476186825314,17.493717512359435
4294,/media/marda/TWOTB1/xBD/hurricanes/images/florence/hurricane-florence_00000382_pre_disaster.png,27,49,1,231,258,950,999,143,19.10605494840613,10.10957069084741
4295,/media/marda/TWOTB1/xBD/hurricanes/images/florence/hurricane-florence_00000099_post_disaster.png,64,26,1,896,960,0,26,585,29.12880237501685,26.863927682438007
4296,/media/marda/TWOTB1/xBD/hurricanes/images/florence/hurricane-florence_00000099_post_disaster.png,64,33,1,885,949,36,69,707,34.2258069974262,27.524606452083404
4297,/media/marda/TWOTB1/xBD/hurricanes/images/florence/hurricane-florence_00000099_post_disaster.png,69,45,1,873,942,179,224,1007,44.665747794569796,30.675967847525428
4298,/media/marda/TWOTB1/xBD/hurricanes/images/florence/hurricane-florence_00000099_post_disaster.png,53,26,1,844,897,203,229,240,21.931313172570473,14.59153111583615
4299,/media/marda/TWOTB1/xBD/hurricanes/images/florence/hurricane-florence_00000099_post_disaster.png,64,55,1,943,1007,297,352,961,46.60221296515269,27.34806557353392
4300,/media/marda/TWOTB1/xBD/hurricanes/images/florence/hurricane-florence_00000099_post_disaster.png,63,37,1,980,1043,298,335,458,26.03019008283245,23.416935963473247
4301,/media/marda/TWOTB1/xBD/hurricanes/images/florence/hurricane-florence_00000099_post_disaster.png,82,133,1,907,989,415,548,3059,129.30643776898967,31.207552317552977
4302,/media/marda/TWOTB1/xBD/hurricanes/images/florence/hurricane-florence_00000099_post_disaster.png,72,47,1,971,1043,423,470,773,38.856643928131476,27.167077224837794
4303,/media/marda/TWOTB1/xBD/hurricanes/images/florence/hurricane-florence_00000099_post_disaster.png,152,77,1,785,937,500,577,3012,136.2897858389204,30.244091497660467
4304,/media/marda/TWOTB1/xBD/hurricanes/images/florence/hurricane-florence_00000099_post_disaster.png,85,110,1,752,837,559,669,2497,99.65027106382205,34.07540324238383
4305,/media/marda/TWOTB1/xBD/hurricanes/images/florence/hurricane-florence_00000099_post_disaster.png,85,100,1,912,997,564,664,1972,87.29018854846132,30.93202489778951
4306,/media/marda/TWOTB1/xBD/hurricanes/images/florence/hurricane-florence_00000099_post_disaster.png,152,82,1,807,959,616,698,3208,133.97250670087124,32.96101398516994
4307,/media/marda/TWOTB1/xBD/hurricanes/images/florence/hurricane-florence_00000099_post_disaster.png,46,65,1,23,69,803,868,960,49.52491975679399,25.615611359195356
4308,/media/marda/TWOTB1/xBD/hurricanes/images/florence/hurricane-florence_00000099_post_disaster.png,21,58,1,74,95,810,868,440,27.229313794824265,21.387789229236223
4309,/media/marda/TWOTB1/xBD/hurricanes/images/florence/hurricane-florence_00000099_post_disaster.png,42,60,1,123,165,821,881,594,40.15813265554684,19.756373164358926
4310,/media/marda/TWOTB1/xBD/hurricanes/images/florence/hurricane-florence_00000099_post_disaster.png,6,52,1,0,6,881,933,74,20.71048362687942,5.305486169952909
4311,/media/marda/TWOTB1/xBD/hurricanes/images/florence/hurricane-florence_00000099_post_disaster.png,82,100,1,142,224,941,1041,3628,74.6345727065445,65.11577235251087
4312,/media/marda/TWOTB1/xBD/hurricanes/images/florence/hurricane-florence_00000099_post_disaster.png,23,61,1,0,23,944,1005,406,25.563048453877798,21.30585869830455
4313,/media/marda/TWOTB1/xBD/hurricanes/images/florence/hurricane-florence_00000544_post_disaster.png,16,41,1,214,230,767,808,85,14.704831738043618,7.888173862030706
4314,/media/marda/TWOTB1/xBD/hurricanes/images/florence/hurricane-florence_00000544_post_disaster.png,126,79,1,233,359,743,822,4802,131.27272889003112,48.4391467074918
4315,/media/marda/TWOTB1/xBD/hurricanes/images/florence/hurricane-florence_00000165_post_disaster.png,34,12,1,556,590,6,18,85,13.234543702613307,8.625691991149404
4316,/media/marda/TWOTB1/xBD/hurricanes/images/florence/hurricane-florence_00000165_post_disaster.png,66,29,1,954,1020,31,60,449,24.60545219723639,24.08644748404189
4317,/media/marda/TWOTB1/xBD/hurricanes/images/florence/hurricane-florence_00000165_post_disaster.png,69,47,1,603,672,51,98,1285,42.68435336686347,39.39931636416925
4318,/media/marda/TWOTB1/xBD/hurricanes/images/florence/hurricane-florence_00000165_post_disaster.png,37,47,1,43,80,81,128,683,54.307051279705085,16.74931415958292
4319,/media/marda/TWOTB1/xBD/hurricanes/images/florence/hurricane-florence_00000165_post_disaster.png,65,36,1,767,832,88,124,735,34.77454598411283,28.188516870669034
4320,/media/marda/TWOTB1/xBD/hurricanes/images/florence/hurricane-florence_00000165_post_disaster.png,57,38,1,727,784,124,162,480,33.95324604593387,18.954334732891542
4321,/media/marda/TWOTB1/xBD/hurricanes/images/florence/hurricane-florence_00000165_post_disaster.png,73,58,1,855,928,182,240,1184,53.72294564116558,32.83960575632666
4322,/media/marda/TWOTB1/xBD/hurricanes/images/florence/hurricane-florence_00000165_post_disaster.png,23,39,1,0,23,189,228,547,34.66222600019005,20.98179399189818
4323,/media/marda/TWOTB1/xBD/hurricanes/images/florence/hurricane-florence_00000165_post_disaster.png,81,76,1,577,658,223,299,1996,67.14915969802156,39.57179184134715
4324,/media/marda/TWOTB1/xBD/hurricanes/images/florence/hurricane-florence_00000165_post_disaster.png,58,46,1,874,932,246,292,725,40.8982074720189,23.486253456815263
4325,/media/marda/TWOTB1/xBD/hurricanes/images/florence/hurricane-florence_00000165_post_disaster.png,60,52,1,641,701,258,310,562,53.412768439435034,13.978776912961695
4326,/media/marda/TWOTB1/xBD/hurricanes/images/florence/hurricane-florence_00000165_post_disaster.png,62,53,1,661,723,275,328,611,50.87378665164681,16.04272797671756
4327,/media/marda/TWOTB1/xBD/hurricanes/images/florence/hurricane-florence_00000165_post_disaster.png,49,26,1,812,861,284,310,214,18.211314300259396,15.622804639981688
4328,/media/marda/TWOTB1/xBD/hurricanes/images/florence/hurricane-florence_00000165_post_disaster.png,53,34,1,644,697,313,347,220,34.002759152849535,8.653235562249915
4329,/media/marda/TWOTB1/xBD/hurricanes/images/florence/hurricane-florence_00000165_post_disaster.png,59,31,1,981,1040,325,356,253,19.000561074754785,17.59952705507371
4330,/media/marda/TWOTB1/xBD/hurricanes/images/florence/hurricane-florence_00000165_post_disaster.png,86,74,1,864,950,405,479,2028,57.613361362645875,47.12202479848302
4331,/media/marda/TWOTB1/xBD/hurricanes/images/florence/hurricane-florence_00000165_post_disaster.png,19,50,1,0,19,500,550,309,28.637831244643717,15.239927442656882
4332,/media/marda/TWOTB1/xBD/hurricanes/images/florence/hurricane-florence_00000165_post_disaster.png,75,58,1,922,997,507,565,910,43.03151091295018,31.081789290293717
4333,/media/marda/TWOTB1/xBD/hurricanes/images/florence/hurricane-florence_00000306_post_disaster.png,45,3,1,508,553,0,3,75,28.844410203711913,3.265986323710904
4334,/media/marda/TWOTB1/xBD/hurricanes/images/florence/hurricane-florence_00000306_post_disaster.png,43,33,1,502,545,34,67,639,36.74998619006804,23.04264761821314
4335,/media/marda/TWOTB1/xBD/hurricanes/images/florence/hurricane-florence_00000306_post_disaster.png,45,31,1,494,539,95,126,597,32.69372486467165,24.314866932302266
4336,/media/marda/TWOTB1/xBD/hurricanes/images/florence/hurricane-florence_00000306_post_disaster.png,29,12,1,464,493,108,120,74,14.153763017713242,7.112658529504411
4337,/media/marda/TWOTB1/xBD/hurricanes/images/florence/hurricane-florence_00000306_post_disaster.png,48,37,1,470,518,146,183,744,34.28054198473808,28.979513163062176
4338,/media/marda/TWOTB1/xBD/hurricanes/images/florence/hurricane-florence_00000306_post_disaster.png,40,49,1,457,497,197,246,788,44.21418583544794,23.816287809572568
4339,/media/marda/TWOTB1/xBD/hurricanes/images/florence/hurricane-florence_00000306_post_disaster.png,26,16,1,433,459,209,225,68,11.148694980382976,8.134510929026565
4340,/media/marda/TWOTB1/xBD/hurricanes/images/florence/hurricane-florence_00000306_post_disaster.png,85,44,1,426,511,244,288,1840,70.35586726728879,34.96650603209044
4341,/media/marda/TWOTB1/xBD/hurricanes/images/florence/hurricane-florence_00000306_post_disaster.png,30,34,1,367,397,295,329,324,26.14829791348924,16.570682058434866
4342,/media/marda/TWOTB1/xBD/hurricanes/images/florence/hurricane-florence_00000306_post_disaster.png,45,52,1,459,504,302,354,968,43.70233043196847,29.395175293308796
4343,/media/marda/TWOTB1/xBD/hurricanes/images/florence/hurricane-florence_00000306_post_disaster.png,44,25,1,615,659,319,344,260,23.065125189341593,14.966629547095765
4344,/media/marda/TWOTB1/xBD/hurricanes/images/florence/hurricane-florence_00000306_post_disaster.png,24,30,1,413,437,565,595,73,10.54359503579634,9.216286721484693
4345,/media/marda/TWOTB1/xBD/hurricanes/images/florence/hurricane-florence_00000306_post_disaster.png,53,71,1,429,482,572,643,1453,56.10524159693441,35.235403792741785
4346,/media/marda/TWOTB1/xBD/hurricanes/images/florence/hurricane-florence_00000306_post_disaster.png,30,55,1,0,30,582,637,961,37.617251216524444,34.12749188085611
4347,/media/marda/TWOTB1/xBD/hurricanes/images/florence/hurricane-florence_00000306_post_disaster.png,31,51,1,40,71,657,708,536,28.801884777401348,24.882003711480365
4348,/media/marda/TWOTB1/xBD/hurricanes/images/florence/hurricane-florence_00000306_post_disaster.png,47,54,1,391,438,657,711,836,35.79433096073148,31.1277532276505
4349,/media/marda/TWOTB1/xBD/hurricanes/images/florence/hurricane-florence_00000306_post_disaster.png,48,62,1,564,612,682,744,921,42.52580355598769,28.78006970565363
4350,/media/marda/TWOTB1/xBD/hurricanes/images/florence/hurricane-florence_00000306_post_disaster.png,30,42,1,313,343,733,775,206,19.856719551097882,13.930549279628348
4351,/media/marda/TWOTB1/xBD/hurricanes/images/florence/hurricane-florence_00000306_post_disaster.png,40,86,1,92,132,734,820,1156,62.08429453240656,24.853828119006995
4352,/media/marda/TWOTB1/xBD/hurricanes/images/florence/hurricane-florence_00000306_post_disaster.png,34,38,1,676,710,742,780,79,10.218090085191601,9.855592096780684
4353,/media/marda/TWOTB1/xBD/hurricanes/images/florence/hurricane-florence_00000306_post_disaster.png,59,73,1,659,718,761,834,1280,49.33127070432,34.6432353864481
4354,/media/marda/TWOTB1/xBD/hurricanes/images/florence/hurricane-florence_00000306_post_disaster.png,98,104,1,576,674,769,873,3216,87.69210139592934,59.81430402653766
4355,/media/marda/TWOTB1/xBD/hurricanes/images/florence/hurricane-florence_00000306_post_disaster.png,55,62,1,279,334,779,841,1136,50.64616844082004,32.518742064628356
4356,/media/marda/TWOTB1/xBD/hurricanes/images/florence/hurricane-florence_00000306_post_disaster.png,64,77,1,432,496,781,858,1477,60.592611270217,35.634865988466636
4357,/media/marda/TWOTB1/xBD/hurricanes/images/florence/hurricane-florence_00000306_post_disaster.png,79,76,1,965,1044,802,878,1185,53.792924915151794,34.22672881489937
4358,/media/marda/TWOTB1/xBD/hurricanes/images/florence/hurricane-florence_00000306_post_disaster.png,55,57,1,182,237,804,861,1015,55.59317935426621,24.367615297649493
4359,/media/marda/TWOTB1/xBD/hurricanes/images/florence/hurricane-florence_00000306_post_disaster.png,63,92,1,561,624,833,925,1863,63.12337226910183,39.25457543440248
4360,/media/marda/TWOTB1/xBD/hurricanes/images/florence/hurricane-florence_00000306_post_disaster.png,55,64,1,650,705,834,898,902,35.298252410757755,34.13990860472603
4361,/media/marda/TWOTB1/xBD/hurricanes/images/florence/hurricane-florence_00000306_post_disaster.png,43,46,1,643,686,865,911,224,21.524616603505283,13.95841125873654
4362,/media/marda/TWOTB1/xBD/hurricanes/images/florence/hurricane-florence_00000306_post_disaster.png,57,61,1,987,1044,979,1040,364,26.181099689986702,18.62111730926323
4363,/media/marda/TWOTB1/xBD/hurricanes/images/florence/hurricane-florence_00000306_post_disaster.png,54,56,1,908,962,987,1043,256,19.925603990201967,17.157860607478064
4364,/media/marda/TWOTB1/xBD/hurricanes/images/florence/hurricane-florence_00000306_post_disaster.png,68,47,1,796,864,996,1043,180,40.57950670013795,6.032580793921293
4365,/media/marda/TWOTB1/xBD/hurricanes/images/florence/hurricane-florence_00000306_post_disaster.png,50,62,1,583,633,380,442,1116,54.642562321969,27.27199364023627
4366,/media/marda/TWOTB1/xBD/hurricanes/images/florence/hurricane-florence_00000120_pre_disaster.png,55,33,1,520,575,110,143,546,31.770621096227124,23.599058242468058
4367,/media/marda/TWOTB1/xBD/hurricanes/images/florence/hurricane-florence_00000120_pre_disaster.png,41,34,1,156,197,157,191,470,39.00208305784573,16.09900440029811
4368,/media/marda/TWOTB1/xBD/hurricanes/images/florence/hurricane-florence_00000120_pre_disaster.png,63,40,1,444,507,197,237,855,46.76530818466286,23.93345775916467
4369,/media/marda/TWOTB1/xBD/hurricanes/images/florence/hurricane-florence_00000120_pre_disaster.png,34,43,1,38,72,217,260,648,32.77746797594067,26.181789316061845
4370,/media/marda/TWOTB1/xBD/hurricanes/images/florence/hurricane-florence_00000120_pre_disaster.png,33,22,1,440,473,235,257,132,15.08018716977703,11.815006679643096
4371,/media/marda/TWOTB1/xBD/hurricanes/images/florence/hurricane-florence_00000120_pre_disaster.png,31,24,1,412,443,262,286,165,16.032214233410134,13.509756644312665
4372,/media/marda/TWOTB1/xBD/hurricanes/images/florence/hurricane-florence_00000120_pre_disaster.png,112,93,1,853,965,276,369,2811,95.39441707935337,39.18939968270184
4373,/media/marda/TWOTB1/xBD/hurricanes/images/florence/hurricane-florence_00000120_pre_disaster.png,35,21,1,408,443,287,308,131,19.58482037650441,8.878639666171743
4374,/media/marda/TWOTB1/xBD/hurricanes/images/florence/hurricane-florence_00000120_pre_disaster.png,44,37,1,494,538,307,344,402,23.68316332277739,22.364012081502032
4375,/media/marda/TWOTB1/xBD/hurricanes/images/florence/hurricane-florence_00000120_pre_disaster.png,101,77,1,923,1024,320,397,2047,65.37398879420655,41.48490391832402
4376,/media/marda/TWOTB1/xBD/hurricanes/images/florence/hurricane-florence_00000120_pre_disaster.png,31,31,1,401,432,350,381,172,17.972571653752862,12.85067017149324
4377,/media/marda/TWOTB1/xBD/hurricanes/images/florence/hurricane-florence_00000120_pre_disaster.png,100,77,1,822,922,367,444,2135,58.1175047940038,49.072489361029795
4378,/media/marda/TWOTB1/xBD/hurricanes/images/florence/hurricane-florence_00000120_pre_disaster.png,82,70,1,962,1044,389,459,1190,59.129429383145265,27.42556306496501
4379,/media/marda/TWOTB1/xBD/hurricanes/images/florence/hurricane-florence_00000120_pre_disaster.png,49,48,1,349,398,421,469,729,35.628706386900596,27.060597450232844
4380,/media/marda/TWOTB1/xBD/hurricanes/images/florence/hurricane-florence_00000120_pre_disaster.png,61,54,1,983,1044,429,483,408,31.74900984773952,19.763390109125478
4381,/media/marda/TWOTB1/xBD/hurricanes/images/florence/hurricane-florence_00000120_pre_disaster.png,57,35,1,934,991,443,478,183,19.471607324064447,14.400556311742468
4382,/media/marda/TWOTB1/xBD/hurricanes/images/florence/hurricane-florence_00000120_pre_disaster.png,51,31,1,945,996,452,483,82,20.45607585784343,5.290592067471217
4383,/media/marda/TWOTB1/xBD/hurricanes/images/florence/hurricane-florence_00000120_pre_disaster.png,64,40,1,979,1043,479,519,191,33.11600000927571,7.727297396781267
4384,/media/marda/TWOTB1/xBD/hurricanes/images/florence/hurricane-florence_00000120_pre_disaster.png,65,40,1,970,1035,489,529,224,32.42724367682075,9.246966693694336
4385,/media/marda/TWOTB1/xBD/hurricanes/images/florence/hurricane-florence_00000120_pre_disaster.png,40,57,1,209,249,741,798,594,31.981807440694528,24.359695460517568
4386,/media/marda/TWOTB1/xBD/hurricanes/images/florence/hurricane-florence_00000120_pre_disaster.png,42,85,1,24,66,868,953,1166,47.99835420980765,36.06854570987248
4387,/media/marda/TWOTB1/xBD/hurricanes/images/florence/hurricane-florence_00000120_pre_disaster.png,26,59,1,90,116,900,959,297,20.533547522445453,19.092562694995355
4388,/media/marda/TWOTB1/xBD/hurricanes/images/florence/hurricane-florence_00000294_pre_disaster.png,31,22,1,272,303,0,22,238,28.49106127376182,11.064051255860097
4389,/media/marda/TWOTB1/xBD/hurricanes/images/florence/hurricane-florence_00000294_pre_disaster.png,47,50,1,217,264,2,52,911,55.073098550868814,23.21315848126019
4390,/media/marda/TWOTB1/xBD/hurricanes/images/florence/hurricane-florence_00000294_pre_disaster.png,53,13,1,962,1015,22,35,137,17.766712212556534,10.381921350647772
4391,/media/marda/TWOTB1/xBD/hurricanes/images/florence/hurricane-florence_00000294_pre_disaster.png,63,29,1,720,783,79,108,913,39.20697043679077,30.964332058762892
4392,/media/marda/TWOTB1/xBD/hurricanes/images/florence/hurricane-florence_00000294_pre_disaster.png,41,18,1,681,722,94,112,234,19.85185043983834,15.65131678394534
4393,/media/marda/TWOTB1/xBD/hurricanes/images/florence/hurricane-florence_00000294_pre_disaster.png,65,34,1,864,929,135,169,531,31.963406850716076,21.849888224269186
4394,/media/marda/TWOTB1/xBD/hurricanes/images/florence/hurricane-florence_00000294_pre_disaster.png,73,66,1,716,789,150,216,2214,67.17054038863958,44.07791294053362
4395,/media/marda/TWOTB1/xBD/hurricanes/images/florence/hurricane-florence_00000294_pre_disaster.png,25,35,1,33,58,204,239,355,27.11408305018846,17.34365252564476
4396,/media/marda/TWOTB1/xBD/hurricanes/images/florence/hurricane-florence_00000294_pre_disaster.png,86,45,1,941,1027,212,257,697,55.82942099428986,16.521874604021892
4397,/media/marda/TWOTB1/xBD/hurricanes/images/florence/hurricane-florence_00000294_pre_disaster.png,52,56,1,90,142,218,274,1258,50.67108668226565,32.58833439889927
4398,/media/marda/TWOTB1/xBD/hurricanes/images/florence/hurricane-florence_00000294_pre_disaster.png,18,28,1,50,68,226,254,227,17.530087624011035,16.840877673385698
4399,/media/marda/TWOTB1/xBD/hurricanes/images/florence/hurricane-florence_00000294_pre_disaster.png,55,32,1,989,1044,243,275,186,24.440666652856585,10.462453079646986
4400,/media/marda/TWOTB1/xBD/hurricanes/images/florence/hurricane-florence_00000294_pre_disaster.png,23,30,1,72,95,258,288,265,20.95819446012303,16.863574474809074
4401,/media/marda/TWOTB1/xBD/hurricanes/images/florence/hurricane-florence_00000294_pre_disaster.png,55,32,1,887,942,315,347,193,20.592254748767306,12.388862640001605
4402,/media/marda/TWOTB1/xBD/hurricanes/images/florence/hurricane-florence_00000294_pre_disaster.png,49,61,1,121,170,317,378,1153,55.111033289407494,27.557253923852535
4403,/media/marda/TWOTB1/xBD/hurricanes/images/florence/hurricane-florence_00000294_pre_disaster.png,50,35,1,994,1044,323,358,118,19.915568827287792,9.11188997159013
4404,/media/marda/TWOTB1/xBD/hurricanes/images/florence/hurricane-florence_00000294_pre_disaster.png,37,32,1,476,513,328,360,197,18.99084519200091,13.779840881508091
4405,/media/marda/TWOTB1/xBD/hurricanes/images/florence/hurricane-florence_00000294_pre_disaster.png,83,60,1,850,933,347,407,1147,50.242571187911174,38.12701797457104
4406,/media/marda/TWOTB1/xBD/hurricanes/images/florence/hurricane-florence_00000294_pre_disaster.png,92,45,1,928,1020,348,393,732,62.0497691650544,15.641453751665512
4407,/media/marda/TWOTB1/xBD/hurricanes/images/florence/hurricane-florence_00000294_pre_disaster.png,26,35,1,117,143,362,397,260,20.063661687524437,17.616419530796083
4408,/media/marda/TWOTB1/xBD/hurricanes/images/florence/hurricane-florence_00000294_pre_disaster.png,39,33,1,449,488,362,395,258,19.38161167390472,17.682706506411396
4409,/media/marda/TWOTB1/xBD/hurricanes/images/florence/hurricane-florence_00000294_pre_disaster.png,45,38,1,491,536,364,402,389,24.456801501766126,20.89292023292292
4410,/media/marda/TWOTB1/xBD/hurricanes/images/florence/hurricane-florence_00000294_pre_disaster.png,34,45,1,92,126,366,411,570,28.287748070248835,26.810246839292926
4411,/media/marda/TWOTB1/xBD/hurricanes/images/florence/hurricane-florence_00000294_pre_disaster.png,40,34,1,514,554,379,413,247,20.736098297522823,15.727934680316539
4412,/media/marda/TWOTB1/xBD/hurricanes/images/florence/hurricane-florence_00000294_pre_disaster.png,65,63,1,424,489,389,452,1351,54.37920929115945,32.80916865467131
4413,/media/marda/TWOTB1/xBD/hurricanes/images/florence/hurricane-florence_00000294_pre_disaster.png,79,54,1,726,805,392,446,1309,53.55757287749493,32.00444939342088
4414,/media/marda/TWOTB1/xBD/hurricanes/images/florence/hurricane-florence_00000294_pre_disaster.png,47,59,1,184,231,448,507,933,40.038667263215885,32.580026799897446
4415,/media/marda/TWOTB1/xBD/hurricanes/images/florence/hurricane-florence_00000294_pre_disaster.png,36,45,1,130,166,457,502,475,29.22918613429309,21.63750439598812
4416,/media/marda/TWOTB1/xBD/hurricanes/images/florence/hurricane-florence_00000294_pre_disaster.png,40,40,1,562,602,486,526,251,22.66738652222228,14.73306032197434
4417,/media/marda/TWOTB1/xBD/hurricanes/images/florence/hurricane-florence_00000294_pre_disaster.png,46,40,1,528,574,496,536,245,28.434101335130414,11.351140334177527
4418,/media/marda/TWOTB1/xBD/hurricanes/images/florence/hurricane-florence_00000294_pre_disaster.png,73,57,1,509,582,519,576,1041,56.65118686577545,24.725941931124765
4419,/media/marda/TWOTB1/xBD/hurricanes/images/florence/hurricane-florence_00000294_pre_disaster.png,42,67,1,239,281,520,587,712,50.82613838768109,20.781096815078726
4420,/media/marda/TWOTB1/xBD/hurricanes/images/florence/hurricane-florence_00000294_pre_disaster.png,58,66,1,179,237,567,633,1246,49.155413930004634,33.57247411227418
4421,/media/marda/TWOTB1/xBD/hurricanes/images/florence/hurricane-florence_00000294_pre_disaster.png,71,77,1,973,1044,665,742,1244,52.89019482288648,31.074946028281452
4422,/media/marda/TWOTB1/xBD/hurricanes/images/florence/hurricane-florence_00000294_pre_disaster.png,39,69,1,125,164,668,737,759,50.42385504820143,20.71087413546893
4423,/media/marda/TWOTB1/xBD/hurricanes/images/florence/hurricane-florence_00000294_pre_disaster.png,67,72,1,613,680,676,748,1154,46.79110610342229,32.74504215119385
4424,/media/marda/TWOTB1/xBD/hurricanes/images/florence/hurricane-florence_00000294_pre_disaster.png,38,39,1,646,684,685,724,112,12.399578587160951,12.018923932427258
4425,/media/marda/TWOTB1/xBD/hurricanes/images/florence/hurricane-florence_00000294_pre_disaster.png,47,51,1,660,707,697,748,291,19.976358003991628,19.25902756023573
4426,/media/marda/TWOTB1/xBD/hurricanes/images/florence/hurricane-florence_00000294_pre_disaster.png,46,59,1,446,492,721,780,544,29.240672270762282,24.631512434086385
4427,/media/marda/TWOTB1/xBD/hurricanes/images/florence/hurricane-florence_00000294_pre_disaster.png,35,68,1,4,39,752,820,813,38.26807043220735,28.331035382486753
4428,/media/marda/TWOTB1/xBD/hurricanes/images/florence/hurricane-florence_00000294_pre_disaster.png,58,67,1,698,756,780,847,653,38.14931422070843,22.43399079418065
4429,/media/marda/TWOTB1/xBD/hurricanes/images/florence/hurricane-florence_00000294_pre_disaster.png,51,48,1,843,894,795,843,176,17.43125536730445,13.34661847621231
4430,/media/marda/TWOTB1/xBD/hurricanes/images/florence/hurricane-florence_00000294_pre_disaster.png,55,55,1,858,913,812,867,291,21.165750326920215,18.16165104460058
4431,/media/marda/TWOTB1/xBD/hurricanes/images/florence/hurricane-florence_00000294_pre_disaster.png,77,83,1,814,891,817,900,1413,50.21215827351289,37.402088729054356
4432,/media/marda/TWOTB1/xBD/hurricanes/images/florence/hurricane-florence_00000294_pre_disaster.png,18,50,1,164,182,837,887,149,15.499469965208178,12.652953280072753
4433,/media/marda/TWOTB1/xBD/hurricanes/images/florence/hurricane-florence_00000294_pre_disaster.png,46,60,1,413,459,865,925,466,26.382073103006203,23.31602719434802
4434,/media/marda/TWOTB1/xBD/hurricanes/images/florence/hurricane-florence_00000294_pre_disaster.png,48,70,1,537,585,867,937,560,37.49937965144293,20.47219605883144
4435,/media/marda/TWOTB1/xBD/hurricanes/images/florence/hurricane-florence_00000294_pre_disaster.png,31,59,1,131,162,869,928,350,30.954293523211714,15.00921751584796
4436,/media/marda/TWOTB1/xBD/hurricanes/images/florence/hurricane-florence_00000294_pre_disaster.png,46,65,1,505,551,900,965,399,31.091308559119742,16.957684268397617
4437,/media/marda/TWOTB1/xBD/hurricanes/images/florence/hurricane-florence_00000294_pre_disaster.png,83,98,1,570,653,944,1042,1641,76.92832870477382,28.780552018037664
4438,/media/marda/TWOTB1/xBD/hurricanes/images/florence/hurricane-florence_00000294_pre_disaster.png,63,76,1,435,498,961,1037,744,56.35045728709168,17.550501791924034
4439,/media/marda/TWOTB1/xBD/hurricanes/images/florence/hurricane-florence_00000294_pre_disaster.png,62,72,1,542,604,970,1042,857,43.87180668897077,25.923530722365392
4440,/media/marda/TWOTB1/xBD/hurricanes/images/florence/hurricane-florence_00000294_pre_disaster.png,32,52,1,51,83,992,1044,233,28.33266747839767,11.925176430894208
4441,/media/marda/TWOTB1/xBD/hurricanes/images/florence/hurricane-florence_00000191_post_disaster.png,65,33,1,915,980,32,65,699,34.5950717692382,26.72544699575734
4442,/media/marda/TWOTB1/xBD/hurricanes/images/florence/hurricane-florence_00000191_post_disaster.png,78,38,1,915,993,66,104,1017,42.218555287504664,33.499367383722145
4443,/media/marda/TWOTB1/xBD/hurricanes/images/florence/hurricane-florence_00000191_post_disaster.png,96,137,1,779,875,78,215,4061,154.12375690323017,35.80091657785597
4444,/media/marda/TWOTB1/xBD/hurricanes/images/florence/hurricane-florence_00000191_post_disaster.png,42,14,1,758,800,88,102,119,13.016298233563385,12.313039245185111
4445,/media/marda/TWOTB1/xBD/hurricanes/images/florence/hurricane-florence_00000191_post_disaster.png,80,31,1,924,1004,98,129,840,46.2849876114113,23.9568501708973
4446,/media/marda/TWOTB1/xBD/hurricanes/images/florence/hurricane-florence_00000191_post_disaster.png,95,162,1,706,801,123,285,3993,181.71606801891642,30.70439850708399
4447,/media/marda/TWOTB1/xBD/hurricanes/images/florence/hurricane-florence_00000191_post_disaster.png,81,32,1,943,1024,173,205,751,47.48549101791623,20.810490423660546
4448,/media/marda/TWOTB1/xBD/hurricanes/images/florence/hurricane-florence_00000191_post_disaster.png,129,53,1,461,590,174,227,2594,123.401968966652,30.085163243460904
4449,/media/marda/TWOTB1/xBD/hurricanes/images/florence/hurricane-florence_00000191_post_disaster.png,56,29,1,884,940,181,210,299,24.68676385943021,16.238513329173312
4450,/media/marda/TWOTB1/xBD/hurricanes/images/florence/hurricane-florence_00000191_post_disaster.png,73,41,1,404,477,188,229,1213,59.96897497920346,27.00059965143573
4451,/media/marda/TWOTB1/xBD/hurricanes/images/florence/hurricane-florence_00000191_post_disaster.png,46,45,1,43,89,201,246,1289,45.25850556348741,36.37106353729089
4452,/media/marda/TWOTB1/xBD/hurricanes/images/florence/hurricane-florence_00000191_post_disaster.png,35,18,1,512,547,207,225,83,15.685323699384886,7.141475222106989
4453,/media/marda/TWOTB1/xBD/hurricanes/images/florence/hurricane-florence_00000191_post_disaster.png,60,53,1,814,874,212,265,746,46.408158854281425,21.363508690858133
4454,/media/marda/TWOTB1/xBD/hurricanes/images/florence/hurricane-florence_00000191_post_disaster.png,108,44,1,486,594,213,257,1381,93.06617076564508,20.72356842627802
4455,/media/marda/TWOTB1/xBD/hurricanes/images/florence/hurricane-florence_00000191_post_disaster.png,32,24,1,401,433,231,255,177,17.434495341669006,13.519567619226137
4456,/media/marda/TWOTB1/xBD/hurricanes/images/florence/hurricane-florence_00000191_post_disaster.png,163,96,1,374,537,279,375,7121,150.55443022876577,81.27187516246794
4457,/media/marda/TWOTB1/xBD/hurricanes/images/florence/hurricane-florence_00000191_post_disaster.png,69,36,1,905,974,279,315,566,34.06581139627215,22.215477963855513
4458,/media/marda/TWOTB1/xBD/hurricanes/images/florence/hurricane-florence_00000191_post_disaster.png,106,64,1,522,628,288,352,3167,83.0714278947905,56.723285071299294
4459,/media/marda/TWOTB1/xBD/hurricanes/images/florence/hurricane-florence_00000191_post_disaster.png,74,42,1,969,1043,295,337,889,40.46319824884656,28.954288628497366
4460,/media/marda/TWOTB1/xBD/hurricanes/images/florence/hurricane-florence_00000191_post_disaster.png,72,32,1,822,894,294,326,393,44.52396935353861,11.715215336910417
4461,/media/marda/TWOTB1/xBD/hurricanes/images/florence/hurricane-florence_00000191_post_disaster.png,52,30,1,936,988,299,329,192,17.40893060553459,14.576854623931618
4462,/media/marda/TWOTB1/xBD/hurricanes/images/florence/hurricane-florence_00000191_post_disaster.png,68,51,1,771,839,329,380,860,41.8235645246169,28.071689245512726
4463,/media/marda/TWOTB1/xBD/hurricanes/images/florence/hurricane-florence_00000191_post_disaster.png,49,30,1,398,447,342,372,425,34.056341398865634,16.22003193984053
4464,/media/marda/TWOTB1/xBD/hurricanes/images/florence/hurricane-florence_00000191_post_disaster.png,75,42,1,796,871,366,408,820,45.4624274990894,23.790601476395242
4465,/media/marda/TWOTB1/xBD/hurricanes/images/florence/hurricane-florence_00000191_post_disaster.png,53,42,1,919,972,383,425,283,32.47160551513731,11.5663554601186
4466,/media/marda/TWOTB1/xBD/hurricanes/images/florence/hurricane-florence_00000191_post_disaster.png,90,91,1,836,926,403,494,2619,75.58744884298251,45.797936401390096
4467,/media/marda/TWOTB1/xBD/hurricanes/images/florence/hurricane-florence_00000191_post_disaster.png,140,113,1,490,630,424,537,7407,115.0709346012047,86.50533010759314
4468,/media/marda/TWOTB1/xBD/hurricanes/images/florence/hurricane-florence_00000191_post_disaster.png,91,75,1,945,1036,429,504,1981,60.77980062312958,45.43687237572036
4469,/media/marda/TWOTB1/xBD/hurricanes/images/florence/hurricane-florence_00000191_post_disaster.png,48,33,1,0,48,464,497,590,54.8779181152707,14.290356842283837
4470,/media/marda/TWOTB1/xBD/hurricanes/images/florence/hurricane-florence_00000191_post_disaster.png,74,95,1,969,1043,490,585,1804,75.62517891990096,35.9529379884649
4471,/media/marda/TWOTB1/xBD/hurricanes/images/florence/hurricane-florence_00000191_post_disaster.png,66,64,1,846,912,492,556,880,44.02013963501366,26.71872220805579
4472,/media/marda/TWOTB1/xBD/hurricanes/images/florence/hurricane-florence_00000191_post_disaster.png,53,43,1,160,213,494,537,529,51.8751379421053,13.617797335616443
4473,/media/marda/TWOTB1/xBD/hurricanes/images/florence/hurricane-florence_00000191_post_disaster.png,104,73,1,566,670,511,584,2367,89.71297383359592,34.9259411838597
4474,/media/marda/TWOTB1/xBD/hurricanes/images/florence/hurricane-florence_00000191_post_disaster.png,22,47,1,0,22,521,568,408,26.982893739100675,20.22952096598505
4475,/media/marda/TWOTB1/xBD/hurricanes/images/florence/hurricane-florence_00000191_post_disaster.png,107,67,1,473,580,537,604,2207,100.31814326249942,30.739333397267554
4476,/media/marda/TWOTB1/xBD/hurricanes/images/florence/hurricane-florence_00000191_post_disaster.png,114,115,1,600,714,549,664,5534,92.49329262081898,78.76053979836456
4477,/media/marda/TWOTB1/xBD/hurricanes/images/florence/hurricane-florence_00000191_post_disaster.png,82,62,1,867,949,551,613,1218,44.992991333691734,36.114012015438924
4478,/media/marda/TWOTB1/xBD/hurricanes/images/florence/hurricane-florence_00000191_post_disaster.png,107,88,1,373,480,560,648,3863,101.68870901313386,50.21202881657353
4479,/media/marda/TWOTB1/xBD/hurricanes/images/florence/hurricane-florence_00000191_post_disaster.png,28,48,1,163,191,561,609,419,27.603860166754842,20.294273533700284
4480,/media/marda/TWOTB1/xBD/hurricanes/images/florence/hurricane-florence_00000191_post_disaster.png,105,69,1,486,591,569,638,2176,97.90939981702759,29.320986837722604
4481,/media/marda/TWOTB1/xBD/hurricanes/images/florence/hurricane-florence_00000191_post_disaster.png,39,49,1,4,43,575,624,716,42.292818336608306,22.394115587279114
4482,/media/marda/TWOTB1/xBD/hurricanes/images/florence/hurricane-florence_00000191_post_disaster.png,34,51,1,137,171,597,648,525,30.776037092877466,22.454381990227333
4483,/media/marda/TWOTB1/xBD/hurricanes/images/florence/hurricane-florence_00000191_post_disaster.png,49,109,1,314,363,597,706,1446,95.68393459131536,20.181656733348344
4484,/media/marda/TWOTB1/xBD/hurricanes/images/florence/hurricane-florence_00000191_post_disaster.png,31,43,1,352,383,602,645,231,18.628205251405873,16.608975172817566
4485,/media/marda/TWOTB1/xBD/hurricanes/images/florence/hurricane-florence_00000191_post_disaster.png,19,40,1,29,48,619,659,219,19.649917973143967,14.807157765079692
4486,/media/marda/TWOTB1/xBD/hurricanes/images/florence/hurricane-florence_00000191_post_disaster.png,41,77,1,353,394,621,698,887,57.09159818217953,20.771205621452083
4487,/media/marda/TWOTB1/xBD/hurricanes/images/florence/hurricane-florence_00000191_post_disaster.png,73,99,1,502,575,624,723,2556,78.3114372793497,43.40656035498656
4488,/media/marda/TWOTB1/xBD/hurricanes/images/florence/hurricane-florence_00000191_post_disaster.png,52,63,1,391,443,629,692,971,36.789731220018346,35.05823373731354
4489,/media/marda/TWOTB1/xBD/hurricanes/images/florence/hurricane-florence_00000191_post_disaster.png,51,63,1,200,251,636,699,1180,41.20045311829367,37.68319439381096
4490,/media/marda/TWOTB1/xBD/hurricanes/images/florence/hurricane-florence_00000191_post_disaster.png,65,71,1,552,617,644,715,1337,43.461112298565084,41.23314833033502
4491,/media/marda/TWOTB1/xBD/hurricanes/images/florence/hurricane-florence_00000191_post_disaster.png,86,66,1,871,957,650,716,1378,54.22655424839316,35.646368112047405
4492,/media/marda/TWOTB1/xBD/hurricanes/images/florence/hurricane-florence_00000191_post_disaster.png,74,90,1,32,106,661,751,2784,71.00742748905047,55.294697610201986
4493,/media/marda/TWOTB1/xBD/hurricanes/images/florence/hurricane-florence_00000191_post_disaster.png,41,77,1,369,410,685,762,884,56.44226387172637,20.85436594319095
4494,/media/marda/TWOTB1/xBD/hurricanes/images/florence/hurricane-florence_00000191_post_disaster.png,47,77,1,221,268,692,769,1285,48.21384929756886,35.57929737423626
4495,/media/marda/TWOTB1/xBD/hurricanes/images/florence/hurricane-florence_00000191_post_disaster.png,40,79,1,337,377,693,772,807,54.11654526459422,19.892940764979052
4496,/media/marda/TWOTB1/xBD/hurricanes/images/florence/hurricane-florence_00000191_post_disaster.png,88,61,1,893,981,716,777,988,53.975690327514116,24.104324328514537
4497,/media/marda/TWOTB1/xBD/hurricanes/images/florence/hurricane-florence_00000191_post_disaster.png,100,78,1,579,679,730,808,1806,88.8670661416385,27.909436914885024
4498,/media/marda/TWOTB1/xBD/hurricanes/images/florence/hurricane-florence_00000191_post_disaster.png,63,105,1,677,740,746,851,2026,81.06447260422301,33.747331722647665
4499,/media/marda/TWOTB1/xBD/hurricanes/images/florence/hurricane-florence_00000191_post_disaster.png,75,110,1,497,572,779,889,2202,89.71651571868654,35.39258437824907
4500,/media/marda/TWOTB1/xBD/hurricanes/images/florence/hurricane-florence_00000191_post_disaster.png,72,125,1,424,496,781,906,2964,106.47942799146819,38.048631968958055
4501,/media/marda/TWOTB1/xBD/hurricanes/images/florence/hurricane-florence_00000191_post_disaster.png,56,43,1,900,956,783,826,172,20.040280395594,11.50354101479448
4502,/media/marda/TWOTB1/xBD/hurricanes/images/florence/hurricane-florence_00000191_post_disaster.png,49,46,1,994,1043,784,830,96,13.018369253468178,9.877347444324815
4503,/media/marda/TWOTB1/xBD/hurricanes/images/florence/hurricane-florence_00000191_post_disaster.png,79,71,1,911,990,797,868,920,44.19466977320076,30.322491155508995
4504,/media/marda/TWOTB1/xBD/hurricanes/images/florence/hurricane-florence_00000191_post_disaster.png,61,129,1,218,279,836,965,2961,102.96017645465591,38.700959644351556
4505,/media/marda/TWOTB1/xBD/hurricanes/images/florence/hurricane-florence_00000191_post_disaster.png,76,81,1,373,449,837,918,1943,65.81792168287262,39.958611723423225
4506,/media/marda/TWOTB1/xBD/hurricanes/images/florence/hurricane-florence_00000191_post_disaster.png,70,73,1,928,998,839,912,892,40.40398609106763,29.452718522019282
4507,/media/marda/TWOTB1/xBD/hurricanes/images/florence/hurricane-florence_00000191_post_disaster.png,106,90,1,274,380,856,946,3085,104.42415579999282,39.98061401145056
4508,/media/marda/TWOTB1/xBD/hurricanes/images/florence/hurricane-florence_00000191_post_disaster.png,97,88,1,621,718,878,966,1709,73.64215417050205,36.11318084706898
4509,/media/marda/TWOTB1/xBD/hurricanes/images/florence/hurricane-florence_00000191_post_disaster.png,78,109,1,521,599,887,996,1634,74.45931351571004,34.89987922966724
4510,/media/marda/TWOTB1/xBD/hurricanes/images/florence/hurricane-florence_00000191_post_disaster.png,103,89,1,686,789,909,998,1929,78.59425367319413,38.59707361154378
4511,/media/marda/TWOTB1/xBD/hurricanes/images/florence/hurricane-florence_00000191_post_disaster.png,40,67,1,473,513,910,977,416,30.441621896304383,18.2643784314748
4512,/media/marda/TWOTB1/xBD/hurricanes/images/florence/hurricane-florence_00000191_post_disaster.png,72,67,1,937,1009,911,978,712,35.239436102606966,26.64432382190906
4513,/media/marda/TWOTB1/xBD/hurricanes/images/florence/hurricane-florence_00000191_post_disaster.png,58,55,1,985,1043,916,971,218,17.60783753133855,16.517601405744383
4514,/media/marda/TWOTB1/xBD/hurricanes/images/florence/hurricane-florence_00000191_post_disaster.png,178,105,1,350,528,936,1041,4982,194.3155753929366,60.88419041729802
4515,/media/marda/TWOTB1/xBD/hurricanes/images/florence/hurricane-florence_00000191_post_disaster.png,82,71,1,74,156,940,1011,1168,90.18743246488995,17.29798862993695
4516,/media/marda/TWOTB1/xBD/hurricanes/images/florence/hurricane-florence_00000191_post_disaster.png,81,99,1,650,731,942,1041,1872,68.34232930540087,42.64786183922907
4517,/media/marda/TWOTB1/xBD/hurricanes/images/florence/hurricane-florence_00000191_post_disaster.png,64,69,1,0,64,963,1032,949,73.95952570735835,17.139563329322755
4518,/media/marda/TWOTB1/xBD/hurricanes/images/florence/hurricane-florence_00000191_post_disaster.png,83,72,1,80,163,963,1035,1184,92.21567926572064,17.13060672454217
4519,/media/marda/TWOTB1/xBD/hurricanes/images/florence/hurricane-florence_00000191_post_disaster.png,56,63,1,734,790,968,1031,451,26.41626955627432,22.768133418260415
4520,/media/marda/TWOTB1/xBD/hurricanes/images/florence/hurricane-florence_00000191_post_disaster.png,58,70,1,544,602,971,1041,773,35.41852803578247,30.553182340036383
4521,/media/marda/TWOTB1/xBD/hurricanes/images/florence/hurricane-florence_00000191_post_disaster.png,67,57,1,3,70,986,1043,563,63.63469765779992,13.18497439496498
4522,/media/marda/TWOTB1/xBD/hurricanes/images/florence/hurricane-florence_00000191_post_disaster.png,77,51,1,966,1043,992,1043,226,37.202758644549334,9.335734551623066
4523,/media/marda/TWOTB1/xBD/hurricanes/images/florence/hurricane-florence_00000090_post_disaster.png,50,60,1,725,775,570,630,551,36.11452294303302,21.377510019882223
4524,/media/marda/TWOTB1/xBD/hurricanes/images/florence/hurricane-florence_00000090_post_disaster.png,72,75,1,582,654,755,830,1208,48.21159343182828,33.327686851168174
4525,/media/marda/TWOTB1/xBD/hurricanes/images/florence/hurricane-florence_00000090_post_disaster.png,77,84,1,462,539,885,969,1443,52.41401615673607,37.80345191267937
4526,/media/marda/TWOTB1/xBD/hurricanes/images/florence/hurricane-florence_00000090_post_disaster.png,68,81,1,399,467,940,1021,1195,44.08375748770758,36.33860380268759
4527,/media/marda/TWOTB1/xBD/hurricanes/images/florence/hurricane-florence_00000090_post_disaster.png,56,67,1,345,401,974,1041,831,40.95582754022522,27.702861431823646
4528,/media/marda/TWOTB1/xBD/hurricanes/images/florence/hurricane-florence_00000271_post_disaster.png,34,63,1,374,408,961,1024,395,30.25020485889177,17.29177893489921
4529,/media/marda/TWOTB1/xBD/hurricanes/images/florence/hurricane-florence_00000271_post_disaster.png,55,63,1,468,523,980,1043,523,34.69668510335831,20.27376489693357
4530,/media/marda/TWOTB1/xBD/hurricanes/images/florence/hurricane-florence_00000531_post_disaster.png,66,58,1,170,236,90,148,3085,64.6700172067546,63.67619079568086
4531,/media/marda/TWOTB1/xBD/hurricanes/images/florence/hurricane-florence_00000531_post_disaster.png,68,24,1,549,617,66,90,1041,52.27996865139066,26.42615017378995
4532,/media/marda/TWOTB1/xBD/hurricanes/images/florence/hurricane-florence_00000292_post_disaster.png,74,65,1,932,1006,428,493,830,56.343974546730514,19.62476813350011
4533,/media/marda/TWOTB1/xBD/hurricanes/images/florence/hurricane-florence_00000292_post_disaster.png,57,36,1,909,966,485,521,254,19.277335440536778,17.241913702124954
4534,/media/marda/TWOTB1/xBD/hurricanes/images/florence/hurricane-florence_00000292_post_disaster.png,74,61,1,877,951,655,716,588,50.25387539360551,15.502686301994562
4535,/media/marda/TWOTB1/xBD/hurricanes/images/florence/hurricane-florence_00000292_post_disaster.png,58,75,1,546,604,692,767,976,47.52284629606014,27.243520411844422
4536,/media/marda/TWOTB1/xBD/hurricanes/images/florence/hurricane-florence_00000292_post_disaster.png,46,52,1,452,498,730,782,368,30.852621204256895,15.709597387642885
4537,/media/marda/TWOTB1/xBD/hurricanes/images/florence/hurricane-florence_00000292_post_disaster.png,39,52,1,468,507,749,801,298,21.539251068578906,18.345363255282127
4538,/media/marda/TWOTB1/xBD/hurricanes/images/florence/hurricane-florence_00000292_post_disaster.png,78,61,1,720,798,753,814,622,57.44207596724492,14.41853467495914
4539,/media/marda/TWOTB1/xBD/hurricanes/images/florence/hurricane-florence_00000292_post_disaster.png,46,48,1,726,772,785,833,144,17.658501455166398,10.921924622931495
4540,/media/marda/TWOTB1/xBD/hurricanes/images/florence/hurricane-florence_00000292_post_disaster.png,72,78,1,891,963,813,891,585,54.57725136144143,14.250565178153801
4541,/media/marda/TWOTB1/xBD/hurricanes/images/florence/hurricane-florence_00000292_post_disaster.png,46,46,1,742,788,865,911,141,16.419593620753012,11.390392561660661
4542,/media/marda/TWOTB1/xBD/hurricanes/images/florence/hurricane-florence_00000292_post_disaster.png,51,55,1,733,784,882,937,246,26.316679082793673,12.44399924606281
4543,/media/marda/TWOTB1/xBD/hurricanes/images/florence/hurricane-florence_00000508_pre_disaster.png,263,164,1,0,263,153,317,10628,322.24021662259963,43.99375857678582
4544,/media/marda/TWOTB1/xBD/hurricanes/images/florence/hurricane-florence_00000508_pre_disaster.png,317,179,1,36,353,260,439,12712,375.6658322775714,45.05313801160481
4545,/media/marda/TWOTB1/xBD/hurricanes/images/florence/hurricane-florence_00000508_pre_disaster.png,320,178,1,115,435,371,549,12242,374.3037569390986,43.555404618283795
4546,/media/marda/TWOTB1/xBD/hurricanes/images/florence/hurricane-florence_00000508_pre_disaster.png,323,184,1,187,510,466,650,12274,375.49689812949987,43.52674817701451
4547,/media/marda/TWOTB1/xBD/hurricanes/images/florence/hurricane-florence_00000508_pre_disaster.png,293,173,1,280,573,567,740,10859,339.3005468988197,42.57304145932961
4548,/media/marda/TWOTB1/xBD/hurricanes/images/florence/hurricane-florence_00000508_pre_disaster.png,65,73,1,626,691,596,669,951,51.400642087910384,24.51625182283772
4549,/media/marda/TWOTB1/xBD/hurricanes/images/florence/hurricane-florence_00000508_pre_disaster.png,55,44,1,595,650,659,703,262,33.38289965141872,10.530502915948267
4550,/media/marda/TWOTB1/xBD/hurricanes/images/florence/hurricane-florence_00000508_pre_disaster.png,131,102,1,386,517,677,779,4238,127.42070520055343,44.11519787447954
4551,/media/marda/TWOTB1/xBD/hurricanes/images/florence/hurricane-florence_00000508_pre_disaster.png,42,56,1,471,513,791,847,323,23.669175981040347,18.2684659512283
4552,/media/marda/TWOTB1/xBD/hurricanes/images/florence/hurricane-florence_00000508_pre_disaster.png,57,89,1,539,596,902,991,1346,52.62465280043518,33.83925703953371
4553,/media/marda/TWOTB1/xBD/hurricanes/images/florence/hurricane-florence_00000508_pre_disaster.png,33,58,1,255,288,914,972,361,26.7771705978174,17.839730279657772
4554,/media/marda/TWOTB1/xBD/hurricanes/images/florence/hurricane-florence_00000508_pre_disaster.png,43,51,1,502,545,993,1044,131,21.00636588398575,9.600959787325158
4555,/media/marda/TWOTB1/xBD/hurricanes/images/florence/hurricane-florence_00000437_pre_disaster.png,26,26,1,0,26,0,26,376,29.922037851590346,18.651004565840722
4556,/media/marda/TWOTB1/xBD/hurricanes/images/florence/hurricane-florence_00000437_pre_disaster.png,37,56,1,287,324,69,125,744,61.832680765889506,16.077978258689807
4557,/media/marda/TWOTB1/xBD/hurricanes/images/florence/hurricane-florence_00000437_pre_disaster.png,16,27,1,0,16,125,152,200,20.52267360110119,13.492126157973182
4558,/media/marda/TWOTB1/xBD/hurricanes/images/florence/hurricane-florence_00000437_pre_disaster.png,10,14,1,3,13,162,176,49,9.453244276508485,7.00037038733998
4559,/media/marda/TWOTB1/xBD/hurricanes/images/florence/hurricane-florence_00000437_pre_disaster.png,62,37,1,879,941,396,433,309,26.551943017755676,15.92071217381379
4560,/media/marda/TWOTB1/xBD/hurricanes/images/florence/hurricane-florence_00000437_pre_disaster.png,97,64,1,796,893,429,493,1475,58.86830449829248,39.18578652118309
4561,/media/marda/TWOTB1/xBD/hurricanes/images/florence/hurricane-florence_00000437_pre_disaster.png,42,26,1,833,875,466,492,50,8.517499240128604,7.933083051021756
4562,/media/marda/TWOTB1/xBD/hurricanes/images/florence/hurricane-florence_00000437_pre_disaster.png,44,27,1,826,870,473,500,62,11.724167133333351,7.163665163731003
4563,/media/marda/TWOTB1/xBD/hurricanes/images/florence/hurricane-florence_00000437_pre_disaster.png,59,41,1,808,867,490,531,264,24.277092130322785,15.757087017209237
4564,/media/marda/TWOTB1/xBD/hurricanes/images/florence/hurricane-florence_00000437_pre_disaster.png,53,38,1,873,926,530,568,189,17.584759927536382,14.188966233963104
4565,/media/marda/TWOTB1/xBD/hurricanes/images/florence/hurricane-florence_00000437_pre_disaster.png,76,73,1,629,705,588,661,1170,61.3028872982578,25.406895925443656
4566,/media/marda/TWOTB1/xBD/hurricanes/images/florence/hurricane-florence_00000105_pre_disaster.png,70,47,1,875,945,292,339,902,34.70357580649287,33.680714141177646
4567,/media/marda/TWOTB1/xBD/hurricanes/images/florence/hurricane-florence_00000465_pre_disaster.png,72,18,1,101,173,0,18,705,71.34688715013041,15.673372637561405
4568,/media/marda/TWOTB1/xBD/hurricanes/images/florence/hurricane-florence_00000465_pre_disaster.png,72,69,1,214,286,294,363,2020,63.40213937459522,42.64392874040783
4569,/media/marda/TWOTB1/xBD/hurricanes/images/florence/hurricane-florence_00000465_pre_disaster.png,98,90,1,852,950,302,392,2456,76.52847540270952,43.626141051172304
4570,/media/marda/TWOTB1/xBD/hurricanes/images/florence/hurricane-florence_00000465_pre_disaster.png,86,64,1,710,796,360,424,1618,51.25599017510494,42.20279989344068
4571,/media/marda/TWOTB1/xBD/hurricanes/images/florence/hurricane-florence_00000465_pre_disaster.png,86,71,1,425,511,374,445,2308,67.2490819913374,52.15947894009574
4572,/media/marda/TWOTB1/xBD/hurricanes/images/florence/hurricane-florence_00000465_pre_disaster.png,80,96,1,719,799,472,568,2537,76.40173672076014,47.42333903091464
4573,/media/marda/TWOTB1/xBD/hurricanes/images/florence/hurricane-florence_00000465_pre_disaster.png,91,96,1,681,772,555,651,2751,71.59388325401856,53.28106255852334
4574,/media/marda/TWOTB1/xBD/hurricanes/images/florence/hurricane-florence_00000465_pre_disaster.png,112,93,1,785,897,705,798,2726,78.97960608524015,55.11456719311838
4575,/media/marda/TWOTB1/xBD/hurricanes/images/florence/hurricane-florence_00000465_pre_disaster.png,106,86,1,734,840,783,869,2200,69.2443256054016,48.06297968375685
4576,/media/marda/TWOTB1/xBD/hurricanes/images/florence/hurricane-florence_00000465_pre_disaster.png,66,100,1,222,288,807,907,2223,64.67594333187826,48.39230977026159
4577,/media/marda/TWOTB1/xBD/hurricanes/images/florence/hurricane-florence_00000465_pre_disaster.png,80,85,1,570,650,882,967,1807,53.5399940065912,43.98177575542652
4578,/media/marda/TWOTB1/xBD/hurricanes/images/florence/hurricane-florence_00000465_pre_disaster.png,74,95,1,246,320,883,978,2269,69.37763667101754,48.21571424172851
4579,/media/marda/TWOTB1/xBD/hurricanes/images/florence/hurricane-florence_00000465_pre_disaster.png,91,96,1,482,573,906,1002,2410,68.66377584355693,48.70635598245769
4580,/media/marda/TWOTB1/xBD/hurricanes/images/florence/hurricane-florence_00000465_pre_disaster.png,26,53,1,59,85,991,1044,175,22.03331419752524,12.178931463621163
4581,/media/marda/TWOTB1/xBD/hurricanes/images/florence/hurricane-florence_00000038_post_disaster.png,52,12,1,619,671,0,12,182,25.708348877984193,10.52554576400714
4582,/media/marda/TWOTB1/xBD/hurricanes/images/florence/hurricane-florence_00000038_post_disaster.png,42,22,1,528,570,10,32,249,21.35221036732323,15.54666199783567
4583,/media/marda/TWOTB1/xBD/hurricanes/images/florence/hurricane-florence_00000038_post_disaster.png,117,80,1,578,695,31,111,3206,103.84090577006764,46.283293266340365
4584,/media/marda/TWOTB1/xBD/hurricanes/images/florence/hurricane-florence_00000038_post_disaster.png,60,31,1,436,496,46,77,607,48.98340422360008,16.51059775945814
4585,/media/marda/TWOTB1/xBD/hurricanes/images/florence/hurricane-florence_00000038_post_disaster.png,36,18,1,453,489,81,99,166,22.352159353342977,9.850593256930436
4586,/media/marda/TWOTB1/xBD/hurricanes/images/florence/hurricane-florence_00000038_post_disaster.png,25,19,1,277,302,109,128,128,17.535182537020848,9.643741410539745
4587,/media/marda/TWOTB1/xBD/hurricanes/images/florence/hurricane-florence_00000038_post_disaster.png,38,25,1,489,527,112,137,220,19.20952573650641,15.238784966639875
4588,/media/marda/TWOTB1/xBD/hurricanes/images/florence/hurricane-florence_00000038_post_disaster.png,76,64,1,379,455,253,317,1814,65.06302384408042,38.18537000650667
4589,/media/marda/TWOTB1/xBD/hurricanes/images/florence/hurricane-florence_00000038_post_disaster.png,66,54,1,586,652,336,390,1040,44.01107749463352,31.530681241237257
4590,/media/marda/TWOTB1/xBD/hurricanes/images/florence/hurricane-florence_00000038_post_disaster.png,46,35,1,632,678,374,409,254,19.350988418088868,17.554934933401977
4591,/media/marda/TWOTB1/xBD/hurricanes/images/florence/hurricane-florence_00000038_post_disaster.png,37,78,1,0,37,426,504,1333,63.61233284152941,29.21438965534153
4592,/media/marda/TWOTB1/xBD/hurricanes/images/florence/hurricane-florence_00000038_post_disaster.png,52,45,1,981,1033,749,794,124,15.362158884224042,10.796958541639553
4593,/media/marda/TWOTB1/xBD/hurricanes/images/florence/hurricane-florence_00000038_post_disaster.png,67,64,1,945,1012,791,855,521,34.527783455543144,19.828789237548158
4594,/media/marda/TWOTB1/xBD/hurricanes/images/florence/hurricane-florence_00000209_post_disaster.png,67,39,1,589,656,141,180,1158,46.68583057535139,34.0664964955242
4595,/media/marda/TWOTB1/xBD/hurricanes/images/florence/hurricane-florence_00000209_post_disaster.png,66,79,1,216,282,225,304,2166,69.2602635736784,43.09939064274649
4596,/media/marda/TWOTB1/xBD/hurricanes/images/florence/hurricane-florence_00000209_post_disaster.png,41,34,1,252,293,285,319,449,31.24942997343255,19.317080683035453
4597,/media/marda/TWOTB1/xBD/hurricanes/images/florence/hurricane-florence_00000209_post_disaster.png,66,51,1,608,674,285,336,933,40.24006647168933,30.538105696859752
4598,/media/marda/TWOTB1/xBD/hurricanes/images/florence/hurricane-florence_00000209_post_disaster.png,18,49,1,0,18,339,388,447,36.20889595630136,17.19718039573591
4599,/media/marda/TWOTB1/xBD/hurricanes/images/florence/hurricane-florence_00000209_post_disaster.png,32,25,1,542,574,375,400,156,14.966629547095765,13.808210118138652
4600,/media/marda/TWOTB1/xBD/hurricanes/images/florence/hurricane-florence_00000209_post_disaster.png,75,73,1,529,604,474,547,1564,52.98420775636793,39.39812091135862
4601,/media/marda/TWOTB1/xBD/hurricanes/images/florence/hurricane-florence_00000209_post_disaster.png,83,62,1,733,816,601,663,1030,57.98229697105973,23.57345355400049
4602,/media/marda/TWOTB1/xBD/hurricanes/images/florence/hurricane-florence_00000186_pre_disaster.png,57,28,1,173,230,20,48,825,50.269454249206355,23.043031155256436
4603,/media/marda/TWOTB1/xBD/hurricanes/images/florence/hurricane-florence_00000186_pre_disaster.png,57,49,1,268,325,24,73,1280,42.21148045191912,39.90622858861289
4604,/media/marda/TWOTB1/xBD/hurricanes/images/florence/hurricane-florence_00000186_pre_disaster.png,23,15,1,251,274,64,79,113,13.895282176937638,10.895354232091229
4605,/media/marda/TWOTB1/xBD/hurricanes/images/florence/hurricane-florence_00000186_pre_disaster.png,30,22,1,261,291,76,98,240,19.633378182486407,16.366544976775035
4606,/media/marda/TWOTB1/xBD/hurricanes/images/florence/hurricane-florence_00000186_pre_disaster.png,44,32,1,538,582,291,323,282,22.147685776438266,17.0426523184859
4607,/media/marda/TWOTB1/xBD/hurricanes/images/florence/hurricane-florence_00000186_pre_disaster.png,65,48,1,979,1044,490,538,456,34.05536253895013,17.892214178265835
4608,/media/marda/TWOTB1/xBD/hurricanes/images/florence/hurricane-florence_00000186_pre_disaster.png,87,79,1,834,921,600,679,1347,55.3091100357023,35.9478662442203
4609,/media/marda/TWOTB1/xBD/hurricanes/images/florence/hurricane-florence_00000490_pre_disaster.png,74,17,1,614,688,0,17,516,44.354804047806205,16.84680413598843
4610,/media/marda/TWOTB1/xBD/hurricanes/images/florence/hurricane-florence_00000490_pre_disaster.png,68,68,1,238,306,86,154,2453,77.14603412903702,43.92658051885559
4611,/media/marda/TWOTB1/xBD/hurricanes/images/florence/hurricane-florence_00000490_pre_disaster.png,94,82,1,906,1000,104,186,2277,72.9159744692897,49.79570147664077
4612,/media/marda/TWOTB1/xBD/hurricanes/images/florence/hurricane-florence_00000490_pre_disaster.png,103,68,1,732,835,283,351,2248,65.08845107065184,47.54647066601355
4613,/media/marda/TWOTB1/xBD/hurricanes/images/florence/hurricane-florence_00000490_pre_disaster.png,87,103,1,674,761,329,432,2574,91.98602548944186,48.33703577485956
4614,/media/marda/TWOTB1/xBD/hurricanes/images/florence/hurricane-florence_00000490_pre_disaster.png,85,72,1,632,717,399,471,1949,53.0852971038096,49.258802752258994
4615,/media/marda/TWOTB1/xBD/hurricanes/images/florence/hurricane-florence_00000490_pre_disaster.png,72,96,1,303,375,405,501,2518,75.96071968674426,48.622409055021926
4616,/media/marda/TWOTB1/xBD/hurricanes/images/florence/hurricane-florence_00000490_pre_disaster.png,93,78,1,796,889,463,541,2107,54.660590212780754,50.994346190346626
4617,/media/marda/TWOTB1/xBD/hurricanes/images/florence/hurricane-florence_00000490_pre_disaster.png,67,69,1,357,424,493,562,1461,45.709825436555775,42.005506277341
4618,/media/marda/TWOTB1/xBD/hurricanes/images/florence/hurricane-florence_00000490_pre_disaster.png,71,93,1,484,555,504,597,2200,71.27672582491148,43.744746181573774
4619,/media/marda/TWOTB1/xBD/hurricanes/images/florence/hurricane-florence_00000490_pre_disaster.png,11,54,1,0,11,557,611,287,35.01318423653297,11.138333916515512
4620,/media/marda/TWOTB1/xBD/hurricanes/images/florence/hurricane-florence_00000490_pre_disaster.png,85,64,1,382,467,562,626,1858,76.34263581252556,36.784115498156126
4621,/media/marda/TWOTB1/xBD/hurricanes/images/florence/hurricane-florence_00000490_pre_disaster.png,54,69,1,230,284,566,635,1257,43.60273882951917,40.030218885289976
4622,/media/marda/TWOTB1/xBD/hurricanes/images/florence/hurricane-florence_00000490_pre_disaster.png,71,70,1,256,327,633,703,1703,59.81455470036099,38.64949485520742
4623,/media/marda/TWOTB1/xBD/hurricanes/images/florence/hurricane-florence_00000490_pre_disaster.png,69,77,1,138,207,673,750,1917,56.60781262974175,45.02423569319082
4624,/media/marda/TWOTB1/xBD/hurricanes/images/florence/hurricane-florence_00000490_pre_disaster.png,9,64,1,0,9,746,810,206,38.12892446885949,8.810902539951769
4625,/media/marda/TWOTB1/xBD/hurricanes/images/florence/hurricane-florence_00000490_pre_disaster.png,115,131,1,474,589,835,966,3759,114.37671450542133,64.36225113985535
4626,/media/marda/TWOTB1/xBD/hurricanes/images/florence/hurricane-florence_00000490_pre_disaster.png,89,91,1,136,225,841,932,3030,78.27655028803778,54.32977040373992
4627,/media/marda/TWOTB1/xBD/hurricanes/images/florence/hurricane-florence_00000490_pre_disaster.png,80,103,1,82,162,891,994,2928,71.55528487875893,56.55918152530258
4628,/media/marda/TWOTB1/xBD/hurricanes/images/florence/hurricane-florence_00000490_pre_disaster.png,55,62,1,532,587,929,991,636,37.73852512510665,21.6356560584378
4629,/media/marda/TWOTB1/xBD/hurricanes/images/florence/hurricane-florence_00000490_pre_disaster.png,125,111,1,420,545,931,1042,4754,103.83433903466963,68.3240935236053
4630,/media/marda/TWOTB1/xBD/hurricanes/images/florence/hurricane-florence_00000037_post_disaster.png,30,10,1,357,387,0,10,110,16.201375017224727,9.347722201753955
4631,/media/marda/TWOTB1/xBD/hurricanes/images/florence/hurricane-florence_00000037_post_disaster.png,77,35,1,946,1023,24,59,799,41.65092730887514,25.74179885314124
4632,/media/marda/TWOTB1/xBD/hurricanes/images/florence/hurricane-florence_00000037_post_disaster.png,50,33,1,312,362,38,71,631,32.858898975484024,25.680071014621802
4633,/media/marda/TWOTB1/xBD/hurricanes/images/florence/hurricane-florence_00000037_post_disaster.png,33,31,1,329,362,146,177,256,27.559617693571422,12.91765884687257
4634,/media/marda/TWOTB1/xBD/hurricanes/images/florence/hurricane-florence_00000037_post_disaster.png,32,27,1,333,365,197,224,170,22.070755132384566,10.197759255732478
4635,/media/marda/TWOTB1/xBD/hurricanes/images/florence/hurricane-florence_00000037_post_disaster.png,66,65,1,336,402,212,277,1265,66.9229517541858,25.23672504400234
4636,/media/marda/TWOTB1/xBD/hurricanes/images/florence/hurricane-florence_00000037_post_disaster.png,54,58,1,360,414,480,538,818,39.37292747343489,27.79254194796892
4637,/media/marda/TWOTB1/xBD/hurricanes/images/florence/hurricane-florence_00000037_post_disaster.png,40,60,1,155,195,557,617,746,43.55185997235543,22.41225272355794
4638,/media/marda/TWOTB1/xBD/hurricanes/images/florence/hurricane-florence_00000037_post_disaster.png,53,65,1,299,352,564,629,885,44.45364413802018,26.578990308609225
4639,/media/marda/TWOTB1/xBD/hurricanes/images/florence/hurricane-florence_00000037_post_disaster.png,49,59,1,263,312,647,706,728,39.89196054117549,23.81647281928337
4640,/media/marda/TWOTB1/xBD/hurricanes/images/florence/hurricane-florence_00000037_post_disaster.png,30,59,1,53,83,654,713,536,33.81409214829306,20.997169323834814
4641,/media/marda/TWOTB1/xBD/hurricanes/images/florence/hurricane-florence_00000037_post_disaster.png,46,84,1,136,182,859,943,764,61.260598836215834,16.651791069511113
4642,/media/marda/TWOTB1/xBD/hurricanes/images/florence/hurricane-florence_00000037_post_disaster.png,38,84,1,45,83,921,1005,690,54.263849226264526,16.990994626659443
4643,/media/marda/TWOTB1/xBD/hurricanes/images/florence/hurricane-florence_00000349_pre_disaster.png,51,29,1,248,299,0,29,762,45.442485963020175,22.560119456736018
4644,/media/marda/TWOTB1/xBD/hurricanes/images/florence/hurricane-florence_00000349_pre_disaster.png,53,10,1,295,348,0,10,249,43.92395937995116,8.719723453272533
4645,/media/marda/TWOTB1/xBD/hurricanes/images/florence/hurricane-florence_00000349_pre_disaster.png,43,10,1,404,447,0,10,149,25.64568464453952,8.70057798407999
4646,/media/marda/TWOTB1/xBD/hurricanes/images/florence/hurricane-florence_00000349_pre_disaster.png,113,39,1,931,1044,0,39,2118,77.90206266747643,37.58035715744211
4647,/media/marda/TWOTB1/xBD/hurricanes/images/florence/hurricane-florence_00000349_pre_disaster.png,53,35,1,337,390,5,40,784,45.36389921130573,23.11308010997026
4648,/media/marda/TWOTB1/xBD/hurricanes/images/florence/hurricane-florence_00000349_pre_disaster.png,69,35,1,606,675,21,56,949,46.224529036138,27.179417778888606
4649,/media/marda/TWOTB1/xBD/hurricanes/images/florence/hurricane-florence_00000349_pre_disaster.png,54,32,1,290,344,24,56,902,46.55198367829143,25.837331315093905
4650,/media/marda/TWOTB1/xBD/hurricanes/images/florence/hurricane-florence_00000349_pre_disaster.png,64,31,1,481,545,36,67,884,46.76014068751807,25.285365905016107
4651,/media/marda/TWOTB1/xBD/hurricanes/images/florence/hurricane-florence_00000349_pre_disaster.png,67,35,1,617,684,49,84,924,43.2897365571646,28.344915798489378
4652,/media/marda/TWOTB1/xBD/hurricanes/images/florence/hurricane-florence_00000349_pre_disaster.png,68,38,1,553,621,51,89,1206,45.560623656032945,34.99756863328157
4653,/media/marda/TWOTB1/xBD/hurricanes/images/florence/hurricane-florence_00000349_pre_disaster.png,55,64,1,450,505,54,118,1316,68.48894858101019,26.394798000053157
4654,/media/marda/TWOTB1/xBD/hurricanes/images/florence/hurricane-florence_00000349_pre_disaster.png,54,63,1,409,463,69,132,1319,67.12710359868633,27.118967298013732
4655,/media/marda/TWOTB1/xBD/hurricanes/images/florence/hurricane-florence_00000349_pre_disaster.png,64,40,1,493,557,72,112,984,48.79088369794904,26.801017433042997
4656,/media/marda/TWOTB1/xBD/hurricanes/images/florence/hurricane-florence_00000349_pre_disaster.png,51,63,1,375,426,80,143,1280,67.42231679553193,26.564316604665997
4657,/media/marda/TWOTB1/xBD/hurricanes/images/florence/hurricane-florence_00000349_pre_disaster.png,127,70,1,749,876,80,150,3899,98.72887778552108,52.56045592569989
4658,/media/marda/TWOTB1/xBD/hurricanes/images/florence/hurricane-florence_00000349_pre_disaster.png,51,64,1,332,383,95,159,1360,68.61437753018858,27.405671323874344
4659,/media/marda/TWOTB1/xBD/hurricanes/images/florence/hurricane-florence_00000349_pre_disaster.png,52,50,1,284,336,99,149,1269,47.491019342456184,35.4921641076673
4660,/media/marda/TWOTB1/xBD/hurricanes/images/florence/hurricane-florence_00000349_pre_disaster.png,50,44,1,528,578,123,167,748,39.921571499039786,24.770379735093332
4661,/media/marda/TWOTB1/xBD/hurricanes/images/florence/hurricane-florence_00000349_pre_disaster.png,98,63,1,790,888,132,195,2625,61.263877266306636,56.320355270058705
4662,/media/marda/TWOTB1/xBD/hurricanes/images/florence/hurricane-florence_00000349_pre_disaster.png,57,39,1,294,351,142,181,1088,49.30425636432554,29.428675533129606
4663,/media/marda/TWOTB1/xBD/hurricanes/images/florence/hurricane-florence_00000349_pre_disaster.png,138,144,1,383,521,186,330,7107,165.64368977134995,81.4342352110775
4664,/media/marda/TWOTB1/xBD/hurricanes/images/florence/hurricane-florence_00000349_pre_disaster.png,103,77,1,798,901,199,276,3040,66.2937855323076,61.16721457888482
4665,/media/marda/TWOTB1/xBD/hurricanes/images/florence/hurricane-florence_00000349_pre_disaster.png,38,30,1,576,614,206,236,148,25.288805517840217,8.009448214224252
4666,/media/marda/TWOTB1/xBD/hurricanes/images/florence/hurricane-florence_00000349_pre_disaster.png,103,51,1,828,931,250,301,1532,76.46181259648468,26.757520621858284
4667,/media/marda/TWOTB1/xBD/hurricanes/images/florence/hurricane-florence_00000349_pre_disaster.png,24,44,1,0,24,295,339,600,35.18451850662011,23.309493814790397
4668,/media/marda/TWOTB1/xBD/hurricanes/images/florence/hurricane-florence_00000349_pre_disaster.png,125,68,1,835,960,333,401,2637,98.82021694458244,35.594843089835344
4669,/media/marda/TWOTB1/xBD/hurricanes/images/florence/hurricane-florence_00000349_pre_disaster.png,36,36,1,494,530,418,454,197,19.03140298623108,13.893950371917168
4670,/media/marda/TWOTB1/xBD/hurricanes/images/florence/hurricane-florence_00000349_pre_disaster.png,71,57,1,409,480,424,481,1296,57.752989898923914,29.94735994647529
4671,/media/marda/TWOTB1/xBD/hurricanes/images/florence/hurricane-florence_00000349_pre_disaster.png,151,86,1,853,1004,449,535,4845,119.43986965339904,53.18911670679912
4672,/media/marda/TWOTB1/xBD/hurricanes/images/florence/hurricane-florence_00000349_pre_disaster.png,65,76,1,614,679,502,578,1315,55.06156335750237,32.997322089015135
4673,/media/marda/TWOTB1/xBD/hurricanes/images/florence/hurricane-florence_00000349_pre_disaster.png,58,44,1,740,798,514,558,508,30.708476337769213,21.592744048103224
4674,/media/marda/TWOTB1/xBD/hurricanes/images/florence/hurricane-florence_00000349_pre_disaster.png,70,66,1,420,490,536,602,1450,53.42046029402077,39.54508768062315
4675,/media/marda/TWOTB1/xBD/hurricanes/images/florence/hurricane-florence_00000349_pre_disaster.png,118,72,1,918,1036,576,648,2342,87.47224127423283,35.70047295839374
4676,/media/marda/TWOTB1/xBD/hurricanes/images/florence/hurricane-florence_00000349_pre_disaster.png,43,57,1,445,488,602,659,561,31.227201861177107,24.10742733219954
4677,/media/marda/TWOTB1/xBD/hurricanes/images/florence/hurricane-florence_00000349_pre_disaster.png,74,64,1,970,1044,650,714,1011,39.93394666739357,33.991153463644295
4678,/media/marda/TWOTB1/xBD/hurricanes/images/florence/hurricane-florence_00000349_pre_disaster.png,51,73,1,480,531,657,730,953,52.6042205745504,24.187471592499985
4679,/media/marda/TWOTB1/xBD/hurricanes/images/florence/hurricane-florence_00000349_pre_disaster.png,40,45,1,536,576,664,709,266,19.69765951666735,18.049283798967476
4680,/media/marda/TWOTB1/xBD/hurricanes/images/florence/hurricane-florence_00000349_pre_disaster.png,60,62,1,799,859,687,749,590,35.39277717241311,22.029613396444223
4681,/media/marda/TWOTB1/xBD/hurricanes/images/florence/hurricane-florence_00000349_pre_disaster.png,58,59,1,488,546,708,767,778,39.20529986168714,26.318106065695954
4682,/media/marda/TWOTB1/xBD/hurricanes/images/florence/hurricane-florence_00000349_pre_disaster.png,63,62,1,811,874,724,786,647,34.884740639398075,24.601407343197774
4683,/media/marda/TWOTB1/xBD/hurricanes/images/florence/hurricane-florence_00000349_pre_disaster.png,56,65,1,504,560,739,804,870,34.59427002634465,33.52282116038835
4684,/media/marda/TWOTB1/xBD/hurricanes/images/florence/hurricane-florence_00000349_pre_disaster.png,54,53,1,877,931,753,806,361,25.180854180824582,19.052186448453593
4685,/media/marda/TWOTB1/xBD/hurricanes/images/florence/hurricane-florence_00000349_pre_disaster.png,61,85,1,514,575,778,863,1310,61.40255490916824,28.39100605495043
4686,/media/marda/TWOTB1/xBD/hurricanes/images/florence/hurricane-florence_00000349_pre_disaster.png,54,59,1,765,819,795,854,447,26.460650022414093,22.3652380631249
4687,/media/marda/TWOTB1/xBD/hurricanes/images/florence/hurricane-florence_00000349_pre_disaster.png,63,70,1,863,926,822,892,676,35.73350490574576,25.34093494864228
4688,/media/marda/TWOTB1/xBD/hurricanes/images/florence/hurricane-florence_00000349_pre_disaster.png,59,76,1,833,892,825,901,819,44.868227223576156,24.633378945505644
4689,/media/marda/TWOTB1/xBD/hurricanes/images/florence/hurricane-florence_00000349_pre_disaster.png,61,49,1,705,766,829,878,270,36.354081267608045,9.964517647675596
4690,/media/marda/TWOTB1/xBD/hurricanes/images/florence/hurricane-florence_00000349_pre_disaster.png,56,68,1,533,589,830,898,826,34.41705091717787,32.050303682887694
4691,/media/marda/TWOTB1/xBD/hurricanes/images/florence/hurricane-florence_00000349_pre_disaster.png,48,46,1,780,828,833,879,149,19.189881913326474,10.44346831560129
4692,/media/marda/TWOTB1/xBD/hurricanes/images/florence/hurricane-florence_00000349_pre_disaster.png,74,72,1,767,841,846,918,999,47.55669095620515,29.083798826969105
4693,/media/marda/TWOTB1/xBD/hurricanes/images/florence/hurricane-florence_00000349_pre_disaster.png,58,50,1,710,768,859,909,286,32.394062398080365,11.832500381494784
4694,/media/marda/TWOTB1/xBD/hurricanes/images/florence/hurricane-florence_00000349_pre_disaster.png,52,59,1,547,599,875,934,539,33.11784300483553,21.530880526951343
4695,/media/marda/TWOTB1/xBD/hurricanes/images/florence/hurricane-florence_00000349_pre_disaster.png,65,61,1,714,779,877,938,683,37.878970292542924,24.090252621400385
4696,/media/marda/TWOTB1/xBD/hurricanes/images/florence/hurricane-florence_00000349_pre_disaster.png,37,49,1,618,655,881,930,160,17.98211142526473,11.628732462713364
4697,/media/marda/TWOTB1/xBD/hurricanes/images/florence/hurricane-florence_00000349_pre_disaster.png,72,68,1,953,1025,885,953,646,31.158242170859737,27.890318490746033
4698,/media/marda/TWOTB1/xBD/hurricanes/images/florence/hurricane-florence_00000349_pre_disaster.png,55,65,1,608,663,900,965,567,29.341437952436518,25.815108287403504
4699,/media/marda/TWOTB1/xBD/hurricanes/images/florence/hurricane-florence_00000349_pre_disaster.png,50,62,1,558,608,912,974,506,30.870726913066004,21.7942431309443
4700,/media/marda/TWOTB1/xBD/hurricanes/images/florence/hurricane-florence_00000349_pre_disaster.png,72,65,1,807,879,937,1002,686,41.5102248579615,22.078038100240324
4701,/media/marda/TWOTB1/xBD/hurricanes/images/florence/hurricane-florence_00000349_pre_disaster.png,60,72,1,715,775,969,1041,748,34.97720263952225,28.412500400035412
4702,/media/marda/TWOTB1/xBD/hurricanes/images/florence/hurricane-florence_00000074_pre_disaster.png,67,36,1,977,1044,38,74,756,34.83897465324555,29.12674088062277
4703,/media/marda/TWOTB1/xBD/hurricanes/images/florence/hurricane-florence_00000074_pre_disaster.png,77,60,1,467,544,121,181,1778,50.01119591670475,47.676018309398465
4704,/media/marda/TWOTB1/xBD/hurricanes/images/florence/hurricane-florence_00000074_pre_disaster.png,51,58,1,393,444,820,878,788,39.36730906036982,26.707422748057443
4705,/media/marda/TWOTB1/xBD/hurricanes/images/florence/hurricane-florence_00000074_pre_disaster.png,65,80,1,393,458,962,1042,1188,55.1961705394964,28.34607320258691
4706,/media/marda/TWOTB1/xBD/hurricanes/images/florence/hurricane-florence_00000289_pre_disaster.png,43,71,1,413,456,673,744,683,51.261937299385124,17.792117562036637
4707,/media/marda/TWOTB1/xBD/hurricanes/images/florence/hurricane-florence_00000289_pre_disaster.png,47,68,1,286,333,814,882,831,35.0706950473814,31.86412450114632
4708,/media/marda/TWOTB1/xBD/hurricanes/images/florence/hurricane-florence_00000289_pre_disaster.png,36,55,1,249,285,850,905,361,28.343936151849423,17.041306808491427
4709,/media/marda/TWOTB1/xBD/hurricanes/images/florence/hurricane-florence_00000289_pre_disaster.png,24,43,1,358,382,919,962,73,13.953948823668437,6.968283061301865
4710,/media/marda/TWOTB1/xBD/hurricanes/images/florence/hurricane-florence_00000289_pre_disaster.png,20,42,1,347,367,939,981,48,9.16515138991168,6.831300510639732
4711,/media/marda/TWOTB1/xBD/hurricanes/images/florence/hurricane-florence_00000289_pre_disaster.png,37,66,1,261,298,944,1010,644,30.288493195817292,28.42224807160215
4712,/media/marda/TWOTB1/xBD/hurricanes/images/florence/hurricane-florence_00000289_pre_disaster.png,57,62,1,339,396,968,1030,991,48.66953706261651,26.79911143501178
4713,/media/marda/TWOTB1/xBD/hurricanes/images/florence/hurricane-florence_00000289_pre_disaster.png,49,62,1,286,335,974,1036,840,41.963430464355206,26.371860738495826
4714,/media/marda/TWOTB1/xBD/hurricanes/images/florence/hurricane-florence_00000289_pre_disaster.png,58,58,1,155,213,986,1044,836,58.94193045312859,18.85019359906394
4715,/media/marda/TWOTB1/xBD/hurricanes/images/florence/hurricane-florence_00000289_pre_disaster.png,31,55,1,15,46,989,1044,275,28.43191242601962,13.964935146658974
4716,/media/marda/TWOTB1/xBD/hurricanes/images/florence/hurricane-florence_00000169_pre_disaster.png,21,17,1,177,198,0,17,151,14.763405982829942,13.705736142221689
4717,/media/marda/TWOTB1/xBD/hurricanes/images/florence/hurricane-florence_00000169_pre_disaster.png,16,17,1,5,21,26,43,142,14.976425177419943,12.681199416510472
4718,/media/marda/TWOTB1/xBD/hurricanes/images/florence/hurricane-florence_00000169_pre_disaster.png,39,32,1,141,180,132,164,547,34.02094328384444,21.29989589564376
4719,/media/marda/TWOTB1/xBD/hurricanes/images/florence/hurricane-florence_00000169_pre_disaster.png,55,21,1,737,792,132,153,185,29.36624655440983,8.451064747877343
4720,/media/marda/TWOTB1/xBD/hurricanes/images/florence/hurricane-florence_00000169_pre_disaster.png,74,45,1,704,778,166,211,971,45.76362892963167,28.19718883652383
4721,/media/marda/TWOTB1/xBD/hurricanes/images/florence/hurricane-florence_00000169_pre_disaster.png,52,42,1,379,431,175,217,804,34.31423438518644,31.04782626419805
4722,/media/marda/TWOTB1/xBD/hurricanes/images/florence/hurricane-florence_00000169_pre_disaster.png,88,55,1,566,654,190,245,1863,67.51615878416598,39.095402115970664
4723,/media/marda/TWOTB1/xBD/hurricanes/images/florence/hurricane-florence_00000169_pre_disaster.png,36,42,1,11,47,201,243,682,33.65302899321196,27.071364335565367
4724,/media/marda/TWOTB1/xBD/hurricanes/images/florence/hurricane-florence_00000169_pre_disaster.png,40,21,1,704,744,204,225,97,11.709879180019312,11.128988776611532
4725,/media/marda/TWOTB1/xBD/hurricanes/images/florence/hurricane-florence_00000169_pre_disaster.png,62,68,1,348,410,223,291,1530,56.168276741916245,39.66533172223789
4726,/media/marda/TWOTB1/xBD/hurricanes/images/florence/hurricane-florence_00000169_pre_disaster.png,44,30,1,450,494,237,267,338,27.829411003878654,16.161001111135143
4727,/media/marda/TWOTB1/xBD/hurricanes/images/florence/hurricane-florence_00000169_pre_disaster.png,28,32,1,86,114,239,271,335,22.570883655968395,19.853648211902975
4728,/media/marda/TWOTB1/xBD/hurricanes/images/florence/hurricane-florence_00000169_pre_disaster.png,42,38,1,119,161,259,297,609,34.63060366849939,23.885083016819934
4729,/media/marda/TWOTB1/xBD/hurricanes/images/florence/hurricane-florence_00000169_pre_disaster.png,72,57,1,402,474,273,330,1424,50.12856187165272,40.12202604302805
4730,/media/marda/TWOTB1/xBD/hurricanes/images/florence/hurricane-florence_00000169_pre_disaster.png,48,43,1,167,215,277,320,829,44.37519360191471,25.039641478151257
4731,/media/marda/TWOTB1/xBD/hurricanes/images/florence/hurricane-florence_00000169_pre_disaster.png,21,36,1,95,116,284,320,240,30.273428207161277,10.62301433091102
4732,/media/marda/TWOTB1/xBD/hurricanes/images/florence/hurricane-florence_00000169_pre_disaster.png,9,58,1,0,9,291,349,246,49.876995596528,7.459111265251593
4733,/media/marda/TWOTB1/xBD/hurricanes/images/florence/hurricane-florence_00000169_pre_disaster.png,59,44,1,638,697,310,354,583,32.74240440915284,24.163567974792624
4734,/media/marda/TWOTB1/xBD/hurricanes/images/florence/hurricane-florence_00000169_pre_disaster.png,20,29,1,139,159,333,362,155,17.286773853000277,11.938998576433773
4735,/media/marda/TWOTB1/xBD/hurricanes/images/florence/hurricane-florence_00000169_pre_disaster.png,85,52,1,600,685,352,404,1284,60.56112138644773,31.468372648652878
4736,/media/marda/TWOTB1/xBD/hurricanes/images/florence/hurricane-florence_00000169_pre_disaster.png,52,34,1,780,832,363,397,254,18.695487282636766,18.179074653699153
4737,/media/marda/TWOTB1/xBD/hurricanes/images/florence/hurricane-florence_00000169_pre_disaster.png,57,44,1,291,348,364,408,592,52.70664361979001,14.977784971776487
4738,/media/marda/TWOTB1/xBD/hurricanes/images/florence/hurricane-florence_00000169_pre_disaster.png,50,51,1,369,419,368,419,837,35.92529577465996,31.13170828418647
4739,/media/marda/TWOTB1/xBD/hurricanes/images/florence/hurricane-florence_00000169_pre_disaster.png,76,63,1,662,738,375,438,1347,54.28380445949434,33.03610989773931
4740,/media/marda/TWOTB1/xBD/hurricanes/images/florence/hurricane-florence_00000169_pre_disaster.png,45,43,1,336,381,393,436,555,29.942763818488814,24.695814772600023
4741,/media/marda/TWOTB1/xBD/hurricanes/images/florence/hurricane-florence_00000169_pre_disaster.png,22,63,1,116,138,399,462,692,53.33546920078094,17.320853843388093
4742,/media/marda/TWOTB1/xBD/hurricanes/images/florence/hurricane-florence_00000169_pre_disaster.png,22,65,1,80,102,405,470,662,54.312618019221546,16.29165399140271
4743,/media/marda/TWOTB1/xBD/hurricanes/images/florence/hurricane-florence_00000169_pre_disaster.png,81,58,1,723,804,410,468,1206,48.41011616160829,34.32881925233869
4744,/media/marda/TWOTB1/xBD/hurricanes/images/florence/hurricane-florence_00000169_pre_disaster.png,48,37,1,157,205,411,448,471,47.2711044586431,13.283619013286653
4745,/media/marda/TWOTB1/xBD/hurricanes/images/florence/hurricane-florence_00000169_pre_disaster.png,133,103,1,873,1006,415,518,4924,108.22422964585209,62.371113036304536
4746,/media/marda/TWOTB1/xBD/hurricanes/images/florence/hurricane-florence_00000169_pre_disaster.png,58,55,1,428,486,416,471,853,42.6118721643029,26.553718207570498
4747,/media/marda/TWOTB1/xBD/hurricanes/images/florence/hurricane-florence_00000169_pre_disaster.png,21,60,1,49,70,417,477,693,48.140704319294606,19.179697838313295
4748,/media/marda/TWOTB1/xBD/hurricanes/images/florence/hurricane-florence_00000169_pre_disaster.png,20,50,1,15,35,435,485,519,37.78345526842655,18.20841451425175
4749,/media/marda/TWOTB1/xBD/hurricanes/images/florence/hurricane-florence_00000169_pre_disaster.png,20,60,1,185,205,443,503,508,48.731410744765775,13.933107929988424
4750,/media/marda/TWOTB1/xBD/hurricanes/images/florence/hurricane-florence_00000169_pre_disaster.png,39,37,1,480,519,451,488,245,18.411718349271684,17.805447206101466
4751,/media/marda/TWOTB1/xBD/hurricanes/images/florence/hurricane-florence_00000169_pre_disaster.png,22,64,1,121,143,457,521,679,53.636092193349675,16.836362113303487
4752,/media/marda/TWOTB1/xBD/hurricanes/images/florence/hurricane-florence_00000169_pre_disaster.png,23,65,1,88,111,463,528,705,53.79486311848354,17.50126459280319
4753,/media/marda/TWOTB1/xBD/hurricanes/images/florence/hurricane-florence_00000169_pre_disaster.png,73,62,1,787,860,466,528,1035,42.22243051602382,32.26075130089779
4754,/media/marda/TWOTB1/xBD/hurricanes/images/florence/hurricane-florence_00000169_pre_disaster.png,38,39,1,436,474,471,510,267,21.312209792073855,16.75467522457966
4755,/media/marda/TWOTB1/xBD/hurricanes/images/florence/hurricane-florence_00000169_pre_disaster.png,22,58,1,23,45,479,537,608,45.59873841052773,17.6886996955545
4756,/media/marda/TWOTB1/xBD/hurricanes/images/florence/hurricane-florence_00000169_pre_disaster.png,63,51,1,549,612,482,533,746,40.53554238592778,24.60017431970248
4757,/media/marda/TWOTB1/xBD/hurricanes/images/florence/hurricane-florence_00000169_pre_disaster.png,80,63,1,591,671,512,575,1394,58.164544487742845,31.87554353558544
4758,/media/marda/TWOTB1/xBD/hurricanes/images/florence/hurricane-florence_00000169_pre_disaster.png,24,65,1,122,146,531,596,617,49.585415871751934,16.58245055873763
4759,/media/marda/TWOTB1/xBD/hurricanes/images/florence/hurricane-florence_00000169_pre_disaster.png,26,69,1,93,119,534,603,707,53.77484107127034,17.60169062275589
4760,/media/marda/TWOTB1/xBD/hurricanes/images/florence/hurricane-florence_00000169_pre_disaster.png,111,116,1,630,741,535,651,4038,98.77746321831788,58.39381612104192
4761,/media/marda/TWOTB1/xBD/hurricanes/images/florence/hurricane-florence_00000169_pre_disaster.png,25,68,1,32,57,547,615,721,53.780274267753796,17.71731014551172
4762,/media/marda/TWOTB1/xBD/hurricanes/images/florence/hurricane-florence_00000169_pre_disaster.png,36,31,1,632,668,562,593,102,12.033397210065216,10.880150129853677
4763,/media/marda/TWOTB1/xBD/hurricanes/images/florence/hurricane-florence_00000169_pre_disaster.png,41,41,1,558,599,572,613,232,19.501215238209518,15.929145662023641
4764,/media/marda/TWOTB1/xBD/hurricanes/images/florence/hurricane-florence_00000169_pre_disaster.png,21,65,1,89,110,614,679,573,46.025253460684006,16.55778270287866
4765,/media/marda/TWOTB1/xBD/hurricanes/images/florence/hurricane-florence_00000169_pre_disaster.png,94,66,1,815,909,666,732,1367,61.800654846944504,29.374301627254507
4766,/media/marda/TWOTB1/xBD/hurricanes/images/florence/hurricane-florence_00000169_pre_disaster.png,76,75,1,951,1027,696,771,1008,47.59393820529221,28.07155105642538
4767,/media/marda/TWOTB1/xBD/hurricanes/images/florence/hurricane-florence_00000169_pre_disaster.png,37,69,1,97,134,701,770,965,41.281372797014164,32.14731747930212
4768,/media/marda/TWOTB1/xBD/hurricanes/images/florence/hurricane-florence_00000169_pre_disaster.png,74,67,1,876,950,712,779,863,39.995369346435716,28.624922252796647
4769,/media/marda/TWOTB1/xBD/hurricanes/images/florence/hurricane-florence_00000169_pre_disaster.png,62,86,1,203,265,732,818,2320,65.6112894029702,49.591340756510334
4770,/media/marda/TWOTB1/xBD/hurricanes/images/florence/hurricane-florence_00000169_pre_disaster.png,58,74,1,371,429,736,810,1047,46.41638091597605,29.780256001696113
4771,/media/marda/TWOTB1/xBD/hurricanes/images/florence/hurricane-florence_00000169_pre_disaster.png,74,73,1,727,801,748,821,1195,43.18051224975017,38.74449279028919
4772,/media/marda/TWOTB1/xBD/hurricanes/images/florence/hurricane-florence_00000169_pre_disaster.png,65,68,1,482,547,776,844,1100,47.064270529822664,31.216801258584773
4773,/media/marda/TWOTB1/xBD/hurricanes/images/florence/hurricane-florence_00000169_pre_disaster.png,83,120,1,871,954,789,909,1968,93.94680704831264,33.457875707840095
4774,/media/marda/TWOTB1/xBD/hurricanes/images/florence/hurricane-florence_00000169_pre_disaster.png,32,77,1,112,144,795,872,849,48.08382826877797,23.461934609397012
4775,/media/marda/TWOTB1/xBD/hurricanes/images/florence/hurricane-florence_00000169_pre_disaster.png,82,89,1,543,625,822,911,1807,60.293635990306285,39.81470869135636
4776,/media/marda/TWOTB1/xBD/hurricanes/images/florence/hurricane-florence_00000169_pre_disaster.png,34,77,1,125,159,864,941,930,49.2550452818663,25.04730653797675
4777,/media/marda/TWOTB1/xBD/hurricanes/images/florence/hurricane-florence_00000169_pre_disaster.png,79,77,1,649,728,868,945,1310,49.77195884089462,36.13009382862569
4778,/media/marda/TWOTB1/xBD/hurricanes/images/florence/hurricane-florence_00000169_pre_disaster.png,54,74,1,391,445,875,949,1243,45.21070589156855,36.2720901424751
4779,/media/marda/TWOTB1/xBD/hurricanes/images/florence/hurricane-florence_00000169_pre_disaster.png,50,61,1,499,549,879,940,488,27.00635678112245,24.03833863469754
4780,/media/marda/TWOTB1/xBD/hurricanes/images/florence/hurricane-florence_00000169_pre_disaster.png,13,81,1,0,13,892,973,329,44.753304197248376,11.070794100254668
4781,/media/marda/TWOTB1/xBD/hurricanes/images/florence/hurricane-florence_00000169_pre_disaster.png,50,70,1,469,519,911,981,853,35.503772252741676,31.69648975468975
4782,/media/marda/TWOTB1/xBD/hurricanes/images/florence/hurricane-florence_00000169_pre_disaster.png,52,66,1,589,641,911,977,468,25.916143491869093,23.88442560418073
4783,/media/marda/TWOTB1/xBD/hurricanes/images/florence/hurricane-florence_00000169_pre_disaster.png,49,58,1,746,795,926,984,253,18.743908110102684,17.924935679778443
4784,/media/marda/TWOTB1/xBD/hurricanes/images/florence/hurricane-florence_00000169_pre_disaster.png,33,83,1,138,171,928,1011,952,50.75373549260969,24.93789908780667
4785,/media/marda/TWOTB1/xBD/hurricanes/images/florence/hurricane-florence_00000169_pre_disaster.png,54,60,1,764,818,934,994,300,22.432737557136466,17.868378559883542
4786,/media/marda/TWOTB1/xBD/hurricanes/images/florence/hurricane-florence_00000169_pre_disaster.png,91,97,1,791,882,934,1031,1674,62.279147096530245,39.393273442186434
4787,/media/marda/TWOTB1/xBD/hurricanes/images/florence/hurricane-florence_00000169_pre_disaster.png,22,78,1,0,22,957,1035,700,42.457693740911765,22.197859369098843
4788,/media/marda/TWOTB1/xBD/hurricanes/images/florence/hurricane-florence_00000169_pre_disaster.png,34,49,1,507,541,966,1015,152,15.177989390659471,13.384981282377822
4789,/media/marda/TWOTB1/xBD/hurricanes/images/florence/hurricane-florence_00000169_pre_disaster.png,61,60,1,736,797,969,1029,416,35.35042108616818,15.419515813926244
4790,/media/marda/TWOTB1/xBD/hurricanes/images/florence/hurricane-florence_00000169_pre_disaster.png,39,57,1,428,467,972,1029,378,24.08936007250188,20.817978730463064
4791,/media/marda/TWOTB1/xBD/hurricanes/images/florence/hurricane-florence_00000169_pre_disaster.png,29,51,1,521,550,993,1044,72,12.028551681150793,8.027291027738302
4792,/media/marda/TWOTB1/xBD/hurricanes/images/florence/hurricane-florence_00000169_pre_disaster.png,30,49,1,126,156,995,1044,176,26.899047128303977,8.754346214245134
4793,/media/marda/TWOTB1/xBD/hurricanes/images/florence/hurricane-florence_00000169_pre_disaster.png,52,49,1,610,662,995,1044,204,31.228308729303556,8.750545671849896
4794,/media/marda/TWOTB1/xBD/hurricanes/images/florence/hurricane-florence_00000475_post_disaster.png,65,74,1,2,67,798,872,2028,72.20018283314266,40.561112247029925
4795,/media/marda/TWOTB1/xBD/hurricanes/images/florence/hurricane-florence_00000475_post_disaster.png,6,49,1,0,6,915,964,43,11.581104904631081,5.588001854998525
4796,/media/marda/TWOTB1/xBD/hurricanes/images/florence/hurricane-florence_00000475_post_disaster.png,19,67,1,0,19,934,1001,316,27.49818772242952,16.394852477675833
4797,/media/marda/TWOTB1/xBD/hurricanes/images/florence/hurricane-florence_00000475_post_disaster.png,49,83,1,129,178,941,1024,1265,48.883836589097605,37.08732011500209
4798,/media/marda/TWOTB1/xBD/hurricanes/images/florence/hurricane-florence_00000475_post_disaster.png,53,72,1,0,53,969,1041,1074,51.598232795512914,27.663623767614272
4799,/media/marda/TWOTB1/xBD/hurricanes/images/florence/hurricane-florence_00000215_pre_disaster.png,31,25,1,228,259,205,230,228,22.926042365301022,13.310974942410686
4800,/media/marda/TWOTB1/xBD/hurricanes/images/florence/hurricane-florence_00000215_pre_disaster.png,33,40,1,200,233,244,284,648,32.47682712398745,26.42064913511234
4801,/media/marda/TWOTB1/xBD/hurricanes/images/florence/hurricane-florence_00000215_pre_disaster.png,64,36,1,196,260,393,429,1150,64.46230298714228,23.649399010462453
4802,/media/marda/TWOTB1/xBD/hurricanes/images/florence/hurricane-florence_00000215_pre_disaster.png,17,43,1,0,17,415,458,325,26.05794758685693,16.91329177205118
4803,/media/marda/TWOTB1/xBD/hurricanes/images/florence/hurricane-florence_00000215_pre_disaster.png,26,30,1,133,159,426,456,239,22.69002445033367,14.129260293609002
4804,/media/marda/TWOTB1/xBD/hurricanes/images/florence/hurricane-florence_00000215_pre_disaster.png,16,36,1,149,165,452,488,240,23.065125189341593,13.808210118138652
4805,/media/marda/TWOTB1/xBD/hurricanes/images/florence/hurricane-florence_00000215_pre_disaster.png,45,57,1,316,361,495,552,738,33.18090944555775,29.251177014564785
4806,/media/marda/TWOTB1/xBD/hurricanes/images/florence/hurricane-florence_00000215_pre_disaster.png,24,36,1,363,387,579,615,156,16.602280055097328,12.632521602379171
4807,/media/marda/TWOTB1/xBD/hurricanes/images/florence/hurricane-florence_00000215_pre_disaster.png,43,53,1,327,370,603,656,575,30.108214664106928,25.32892443714702
4808,/media/marda/TWOTB1/xBD/hurricanes/images/florence/hurricane-florence_00000215_pre_disaster.png,43,60,1,250,293,765,825,592,33.48501743239391,23.459570404505776
4809,/media/marda/TWOTB1/xBD/hurricanes/images/florence/hurricane-florence_00000215_pre_disaster.png,42,67,1,185,227,788,855,670,31.652899237355594,28.132115478695507
4810,/media/marda/TWOTB1/xBD/hurricanes/images/florence/hurricane-florence_00000215_pre_disaster.png,38,83,1,69,107,958,1041,1020,46.268751601193486,29.370233084432847
4811,/media/marda/TWOTB1/xBD/hurricanes/images/florence/hurricane-florence_00000143_post_disaster.png,201,159,1,761,962,33,192,6288,231.12509419124055,36.319805082187145
4812,/media/marda/TWOTB1/xBD/hurricanes/images/florence/hurricane-florence_00000143_post_disaster.png,73,64,1,842,915,684,748,586,50.20720459862595,17.567066934991196
4813,/media/marda/TWOTB1/xBD/hurricanes/images/florence/hurricane-florence_00000143_post_disaster.png,49,42,1,808,857,693,735,132,15.806547103459033,11.218822394551607
4814,/media/marda/TWOTB1/xBD/hurricanes/images/florence/hurricane-florence_00000149_pre_disaster.png,54,26,1,781,835,0,26,576,29.160519567505517,26.357464611755024
4815,/media/marda/TWOTB1/xBD/hurricanes/images/florence/hurricane-florence_00000149_pre_disaster.png,33,14,1,605,638,29,43,112,16.261714314203164,9.14093253247391
4816,/media/marda/TWOTB1/xBD/hurricanes/images/florence/hurricane-florence_00000149_pre_disaster.png,35,40,1,561,596,38,78,580,46.16232587569546,16.73726332642546
4817,/media/marda/TWOTB1/xBD/hurricanes/images/florence/hurricane-florence_00000149_pre_disaster.png,31,36,1,444,475,572,608,174,16.471803170174447,14.235995994149413
4818,/media/marda/TWOTB1/xBD/hurricanes/images/florence/hurricane-florence_00000149_pre_disaster.png,59,54,1,295,354,603,657,718,50.36675854420715,21.25022503536044
4819,/media/marda/TWOTB1/xBD/hurricanes/images/florence/hurricane-florence_00000149_pre_disaster.png,69,76,1,398,467,607,683,1834,56.07152149796198,47.416700762614504
4820,/media/marda/TWOTB1/xBD/hurricanes/images/florence/hurricane-florence_00000149_pre_disaster.png,45,60,1,203,248,759,819,923,38.04558129281733,32.47692758808986
4821,/media/marda/TWOTB1/xBD/hurricanes/images/florence/hurricane-florence_00000149_pre_disaster.png,47,64,1,539,586,844,908,654,32.77458907741168,26.332952015488548
4822,/media/marda/TWOTB1/xBD/hurricanes/images/florence/hurricane-florence_00000149_pre_disaster.png,40,45,1,569,609,844,889,212,22.258526676691087,12.751302915078439
4823,/media/marda/TWOTB1/xBD/hurricanes/images/florence/hurricane-florence_00000149_pre_disaster.png,54,59,1,618,672,895,954,567,34.84495134862911,21.878340992147542
4824,/media/marda/TWOTB1/xBD/hurricanes/images/florence/hurricane-florence_00000117_pre_disaster.png,40,54,1,329,369,533,587,564,32.20444580157956,23.397247441539538
4825,/media/marda/TWOTB1/xBD/hurricanes/images/florence/hurricane-florence_00000117_pre_disaster.png,50,84,1,207,257,559,643,1662,67.16866466315192,32.63933068664627
4826,/media/marda/TWOTB1/xBD/hurricanes/images/florence/hurricane-florence_00000117_pre_disaster.png,43,56,1,420,463,568,624,580,41.31043474471465,19.6729729495755
4827,/media/marda/TWOTB1/xBD/hurricanes/images/florence/hurricane-florence_00000117_pre_disaster.png,35,39,1,393,428,580,619,224,17.69540512182507,17.00276267536824
4828,/media/marda/TWOTB1/xBD/hurricanes/images/florence/hurricane-florence_00000117_pre_disaster.png,100,52,1,335,435,613,665,1018,93.78956828131278,20.148673822200383
4829,/media/marda/TWOTB1/xBD/hurricanes/images/florence/hurricane-florence_00000117_pre_disaster.png,47,57,1,345,392,640,697,739,35.40010800953065,27.735652931329792
4830,/media/marda/TWOTB1/xBD/hurricanes/images/florence/hurricane-florence_00000117_pre_disaster.png,20,38,1,256,276,641,679,168,16.1245154965971,13.808210118138652
4831,/media/marda/TWOTB1/xBD/hurricanes/images/florence/hurricane-florence_00000117_pre_disaster.png,43,73,1,280,323,650,723,1088,50.72401851488102,28.89070189929651
4832,/media/marda/TWOTB1/xBD/hurricanes/images/florence/hurricane-florence_00000051_post_disaster.png,47,67,1,378,425,913,980,575,32.74525790240168,23.09914003075438
4833,/media/marda/TWOTB1/xBD/hurricanes/images/florence/hurricane-florence_00000051_post_disaster.png,31,42,1,134,165,81,123,982,47.588300490236264,28.19417048127676
4834,/media/marda/TWOTB1/xBD/hurricanes/images/florence/hurricane-florence_00000051_post_disaster.png,71,89,1,463,534,952,1041,1245,60.24047156799052,27.3768642256354
4835,/media/marda/TWOTB1/xBD/hurricanes/images/florence/hurricane-florence_00000051_post_disaster.png,14,15,1,14,28,2,17,111,12.572614033836002,11.742979211290754
4836,/media/marda/TWOTB1/xBD/hurricanes/images/florence/hurricane-florence_00000051_post_disaster.png,34,36,1,97,131,109,145,567,27.787159891738074,27.094501843200305
4837,/media/marda/TWOTB1/xBD/hurricanes/images/florence/hurricane-florence_00000051_post_disaster.png,32,26,1,413,445,136,162,232,22.250566268707743,14.224179515386314
4838,/media/marda/TWOTB1/xBD/hurricanes/images/florence/hurricane-florence_00000051_post_disaster.png,59,43,1,392,451,155,198,996,42.05832574322687,33.82413688595526
4839,/media/marda/TWOTB1/xBD/hurricanes/images/florence/hurricane-florence_00000051_post_disaster.png,45,39,1,77,122,186,225,1035,42.55586686536912,31.674359218500264
4840,/media/marda/TWOTB1/xBD/hurricanes/images/florence/hurricane-florence_00000051_post_disaster.png,31,18,1,441,472,197,215,144,15.248683575389759,12.564710077876667
4841,/media/marda/TWOTB1/xBD/hurricanes/images/florence/hurricane-florence_00000051_post_disaster.png,26,17,1,466,492,201,218,56,10.20510788404465,7.500248813118349
4842,/media/marda/TWOTB1/xBD/hurricanes/images/florence/hurricane-florence_00000051_post_disaster.png,70,53,1,387,457,253,306,1872,57.65687915778979,43.3697270221253
4843,/media/marda/TWOTB1/xBD/hurricanes/images/florence/hurricane-florence_00000051_post_disaster.png,29,19,1,451,480,286,305,81,13.644405198860484,7.904127427727644
4844,/media/marda/TWOTB1/xBD/hurricanes/images/florence/hurricane-florence_00000051_post_disaster.png,68,50,1,209,277,385,435,1326,63.80443581200897,27.140405554309265
4845,/media/marda/TWOTB1/xBD/hurricanes/images/florence/hurricane-florence_00000051_post_disaster.png,37,49,1,207,244,425,474,630,32.389972520122726,25.607704755239382
4846,/media/marda/TWOTB1/xBD/hurricanes/images/florence/hurricane-florence_00000051_post_disaster.png,61,52,1,395,456,440,492,1104,46.4640481873567,31.23333990080319
4847,/media/marda/TWOTB1/xBD/hurricanes/images/florence/hurricane-florence_00000051_post_disaster.png,23,21,1,439,462,480,501,35,8.0,5.656854249492381
4848,/media/marda/TWOTB1/xBD/hurricanes/images/florence/hurricane-florence_00000051_post_disaster.png,63,70,1,536,599,496,566,1376,45.02873205919458,40.85887189235591
4849,/media/marda/TWOTB1/xBD/hurricanes/images/florence/hurricane-florence_00000051_post_disaster.png,48,56,1,407,455,561,617,624,30.695205980940685,26.98106177210991
4850,/media/marda/TWOTB1/xBD/hurricanes/images/florence/hurricane-florence_00000051_post_disaster.png,61,57,1,518,579,580,637,872,39.69404445114043,29.027949482989243
4851,/media/marda/TWOTB1/xBD/hurricanes/images/florence/hurricane-florence_00000515_pre_disaster.png,169,88,1,875,1044,242,330,6116,155.64075587034228,52.25253276742698
4852,/media/marda/TWOTB1/xBD/hurricanes/images/florence/hurricane-florence_00000515_pre_disaster.png,40,15,1,851,891,269,284,49,8.626666160938804,7.18295146259953
4853,/media/marda/TWOTB1/xBD/hurricanes/images/florence/hurricane-florence_00000515_pre_disaster.png,155,88,1,889,1044,310,398,5402,135.31389439786,53.07560493919675
4854,/media/marda/TWOTB1/xBD/hurricanes/images/florence/hurricane-florence_00000515_pre_disaster.png,59,54,1,826,885,325,379,690,42.69907789812574,21.58024654923434
4855,/media/marda/TWOTB1/xBD/hurricanes/images/florence/hurricane-florence_00000515_pre_disaster.png,41,19,1,866,907,326,345,51,8.876200207006525,7.29293672633238
4856,/media/marda/TWOTB1/xBD/hurricanes/images/florence/hurricane-florence_00000515_pre_disaster.png,41,20,1,869,910,336,356,55,8.947498309020478,7.820155752512016
4857,/media/marda/TWOTB1/xBD/hurricanes/images/florence/hurricane-florence_00000515_pre_disaster.png,42,19,1,882,924,387,406,48,8.32666399786453,7.301065371269836
4858,/media/marda/TWOTB1/xBD/hurricanes/images/florence/hurricane-florence_00000515_pre_disaster.png,165,89,1,879,1044,388,477,5863,150.66872120048694,51.733489547707315
4859,/media/marda/TWOTB1/xBD/hurricanes/images/florence/hurricane-florence_00000515_pre_disaster.png,43,23,1,876,919,404,427,54,9.280593078344006,7.402559677721735
4860,/media/marda/TWOTB1/xBD/hurricanes/images/florence/hurricane-florence_00000515_pre_disaster.png,47,87,1,0,47,898,985,1342,54.98679338596379,31.81482889014737
4861,/media/marda/TWOTB1/xBD/hurricanes/images/florence/hurricane-florence_00000536_pre_disaster.png,305,91,1,739,1044,907,998,10401,311.12301133119996,44.49962327634017
4862,/media/marda/TWOTB1/xBD/hurricanes/images/florence/hurricane-florence_00000536_pre_disaster.png,48,49,1,993,1041,964,1013,85,14.39709430640591,7.835228366814603
4863,/media/marda/TWOTB1/xBD/hurricanes/images/florence/hurricane-florence_00000536_pre_disaster.png,203,53,1,736,939,991,1044,1117,165.50292305561624,10.332516410730747
4864,/media/marda/TWOTB1/xBD/hurricanes/images/florence/hurricane-florence_00000536_pre_disaster.png,49,48,1,991,1040,993,1041,50,8.679021276136377,7.357566832069698
4865,/media/marda/TWOTB1/xBD/hurricanes/images/florence/hurricane-florence_00000113_post_disaster.png,79,40,1,787,866,5,45,745,55.24288324390725,20.788843267643113
4866,/media/marda/TWOTB1/xBD/hurricanes/images/florence/hurricane-florence_00000113_post_disaster.png,27,19,1,363,390,27,46,217,21.36502148950535,13.579505908159453
4867,/media/marda/TWOTB1/xBD/hurricanes/images/florence/hurricane-florence_00000113_post_disaster.png,60,41,1,297,357,67,108,1189,48.49508305432274,34.429741032234965
4868,/media/marda/TWOTB1/xBD/hurricanes/images/florence/hurricane-florence_00000113_post_disaster.png,33,21,1,420,453,122,143,176,16.563737380455905,14.272565888765032
4869,/media/marda/TWOTB1/xBD/hurricanes/images/florence/hurricane-florence_00000113_post_disaster.png,47,38,1,391,438,128,166,554,34.47365886771944,21.334750596807776
4870,/media/marda/TWOTB1/xBD/hurricanes/images/florence/hurricane-florence_00000113_post_disaster.png,62,46,1,543,605,198,244,782,43.11987567475917,24.166000021010483
4871,/media/marda/TWOTB1/xBD/hurricanes/images/florence/hurricane-florence_00000113_post_disaster.png,42,41,1,220,262,236,277,549,34.89754672732204,20.922023197524148
4872,/media/marda/TWOTB1/xBD/hurricanes/images/florence/hurricane-florence_00000113_post_disaster.png,62,53,1,706,768,257,310,555,52.83286407703393,14.405719339690515
4873,/media/marda/TWOTB1/xBD/hurricanes/images/florence/hurricane-florence_00000113_post_disaster.png,42,29,1,561,603,259,288,234,20.548309524429065,15.245774573793371
4874,/media/marda/TWOTB1/xBD/hurricanes/images/florence/hurricane-florence_00000113_post_disaster.png,58,48,1,506,564,275,323,915,39.530890164522404,31.227654299999227
4875,/media/marda/TWOTB1/xBD/hurricanes/images/florence/hurricane-florence_00000113_post_disaster.png,48,25,1,574,622,289,314,160,29.507349924681236,7.2330007896041435
4876,/media/marda/TWOTB1/xBD/hurricanes/images/florence/hurricane-florence_00000113_post_disaster.png,45,26,1,716,761,307,333,103,17.51964615837076,7.931169765776567
4877,/media/marda/TWOTB1/xBD/hurricanes/images/florence/hurricane-florence_00000113_post_disaster.png,40,28,1,522,562,341,369,188,19.95434050102058,12.638241779892885
4878,/media/marda/TWOTB1/xBD/hurricanes/images/florence/hurricane-florence_00000113_post_disaster.png,27,24,1,423,450,353,377,107,13.102555717112551,10.98393849037789
4879,/media/marda/TWOTB1/xBD/hurricanes/images/florence/hurricane-florence_00000113_post_disaster.png,51,29,1,796,847,354,383,158,17.019371264309065,12.432353036492326
4880,/media/marda/TWOTB1/xBD/hurricanes/images/florence/hurricane-florence_00000113_post_disaster.png,44,51,1,409,453,379,430,856,39.59935929779875,28.436798105627105
4881,/media/marda/TWOTB1/xBD/hurricanes/images/florence/hurricane-florence_00000113_post_disaster.png,45,41,1,365,410,417,458,288,35.186067780921114,10.99544173986187
4882,/media/marda/TWOTB1/xBD/hurricanes/images/florence/hurricane-florence_00000113_post_disaster.png,28,36,1,405,433,451,487,175,19.22234066351027,12.274115580908894
4883,/media/marda/TWOTB1/xBD/hurricanes/images/florence/hurricane-florence_00000113_post_disaster.png,73,61,1,850,923,457,518,839,52.56177292321713,21.29734925934253
4884,/media/marda/TWOTB1/xBD/hurricanes/images/florence/hurricane-florence_00000113_post_disaster.png,58,43,1,875,933,503,546,272,20.672548120045843,17.728177332298632
4885,/media/marda/TWOTB1/xBD/hurricanes/images/florence/hurricane-florence_00000113_post_disaster.png,43,63,1,560,603,757,820,681,37.93522117645778,23.812945995067516
4886,/media/marda/TWOTB1/xBD/hurricanes/images/florence/hurricane-florence_00000113_post_disaster.png,51,74,1,773,824,829,903,832,45.773447497564725,24.251415214633095
4887,/media/marda/TWOTB1/xBD/hurricanes/images/florence/hurricane-florence_00000113_post_disaster.png,42,65,1,565,607,841,906,659,35.35096158610834,24.90151932074068
4888,/media/marda/TWOTB1/xBD/hurricanes/images/florence/hurricane-florence_00000113_post_disaster.png,38,84,1,564,602,954,1038,571,52.22891895173368,15.446260677669278
4889,/media/marda/TWOTB1/xBD/hurricanes/images/florence/hurricane-florence_00000113_post_disaster.png,53,55,1,781,834,988,1043,327,25.449381841280523,17.01333368813134
4890,/media/marda/TWOTB1/xBD/hurricanes/images/florence/hurricane-florence_00000088_pre_disaster.png,19,71,1,0,19,882,953,433,38.82386923512283,17.095422671881348
4891,/media/marda/TWOTB1/xBD/hurricanes/images/florence/hurricane-florence_00000445_pre_disaster.png,40,18,1,630,670,0,18,265,19.727442383528693,17.918957423926297
4892,/media/marda/TWOTB1/xBD/hurricanes/images/florence/hurricane-florence_00000445_pre_disaster.png,34,11,1,666,700,0,11,92,12.408522780703125,9.777980500360076
4893,/media/marda/TWOTB1/xBD/hurricanes/images/florence/hurricane-florence_00000445_pre_disaster.png,64,45,1,791,855,0,45,961,51.36874473675875,24.89113075957779
4894,/media/marda/TWOTB1/xBD/hurricanes/images/florence/hurricane-florence_00000445_pre_disaster.png,47,15,1,502,549,1,16,264,29.39378154979112,12.72285656266259
4895,/media/marda/TWOTB1/xBD/hurricanes/images/florence/hurricane-florence_00000445_pre_disaster.png,94,49,1,364,458,12,61,2754,87.94666155179047,41.49201846472777
4896,/media/marda/TWOTB1/xBD/hurricanes/images/florence/hurricane-florence_00000445_pre_disaster.png,37,22,1,511,548,21,43,271,21.35785369153672,16.985824097615502
4897,/media/marda/TWOTB1/xBD/hurricanes/images/florence/hurricane-florence_00000445_pre_disaster.png,31,66,1,6,37,455,521,740,55.21917558338198,17.836059390533734
4898,/media/marda/TWOTB1/xBD/hurricanes/images/florence/hurricane-florence_00000445_pre_disaster.png,10,47,1,0,10,522,569,144,24.81149362356733,8.85894088197871
4899,/media/marda/TWOTB1/xBD/hurricanes/images/florence/hurricane-florence_00000249_pre_disaster.png,45,20,1,640,685,202,222,207,23.865215337344107,11.633355983078255
4900,/media/marda/TWOTB1/xBD/hurricanes/images/florence/hurricane-florence_00000249_pre_disaster.png,56,51,1,676,732,221,272,1009,47.2053620286527,28.320284213675613
4901,/media/marda/TWOTB1/xBD/hurricanes/images/florence/hurricane-florence_00000249_pre_disaster.png,62,52,1,598,660,381,433,883,38.952801752743646,30.19427309021581
4902,/media/marda/TWOTB1/xBD/hurricanes/images/florence/hurricane-florence_00000249_pre_disaster.png,44,34,1,602,646,437,471,208,17.57718000207442,15.785563511133333
4903,/media/marda/TWOTB1/xBD/hurricanes/images/florence/hurricane-florence_00000249_pre_disaster.png,73,77,1,604,677,455,532,1585,61.58511636580045,34.27630327294936
4904,/media/marda/TWOTB1/xBD/hurricanes/images/florence/hurricane-florence_00000249_pre_disaster.png,50,36,1,452,502,483,519,375,32.21111306566632,15.544306037323503
4905,/media/marda/TWOTB1/xBD/hurricanes/images/florence/hurricane-florence_00000249_pre_disaster.png,55,46,1,522,577,514,560,481,36.31054857227566,17.599752016104304
4906,/media/marda/TWOTB1/xBD/hurricanes/images/florence/hurricane-florence_00000249_pre_disaster.png,62,62,1,588,650,529,591,971,38.37846056815997,33.495569458881235
4907,/media/marda/TWOTB1/xBD/hurricanes/images/florence/hurricane-florence_00000249_pre_disaster.png,37,39,1,473,510,642,681,184,18.933995384113917,12.765518014335143
4908,/media/marda/TWOTB1/xBD/hurricanes/images/florence/hurricane-florence_00000249_pre_disaster.png,102,107,1,456,558,705,812,3210,89.93107742445949,60.18521476486178
4909,/media/marda/TWOTB1/xBD/hurricanes/images/florence/hurricane-florence_00000249_pre_disaster.png,59,74,1,594,653,854,928,857,43.626144706593465,26.119219297390888
4910,/media/marda/TWOTB1/xBD/hurricanes/images/florence/hurricane-florence_00000015_post_disaster.png,15,28,1,0,15,0,28,271,28.09229951435916,13.519029462004058
4911,/media/marda/TWOTB1/xBD/hurricanes/images/florence/hurricane-florence_00000015_post_disaster.png,51,57,1,10,61,0,57,1756,54.281394297490735,44.738968337330185
4912,/media/marda/TWOTB1/xBD/hurricanes/images/florence/hurricane-florence_00000015_post_disaster.png,59,20,1,110,169,0,20,628,55.76390907855716,17.55718875773887
4913,/media/marda/TWOTB1/xBD/hurricanes/images/florence/hurricane-florence_00000015_post_disaster.png,80,31,1,590,670,0,31,981,51.85692182287899,27.645747448571058
4914,/media/marda/TWOTB1/xBD/hurricanes/images/florence/hurricane-florence_00000015_post_disaster.png,56,12,1,831,887,0,12,150,20.573996971735557,11.183808919162983
4915,/media/marda/TWOTB1/xBD/hurricanes/images/florence/hurricane-florence_00000015_post_disaster.png,97,42,1,906,1003,0,42,1400,58.782935950807044,31.8900738216495
4916,/media/marda/TWOTB1/xBD/hurricanes/images/florence/hurricane-florence_00000015_post_disaster.png,52,57,1,70,122,14,71,1760,55.17111524452672,43.806987445841436
4917,/media/marda/TWOTB1/xBD/hurricanes/images/florence/hurricane-florence_00000015_post_disaster.png,83,51,1,650,733,16,67,1337,61.1041249955149,29.444784999453
4918,/media/marda/TWOTB1/xBD/hurricanes/images/florence/hurricane-florence_00000015_post_disaster.png,90,31,1,842,932,40,71,1340,59.76698292284172,30.19212815252867
4919,/media/marda/TWOTB1/xBD/hurricanes/images/florence/hurricane-florence_00000015_post_disaster.png,90,61,1,691,781,46,107,1834,55.13703741741297,47.358972700454345
4920,/media/marda/TWOTB1/xBD/hurricanes/images/florence/hurricane-florence_00000015_post_disaster.png,101,42,1,448,549,50,92,2654,86.6362385135783,40.116497627182646
4921,/media/marda/TWOTB1/xBD/hurricanes/images/florence/hurricane-florence_00000015_post_disaster.png,69,68,1,975,1044,98,166,1104,57.698969607403356,28.277010849837904
4922,/media/marda/TWOTB1/xBD/hurricanes/images/florence/hurricane-florence_00000015_post_disaster.png,67,65,1,767,834,102,167,1588,65.02734805177745,33.40367354101086
4923,/media/marda/TWOTB1/xBD/hurricanes/images/florence/hurricane-florence_00000015_post_disaster.png,66,81,1,354,420,104,185,2096,83.43746102521555,33.959579156597485
4924,/media/marda/TWOTB1/xBD/hurricanes/images/florence/hurricane-florence_00000015_post_disaster.png,77,72,1,543,620,120,192,2103,67.52691415624878,44.69871593158367
4925,/media/marda/TWOTB1/xBD/hurricanes/images/florence/hurricane-florence_00000015_post_disaster.png,96,56,1,926,1022,150,206,1596,54.836479950162115,41.80990558100065
4926,/media/marda/TWOTB1/xBD/hurricanes/images/florence/hurricane-florence_00000015_post_disaster.png,87,53,1,694,781,170,223,1448,53.21819214772163,38.053467762682764
4927,/media/marda/TWOTB1/xBD/hurricanes/images/florence/hurricane-florence_00000015_post_disaster.png,88,53,1,874,962,180,233,1443,49.138997231972354,38.49967256908815
4928,/media/marda/TWOTB1/xBD/hurricanes/images/florence/hurricane-florence_00000015_post_disaster.png,79,59,1,578,657,183,242,1664,55.51220702433363,40.26942806476018
4929,/media/marda/TWOTB1/xBD/hurricanes/images/florence/hurricane-florence_00000015_post_disaster.png,69,70,1,390,459,185,255,1699,60.27852435270705,46.49890208647236
4930,/media/marda/TWOTB1/xBD/hurricanes/images/florence/hurricane-florence_00000015_post_disaster.png,81,103,1,642,723,201,304,2436,90.35257695233415,43.47812159219787
4931,/media/marda/TWOTB1/xBD/hurricanes/images/florence/hurricane-florence_00000015_post_disaster.png,92,81,1,840,932,222,303,2071,66.40359265656443,43.983484815841486
4932,/media/marda/TWOTB1/xBD/hurricanes/images/florence/hurricane-florence_00000015_post_disaster.png,70,56,1,459,529,250,306,1460,48.09739087288065,40.71256494847169
4933,/media/marda/TWOTB1/xBD/hurricanes/images/florence/hurricane-florence_00000015_post_disaster.png,84,72,1,787,871,258,330,1570,62.1346440275099,36.321667895855015
4934,/media/marda/TWOTB1/xBD/hurricanes/images/florence/hurricane-florence_00000015_post_disaster.png,67,67,1,260,327,285,352,1722,56.32588042900121,49.67544994903261
4935,/media/marda/TWOTB1/xBD/hurricanes/images/florence/hurricane-florence_00000015_post_disaster.png,75,61,1,509,584,293,354,1563,53.69603458809636,39.546650289367946
4936,/media/marda/TWOTB1/xBD/hurricanes/images/florence/hurricane-florence_00000015_post_disaster.png,81,86,1,159,240,301,387,2415,82.5282492796787,40.21716728322478
4937,/media/marda/TWOTB1/xBD/hurricanes/images/florence/hurricane-florence_00000015_post_disaster.png,78,67,1,749,827,312,379,1308,48.10098976517097,38.60139369863134
4938,/media/marda/TWOTB1/xBD/hurricanes/images/florence/hurricane-florence_00000015_post_disaster.png,66,64,1,601,667,345,409,1021,56.126992363636944,24.28457777041661
4939,/media/marda/TWOTB1/xBD/hurricanes/images/florence/hurricane-florence_00000015_post_disaster.png,69,70,1,308,377,349,419,1609,59.83892773822774,35.888125998377646
4940,/media/marda/TWOTB1/xBD/hurricanes/images/florence/hurricane-florence_00000015_post_disaster.png,85,68,1,709,794,376,444,1703,52.32136877546066,45.66077827621157
4941,/media/marda/TWOTB1/xBD/hurricanes/images/florence/hurricane-florence_00000015_post_disaster.png,78,68,1,542,620,388,456,1472,56.50267439797148,36.59722955483766
4942,/media/marda/TWOTB1/xBD/hurricanes/images/florence/hurricane-florence_00000015_post_disaster.png,52,65,1,36,88,394,459,1208,48.916090593331425,33.63583696419966
4943,/media/marda/TWOTB1/xBD/hurricanes/images/florence/hurricane-florence_00000015_post_disaster.png,71,73,1,361,432,401,474,1546,59.822878131275125,36.393490210589306
4944,/media/marda/TWOTB1/xBD/hurricanes/images/florence/hurricane-florence_00000015_post_disaster.png,53,76,1,170,223,406,482,1322,57.3130215745438,34.19756930229845
4945,/media/marda/TWOTB1/xBD/hurricanes/images/florence/hurricane-florence_00000015_post_disaster.png,48,71,1,63,111,419,490,1255,47.37846011644794,36.38973068108715
4946,/media/marda/TWOTB1/xBD/hurricanes/images/florence/hurricane-florence_00000015_post_disaster.png,77,80,1,677,754,420,500,1603,62.28437151208736,35.405601205905064
4947,/media/marda/TWOTB1/xBD/hurricanes/images/florence/hurricane-florence_00000015_post_disaster.png,56,60,1,89,145,452,512,1186,47.307235423079476,34.30913478289473
4948,/media/marda/TWOTB1/xBD/hurricanes/images/florence/hurricane-florence_00000015_post_disaster.png,92,73,1,504,596,452,525,1981,68.9748662442961,42.739473268042424
4949,/media/marda/TWOTB1/xBD/hurricanes/images/florence/hurricane-florence_00000015_post_disaster.png,57,73,1,430,487,454,527,1070,53.96277254751471,33.0754975586854
4950,/media/marda/TWOTB1/xBD/hurricanes/images/florence/hurricane-florence_00000015_post_disaster.png,73,69,1,230,303,456,525,1680,60.712268382072736,38.64885017475434
4951,/media/marda/TWOTB1/xBD/hurricanes/images/florence/hurricane-florence_00000015_post_disaster.png,19,50,1,0,19,464,514,337,31.18480324245533,15.544998407407904
4952,/media/marda/TWOTB1/xBD/hurricanes/images/florence/hurricane-florence_00000015_post_disaster.png,48,70,1,121,169,476,546,1193,48.60083831242679,34.34673172886419
4953,/media/marda/TWOTB1/xBD/hurricanes/images/florence/hurricane-florence_00000015_post_disaster.png,77,65,1,651,728,479,544,1410,46.373267992243576,41.23444085160455
4954,/media/marda/TWOTB1/xBD/hurricanes/images/florence/hurricane-florence_00000015_post_disaster.png,62,65,1,281,343,494,559,1206,45.886622039667216,37.33049076354807
4955,/media/marda/TWOTB1/xBD/hurricanes/images/florence/hurricane-florence_00000015_post_disaster.png,64,75,1,477,541,506,581,1325,53.07228899502265,35.22709518796602
4956,/media/marda/TWOTB1/xBD/hurricanes/images/florence/hurricane-florence_00000015_post_disaster.png,62,59,1,143,205,509,568,1169,50.25587454064806,31.418663200597123
4957,/media/marda/TWOTB1/xBD/hurricanes/images/florence/hurricane-florence_00000015_post_disaster.png,100,80,1,717,817,517,597,1987,67.5722100859591,44.78916490983234
4958,/media/marda/TWOTB1/xBD/hurricanes/images/florence/hurricane-florence_00000015_post_disaster.png,53,63,1,177,230,538,601,1045,42.66287548341812,32.578712842170326
4959,/media/marda/TWOTB1/xBD/hurricanes/images/florence/hurricane-florence_00000015_post_disaster.png,60,68,1,337,397,541,609,1121,47.25001752424581,33.467487547600975
4960,/media/marda/TWOTB1/xBD/hurricanes/images/florence/hurricane-florence_00000015_post_disaster.png,48,65,1,211,259,565,630,936,39.00903329809772,34.89113277414419
4961,/media/marda/TWOTB1/xBD/hurricanes/images/florence/hurricane-florence_00000015_post_disaster.png,49,67,1,91,140,575,642,1063,48.254683415198905,29.565056269715402
4962,/media/marda/TWOTB1/xBD/hurricanes/images/florence/hurricane-florence_00000015_post_disaster.png,89,68,1,584,673,579,647,1693,63.15987473279804,39.79820017036135
4963,/media/marda/TWOTB1/xBD/hurricanes/images/florence/hurricane-florence_00000015_post_disaster.png,95,73,1,775,870,583,656,1567,61.30548694975055,39.23922224522748
4964,/media/marda/TWOTB1/xBD/hurricanes/images/florence/hurricane-florence_00000015_post_disaster.png,52,74,1,236,288,588,662,1137,45.223897406494046,34.330924432705544
4965,/media/marda/TWOTB1/xBD/hurricanes/images/florence/hurricane-florence_00000015_post_disaster.png,63,88,1,416,479,600,688,1545,62.48920200431445,35.44554358894103
4966,/media/marda/TWOTB1/xBD/hurricanes/images/florence/hurricane-florence_00000015_post_disaster.png,47,78,1,45,92,603,681,1246,49.16820289863066,34.93390547974349
4967,/media/marda/TWOTB1/xBD/hurricanes/images/florence/hurricane-florence_00000015_post_disaster.png,45,69,1,119,164,609,678,1002,40.91928843828814,32.60856953291832
4968,/media/marda/TWOTB1/xBD/hurricanes/images/florence/hurricane-florence_00000015_post_disaster.png,57,68,1,265,322,617,685,1075,44.52094415193386,32.84455388855807
4969,/media/marda/TWOTB1/xBD/hurricanes/images/florence/hurricane-florence_00000015_post_disaster.png,83,87,1,640,723,624,711,1722,56.52095238216518,46.01197199256846
4970,/media/marda/TWOTB1/xBD/hurricanes/images/florence/hurricane-florence_00000015_post_disaster.png,85,70,1,819,904,628,698,1224,49.37872074741399,33.78394134979811
4971,/media/marda/TWOTB1/xBD/hurricanes/images/florence/hurricane-florence_00000015_post_disaster.png,79,88,1,533,612,631,719,1742,67.49415952909501,38.251826211412165
4972,/media/marda/TWOTB1/xBD/hurricanes/images/florence/hurricane-florence_00000015_post_disaster.png,38,63,1,154,192,637,700,668,36.12666691133911,25.419547730898262
4973,/media/marda/TWOTB1/xBD/hurricanes/images/florence/hurricane-florence_00000015_post_disaster.png,54,66,1,70,124,647,713,1225,47.00605473973161,35.14656166655139
4974,/media/marda/TWOTB1/xBD/hurricanes/images/florence/hurricane-florence_00000015_post_disaster.png,67,61,1,285,352,656,717,1278,56.16068572089863,30.825608047977063
4975,/media/marda/TWOTB1/xBD/hurricanes/images/florence/hurricane-florence_00000015_post_disaster.png,52,76,1,380,432,659,735,1006,48.091251572779285,30.20264381236155
4976,/media/marda/TWOTB1/xBD/hurricanes/images/florence/hurricane-florence_00000015_post_disaster.png,49,70,1,169,218,674,744,1057,47.40839555530809,29.28438116461212
4977,/media/marda/TWOTB1/xBD/hurricanes/images/florence/hurricane-florence_00000015_post_disaster.png,48,64,1,94,142,681,745,944,40.24918384672625,32.40527546886587
4978,/media/marda/TWOTB1/xBD/hurricanes/images/florence/hurricane-florence_00000015_post_disaster.png,86,77,1,860,946,682,759,1225,60.35080427057972,26.90413238883511
4979,/media/marda/TWOTB1/xBD/hurricanes/images/florence/hurricane-florence_00000015_post_disaster.png,79,84,1,687,766,683,767,1656,60.80003553022665,36.138176489589696
4980,/media/marda/TWOTB1/xBD/hurricanes/images/florence/hurricane-florence_00000015_post_disaster.png,56,70,1,270,326,693,763,964,39.854631374303366,32.39291686516981
4981,/media/marda/TWOTB1/xBD/hurricanes/images/florence/hurricane-florence_00000015_post_disaster.png,67,82,1,498,565,696,778,1515,51.73426218271972,40.20242368337575
4982,/media/marda/TWOTB1/xBD/hurricanes/images/florence/hurricane-florence_00000015_post_disaster.png,11,45,1,0,11,700,745,100,15.559427513513528,9.22684211698229
4983,/media/marda/TWOTB1/xBD/hurricanes/images/florence/hurricane-florence_00000015_post_disaster.png,45,68,1,0,45,709,777,1058,48.72695972554941,28.511856833367013
4984,/media/marda/TWOTB1/xBD/hurricanes/images/florence/hurricane-florence_00000015_post_disaster.png,46,64,1,127,173,713,777,1104,49.61823957186944,31.517117824878405
4985,/media/marda/TWOTB1/xBD/hurricanes/images/florence/hurricane-florence_00000015_post_disaster.png,62,85,1,348,410,717,802,1395,56.19833335386909,34.35039713009011
4986,/media/marda/TWOTB1/xBD/hurricanes/images/florence/hurricane-florence_00000015_post_disaster.png,51,72,1,249,300,719,791,935,40.178475076947635,31.319887099778004
4987,/media/marda/TWOTB1/xBD/hurricanes/images/florence/hurricane-florence_00000015_post_disaster.png,43,77,1,17,60,731,808,1185,48.31862836897154,32.89931450946752
4988,/media/marda/TWOTB1/xBD/hurricanes/images/florence/hurricane-florence_00000015_post_disaster.png,76,83,1,587,663,733,816,1447,57.33857923183217,34.8445283094422
4989,/media/marda/TWOTB1/xBD/hurricanes/images/florence/hurricane-florence_00000015_post_disaster.png,93,89,1,731,824,736,825,1841,55.32425900546038,50.47769103701007
4990,/media/marda/TWOTB1/xBD/hurricanes/images/florence/hurricane-florence_00000015_post_disaster.png,101,71,1,892,993,740,811,1519,61.40848989600858,34.62874732778475
4991,/media/marda/TWOTB1/xBD/hurricanes/images/florence/hurricane-florence_00000015_post_disaster.png,77,101,1,202,279,743,844,2290,93.27342312730512,41.157934078374694
4992,/media/marda/TWOTB1/xBD/hurricanes/images/florence/hurricane-florence_00000015_post_disaster.png,39,56,1,295,334,761,817,399,26.510026909114732,20.112774016712017
4993,/media/marda/TWOTB1/xBD/hurricanes/images/florence/hurricane-florence_00000015_post_disaster.png,43,72,1,37,80,763,835,1058,42.65420373359498,32.89992580793352
4994,/media/marda/TWOTB1/xBD/hurricanes/images/florence/hurricane-florence_00000015_post_disaster.png,93,92,1,942,1035,771,863,1635,62.63415536411067,36.25586577690629
4995,/media/marda/TWOTB1/xBD/hurricanes/images/florence/hurricane-florence_00000015_post_disaster.png,65,83,1,296,361,773,856,1432,58.904937678872486,31.967618680925803
4996,/media/marda/TWOTB1/xBD/hurricanes/images/florence/hurricane-florence_00000015_post_disaster.png,90,88,1,780,870,776,864,1820,59.44642447270167,43.97262291023856
4997,/media/marda/TWOTB1/xBD/hurricanes/images/florence/hurricane-florence_00000015_post_disaster.png,38,77,1,59,97,792,869,876,43.493096292757286,28.43883012881701
4998,/media/marda/TWOTB1/xBD/hurricanes/images/florence/hurricane-florence_00000015_post_disaster.png,80,90,1,440,520,792,882,1807,57.90054208190578,44.02050535621283
4999,/media/marda/TWOTB1/xBD/hurricanes/images/florence/hurricane-florence_00000015_post_disaster.png,79,87,1,643,722,811,898,1248,62.33442997606257,26.779319058197856
5000,/media/marda/TWOTB1/xBD/hurricanes/images/florence/hurricane-florence_00000015_post_disaster.png,61,72,1,208,269,816,888,1321,51.8561567560756,35.703221683318965
5001,/media/marda/TWOTB1/xBD/hurricanes/images/florence/hurricane-florence_00000015_post_disaster.png,55,81,1,77,132,818,899,1415,46.98329815420816,40.12822829041732
5002,/media/marda/TWOTB1/xBD/hurricanes/images/florence/hurricane-florence_00000015_post_disaster.png,81,90,1,823,904,823,913,1406,54.232854444222106,35.16080336690529
5003,/media/marda/TWOTB1/xBD/hurricanes/images/florence/hurricane-florence_00000015_post_disaster.png,59,80,1,985,1044,827,907,492,42.71266191565104,17.11964591844801
5004,/media/marda/TWOTB1/xBD/hurricanes/images/florence/hurricane-florence_00000015_post_disaster.png,72,97,1,392,464,844,941,1861,60.52549033459649,43.689260294811795
5005,/media/marda/TWOTB1/xBD/hurricanes/images/florence/hurricane-florence_00000015_post_disaster.png,45,83,1,103,148,846,929,1154,48.7852941206939,32.230701107425254
5006,/media/marda/TWOTB1/xBD/hurricanes/images/florence/hurricane-florence_00000015_post_disaster.png,48,77,1,131,179,871,948,1089,41.96134893860842,35.11918507812916
5007,/media/marda/TWOTB1/xBD/hurricanes/images/florence/hurricane-florence_00000015_post_disaster.png,89,93,1,867,956,875,968,1529,63.47254075078494,34.609451380911054
5008,/media/marda/TWOTB1/xBD/hurricanes/images/florence/hurricane-florence_00000015_post_disaster.png,71,69,1,593,664,896,965,1119,49.42192950908542,30.354306879816026
5009,/media/marda/TWOTB1/xBD/hurricanes/images/florence/hurricane-florence_00000015_post_disaster.png,44,78,1,148,192,904,982,896,37.21492510197518,32.4266693093627
5010,/media/marda/TWOTB1/xBD/hurricanes/images/florence/hurricane-florence_00000015_post_disaster.png,91,96,1,906,997,924,1020,1520,64.86947785431964,31.18631035745104
5011,/media/marda/TWOTB1/xBD/hurricanes/images/florence/hurricane-florence_00000015_post_disaster.png,50,86,1,162,212,940,1026,1153,47.146436516663684,33.6433621025695
5012,/media/marda/TWOTB1/xBD/hurricanes/images/florence/hurricane-florence_00000015_post_disaster.png,90,63,1,938,1028,978,1041,743,44.19206524565361,25.206743125989682
5013,/media/marda/TWOTB1/xBD/hurricanes/images/florence/hurricane-florence_00000249_post_disaster.png,45,20,1,640,685,202,222,207,23.865215337344107,11.633355983078255
5014,/media/marda/TWOTB1/xBD/hurricanes/images/florence/hurricane-florence_00000249_post_disaster.png,56,51,1,676,732,221,272,1009,47.2053620286527,28.320284213675613
5015,/media/marda/TWOTB1/xBD/hurricanes/images/florence/hurricane-florence_00000249_post_disaster.png,62,52,1,598,660,381,433,883,38.952801752743646,30.19427309021581
5016,/media/marda/TWOTB1/xBD/hurricanes/images/florence/hurricane-florence_00000249_post_disaster.png,44,34,1,602,646,437,471,208,17.57718000207442,15.785563511133333
5017,/media/marda/TWOTB1/xBD/hurricanes/images/florence/hurricane-florence_00000249_post_disaster.png,73,77,1,604,677,455,532,1585,61.58511636580045,34.27630327294936
5018,/media/marda/TWOTB1/xBD/hurricanes/images/florence/hurricane-florence_00000249_post_disaster.png,50,36,1,452,502,483,519,375,32.21111306566632,15.544306037323503
5019,/media/marda/TWOTB1/xBD/hurricanes/images/florence/hurricane-florence_00000249_post_disaster.png,55,46,1,522,577,514,560,481,36.31054857227566,17.599752016104304
5020,/media/marda/TWOTB1/xBD/hurricanes/images/florence/hurricane-florence_00000249_post_disaster.png,62,62,1,588,650,529,591,971,38.37846056815997,33.495569458881235
5021,/media/marda/TWOTB1/xBD/hurricanes/images/florence/hurricane-florence_00000249_post_disaster.png,37,39,1,473,510,642,681,184,18.933995384113917,12.765518014335143
5022,/media/marda/TWOTB1/xBD/hurricanes/images/florence/hurricane-florence_00000249_post_disaster.png,102,107,1,456,558,705,812,3210,89.93107742445949,60.18521476486178
5023,/media/marda/TWOTB1/xBD/hurricanes/images/florence/hurricane-florence_00000249_post_disaster.png,59,74,1,594,653,854,928,857,43.626144706593465,26.119219297390888
5024,/media/marda/TWOTB1/xBD/hurricanes/images/florence/hurricane-florence_00000471_pre_disaster.png,74,47,1,380,454,74,121,1961,61.59459587317508,42.37846073028257
5025,/media/marda/TWOTB1/xBD/hurricanes/images/florence/hurricane-florence_00000486_pre_disaster.png,266,23,1,674,940,0,23,2720,225.5278466531921,18.54056816042332
5026,/media/marda/TWOTB1/xBD/hurricanes/images/florence/hurricane-florence_00000413_post_disaster.png,23,26,1,0,23,25,51,392,24.315759025952413,22.036146189314987
5027,/media/marda/TWOTB1/xBD/hurricanes/images/florence/hurricane-florence_00000413_post_disaster.png,68,49,1,5,73,49,98,1892,67.38968046506784,41.02124742660844
5028,/media/marda/TWOTB1/xBD/hurricanes/images/florence/hurricane-florence_00000413_post_disaster.png,71,48,1,259,330,57,105,1957,64.62273108970565,42.56000970752237
5029,/media/marda/TWOTB1/xBD/hurricanes/images/florence/hurricane-florence_00000413_post_disaster.png,65,44,1,250,315,107,151,1506,56.25170967554816,37.22162353407977
5030,/media/marda/TWOTB1/xBD/hurricanes/images/florence/hurricane-florence_00000413_post_disaster.png,71,54,1,76,147,130,184,1844,62.06714319080535,42.83471340624116
5031,/media/marda/TWOTB1/xBD/hurricanes/images/florence/hurricane-florence_00000413_post_disaster.png,58,67,1,279,337,208,275,1944,59.076395741242756,45.01403027379398
5032,/media/marda/TWOTB1/xBD/hurricanes/images/florence/hurricane-florence_00000413_post_disaster.png,85,68,1,235,320,338,406,2274,74.95778813706006,42.20394793078292
5033,/media/marda/TWOTB1/xBD/hurricanes/images/florence/hurricane-florence_00000413_post_disaster.png,41,77,1,0,41,659,736,1433,53.304957308878954,36.63667592948661
5034,/media/marda/TWOTB1/xBD/hurricanes/images/florence/hurricane-florence_00000413_post_disaster.png,37,72,1,8,45,793,865,1253,42.23523506548655,39.38349168287091
5035,/media/marda/TWOTB1/xBD/hurricanes/images/florence/hurricane-florence_00000413_post_disaster.png,52,81,1,13,65,862,943,1802,62.37873162312802,44.47117576050641
5036,/media/marda/TWOTB1/xBD/hurricanes/images/florence/hurricane-florence_00000330_pre_disaster.png,33,12,1,191,224,0,12,228,26.639439053256318,11.879817692164467
5037,/media/marda/TWOTB1/xBD/hurricanes/images/florence/hurricane-florence_00000330_pre_disaster.png,42,13,1,296,338,0,13,261,29.032995904058076,12.477743974024653
5038,/media/marda/TWOTB1/xBD/hurricanes/images/florence/hurricane-florence_00000330_pre_disaster.png,32,22,1,176,208,4,26,327,26.073925822611773,16.707297579114094
5039,/media/marda/TWOTB1/xBD/hurricanes/images/florence/hurricane-florence_00000330_pre_disaster.png,56,59,1,160,216,27,86,1637,62.53249358115568,37.12939925060817
5040,/media/marda/TWOTB1/xBD/hurricanes/images/florence/hurricane-florence_00000330_pre_disaster.png,20,9,1,326,346,31,40,61,9.458909452539176,8.646395355010812
5041,/media/marda/TWOTB1/xBD/hurricanes/images/florence/hurricane-florence_00000330_pre_disaster.png,93,43,1,917,1010,78,121,1248,57.787430800986954,30.005339253960667
5042,/media/marda/TWOTB1/xBD/hurricanes/images/florence/hurricane-florence_00000330_pre_disaster.png,66,35,1,888,954,150,185,336,39.58382033187163,18.759377703813445
5043,/media/marda/TWOTB1/xBD/hurricanes/images/florence/hurricane-florence_00000330_pre_disaster.png,47,33,1,527,574,170,203,500,25.90343278739231,25.327900383352915
5044,/media/marda/TWOTB1/xBD/hurricanes/images/florence/hurricane-florence_00000330_pre_disaster.png,75,35,1,438,513,194,229,810,65.91186469399744,16.23339710037856
5045,/media/marda/TWOTB1/xBD/hurricanes/images/florence/hurricane-florence_00000330_pre_disaster.png,62,61,1,553,615,207,268,1188,53.35616122214698,29.54878727650846
5046,/media/marda/TWOTB1/xBD/hurricanes/images/florence/hurricane-florence_00000330_pre_disaster.png,75,38,1,877,952,275,313,811,42.87474653277403,24.963060683548505
5047,/media/marda/TWOTB1/xBD/hurricanes/images/florence/hurricane-florence_00000330_pre_disaster.png,83,50,1,891,974,439,489,982,49.64235062963826,26.22755627869833
5048,/media/marda/TWOTB1/xBD/hurricanes/images/florence/hurricane-florence_00000330_pre_disaster.png,59,34,1,894,953,486,520,210,23.918421306250504,11.768585233883389
5049,/media/marda/TWOTB1/xBD/hurricanes/images/florence/hurricane-florence_00000330_pre_disaster.png,65,58,1,979,1044,656,714,700,33.19123182407892,27.88610756822065
5050,/media/marda/TWOTB1/xBD/hurricanes/images/florence/hurricane-florence_00000330_pre_disaster.png,51,66,1,642,693,967,1033,464,27.76726801060222,22.083425857863997
5051,/media/marda/TWOTB1/xBD/hurricanes/images/florence/hurricane-florence_00000330_pre_disaster.png,40,47,1,675,715,977,1024,68,13.570944992887132,6.76105057969604
5052,/media/marda/TWOTB1/xBD/hurricanes/images/florence/hurricane-florence_00000191_pre_disaster.png,65,33,1,915,980,32,65,699,34.5950717692382,26.72544699575734
5053,/media/marda/TWOTB1/xBD/hurricanes/images/florence/hurricane-florence_00000191_pre_disaster.png,78,38,1,915,993,66,104,1017,42.218555287504664,33.499367383722145
5054,/media/marda/TWOTB1/xBD/hurricanes/images/florence/hurricane-florence_00000191_pre_disaster.png,96,137,1,779,875,78,215,4061,154.12375690323017,35.80091657785597
5055,/media/marda/TWOTB1/xBD/hurricanes/images/florence/hurricane-florence_00000191_pre_disaster.png,42,14,1,758,800,88,102,119,13.016298233563385,12.313039245185111
5056,/media/marda/TWOTB1/xBD/hurricanes/images/florence/hurricane-florence_00000191_pre_disaster.png,80,31,1,924,1004,98,129,840,46.2849876114113,23.9568501708973
5057,/media/marda/TWOTB1/xBD/hurricanes/images/florence/hurricane-florence_00000191_pre_disaster.png,95,162,1,706,801,123,285,3993,181.71606801891642,30.70439850708399
5058,/media/marda/TWOTB1/xBD/hurricanes/images/florence/hurricane-florence_00000191_pre_disaster.png,81,32,1,943,1024,173,205,751,47.48549101791623,20.810490423660546
5059,/media/marda/TWOTB1/xBD/hurricanes/images/florence/hurricane-florence_00000191_pre_disaster.png,129,53,1,461,590,174,227,2594,123.401968966652,30.085163243460904
5060,/media/marda/TWOTB1/xBD/hurricanes/images/florence/hurricane-florence_00000191_pre_disaster.png,56,29,1,884,940,181,210,299,24.68676385943021,16.238513329173312
5061,/media/marda/TWOTB1/xBD/hurricanes/images/florence/hurricane-florence_00000191_pre_disaster.png,73,41,1,404,477,188,229,1213,59.96897497920346,27.00059965143573
5062,/media/marda/TWOTB1/xBD/hurricanes/images/florence/hurricane-florence_00000191_pre_disaster.png,46,45,1,43,89,201,246,1289,45.25850556348741,36.37106353729089
5063,/media/marda/TWOTB1/xBD/hurricanes/images/florence/hurricane-florence_00000191_pre_disaster.png,35,18,1,512,547,207,225,83,15.685323699384886,7.141475222106989
5064,/media/marda/TWOTB1/xBD/hurricanes/images/florence/hurricane-florence_00000191_pre_disaster.png,60,53,1,814,874,212,265,746,46.408158854281425,21.363508690858133
5065,/media/marda/TWOTB1/xBD/hurricanes/images/florence/hurricane-florence_00000191_pre_disaster.png,108,44,1,486,594,213,257,1381,93.06617076564508,20.72356842627802
5066,/media/marda/TWOTB1/xBD/hurricanes/images/florence/hurricane-florence_00000191_pre_disaster.png,32,24,1,401,433,231,255,177,17.434495341669006,13.519567619226137
5067,/media/marda/TWOTB1/xBD/hurricanes/images/florence/hurricane-florence_00000191_pre_disaster.png,163,96,1,374,537,279,375,7121,150.55443022876577,81.27187516246794
5068,/media/marda/TWOTB1/xBD/hurricanes/images/florence/hurricane-florence_00000191_pre_disaster.png,69,36,1,905,974,279,315,566,34.06581139627215,22.215477963855513
5069,/media/marda/TWOTB1/xBD/hurricanes/images/florence/hurricane-florence_00000191_pre_disaster.png,106,64,1,522,628,288,352,3170,83.05024874068673,56.69647303039122
5070,/media/marda/TWOTB1/xBD/hurricanes/images/florence/hurricane-florence_00000191_pre_disaster.png,75,42,1,969,1044,295,337,900,41.514744983747406,28.485690985295204
5071,/media/marda/TWOTB1/xBD/hurricanes/images/florence/hurricane-florence_00000191_pre_disaster.png,72,32,1,822,894,294,326,393,44.52396935353861,11.715215336910417
5072,/media/marda/TWOTB1/xBD/hurricanes/images/florence/hurricane-florence_00000191_pre_disaster.png,52,30,1,936,988,299,329,192,17.40893060553459,14.576854623931618
5073,/media/marda/TWOTB1/xBD/hurricanes/images/florence/hurricane-florence_00000191_pre_disaster.png,68,51,1,771,839,329,380,860,41.8235645246169,28.071689245512726
5074,/media/marda/TWOTB1/xBD/hurricanes/images/florence/hurricane-florence_00000191_pre_disaster.png,49,30,1,398,447,342,372,425,34.056341398865634,16.22003193984053
5075,/media/marda/TWOTB1/xBD/hurricanes/images/florence/hurricane-florence_00000191_pre_disaster.png,75,42,1,796,871,366,408,820,45.4624274990894,23.790601476395242
5076,/media/marda/TWOTB1/xBD/hurricanes/images/florence/hurricane-florence_00000191_pre_disaster.png,53,42,1,919,972,383,425,283,32.47160551513731,11.5663554601186
5077,/media/marda/TWOTB1/xBD/hurricanes/images/florence/hurricane-florence_00000191_pre_disaster.png,90,91,1,836,926,403,494,2619,75.58744884298251,45.797936401390096
5078,/media/marda/TWOTB1/xBD/hurricanes/images/florence/hurricane-florence_00000191_pre_disaster.png,140,113,1,490,630,424,537,7407,115.0709346012047,86.50533010759314
5079,/media/marda/TWOTB1/xBD/hurricanes/images/florence/hurricane-florence_00000191_pre_disaster.png,91,75,1,945,1036,429,504,1981,60.77980062312958,45.43687237572036
5080,/media/marda/TWOTB1/xBD/hurricanes/images/florence/hurricane-florence_00000191_pre_disaster.png,48,33,1,0,48,464,497,590,54.8779181152707,14.290356842283837
5081,/media/marda/TWOTB1/xBD/hurricanes/images/florence/hurricane-florence_00000191_pre_disaster.png,75,95,1,969,1044,490,585,1875,76.08418456151445,36.776122725492925
5082,/media/marda/TWOTB1/xBD/hurricanes/images/florence/hurricane-florence_00000191_pre_disaster.png,66,64,1,846,912,492,556,880,44.02013963501366,26.71872220805579
5083,/media/marda/TWOTB1/xBD/hurricanes/images/florence/hurricane-florence_00000191_pre_disaster.png,53,43,1,160,213,494,537,529,51.8751379421053,13.617797335616443
5084,/media/marda/TWOTB1/xBD/hurricanes/images/florence/hurricane-florence_00000191_pre_disaster.png,104,73,1,566,670,511,584,2367,89.71297383359592,34.9259411838597
5085,/media/marda/TWOTB1/xBD/hurricanes/images/florence/hurricane-florence_00000191_pre_disaster.png,22,47,1,0,22,521,568,408,26.982893739100675,20.22952096598505
5086,/media/marda/TWOTB1/xBD/hurricanes/images/florence/hurricane-florence_00000191_pre_disaster.png,107,67,1,473,580,537,604,2207,100.31814326249942,30.739333397267554
5087,/media/marda/TWOTB1/xBD/hurricanes/images/florence/hurricane-florence_00000191_pre_disaster.png,114,115,1,600,714,549,664,5534,92.49329262081898,78.76053979836456
5088,/media/marda/TWOTB1/xBD/hurricanes/images/florence/hurricane-florence_00000191_pre_disaster.png,82,62,1,867,949,551,613,1218,44.992991333691734,36.114012015438924
5089,/media/marda/TWOTB1/xBD/hurricanes/images/florence/hurricane-florence_00000191_pre_disaster.png,107,88,1,373,480,560,648,3863,101.68870901313386,50.21202881657353
5090,/media/marda/TWOTB1/xBD/hurricanes/images/florence/hurricane-florence_00000191_pre_disaster.png,28,48,1,163,191,561,609,419,27.603860166754842,20.294273533700284
5091,/media/marda/TWOTB1/xBD/hurricanes/images/florence/hurricane-florence_00000191_pre_disaster.png,105,69,1,486,591,569,638,2176,97.90939981702759,29.320986837722604
5092,/media/marda/TWOTB1/xBD/hurricanes/images/florence/hurricane-florence_00000191_pre_disaster.png,39,49,1,4,43,575,624,716,42.292818336608306,22.394115587279114
5093,/media/marda/TWOTB1/xBD/hurricanes/images/florence/hurricane-florence_00000191_pre_disaster.png,34,51,1,137,171,597,648,525,30.776037092877466,22.454381990227333
5094,/media/marda/TWOTB1/xBD/hurricanes/images/florence/hurricane-florence_00000191_pre_disaster.png,49,109,1,314,363,597,706,1446,95.68393459131536,20.181656733348344
5095,/media/marda/TWOTB1/xBD/hurricanes/images/florence/hurricane-florence_00000191_pre_disaster.png,31,43,1,352,383,602,645,231,18.628205251405873,16.608975172817566
5096,/media/marda/TWOTB1/xBD/hurricanes/images/florence/hurricane-florence_00000191_pre_disaster.png,19,40,1,29,48,619,659,219,19.649917973143967,14.807157765079692
5097,/media/marda/TWOTB1/xBD/hurricanes/images/florence/hurricane-florence_00000191_pre_disaster.png,41,77,1,353,394,621,698,887,57.09159818217953,20.771205621452083
5098,/media/marda/TWOTB1/xBD/hurricanes/images/florence/hurricane-florence_00000191_pre_disaster.png,73,99,1,502,575,624,723,2556,78.3114372793497,43.40656035498656
5099,/media/marda/TWOTB1/xBD/hurricanes/images/florence/hurricane-florence_00000191_pre_disaster.png,52,63,1,391,443,629,692,971,36.789731220018346,35.05823373731354
5100,/media/marda/TWOTB1/xBD/hurricanes/images/florence/hurricane-florence_00000191_pre_disaster.png,51,63,1,200,251,636,699,1180,41.20045311829367,37.68319439381096
5101,/media/marda/TWOTB1/xBD/hurricanes/images/florence/hurricane-florence_00000191_pre_disaster.png,65,71,1,552,617,644,715,1337,43.461112298565084,41.23314833033502
5102,/media/marda/TWOTB1/xBD/hurricanes/images/florence/hurricane-florence_00000191_pre_disaster.png,86,66,1,871,957,650,716,1378,54.22655424839316,35.646368112047405
5103,/media/marda/TWOTB1/xBD/hurricanes/images/florence/hurricane-florence_00000191_pre_disaster.png,74,90,1,32,106,661,751,2784,71.00742748905047,55.294697610201986
5104,/media/marda/TWOTB1/xBD/hurricanes/images/florence/hurricane-florence_00000191_pre_disaster.png,41,77,1,369,410,685,762,884,56.44226387172637,20.85436594319095
5105,/media/marda/TWOTB1/xBD/hurricanes/images/florence/hurricane-florence_00000191_pre_disaster.png,47,77,1,221,268,692,769,1285,48.21384929756886,35.57929737423626
5106,/media/marda/TWOTB1/xBD/hurricanes/images/florence/hurricane-florence_00000191_pre_disaster.png,40,79,1,337,377,693,772,807,54.11654526459422,19.892940764979052
5107,/media/marda/TWOTB1/xBD/hurricanes/images/florence/hurricane-florence_00000191_pre_disaster.png,88,61,1,893,981,716,777,988,53.975690327514116,24.104324328514537
5108,/media/marda/TWOTB1/xBD/hurricanes/images/florence/hurricane-florence_00000191_pre_disaster.png,100,78,1,579,679,730,808,1806,88.8670661416385,27.909436914885024
5109,/media/marda/TWOTB1/xBD/hurricanes/images/florence/hurricane-florence_00000191_pre_disaster.png,63,105,1,677,740,746,851,2026,81.06447260422301,33.747331722647665
5110,/media/marda/TWOTB1/xBD/hurricanes/images/florence/hurricane-florence_00000191_pre_disaster.png,75,110,1,497,572,779,889,2202,89.71651571868654,35.39258437824907
5111,/media/marda/TWOTB1/xBD/hurricanes/images/florence/hurricane-florence_00000191_pre_disaster.png,72,125,1,424,496,781,906,2964,106.47942799146819,38.048631968958055
5112,/media/marda/TWOTB1/xBD/hurricanes/images/florence/hurricane-florence_00000191_pre_disaster.png,56,43,1,900,956,783,826,172,20.040280395594,11.50354101479448
5113,/media/marda/TWOTB1/xBD/hurricanes/images/florence/hurricane-florence_00000191_pre_disaster.png,50,45,1,994,1044,785,830,103,12.481344060375372,10.873197275941097
5114,/media/marda/TWOTB1/xBD/hurricanes/images/florence/hurricane-florence_00000191_pre_disaster.png,79,71,1,911,990,797,868,920,44.19466977320076,30.322491155508995
5115,/media/marda/TWOTB1/xBD/hurricanes/images/florence/hurricane-florence_00000191_pre_disaster.png,61,129,1,218,279,836,965,2961,102.96017645465591,38.700959644351556
5116,/media/marda/TWOTB1/xBD/hurricanes/images/florence/hurricane-florence_00000191_pre_disaster.png,76,81,1,373,449,837,918,1943,65.81792168287262,39.958611723423225
5117,/media/marda/TWOTB1/xBD/hurricanes/images/florence/hurricane-florence_00000191_pre_disaster.png,70,73,1,928,998,839,912,892,40.40398609106763,29.452718522019282
5118,/media/marda/TWOTB1/xBD/hurricanes/images/florence/hurricane-florence_00000191_pre_disaster.png,106,90,1,274,380,856,946,3085,104.42415579999282,39.98061401145056
5119,/media/marda/TWOTB1/xBD/hurricanes/images/florence/hurricane-florence_00000191_pre_disaster.png,97,88,1,621,718,878,966,1709,73.64215417050205,36.11318084706898
5120,/media/marda/TWOTB1/xBD/hurricanes/images/florence/hurricane-florence_00000191_pre_disaster.png,78,109,1,521,599,887,996,1634,74.45931351571004,34.89987922966724
5121,/media/marda/TWOTB1/xBD/hurricanes/images/florence/hurricane-florence_00000191_pre_disaster.png,103,89,1,686,789,909,998,1929,78.59425367319413,38.59707361154378
5122,/media/marda/TWOTB1/xBD/hurricanes/images/florence/hurricane-florence_00000191_pre_disaster.png,40,67,1,473,513,910,977,416,30.441621896304383,18.2643784314748
5123,/media/marda/TWOTB1/xBD/hurricanes/images/florence/hurricane-florence_00000191_pre_disaster.png,72,67,1,937,1009,911,978,712,35.239436102606966,26.64432382190906
5124,/media/marda/TWOTB1/xBD/hurricanes/images/florence/hurricane-florence_00000191_pre_disaster.png,59,55,1,985,1044,916,971,221,17.61987651135522,16.81249518399227
5125,/media/marda/TWOTB1/xBD/hurricanes/images/florence/hurricane-florence_00000191_pre_disaster.png,179,106,1,350,529,936,1042,5147,194.53506237239625,61.71763809201894
5126,/media/marda/TWOTB1/xBD/hurricanes/images/florence/hurricane-florence_00000191_pre_disaster.png,82,71,1,74,156,940,1011,1168,90.18743246488995,17.29798862993695
5127,/media/marda/TWOTB1/xBD/hurricanes/images/florence/hurricane-florence_00000191_pre_disaster.png,81,100,1,650,731,942,1042,1911,69.44678492055152,42.699327902834774
5128,/media/marda/TWOTB1/xBD/hurricanes/images/florence/hurricane-florence_00000191_pre_disaster.png,64,69,1,0,64,963,1032,949,73.95952570735835,17.139563329322755
5129,/media/marda/TWOTB1/xBD/hurricanes/images/florence/hurricane-florence_00000191_pre_disaster.png,83,72,1,80,163,963,1035,1184,92.21567926572064,17.13060672454217
5130,/media/marda/TWOTB1/xBD/hurricanes/images/florence/hurricane-florence_00000191_pre_disaster.png,56,63,1,734,790,968,1031,451,26.41626955627432,22.768133418260415
5131,/media/marda/TWOTB1/xBD/hurricanes/images/florence/hurricane-florence_00000191_pre_disaster.png,58,71,1,544,602,971,1042,801,36.11283451819133,30.799227912885165
5132,/media/marda/TWOTB1/xBD/hurricanes/images/florence/hurricane-florence_00000191_pre_disaster.png,66,58,1,4,70,986,1044,587,63.033758185797595,13.759412778169478
5133,/media/marda/TWOTB1/xBD/hurricanes/images/florence/hurricane-florence_00000191_pre_disaster.png,78,52,1,966,1044,992,1044,268,39.21680256286686,10.366026975511776
5134,/media/marda/TWOTB1/xBD/hurricanes/images/florence/hurricane-florence_00000297_pre_disaster.png,46,62,1,7,53,200,262,949,62.235529711284784,20.354360416033984
5135,/media/marda/TWOTB1/xBD/hurricanes/images/florence/hurricane-florence_00000297_pre_disaster.png,37,40,1,0,37,291,331,430,46.12001501437319,12.51757647281361
5136,/media/marda/TWOTB1/xBD/hurricanes/images/florence/hurricane-florence_00000297_pre_disaster.png,31,38,1,138,169,302,340,370,26.422472917591787,18.533302783449827
5137,/media/marda/TWOTB1/xBD/hurricanes/images/florence/hurricane-florence_00000297_pre_disaster.png,17,18,1,118,135,319,337,73,14.134230433568824,6.723434922087533
5138,/media/marda/TWOTB1/xBD/hurricanes/images/florence/hurricane-florence_00000297_pre_disaster.png,47,48,1,45,92,322,370,576,55.852327752077045,13.7597933736997
5139,/media/marda/TWOTB1/xBD/hurricanes/images/florence/hurricane-florence_00000297_pre_disaster.png,62,56,1,99,161,327,383,1518,55.6834941185637,37.387776424968486
5140,/media/marda/TWOTB1/xBD/hurricanes/images/florence/hurricane-florence_00000297_pre_disaster.png,20,26,1,184,204,364,390,106,12.44036325264946,11.391473303700508
5141,/media/marda/TWOTB1/xBD/hurricanes/images/florence/hurricane-florence_00000297_pre_disaster.png,39,45,1,153,192,365,410,617,33.797817725063325,24.255479400623233
5142,/media/marda/TWOTB1/xBD/hurricanes/images/florence/hurricane-florence_00000297_pre_disaster.png,51,60,1,24,75,740,800,1016,55.808419508665175,24.036141736485817
5143,/media/marda/TWOTB1/xBD/hurricanes/images/florence/hurricane-florence_00000297_pre_disaster.png,22,42,1,345,367,778,820,140,16.1245154965971,11.489125293076057
5144,/media/marda/TWOTB1/xBD/hurricanes/images/florence/hurricane-florence_00000297_pre_disaster.png,38,63,1,192,230,783,846,758,33.796351952735165,29.58860426785244
5145,/media/marda/TWOTB1/xBD/hurricanes/images/florence/hurricane-florence_00000297_pre_disaster.png,59,66,1,121,180,787,853,1169,59.32557546583852,26.287728707213002
5146,/media/marda/TWOTB1/xBD/hurricanes/images/florence/hurricane-florence_00000297_pre_disaster.png,60,68,1,299,359,797,865,1127,49.96486102406779,31.69282517491227
5147,/media/marda/TWOTB1/xBD/hurricanes/images/florence/hurricane-florence_00000297_pre_disaster.png,28,81,1,69,97,893,974,839,46.68269231849929,23.91594501653482
5148,/media/marda/TWOTB1/xBD/hurricanes/images/florence/hurricane-florence_00000297_pre_disaster.png,25,49,1,368,393,938,987,103,12.153208148456699,11.37654364438157
5149,/media/marda/TWOTB1/xBD/hurricanes/images/florence/hurricane-florence_00000079_pre_disaster.png,58,39,1,412,470,25,64,1283,44.70667578779399,38.102079445020564
5150,/media/marda/TWOTB1/xBD/hurricanes/images/florence/hurricane-florence_00000079_pre_disaster.png,53,27,1,316,369,46,73,825,43.21584422337743,24.827498772465418
5151,/media/marda/TWOTB1/xBD/hurricanes/images/florence/hurricane-florence_00000079_pre_disaster.png,69,65,1,85,154,98,163,2739,62.527787740496265,57.294466790161565
5152,/media/marda/TWOTB1/xBD/hurricanes/images/florence/hurricane-florence_00000079_pre_disaster.png,42,33,1,322,364,169,202,666,31.24376591074565,28.268225189714123
5153,/media/marda/TWOTB1/xBD/hurricanes/images/florence/hurricane-florence_00000079_pre_disaster.png,24,49,1,22,46,320,369,757,40.66606059829744,24.87056099962886
5154,/media/marda/TWOTB1/xBD/hurricanes/images/florence/hurricane-florence_00000079_pre_disaster.png,35,45,1,320,355,571,616,487,27.58427074141073,23.70843908267452
5155,/media/marda/TWOTB1/xBD/hurricanes/images/florence/hurricane-florence_00000079_pre_disaster.png,66,46,1,435,501,582,628,767,53.89829909844355,18.88368820858227
5156,/media/marda/TWOTB1/xBD/hurricanes/images/florence/hurricane-florence_00000079_pre_disaster.png,51,50,1,367,418,642,692,711,39.23804700752515,23.910952887509918
5157,/media/marda/TWOTB1/xBD/hurricanes/images/florence/hurricane-florence_00000079_pre_disaster.png,51,56,1,307,358,715,771,827,40.75431826167004,26.69331437755323
5158,/media/marda/TWOTB1/xBD/hurricanes/images/florence/hurricane-florence_00000079_pre_disaster.png,30,52,1,374,404,785,837,271,20.08663563696899,18.080223055752096
5159,/media/marda/TWOTB1/xBD/hurricanes/images/florence/hurricane-florence_00000079_pre_disaster.png,48,58,1,323,371,801,859,701,38.46383284617658,23.79911120424483
5160,/media/marda/TWOTB1/xBD/hurricanes/images/florence/hurricane-florence_00000300_post_disaster.png,25,22,1,226,251,119,141,282,19.821897112273493,18.976502194885704
5161,/media/marda/TWOTB1/xBD/hurricanes/images/florence/hurricane-florence_00000300_post_disaster.png,21,25,1,224,245,165,190,241,23.25746990725642,13.844982506149462
5162,/media/marda/TWOTB1/xBD/hurricanes/images/florence/hurricane-florence_00000300_post_disaster.png,77,42,1,905,982,194,236,840,36.969341827218074,30.14919380864575
5163,/media/marda/TWOTB1/xBD/hurricanes/images/florence/hurricane-florence_00000300_post_disaster.png,65,30,1,276,341,265,295,639,62.71946661505628,13.616478908791704
5164,/media/marda/TWOTB1/xBD/hurricanes/images/florence/hurricane-florence_00000300_post_disaster.png,21,34,1,8,29,279,313,463,26.622715078921605,23.405941707477037
5165,/media/marda/TWOTB1/xBD/hurricanes/images/florence/hurricane-florence_00000300_post_disaster.png,7,19,1,0,7,299,318,49,8.0,8.0
5166,/media/marda/TWOTB1/xBD/hurricanes/images/florence/hurricane-florence_00000300_post_disaster.png,17,22,1,268,285,317,339,74,10.646707566258483,9.372129277158077
5167,/media/marda/TWOTB1/xBD/hurricanes/images/florence/hurricane-florence_00000300_post_disaster.png,58,34,1,37,95,331,365,1208,66.32450329805557,24.315362087972982
5168,/media/marda/TWOTB1/xBD/hurricanes/images/florence/hurricane-florence_00000300_post_disaster.png,20,25,1,262,282,355,380,114,13.505096903004997,11.381659905384993
5169,/media/marda/TWOTB1/xBD/hurricanes/images/florence/hurricane-florence_00000300_post_disaster.png,28,64,1,257,285,374,438,766,59.28568290196195,17.242632320868594
5170,/media/marda/TWOTB1/xBD/hurricanes/images/florence/hurricane-florence_00000300_post_disaster.png,43,68,1,388,431,391,459,1249,62.916357330837805,26.52711369311977
5171,/media/marda/TWOTB1/xBD/hurricanes/images/florence/hurricane-florence_00000300_post_disaster.png,42,37,1,735,777,432,469,243,21.887947306737832,14.720219813913332
5172,/media/marda/TWOTB1/xBD/hurricanes/images/florence/hurricane-florence_00000300_post_disaster.png,51,59,1,752,803,446,505,795,47.07008887949999,22.574393373440767
5173,/media/marda/TWOTB1/xBD/hurricanes/images/florence/hurricane-florence_00000300_post_disaster.png,44,43,1,702,746,481,524,365,28.756418896480575,16.934156350091794
5174,/media/marda/TWOTB1/xBD/hurricanes/images/florence/hurricane-florence_00000300_post_disaster.png,43,42,1,686,729,484,526,261,26.763057076353128,13.052353359849908
5175,/media/marda/TWOTB1/xBD/hurricanes/images/florence/hurricane-florence_00000300_post_disaster.png,46,42,1,250,296,493,535,836,43.86342439892262,25.37715508089904
5176,/media/marda/TWOTB1/xBD/hurricanes/images/florence/hurricane-florence_00000300_post_disaster.png,61,42,1,668,729,553,595,394,39.95415162830014,13.175534208257124
5177,/media/marda/TWOTB1/xBD/hurricanes/images/florence/hurricane-florence_00000180_post_disaster.png,62,61,1,981,1043,354,415,618,43.822255134408415,21.518775000412226
5178,/media/marda/TWOTB1/xBD/hurricanes/images/florence/hurricane-florence_00000055_pre_disaster.png,51,71,1,74,125,312,383,1490,61.999318817892835,33.67210772736383
5179,/media/marda/TWOTB1/xBD/hurricanes/images/florence/hurricane-florence_00000055_pre_disaster.png,63,65,1,63,126,756,821,1212,68.18348233950715,23.602604666426334
5180,/media/marda/TWOTB1/xBD/hurricanes/images/florence/hurricane-florence_00000055_pre_disaster.png,18,43,1,146,164,760,803,110,15.839613220679885,9.298495841806323
5181,/media/marda/TWOTB1/xBD/hurricanes/images/florence/hurricane-florence_00000055_pre_disaster.png,48,68,1,113,161,810,878,846,46.6483848017252,25.73031227078271
5182,/media/marda/TWOTB1/xBD/hurricanes/images/florence/hurricane-florence_00000055_pre_disaster.png,36,81,1,206,242,813,894,670,54.64609773751028,16.701668901596715
5183,/media/marda/TWOTB1/xBD/hurricanes/images/florence/hurricane-florence_00000055_pre_disaster.png,28,53,1,97,125,954,1007,232,27.30508441749461,11.194973441318586
5184,/media/marda/TWOTB1/xBD/hurricanes/images/florence/hurricane-florence_00000055_pre_disaster.png,56,57,1,121,177,987,1044,522,50.29928440081074,15.10258081525646
5185,/media/marda/TWOTB1/xBD/hurricanes/images/florence/hurricane-florence_00000055_pre_disaster.png,20,53,1,84,104,991,1044,147,16.576110239477234,11.88176318899776
5186,/media/marda/TWOTB1/xBD/hurricanes/images/florence/hurricane-florence_00000055_pre_disaster.png,27,50,1,381,408,994,1044,92,13.268589038262942,9.551142240098214
5187,/media/marda/TWOTB1/xBD/hurricanes/images/florence/hurricane-florence_00000029_post_disaster.png,46,55,1,410,456,634,689,583,29.983434933369228,25.942869947450873
5188,/media/marda/TWOTB1/xBD/hurricanes/images/florence/hurricane-florence_00000140_post_disaster.png,48,31,1,927,975,526,557,92,12.899791247720342,9.656477602018303
5189,/media/marda/TWOTB1/xBD/hurricanes/images/florence/hurricane-florence_00000087_pre_disaster.png,79,35,1,346,425,0,35,1381,61.249431926625824,34.73655821213022
5190,/media/marda/TWOTB1/xBD/hurricanes/images/florence/hurricane-florence_00000087_pre_disaster.png,52,9,1,499,551,0,9,245,36.608945285840484,9.205067263961539
5191,/media/marda/TWOTB1/xBD/hurricanes/images/florence/hurricane-florence_00000087_pre_disaster.png,56,55,1,491,547,15,70,1621,60.95672893446505,36.63487263466059
5192,/media/marda/TWOTB1/xBD/hurricanes/images/florence/hurricane-florence_00000087_pre_disaster.png,61,59,1,313,374,39,98,1801,60.16520040656405,40.404785917365025
5193,/media/marda/TWOTB1/xBD/hurricanes/images/florence/hurricane-florence_00000087_pre_disaster.png,50,29,1,540,590,49,78,634,32.99878609338766,25.84904122964668
5194,/media/marda/TWOTB1/xBD/hurricanes/images/florence/hurricane-florence_00000087_pre_disaster.png,39,18,1,393,432,58,76,263,25.526924343614784,13.90469539518031
5195,/media/marda/TWOTB1/xBD/hurricanes/images/florence/hurricane-florence_00000087_pre_disaster.png,58,39,1,480,538,99,138,1127,40.81622479251096,36.8041480486422
5196,/media/marda/TWOTB1/xBD/hurricanes/images/florence/hurricane-florence_00000087_pre_disaster.png,67,52,1,366,433,103,155,1261,56.67819128998457,30.052336761085325
5197,/media/marda/TWOTB1/xBD/hurricanes/images/florence/hurricane-florence_00000087_pre_disaster.png,231,183,1,680,911,161,344,13675,224.55517689538252,118.6705158865782
5198,/media/marda/TWOTB1/xBD/hurricanes/images/florence/hurricane-florence_00000087_pre_disaster.png,68,38,1,814,882,163,201,695,35.51912763104662,25.83350004546368
5199,/media/marda/TWOTB1/xBD/hurricanes/images/florence/hurricane-florence_00000087_pre_disaster.png,68,37,1,843,911,180,217,660,35.36997119167836,24.724833420475747
5200,/media/marda/TWOTB1/xBD/hurricanes/images/florence/hurricane-florence_00000087_pre_disaster.png,49,27,1,764,813,192,219,251,21.748056642752584,15.465490448525259
5201,/media/marda/TWOTB1/xBD/hurricanes/images/florence/hurricane-florence_00000087_pre_disaster.png,169,132,1,377,546,303,435,8859,139.75379169034724,88.46965739271769
5202,/media/marda/TWOTB1/xBD/hurricanes/images/florence/hurricane-florence_00000087_pre_disaster.png,105,144,1,73,178,345,489,7351,124.61752752888188,84.59868199232393
5203,/media/marda/TWOTB1/xBD/hurricanes/images/florence/hurricane-florence_00000087_pre_disaster.png,71,61,1,552,623,377,438,1460,46.197176229760515,41.2148245670378
5204,/media/marda/TWOTB1/xBD/hurricanes/images/florence/hurricane-florence_00000087_pre_disaster.png,123,160,1,211,334,380,540,10130,136.96510690075837,98.70840487008104
5205,/media/marda/TWOTB1/xBD/hurricanes/images/florence/hurricane-florence_00000087_pre_disaster.png,58,52,1,986,1044,393,445,449,33.968837465380396,18.06483321833703
5206,/media/marda/TWOTB1/xBD/hurricanes/images/florence/hurricane-florence_00000087_pre_disaster.png,29,28,1,405,434,427,455,83,13.059219885880433,8.469937185296656
5207,/media/marda/TWOTB1/xBD/hurricanes/images/florence/hurricane-florence_00000087_pre_disaster.png,77,68,1,657,734,427,495,1392,44.55249492527905,41.67893047107785
5208,/media/marda/TWOTB1/xBD/hurricanes/images/florence/hurricane-florence_00000087_pre_disaster.png,36,33,1,538,574,451,484,160,16.858115842470536,12.437500964496198
5209,/media/marda/TWOTB1/xBD/hurricanes/images/florence/hurricane-florence_00000087_pre_disaster.png,21,34,1,172,193,478,512,166,16.168777030205298,13.685544254780911
5210,/media/marda/TWOTB1/xBD/hurricanes/images/florence/hurricane-florence_00000087_pre_disaster.png,22,37,1,63,85,485,522,252,18.926628232547134,17.586468591897518
5211,/media/marda/TWOTB1/xBD/hurricanes/images/florence/hurricane-florence_00000087_pre_disaster.png,70,64,1,760,830,488,552,980,47.33729135106155,27.625013978560116
5212,/media/marda/TWOTB1/xBD/hurricanes/images/florence/hurricane-florence_00000087_pre_disaster.png,23,35,1,165,188,490,525,193,18.63377067696825,13.783523569119893
5213,/media/marda/TWOTB1/xBD/hurricanes/images/florence/hurricane-florence_00000087_pre_disaster.png,107,93,1,210,317,500,593,2554,117.9433497883205,31.43165644204697
5214,/media/marda/TWOTB1/xBD/hurricanes/images/florence/hurricane-florence_00000087_pre_disaster.png,66,67,1,447,513,505,572,1885,51.07936843138946,47.96158680876798
5215,/media/marda/TWOTB1/xBD/hurricanes/images/florence/hurricane-florence_00000087_pre_disaster.png,61,69,1,495,556,521,590,1187,43.20999836318626,38.92665360464195
5216,/media/marda/TWOTB1/xBD/hurricanes/images/florence/hurricane-florence_00000087_pre_disaster.png,20,40,1,116,136,551,591,168,20.234795185581813,11.133838549651657
5217,/media/marda/TWOTB1/xBD/hurricanes/images/florence/hurricane-florence_00000087_pre_disaster.png,63,69,1,527,590,551,620,1238,44.68877186128005,38.062271155658486
5218,/media/marda/TWOTB1/xBD/hurricanes/images/florence/hurricane-florence_00000087_pre_disaster.png,67,75,1,570,637,574,649,1539,48.93752852119185,41.23074210492821
5219,/media/marda/TWOTB1/xBD/hurricanes/images/florence/hurricane-florence_00000087_pre_disaster.png,45,45,1,332,377,589,634,553,33.50657311176401,21.974006658269634
5220,/media/marda/TWOTB1/xBD/hurricanes/images/florence/hurricane-florence_00000087_pre_disaster.png,62,70,1,621,683,594,664,1180,43.503547997713,38.12473444542996
5221,/media/marda/TWOTB1/xBD/hurricanes/images/florence/hurricane-florence_00000087_pre_disaster.png,66,69,1,174,240,615,684,1350,65.75097023177409,27.122597723491456
5222,/media/marda/TWOTB1/xBD/hurricanes/images/florence/hurricane-florence_00000087_pre_disaster.png,69,64,1,555,624,703,767,1251,49.57531217802615,33.42038572175227
5223,/media/marda/TWOTB1/xBD/hurricanes/images/florence/hurricane-florence_00000087_pre_disaster.png,60,72,1,602,662,705,777,1162,46.81465627597774,32.68451025135938
5224,/media/marda/TWOTB1/xBD/hurricanes/images/florence/hurricane-florence_00000087_pre_disaster.png,64,76,1,642,706,705,781,1325,46.81423241655484,40.093928345441526
5225,/media/marda/TWOTB1/xBD/hurricanes/images/florence/hurricane-florence_00000087_pre_disaster.png,70,76,1,914,984,706,782,1408,53.96316064081799,35.21037323665767
5226,/media/marda/TWOTB1/xBD/hurricanes/images/florence/hurricane-florence_00000087_pre_disaster.png,64,66,1,686,750,707,773,1111,42.04545406873148,35.07883562654403
5227,/media/marda/TWOTB1/xBD/hurricanes/images/florence/hurricane-florence_00000087_pre_disaster.png,69,62,1,726,795,709,771,1060,41.39837087099285,34.30741068418857
5228,/media/marda/TWOTB1/xBD/hurricanes/images/florence/hurricane-florence_00000087_pre_disaster.png,73,71,1,815,888,709,780,1338,46.19205216080641,39.050571798524466
5229,/media/marda/TWOTB1/xBD/hurricanes/images/florence/hurricane-florence_00000087_pre_disaster.png,79,67,1,954,1033,742,809,1151,41.663084622167446,36.43544081859122
5230,/media/marda/TWOTB1/xBD/hurricanes/images/florence/hurricane-florence_00000087_pre_disaster.png,57,74,1,511,568,802,876,1051,41.583288471513036,35.52067922346496
5231,/media/marda/TWOTB1/xBD/hurricanes/images/florence/hurricane-florence_00000087_pre_disaster.png,63,68,1,560,623,818,886,1107,40.79455107654204,35.79486237310085
5232,/media/marda/TWOTB1/xBD/hurricanes/images/florence/hurricane-florence_00000087_pre_disaster.png,58,76,1,606,664,823,899,1198,46.15688277033869,33.91094669220263
5233,/media/marda/TWOTB1/xBD/hurricanes/images/florence/hurricane-florence_00000087_pre_disaster.png,55,79,1,696,751,828,907,1201,53.54125430375765,29.633943816203185
5234,/media/marda/TWOTB1/xBD/hurricanes/images/florence/hurricane-florence_00000087_pre_disaster.png,61,76,1,647,708,833,909,1400,46.80778087952662,39.15496340616735
5235,/media/marda/TWOTB1/xBD/hurricanes/images/florence/hurricane-florence_00000087_pre_disaster.png,73,69,1,811,884,834,903,1249,42.833550734787806,38.17269853686358
5236,/media/marda/TWOTB1/xBD/hurricanes/images/florence/hurricane-florence_00000087_pre_disaster.png,59,83,1,516,575,914,997,1452,51.368281887606585,37.76985770570965
5237,/media/marda/TWOTB1/xBD/hurricanes/images/florence/hurricane-florence_00000087_pre_disaster.png,58,82,1,564,622,923,1005,1168,47.061932701041066,32.979774915755726
5238,/media/marda/TWOTB1/xBD/hurricanes/images/florence/hurricane-florence_00000087_pre_disaster.png,65,82,1,604,669,940,1022,1281,42.87430606105707,41.056338531481714
5239,/media/marda/TWOTB1/xBD/hurricanes/images/florence/hurricane-florence_00000087_pre_disaster.png,68,75,1,771,839,943,1018,1222,43.95982893626745,37.40791973520137
5240,/media/marda/TWOTB1/xBD/hurricanes/images/florence/hurricane-florence_00000087_pre_disaster.png,71,70,1,727,798,944,1014,1097,44.73450454248939,32.831316985976265
5241,/media/marda/TWOTB1/xBD/hurricanes/images/florence/hurricane-florence_00000087_pre_disaster.png,76,68,1,815,891,944,1012,1097,44.51131459607525,33.020998054640444
5242,/media/marda/TWOTB1/xBD/hurricanes/images/florence/hurricane-florence_00000087_pre_disaster.png,60,74,1,650,710,946,1020,1128,42.154462236622166,35.27510185599445
5243,/media/marda/TWOTB1/xBD/hurricanes/images/florence/hurricane-florence_00000087_pre_disaster.png,65,73,1,687,752,946,1019,1104,41.63060495302701,35.68105782063691
5244,/media/marda/TWOTB1/xBD/hurricanes/images/florence/hurricane-florence_00000263_post_disaster.png,32,71,1,0,32,876,947,709,36.77771022475809,26.179090186041407
5245,/media/marda/TWOTB1/xBD/hurricanes/images/florence/hurricane-florence_00000083_pre_disaster.png,30,55,1,15,45,550,605,869,36.51508235842856,31.359921482689668
5246,/media/marda/TWOTB1/xBD/hurricanes/images/florence/hurricane-florence_00000083_pre_disaster.png,21,68,1,0,21,807,875,639,40.35505423893898,20.975376334600867
5247,/media/marda/TWOTB1/xBD/hurricanes/images/florence/hurricane-florence_00000083_pre_disaster.png,32,59,1,111,143,814,873,392,24.415617193798546,21.454910503993066
5248,/media/marda/TWOTB1/xBD/hurricanes/images/florence/hurricane-florence_00000083_pre_disaster.png,29,52,1,175,204,854,906,196,24.871116292471548,10.537207356844686
5249,/media/marda/TWOTB1/xBD/hurricanes/images/florence/hurricane-florence_00000083_pre_disaster.png,21,61,1,217,238,892,953,187,26.40222075320989,9.536463163726085
5250,/media/marda/TWOTB1/xBD/hurricanes/images/florence/hurricane-florence_00000083_pre_disaster.png,20,54,1,134,154,904,958,150,16.605707646301294,11.964398401972675
5251,/media/marda/TWOTB1/xBD/hurricanes/images/florence/hurricane-florence_00000083_pre_disaster.png,59,87,1,278,337,947,1034,1351,46.032183399668334,38.69146910032874
5252,/media/marda/TWOTB1/xBD/hurricanes/images/florence/hurricane-florence_00000083_pre_disaster.png,51,64,1,344,395,980,1044,533,34.4423478931817,22.430082570179465
5253,/media/marda/TWOTB1/xBD/hurricanes/images/florence/hurricane-florence_00000482_post_disaster.png,26,19,1,244,270,262,281,134,19.00533931741563,9.325767766684834
5254,/media/marda/TWOTB1/xBD/hurricanes/images/florence/hurricane-florence_00000482_post_disaster.png,24,28,1,293,317,300,328,212,18.59683519256848,15.329547595125295
5255,/media/marda/TWOTB1/xBD/hurricanes/images/florence/hurricane-florence_00000482_post_disaster.png,19,30,1,223,242,331,361,151,17.716439175202826,11.396717159500824
5256,/media/marda/TWOTB1/xBD/hurricanes/images/florence/hurricane-florence_00000482_post_disaster.png,26,47,1,353,379,556,603,331,29.62751500083267,14.800840939968833
5257,/media/marda/TWOTB1/xBD/hurricanes/images/florence/hurricane-florence_00000377_pre_disaster.png,49,29,1,570,619,0,29,604,33.890288021857046,23.922419547691714
5258,/media/marda/TWOTB1/xBD/hurricanes/images/florence/hurricane-florence_00000377_pre_disaster.png,59,36,1,514,573,20,56,1134,44.83606936342625,34.89839342218286
5259,/media/marda/TWOTB1/xBD/hurricanes/images/florence/hurricane-florence_00000377_pre_disaster.png,65,27,1,434,499,37,64,1124,54.98421801446888,27.137641356751264
5260,/media/marda/TWOTB1/xBD/hurricanes/images/florence/hurricane-florence_00000377_pre_disaster.png,56,23,1,381,437,40,63,824,47.427259473634074,23.20727017375535
5261,/media/marda/TWOTB1/xBD/hurricanes/images/florence/hurricane-florence_00000377_pre_disaster.png,52,34,1,231,283,46,80,1184,48.63467692314997,33.15486753561202
5262,/media/marda/TWOTB1/xBD/hurricanes/images/florence/hurricane-florence_00000377_pre_disaster.png,54,26,1,332,386,47,73,968,48.62978059475145,26.580996933599398
5263,/media/marda/TWOTB1/xBD/hurricanes/images/florence/hurricane-florence_00000377_pre_disaster.png,49,31,1,286,335,50,81,1037,43.41402060132932,31.899092046175433
5264,/media/marda/TWOTB1/xBD/hurricanes/images/florence/hurricane-florence_00000377_pre_disaster.png,24,34,1,84,108,54,88,620,36.70732959984076,22.419662273509562
5265,/media/marda/TWOTB1/xBD/hurricanes/images/florence/hurricane-florence_00000377_pre_disaster.png,52,31,1,179,231,58,89,1230,49.97036984848455,32.90052299931462
5266,/media/marda/TWOTB1/xBD/hurricanes/images/florence/hurricane-florence_00000377_pre_disaster.png,35,29,1,5,40,63,92,1015,40.39801975344831,33.46640106136302
5267,/media/marda/TWOTB1/xBD/hurricanes/images/florence/hurricane-florence_00000377_pre_disaster.png,50,12,1,557,607,63,75,360,34.62176579359676,13.808210118138652
5268,/media/marda/TWOTB1/xBD/hurricanes/images/florence/hurricane-florence_00000377_pre_disaster.png,33,24,1,334,367,90,114,461,26.78273817653348,22.9731630789477
5269,/media/marda/TWOTB1/xBD/hurricanes/images/florence/hurricane-florence_00000377_pre_disaster.png,58,24,1,513,571,92,116,875,43.909745251287276,26.567124615479216
5270,/media/marda/TWOTB1/xBD/hurricanes/images/florence/hurricane-florence_00000377_pre_disaster.png,28,19,1,208,236,98,117,274,22.609635637475368,16.177766894672903
5271,/media/marda/TWOTB1/xBD/hurricanes/images/florence/hurricane-florence_00000377_pre_disaster.png,33,13,1,552,585,100,113,105,13.67524499029191,10.060664565904693
5272,/media/marda/TWOTB1/xBD/hurricanes/images/florence/hurricane-florence_00000377_pre_disaster.png,36,15,1,581,617,100,115,131,15.567764923163423,11.241817116071733
5273,/media/marda/TWOTB1/xBD/hurricanes/images/florence/hurricane-florence_00000377_pre_disaster.png,19,20,1,188,207,122,142,196,17.393639130980063,15.019418556474657
5274,/media/marda/TWOTB1/xBD/hurricanes/images/florence/hurricane-florence_00000377_pre_disaster.png,52,45,1,553,605,132,177,931,40.39247673570766,30.745953674801513
5275,/media/marda/TWOTB1/xBD/hurricanes/images/florence/hurricane-florence_00000377_pre_disaster.png,53,32,1,415,468,150,182,859,41.098356969209334,28.1132077966255
5276,/media/marda/TWOTB1/xBD/hurricanes/images/florence/hurricane-florence_00000377_pre_disaster.png,59,30,1,354,413,157,187,947,47.62008807652804,26.32600488898349
5277,/media/marda/TWOTB1/xBD/hurricanes/images/florence/hurricane-florence_00000377_pre_disaster.png,49,38,1,511,560,164,202,727,34.7631022406197,27.936503289356157
5278,/media/marda/TWOTB1/xBD/hurricanes/images/florence/hurricane-florence_00000377_pre_disaster.png,53,31,1,257,310,165,196,784,46.34423845409619,25.327207605168446
5279,/media/marda/TWOTB1/xBD/hurricanes/images/florence/hurricane-florence_00000377_pre_disaster.png,37,37,1,111,148,168,205,940,38.144428417329586,32.72331779862911
5280,/media/marda/TWOTB1/xBD/hurricanes/images/florence/hurricane-florence_00000377_pre_disaster.png,48,35,1,159,207,168,203,1141,47.74844100886309,32.48827032937037
5281,/media/marda/TWOTB1/xBD/hurricanes/images/florence/hurricane-florence_00000377_pre_disaster.png,51,26,1,206,257,169,195,845,47.4337752322154,23.430677914014247
5282,/media/marda/TWOTB1/xBD/hurricanes/images/florence/hurricane-florence_00000377_pre_disaster.png,31,28,1,76,107,180,208,611,32.16646709800255,25.119525552051105
5283,/media/marda/TWOTB1/xBD/hurricanes/images/florence/hurricane-florence_00000377_pre_disaster.png,30,47,1,16,46,182,229,1044,46.09314199684785,30.012730237938907
5284,/media/marda/TWOTB1/xBD/hurricanes/images/florence/hurricane-florence_00000377_pre_disaster.png,45,28,1,442,487,254,282,580,33.46640106136302,23.065125189341593
5285,/media/marda/TWOTB1/xBD/hurricanes/images/florence/hurricane-florence_00000377_pre_disaster.png,63,37,1,382,445,256,293,1080,55.242407689687326,26.044124219558544
5286,/media/marda/TWOTB1/xBD/hurricanes/images/florence/hurricane-florence_00000377_pre_disaster.png,54,36,1,256,310,263,299,978,47.14843158938372,27.08231761666095
5287,/media/marda/TWOTB1/xBD/hurricanes/images/florence/hurricane-florence_00000377_pre_disaster.png,40,34,1,311,351,265,299,504,30.911351826076526,23.623671062249297
5288,/media/marda/TWOTB1/xBD/hurricanes/images/florence/hurricane-florence_00000377_pre_disaster.png,30,59,1,0,30,274,333,1318,58.42481901138143,30.398601714502433
5289,/media/marda/TWOTB1/xBD/hurricanes/images/florence/hurricane-florence_00000377_pre_disaster.png,43,37,1,197,240,274,311,846,38.982099717551975,28.892987823036695
5290,/media/marda/TWOTB1/xBD/hurricanes/images/florence/hurricane-florence_00000377_pre_disaster.png,47,33,1,121,168,280,313,944,48.35981227349405,25.854153517101643
5291,/media/marda/TWOTB1/xBD/hurricanes/images/florence/hurricane-florence_00000377_pre_disaster.png,65,45,1,539,604,292,337,908,46.3834002619293,25.701423318549168
5292,/media/marda/TWOTB1/xBD/hurricanes/images/florence/hurricane-florence_00000377_pre_disaster.png,98,70,1,946,1044,295,365,1987,71.36309921846775,39.20427692050262
5293,/media/marda/TWOTB1/xBD/hurricanes/images/florence/hurricane-florence_00000377_pre_disaster.png,78,51,1,443,521,298,349,1969,65.03574676870004,40.11018034507134
5294,/media/marda/TWOTB1/xBD/hurricanes/images/florence/hurricane-florence_00000377_pre_disaster.png,24,23,1,192,216,308,331,192,20.18308890363965,12.64250870968435
5295,/media/marda/TWOTB1/xBD/hurricanes/images/florence/hurricane-florence_00000377_pre_disaster.png,23,25,1,263,286,311,336,185,16.84434786890041,14.526727502356323
5296,/media/marda/TWOTB1/xBD/hurricanes/images/florence/hurricane-florence_00000377_pre_disaster.png,31,29,1,210,241,326,355,318,26.154918190566736,16.290318261849496
5297,/media/marda/TWOTB1/xBD/hurricanes/images/florence/hurricane-florence_00000377_pre_disaster.png,32,28,1,282,314,329,357,310,25.522469334145374,16.246796539542387
5298,/media/marda/TWOTB1/xBD/hurricanes/images/florence/hurricane-florence_00000377_pre_disaster.png,51,45,1,111,162,337,382,1072,50.37843819374921,28.34536782358513
5299,/media/marda/TWOTB1/xBD/hurricanes/images/florence/hurricane-florence_00000377_pre_disaster.png,54,41,1,173,227,344,385,1056,53.610440071483325,26.238899161508797
5300,/media/marda/TWOTB1/xBD/hurricanes/images/florence/hurricane-florence_00000377_pre_disaster.png,65,72,1,416,481,345,417,1895,67.2096161016118,40.40314760611174
5301,/media/marda/TWOTB1/xBD/hurricanes/images/florence/hurricane-florence_00000377_pre_disaster.png,47,47,1,581,628,350,397,763,38.32929260171225,26.595322235818948
5302,/media/marda/TWOTB1/xBD/hurricanes/images/florence/hurricane-florence_00000377_pre_disaster.png,52,41,1,245,297,354,395,959,48.72282508622455,26.088937907673326
5303,/media/marda/TWOTB1/xBD/hurricanes/images/florence/hurricane-florence_00000377_pre_disaster.png,62,41,1,310,372,361,402,1075,55.89111284014519,25.688528032944067
5304,/media/marda/TWOTB1/xBD/hurricanes/images/florence/hurricane-florence_00000377_pre_disaster.png,56,82,1,576,632,393,475,1489,69.41359636707833,29.142269471646603
5305,/media/marda/TWOTB1/xBD/hurricanes/images/florence/hurricane-florence_00000377_pre_disaster.png,39,49,1,101,140,440,489,812,39.53432178989706,27.974983989815
5306,/media/marda/TWOTB1/xBD/hurricanes/images/florence/hurricane-florence_00000377_pre_disaster.png,50,44,1,169,219,449,493,998,48.43237223869642,27.030541715201036
5307,/media/marda/TWOTB1/xBD/hurricanes/images/florence/hurricane-florence_00000377_pre_disaster.png,97,64,1,910,1007,455,519,1311,65.87374303375404,25.992519525871863
5308,/media/marda/TWOTB1/xBD/hurricanes/images/florence/hurricane-florence_00000377_pre_disaster.png,53,53,1,235,288,456,509,1172,46.06088800849482,34.66583221122185
5309,/media/marda/TWOTB1/xBD/hurricanes/images/florence/hurricane-florence_00000377_pre_disaster.png,52,44,1,300,352,463,507,852,42.90584316052618,26.32823946815641
5310,/media/marda/TWOTB1/xBD/hurricanes/images/florence/hurricane-florence_00000377_pre_disaster.png,21,30,1,136,157,478,508,194,18.71480342922614,13.927035512715396
5311,/media/marda/TWOTB1/xBD/hurricanes/images/florence/hurricane-florence_00000377_pre_disaster.png,47,44,1,444,491,488,532,729,34.90971860433069,27.76578493776989
5312,/media/marda/TWOTB1/xBD/hurricanes/images/florence/hurricane-florence_00000377_pre_disaster.png,57,56,1,619,676,497,553,767,35.99985606850798,28.68630919492867
5313,/media/marda/TWOTB1/xBD/hurricanes/images/florence/hurricane-florence_00000377_pre_disaster.png,60,61,1,506,566,500,561,820,41.36248529855241,26.22176082799346
5314,/media/marda/TWOTB1/xBD/hurricanes/images/florence/hurricane-florence_00000377_pre_disaster.png,37,56,1,97,134,503,559,869,38.709415623266224,30.335533019016033
5315,/media/marda/TWOTB1/xBD/hurricanes/images/florence/hurricane-florence_00000377_pre_disaster.png,24,33,1,259,283,504,537,150,17.02243528887729,11.870122490821073
5316,/media/marda/TWOTB1/xBD/hurricanes/images/florence/hurricane-florence_00000377_pre_disaster.png,32,34,1,326,358,504,538,193,21.693764745384943,11.937725891471167
5317,/media/marda/TWOTB1/xBD/hurricanes/images/florence/hurricane-florence_00000377_pre_disaster.png,35,46,1,2,37,508,554,621,34.869674052155574,24.170112723268492
5318,/media/marda/TWOTB1/xBD/hurricanes/images/florence/hurricane-florence_00000377_pre_disaster.png,44,54,1,298,342,525,579,773,34.66501254220139,29.80978836447567
5319,/media/marda/TWOTB1/xBD/hurricanes/images/florence/hurricane-florence_00000377_pre_disaster.png,36,37,1,477,513,532,569,152,17.252196996915334,11.731686767165847
5320,/media/marda/TWOTB1/xBD/hurricanes/images/florence/hurricane-florence_00000377_pre_disaster.png,58,58,1,409,467,547,605,771,35.11726739336447,30.836432322251255
5321,/media/marda/TWOTB1/xBD/hurricanes/images/florence/hurricane-florence_00000377_pre_disaster.png,58,56,1,627,685,557,613,885,37.11264054475563,32.15119726556322
5322,/media/marda/TWOTB1/xBD/hurricanes/images/florence/hurricane-florence_00000377_pre_disaster.png,44,38,1,355,399,564,602,320,35.051208314150045,12.216778246250465
5323,/media/marda/TWOTB1/xBD/hurricanes/images/florence/hurricane-florence_00000377_pre_disaster.png,54,56,1,529,583,566,622,912,36.84079487215717,33.73850881983159
5324,/media/marda/TWOTB1/xBD/hurricanes/images/florence/hurricane-florence_00000377_pre_disaster.png,41,49,1,84,125,573,622,767,43.151462665479315,23.531417820619097
5325,/media/marda/TWOTB1/xBD/hurricanes/images/florence/hurricane-florence_00000377_pre_disaster.png,80,51,1,154,234,587,638,1360,79.32138680253266,27.009013948630585
5326,/media/marda/TWOTB1/xBD/hurricanes/images/florence/hurricane-florence_00000377_pre_disaster.png,58,64,1,623,681,597,661,789,39.69508668933529,27.02076504695358
5327,/media/marda/TWOTB1/xBD/hurricanes/images/florence/hurricane-florence_00000377_pre_disaster.png,53,57,1,287,340,605,662,876,46.76412811700818,25.57140813527557
5328,/media/marda/TWOTB1/xBD/hurricanes/images/florence/hurricane-florence_00000377_pre_disaster.png,58,53,1,484,542,631,684,817,43.83471320374995,24.80619445467783
5329,/media/marda/TWOTB1/xBD/hurricanes/images/florence/hurricane-florence_00000377_pre_disaster.png,56,52,1,404,460,634,686,725,43.5961879203603,22.32842075930462
5330,/media/marda/TWOTB1/xBD/hurricanes/images/florence/hurricane-florence_00000377_pre_disaster.png,39,52,1,76,115,670,722,825,40.8390609685546,26.766496180034615
5331,/media/marda/TWOTB1/xBD/hurricanes/images/florence/hurricane-florence_00000377_pre_disaster.png,51,57,1,351,402,729,786,769,40.019999216338555,25.668252882673904
5332,/media/marda/TWOTB1/xBD/hurricanes/images/florence/hurricane-florence_00000377_pre_disaster.png,46,49,1,470,516,741,790,549,32.35451019547922,22.714307569707838
5333,/media/marda/TWOTB1/xBD/hurricanes/images/florence/hurricane-florence_00000377_pre_disaster.png,68,90,1,163,231,791,881,2760,62.08439240594304,56.639211562111036
5334,/media/marda/TWOTB1/xBD/hurricanes/images/florence/hurricane-florence_00000377_pre_disaster.png,49,66,1,176,225,868,934,996,44.86726177634815,31.739749272359955
5335,/media/marda/TWOTB1/xBD/hurricanes/images/florence/hurricane-florence_00000377_pre_disaster.png,28,82,1,58,86,889,971,1004,50.25811715455958,26.64245445049152
5336,/media/marda/TWOTB1/xBD/hurricanes/images/florence/hurricane-florence_00000377_pre_disaster.png,49,80,1,46,95,962,1042,1384,53.96255189536317,37.134156613740714
5337,/media/marda/TWOTB1/xBD/hurricanes/images/florence/hurricane-florence_00000377_pre_disaster.png,32,67,1,103,135,975,1042,736,35.30102001236792,27.82098812030211
5338,/media/marda/TWOTB1/xBD/hurricanes/images/florence/hurricane-florence_00000280_post_disaster.png,29,67,1,0,29,403,470,843,46.50298531566158,26.3924368415748
5339,/media/marda/TWOTB1/xBD/hurricanes/images/florence/hurricane-florence_00000280_post_disaster.png,58,52,1,727,785,452,504,1014,40.39153284723116,33.403778180184446
5340,/media/marda/TWOTB1/xBD/hurricanes/images/florence/hurricane-florence_00000280_post_disaster.png,36,27,1,681,717,456,483,96,11.752700572540675,10.93140233593018
5341,/media/marda/TWOTB1/xBD/hurricanes/images/florence/hurricane-florence_00000280_post_disaster.png,39,28,1,768,807,460,488,122,12.9082512688463,12.597163354905101
5342,/media/marda/TWOTB1/xBD/hurricanes/images/florence/hurricane-florence_00000280_post_disaster.png,65,49,1,671,736,488,537,1191,41.81577137144599,38.11371621023872
5343,/media/marda/TWOTB1/xBD/hurricanes/images/florence/hurricane-florence_00000280_post_disaster.png,49,48,1,709,758,538,586,449,29.25551136535532,20.158532005871237
5344,/media/marda/TWOTB1/xBD/hurricanes/images/florence/hurricane-florence_00000280_post_disaster.png,60,63,1,740,800,538,601,972,46.44673331061703,27.777503509954197
5345,/media/marda/TWOTB1/xBD/hurricanes/images/florence/hurricane-florence_00000280_post_disaster.png,13,37,1,63,76,619,656,115,13.216075877301542,11.608262002685356
5346,/media/marda/TWOTB1/xBD/hurricanes/images/florence/hurricane-florence_00000280_post_disaster.png,11,49,1,0,11,622,671,143,21.85495836967115,10.058005493018282
5347,/media/marda/TWOTB1/xBD/hurricanes/images/florence/hurricane-florence_00000280_post_disaster.png,31,54,1,57,88,639,693,601,30.33225971535496,25.95684671787274
5348,/media/marda/TWOTB1/xBD/hurricanes/images/florence/hurricane-florence_00000280_post_disaster.png,37,81,1,0,37,674,755,1273,50.69065114313604,34.93150551410342
5349,/media/marda/TWOTB1/xBD/hurricanes/images/florence/hurricane-florence_00000280_post_disaster.png,60,98,1,0,60,742,840,2409,68.85740228406736,47.321925063900004
5350,/media/marda/TWOTB1/xBD/hurricanes/images/florence/hurricane-florence_00000280_post_disaster.png,85,116,1,0,85,811,927,3632,99.71147622150042,48.923262517726705
5351,/media/marda/TWOTB1/xBD/hurricanes/images/florence/hurricane-florence_00000280_post_disaster.png,111,131,1,0,111,882,1013,4780,132.54584544906098,48.27550563621175
5352,/media/marda/TWOTB1/xBD/hurricanes/images/florence/hurricane-florence_00000501_post_disaster.png,60,40,1,68,128,0,40,1155,61.12659904580952,24.953239806682696
5353,/media/marda/TWOTB1/xBD/hurricanes/images/florence/hurricane-florence_00000501_post_disaster.png,35,15,1,526,561,25,40,143,14.430056202431553,13.165987881928304
5354,/media/marda/TWOTB1/xBD/hurricanes/images/florence/hurricane-florence_00000501_post_disaster.png,50,36,1,731,781,311,347,281,20.885066472169207,17.980235773123955
5355,/media/marda/TWOTB1/xBD/hurricanes/images/florence/hurricane-florence_00000524_pre_disaster.png,60,60,1,141,201,0,60,1883,65.64030777733915,38.271959221939234
5356,/media/marda/TWOTB1/xBD/hurricanes/images/florence/hurricane-florence_00000524_pre_disaster.png,59,39,1,312,371,0,39,1082,44.28593988617251,32.151481835728276
5357,/media/marda/TWOTB1/xBD/hurricanes/images/florence/hurricane-florence_00000524_pre_disaster.png,56,98,1,301,357,351,449,1921,86.73320536334032,35.37593250833935
5358,/media/marda/TWOTB1/xBD/hurricanes/images/florence/hurricane-florence_00000524_pre_disaster.png,51,57,1,393,444,361,418,940,44.31012367812604,29.051553306112442
5359,/media/marda/TWOTB1/xBD/hurricanes/images/florence/hurricane-florence_00000524_pre_disaster.png,19,84,1,146,165,440,524,986,78.48112217369025,16.739595481630555
5360,/media/marda/TWOTB1/xBD/hurricanes/images/florence/hurricane-florence_00000524_pre_disaster.png,22,84,1,164,186,440,524,1092,76.36197069665963,19.09288586601505
5361,/media/marda/TWOTB1/xBD/hurricanes/images/florence/hurricane-florence_00000524_pre_disaster.png,64,54,1,758,822,440,494,766,34.31461022004819,30.152191908759256
5362,/media/marda/TWOTB1/xBD/hurricanes/images/florence/hurricane-florence_00000524_pre_disaster.png,16,83,1,129,145,441,524,736,77.16830276606996,12.789261800092465
5363,/media/marda/TWOTB1/xBD/hurricanes/images/florence/hurricane-florence_00000524_pre_disaster.png,22,73,1,190,212,450,523,813,64.76401482327294,16.753039424602846
5364,/media/marda/TWOTB1/xBD/hurricanes/images/florence/hurricane-florence_00000524_pre_disaster.png,20,71,1,204,224,451,522,604,63.57518119161183,12.66262341767942
5365,/media/marda/TWOTB1/xBD/hurricanes/images/florence/hurricane-florence_00000524_pre_disaster.png,33,76,1,216,249,451,527,987,66.57230604606963,19.820219112702773
5366,/media/marda/TWOTB1/xBD/hurricanes/images/florence/hurricane-florence_00000524_pre_disaster.png,58,42,1,334,392,462,504,559,51.70862123733543,14.409267329406244
5367,/media/marda/TWOTB1/xBD/hurricanes/images/florence/hurricane-florence_00000524_pre_disaster.png,71,54,1,248,319,473,527,1218,66.40820550003936,24.47517080853383
5368,/media/marda/TWOTB1/xBD/hurricanes/images/florence/hurricane-florence_00000524_pre_disaster.png,74,56,1,254,328,493,549,1190,70.76336299963968,22.4472998892768
5369,/media/marda/TWOTB1/xBD/hurricanes/images/florence/hurricane-florence_00000524_pre_disaster.png,59,65,1,655,714,498,563,1157,48.955035241817775,32.05013621008173
5370,/media/marda/TWOTB1/xBD/hurricanes/images/florence/hurricane-florence_00000524_pre_disaster.png,37,78,1,222,259,512,590,1540,65.91731489070875,31.163302177806656
5371,/media/marda/TWOTB1/xBD/hurricanes/images/florence/hurricane-florence_00000524_pre_disaster.png,39,77,1,189,228,514,591,1767,64.82722518625829,36.35594819184924
5372,/media/marda/TWOTB1/xBD/hurricanes/images/florence/hurricane-florence_00000524_pre_disaster.png,19,87,1,140,159,516,603,925,76.30691598664923,16.166981535328492
5373,/media/marda/TWOTB1/xBD/hurricanes/images/florence/hurricane-florence_00000524_pre_disaster.png,22,86,1,157,179,516,602,1122,76.22257088247005,19.615971929361418
5374,/media/marda/TWOTB1/xBD/hurricanes/images/florence/hurricane-florence_00000524_pre_disaster.png,73,57,1,261,334,517,574,1205,69.84970222703936,23.01657375150922
5375,/media/marda/TWOTB1/xBD/hurricanes/images/florence/hurricane-florence_00000524_pre_disaster.png,77,53,1,901,978,522,575,949,43.83338120507313,28.345098971654
5376,/media/marda/TWOTB1/xBD/hurricanes/images/florence/hurricane-florence_00000524_pre_disaster.png,89,86,1,263,352,545,631,2600,83.78572965292928,52.3000412166183
5377,/media/marda/TWOTB1/xBD/hurricanes/images/florence/hurricane-florence_00000524_pre_disaster.png,67,56,1,910,977,556,612,768,34.55500407863953,29.665384313346408
5378,/media/marda/TWOTB1/xBD/hurricanes/images/florence/hurricane-florence_00000524_pre_disaster.png,34,59,1,240,274,573,632,528,41.49271593902256,17.00037680238982
5379,/media/marda/TWOTB1/xBD/hurricanes/images/florence/hurricane-florence_00000524_pre_disaster.png,62,50,1,184,246,576,626,710,63.233065527190725,14.982496410207853
5380,/media/marda/TWOTB1/xBD/hurricanes/images/florence/hurricane-florence_00000524_pre_disaster.png,63,55,1,190,253,588,643,807,63.4747919745817,16.9447263148185
5381,/media/marda/TWOTB1/xBD/hurricanes/images/florence/hurricane-florence_00000524_pre_disaster.png,98,63,1,842,940,588,651,1668,67.36235453260707,33.77653817983055
5382,/media/marda/TWOTB1/xBD/hurricanes/images/florence/hurricane-florence_00000524_pre_disaster.png,76,56,1,694,770,595,651,1451,54.123127780062774,35.63314215118047
5383,/media/marda/TWOTB1/xBD/hurricanes/images/florence/hurricane-florence_00000524_pre_disaster.png,75,63,1,185,260,607,670,1314,76.3129447998802,22.9197491419508
5384,/media/marda/TWOTB1/xBD/hurricanes/images/florence/hurricane-florence_00000524_pre_disaster.png,44,48,1,223,267,633,681,460,36.62420325767782,16.792024403459763
5385,/media/marda/TWOTB1/xBD/hurricanes/images/florence/hurricane-florence_00000524_pre_disaster.png,55,55,1,281,336,638,693,845,44.26571128586737,25.48057271965404
5386,/media/marda/TWOTB1/xBD/hurricanes/images/florence/hurricane-florence_00000524_pre_disaster.png,27,54,1,124,151,644,698,403,27.384917108613173,20.19359475613252
5387,/media/marda/TWOTB1/xBD/hurricanes/images/florence/hurricane-florence_00000524_pre_disaster.png,59,54,1,612,671,646,700,756,36.96743855480017,27.166940929534796
5388,/media/marda/TWOTB1/xBD/hurricanes/images/florence/hurricane-florence_00000524_pre_disaster.png,58,70,1,519,577,676,746,1259,47.71449071600822,35.141039357704464
5389,/media/marda/TWOTB1/xBD/hurricanes/images/florence/hurricane-florence_00000524_pre_disaster.png,59,78,1,230,289,696,774,1887,53.54148393831442,47.00706210159477
5390,/media/marda/TWOTB1/xBD/hurricanes/images/florence/hurricane-florence_00000524_pre_disaster.png,62,51,1,877,939,762,813,446,29.509835338493797,20.18844238020677
5391,/media/marda/TWOTB1/xBD/hurricanes/images/florence/hurricane-florence_00000524_pre_disaster.png,61,63,1,883,944,783,846,613,34.20386784751333,23.66458539908286
5392,/media/marda/TWOTB1/xBD/hurricanes/images/florence/hurricane-florence_00000524_pre_disaster.png,54,97,1,124,178,848,945,1667,68.51160476715609,33.19839798880862
5393,/media/marda/TWOTB1/xBD/hurricanes/images/florence/hurricane-florence_00000524_pre_disaster.png,14,56,1,115,129,950,1006,124,18.839337170297096,9.256675143555093
5394,/media/marda/TWOTB1/xBD/hurricanes/images/florence/hurricane-florence_00000524_pre_disaster.png,35,69,1,114,149,963,1032,586,30.157464181687985,25.803944443518333
5395,/media/marda/TWOTB1/xBD/hurricanes/images/florence/hurricane-florence_00000524_pre_disaster.png,76,54,1,869,945,990,1044,400,46.6499804753718,12.053054453018522
5396,/media/marda/TWOTB1/xBD/hurricanes/images/florence/hurricane-florence_00000095_post_disaster.png,55,20,1,727,782,0,20,415,26.960705000935512,20.074992290171387
5397,/media/marda/TWOTB1/xBD/hurricanes/images/florence/hurricane-florence_00000095_post_disaster.png,60,53,1,596,656,2,55,1201,56.71719181165249,27.996823714858504
5398,/media/marda/TWOTB1/xBD/hurricanes/images/florence/hurricane-florence_00000095_post_disaster.png,67,39,1,774,841,151,190,827,38.52092497941753,28.603567118900774
5399,/media/marda/TWOTB1/xBD/hurricanes/images/florence/hurricane-florence_00000095_post_disaster.png,73,34,1,784,857,192,226,768,43.11490005463561,23.55296397544866
5400,/media/marda/TWOTB1/xBD/hurricanes/images/florence/hurricane-florence_00000095_post_disaster.png,72,38,1,794,866,222,260,751,41.784038535217405,23.798167486408143
5401,/media/marda/TWOTB1/xBD/hurricanes/images/florence/hurricane-florence_00000095_post_disaster.png,67,43,1,709,776,301,344,768,38.08713506899575,26.69589509604668
5402,/media/marda/TWOTB1/xBD/hurricanes/images/florence/hurricane-florence_00000095_post_disaster.png,21,31,1,96,117,312,343,205,17.930099298717742,14.957983932937035
5403,/media/marda/TWOTB1/xBD/hurricanes/images/florence/hurricane-florence_00000095_post_disaster.png,71,43,1,820,891,318,361,844,42.433445893029216,26.345583332472994
5404,/media/marda/TWOTB1/xBD/hurricanes/images/florence/hurricane-florence_00000095_post_disaster.png,50,56,1,46,96,324,380,1057,50.31981884367427,28.03756545655216
5405,/media/marda/TWOTB1/xBD/hurricanes/images/florence/hurricane-florence_00000095_post_disaster.png,74,45,1,837,911,382,427,867,43.58488721200217,26.224411790991276
5406,/media/marda/TWOTB1/xBD/hurricanes/images/florence/hurricane-florence_00000095_post_disaster.png,38,27,1,742,780,409,436,88,11.205615999700695,10.601451864603247
5407,/media/marda/TWOTB1/xBD/hurricanes/images/florence/hurricane-florence_00000095_post_disaster.png,65,41,1,845,910,416,457,596,34.50672125184279,22.633667407370094
5408,/media/marda/TWOTB1/xBD/hurricanes/images/florence/hurricane-florence_00000095_post_disaster.png,36,33,1,566,602,442,475,205,16.673633757726172,16.057709070629407
5409,/media/marda/TWOTB1/xBD/hurricanes/images/florence/hurricane-florence_00000095_post_disaster.png,84,71,1,733,817,500,571,1641,55.72010174489296,43.47875893663248
5410,/media/marda/TWOTB1/xBD/hurricanes/images/florence/hurricane-florence_00000095_post_disaster.png,49,40,1,705,754,536,576,286,21.403165130957095,17.90580378230112
5411,/media/marda/TWOTB1/xBD/hurricanes/images/florence/hurricane-florence_00000095_post_disaster.png,63,72,1,771,834,547,619,1026,53.48319595087449,26.87175659949447
5412,/media/marda/TWOTB1/xBD/hurricanes/images/florence/hurricane-florence_00000095_post_disaster.png,57,55,1,548,605,552,607,678,40.781114597834616,27.315770631667135
5413,/media/marda/TWOTB1/xBD/hurricanes/images/florence/hurricane-florence_00000095_post_disaster.png,56,45,1,756,812,598,643,357,28.34831073419158,16.67931962656872
5414,/media/marda/TWOTB1/xBD/hurricanes/images/florence/hurricane-florence_00000095_post_disaster.png,53,57,1,586,639,617,674,762,34.60310648940661,29.077308944552936
5415,/media/marda/TWOTB1/xBD/hurricanes/images/florence/hurricane-florence_00000095_post_disaster.png,61,59,1,787,848,632,691,646,34.248226509824335,24.823266152395412
5416,/media/marda/TWOTB1/xBD/hurricanes/images/florence/hurricane-florence_00000095_post_disaster.png,54,47,1,586,640,647,694,461,32.62069731747676,19.079480665004915
5417,/media/marda/TWOTB1/xBD/hurricanes/images/florence/hurricane-florence_00000095_post_disaster.png,60,59,1,808,868,684,743,684,37.92612874756043,27.419666185887653
5418,/media/marda/TWOTB1/xBD/hurricanes/images/florence/hurricane-florence_00000095_post_disaster.png,51,57,1,756,807,698,755,522,30.09606883624454,22.760605001600013
5419,/media/marda/TWOTB1/xBD/hurricanes/images/florence/hurricane-florence_00000095_post_disaster.png,63,77,1,740,803,739,816,1064,51.23108220926959,27.699678120039465
5420,/media/marda/TWOTB1/xBD/hurricanes/images/florence/hurricane-florence_00000095_post_disaster.png,63,67,1,836,899,749,816,752,40.30413124988496,25.15817190333061
5421,/media/marda/TWOTB1/xBD/hurricanes/images/florence/hurricane-florence_00000095_post_disaster.png,41,47,1,746,787,788,835,176,16.278145914895678,14.45473351346423
5422,/media/marda/TWOTB1/xBD/hurricanes/images/florence/hurricane-florence_00000095_post_disaster.png,73,63,1,841,914,793,856,781,42.190515829696594,24.41322128729545
5423,/media/marda/TWOTB1/xBD/hurricanes/images/florence/hurricane-florence_00000095_post_disaster.png,70,88,1,650,720,819,907,1689,61.99400667427289,36.35487109351191
5424,/media/marda/TWOTB1/xBD/hurricanes/images/florence/hurricane-florence_00000095_post_disaster.png,93,103,1,842,935,827,930,1882,73.21908128517885,46.296411372650645
5425,/media/marda/TWOTB1/xBD/hurricanes/images/florence/hurricane-florence_00000095_post_disaster.png,45,47,1,724,769,868,915,196,18.510224954768322,14.07133821683585
5426,/media/marda/TWOTB1/xBD/hurricanes/images/florence/hurricane-florence_00000095_post_disaster.png,67,59,1,976,1043,879,938,574,32.03000933528413,23.364178498058983
5427,/media/marda/TWOTB1/xBD/hurricanes/images/florence/hurricane-florence_00000095_post_disaster.png,69,63,1,872,941,898,961,610,36.36733516299628,22.119504941350694
5428,/media/marda/TWOTB1/xBD/hurricanes/images/florence/hurricane-florence_00000095_post_disaster.png,49,53,1,847,896,908,961,172,15.495703961728003,14.91225390924151
5429,/media/marda/TWOTB1/xBD/hurricanes/images/florence/hurricane-florence_00000095_post_disaster.png,57,58,1,890,947,941,999,276,19.484444871541097,18.957922535643284
5430,/media/marda/TWOTB1/xBD/hurricanes/images/florence/hurricane-florence_00000095_post_disaster.png,54,60,1,989,1043,948,1008,262,22.814735489671737,15.258758939708857
5431,/media/marda/TWOTB1/xBD/hurricanes/images/florence/hurricane-florence_00000095_post_disaster.png,83,67,1,842,925,949,1016,858,53.29175007463769,21.29574188448697
5432,/media/marda/TWOTB1/xBD/hurricanes/images/florence/hurricane-florence_00000095_post_disaster.png,59,59,1,809,868,968,1027,425,27.897686352286357,20.742090767505783
5433,/media/marda/TWOTB1/xBD/hurricanes/images/florence/hurricane-florence_00000095_post_disaster.png,73,60,1,896,969,975,1035,551,38.10617958364437,19.136647309612723
5434,/media/marda/TWOTB1/xBD/hurricanes/images/florence/hurricane-florence_00000487_pre_disaster.png,167,92,1,180,347,0,92,5108,166.71009365697677,41.3055231608389
5435,/media/marda/TWOTB1/xBD/hurricanes/images/florence/hurricane-florence_00000487_pre_disaster.png,232,168,1,124,356,34,202,9029,284.7495917536514,42.24739827523777
5436,/media/marda/TWOTB1/xBD/hurricanes/images/florence/hurricane-florence_00000387_post_disaster.png,57,27,1,839,896,158,185,466,26.941068247265147,22.72336763142363
5437,/media/marda/TWOTB1/xBD/hurricanes/images/florence/hurricane-florence_00000387_post_disaster.png,45,45,1,555,600,162,207,602,43.856875618545615,18.34376612008675
5438,/media/marda/TWOTB1/xBD/hurricanes/images/florence/hurricane-florence_00000387_post_disaster.png,42,47,1,491,533,166,213,571,48.65219300943093,15.644396721997818
5439,/media/marda/TWOTB1/xBD/hurricanes/images/florence/hurricane-florence_00000387_post_disaster.png,47,45,1,412,459,168,213,533,47.5541012815889,14.963707740752087
5440,/media/marda/TWOTB1/xBD/hurricanes/images/florence/hurricane-florence_00000387_post_disaster.png,43,42,1,453,496,169,211,462,41.84344291447717,14.786177817940752
5441,/media/marda/TWOTB1/xBD/hurricanes/images/florence/hurricane-florence_00000387_post_disaster.png,37,38,1,526,563,172,210,381,36.96134303272901,13.8855037119775
5442,/media/marda/TWOTB1/xBD/hurricanes/images/florence/hurricane-florence_00000387_post_disaster.png,55,23,1,827,882,188,211,375,24.438381413026466,20.218561222585606
5443,/media/marda/TWOTB1/xBD/hurricanes/images/florence/hurricane-florence_00000387_post_disaster.png,73,19,1,338,411,190,209,677,67.66446101050553,13.376687213548333
5444,/media/marda/TWOTB1/xBD/hurricanes/images/florence/hurricane-florence_00000387_post_disaster.png,65,58,1,838,903,202,260,1353,50.70122359200937,35.294548215074634
5445,/media/marda/TWOTB1/xBD/hurricanes/images/florence/hurricane-florence_00000387_post_disaster.png,117,55,1,76,193,222,277,1984,131.9618282267638,20.06569052351203
5446,/media/marda/TWOTB1/xBD/hurricanes/images/florence/hurricane-florence_00000387_post_disaster.png,45,64,1,543,588,225,289,866,63.42677388878355,18.23836307206387
5447,/media/marda/TWOTB1/xBD/hurricanes/images/florence/hurricane-florence_00000387_post_disaster.png,37,48,1,449,486,227,275,604,43.25918813058288,18.666299090956297
5448,/media/marda/TWOTB1/xBD/hurricanes/images/florence/hurricane-florence_00000387_post_disaster.png,43,59,1,513,556,227,286,771,57.938698132987234,17.78249348182318
5449,/media/marda/TWOTB1/xBD/hurricanes/images/florence/hurricane-florence_00000387_post_disaster.png,44,55,1,480,524,232,287,814,51.02746367866034,21.356821412070584
5450,/media/marda/TWOTB1/xBD/hurricanes/images/florence/hurricane-florence_00000387_post_disaster.png,38,46,1,415,453,235,281,534,40.425195024533366,17.65732525945904
5451,/media/marda/TWOTB1/xBD/hurricanes/images/florence/hurricane-florence_00000387_post_disaster.png,34,43,1,352,386,236,279,475,37.70195368946107,16.84144610282317
5452,/media/marda/TWOTB1/xBD/hurricanes/images/florence/hurricane-florence_00000387_post_disaster.png,48,54,1,568,616,238,292,652,49.68332104327572,19.160892941702237
5453,/media/marda/TWOTB1/xBD/hurricanes/images/florence/hurricane-florence_00000387_post_disaster.png,37,45,1,381,418,239,284,510,40.25103292850224,16.93831720196036
5454,/media/marda/TWOTB1/xBD/hurricanes/images/florence/hurricane-florence_00000387_post_disaster.png,34,50,1,281,315,249,299,597,44.81859601114543,17.799130524721804
5455,/media/marda/TWOTB1/xBD/hurricanes/images/florence/hurricane-florence_00000387_post_disaster.png,116,54,1,70,186,251,305,1964,130.65278942335996,20.05653562567876
5456,/media/marda/TWOTB1/xBD/hurricanes/images/florence/hurricane-florence_00000387_post_disaster.png,39,47,1,311,350,251,298,545,43.50641478299038,16.793878869096794
5457,/media/marda/TWOTB1/xBD/hurricanes/images/florence/hurricane-florence_00000387_post_disaster.png,115,54,1,62,177,277,331,1940,129.99493299526293,19.912505756773303
5458,/media/marda/TWOTB1/xBD/hurricanes/images/florence/hurricane-florence_00000387_post_disaster.png,75,56,1,363,438,321,377,1804,67.75458755357113,40.98192732056525
5459,/media/marda/TWOTB1/xBD/hurricanes/images/florence/hurricane-florence_00000387_post_disaster.png,44,48,1,443,487,329,377,848,39.19415117027742,28.562519370592053
5460,/media/marda/TWOTB1/xBD/hurricanes/images/florence/hurricane-florence_00000387_post_disaster.png,53,65,1,393,446,486,551,1175,49.726149132318234,31.540494797515088
5461,/media/marda/TWOTB1/xBD/hurricanes/images/florence/hurricane-florence_00000387_post_disaster.png,82,63,1,204,286,510,573,1804,80.14911790473036,30.377437903130616
5462,/media/marda/TWOTB1/xBD/hurricanes/images/florence/hurricane-florence_00000387_post_disaster.png,23,31,1,300,323,547,578,85,11.37225632005023,10.137461140295846
5463,/media/marda/TWOTB1/xBD/hurricanes/images/florence/hurricane-florence_00000387_post_disaster.png,43,45,1,461,504,593,638,411,27.518936327165548,19.725210481810727
5464,/media/marda/TWOTB1/xBD/hurricanes/images/florence/hurricane-florence_00000387_post_disaster.png,70,58,1,320,390,599,657,1182,59.38579108611879,27.183992364417914
5465,/media/marda/TWOTB1/xBD/hurricanes/images/florence/hurricane-florence_00000387_post_disaster.png,53,48,1,774,827,603,651,552,27.688746209726915,26.5329983228432
5466,/media/marda/TWOTB1/xBD/hurricanes/images/florence/hurricane-florence_00000387_post_disaster.png,33,37,1,506,539,606,643,148,14.883462326246935,13.240970842871976
5467,/media/marda/TWOTB1/xBD/hurricanes/images/florence/hurricane-florence_00000387_post_disaster.png,48,38,1,599,647,609,647,264,26.475171917072718,13.226945782554285
5468,/media/marda/TWOTB1/xBD/hurricanes/images/florence/hurricane-florence_00000387_post_disaster.png,69,77,1,724,793,618,695,1672,56.84824218586499,39.51102167132626
5469,/media/marda/TWOTB1/xBD/hurricanes/images/florence/hurricane-florence_00000387_post_disaster.png,65,68,1,442,507,619,687,1388,49.23300849622061,39.12426385843938
5470,/media/marda/TWOTB1/xBD/hurricanes/images/florence/hurricane-florence_00000387_post_disaster.png,51,44,1,833,884,620,664,197,18.228101647795594,14.335509320066583
5471,/media/marda/TWOTB1/xBD/hurricanes/images/florence/hurricane-florence_00000387_post_disaster.png,66,71,1,583,649,625,696,1432,48.444348098768685,42.55995761279281
5472,/media/marda/TWOTB1/xBD/hurricanes/images/florence/hurricane-florence_00000387_post_disaster.png,60,69,1,516,576,628,697,1410,52.68224332616719,36.8655885056798
5473,/media/marda/TWOTB1/xBD/hurricanes/images/florence/hurricane-florence_00000387_post_disaster.png,71,67,1,658,729,632,699,1371,51.65997927648752,38.57378564448825
5474,/media/marda/TWOTB1/xBD/hurricanes/images/florence/hurricane-florence_00000387_post_disaster.png,84,72,1,797,881,635,707,1313,48.56929682339171,39.177904707054836
5475,/media/marda/TWOTB1/xBD/hurricanes/images/florence/hurricane-florence_00000387_post_disaster.png,65,75,1,827,892,703,778,1078,48.10218741804795,30.860461357659403
5476,/media/marda/TWOTB1/xBD/hurricanes/images/florence/hurricane-florence_00000387_post_disaster.png,44,65,1,19,63,705,770,978,47.65335146918607,27.40392792673263
5477,/media/marda/TWOTB1/xBD/hurricanes/images/florence/hurricane-florence_00000387_post_disaster.png,63,71,1,275,338,727,798,1447,53.019548077259614,37.727812421937635
5478,/media/marda/TWOTB1/xBD/hurricanes/images/florence/hurricane-florence_00000387_post_disaster.png,60,61,1,338,398,744,805,1040,50.62489783372663,27.07833558005883
5479,/media/marda/TWOTB1/xBD/hurricanes/images/florence/hurricane-florence_00000387_post_disaster.png,67,72,1,410,477,754,826,1486,51.88041179592849,39.88106102109261
5480,/media/marda/TWOTB1/xBD/hurricanes/images/florence/hurricane-florence_00000387_post_disaster.png,58,73,1,492,550,762,835,1255,45.693602367417974,38.527556741058795
5481,/media/marda/TWOTB1/xBD/hurricanes/images/florence/hurricane-florence_00000387_post_disaster.png,64,74,1,637,701,764,838,1356,48.35181328579369,40.23370950554102
5482,/media/marda/TWOTB1/xBD/hurricanes/images/florence/hurricane-florence_00000387_post_disaster.png,60,70,1,555,615,766,836,1156,44.3790932449142,34.97865314772948
5483,/media/marda/TWOTB1/xBD/hurricanes/images/florence/hurricane-florence_00000387_post_disaster.png,81,76,1,786,867,768,844,1293,49.18688760318211,38.92635484125284
5484,/media/marda/TWOTB1/xBD/hurricanes/images/florence/hurricane-florence_00000387_post_disaster.png,68,68,1,703,771,770,838,1171,42.28278968293405,37.5616477330892
5485,/media/marda/TWOTB1/xBD/hurricanes/images/florence/hurricane-florence_00000387_post_disaster.png,33,47,1,359,392,796,843,201,20.805576595622725,12.868300937923406
5486,/media/marda/TWOTB1/xBD/hurricanes/images/florence/hurricane-florence_00000387_post_disaster.png,34,42,1,517,551,796,838,132,16.209660544372728,10.85499548939444
5487,/media/marda/TWOTB1/xBD/hurricanes/images/florence/hurricane-florence_00000387_post_disaster.png,36,47,1,597,633,803,850,155,16.42425964938546,12.623550941073134
5488,/media/marda/TWOTB1/xBD/hurricanes/images/florence/hurricane-florence_00000387_post_disaster.png,42,44,1,688,730,813,857,137,15.766208736747712,11.703184055757083
5489,/media/marda/TWOTB1/xBD/hurricanes/images/florence/hurricane-florence_00000387_post_disaster.png,39,71,1,2,41,814,885,1059,40.56091891259518,35.5191641210561
5490,/media/marda/TWOTB1/xBD/hurricanes/images/florence/hurricane-florence_00000387_post_disaster.png,176,155,1,133,309,834,989,9777,185.30445814925793,103.6771928474231
5491,/media/marda/TWOTB1/xBD/hurricanes/images/florence/hurricane-florence_00000387_post_disaster.png,69,56,1,324,393,853,909,790,60.33322430472275,19.574665956775803
5492,/media/marda/TWOTB1/xBD/hurricanes/images/florence/hurricane-florence_00000387_post_disaster.png,10,72,1,0,10,944,1016,269,38.55260118360013,10.319976064808417
5493,/media/marda/TWOTB1/xBD/hurricanes/images/florence/hurricane-florence_00000387_post_disaster.png,30,62,1,352,382,974,1036,292,26.001146339571527,15.029946544741112
5494,/media/marda/TWOTB1/xBD/hurricanes/images/florence/hurricane-florence_00000356_post_disaster.png,86,80,1,930,1016,583,663,1334,63.21748259572874,28.16253987313993
5495,/media/marda/TWOTB1/xBD/hurricanes/images/florence/hurricane-florence_00000356_post_disaster.png,95,93,1,851,946,629,722,1922,67.012305226903,51.346297101291945
5496,/media/marda/TWOTB1/xBD/hurricanes/images/florence/hurricane-florence_00000356_post_disaster.png,55,43,1,911,966,645,688,186,16.22783695990348,15.413508937631303
5497,/media/marda/TWOTB1/xBD/hurricanes/images/florence/hurricane-florence_00000356_post_disaster.png,71,59,1,973,1044,682,741,717,32.147341204356856,29.931036289523416
5498,/media/marda/TWOTB1/xBD/hurricanes/images/florence/hurricane-florence_00000356_post_disaster.png,61,72,1,605,666,807,879,836,35.799980422594366,31.386990669614697
5499,/media/marda/TWOTB1/xBD/hurricanes/images/florence/hurricane-florence_00000411_pre_disaster.png,54,47,1,512,566,22,69,578,54.41117572150411,14.184955683769319
5500,/media/marda/TWOTB1/xBD/hurricanes/images/florence/hurricane-florence_00000411_pre_disaster.png,58,47,1,571,629,22,69,709,54.11319893442448,17.4207270309483
5501,/media/marda/TWOTB1/xBD/hurricanes/images/florence/hurricane-florence_00000411_pre_disaster.png,68,47,1,479,547,41,88,722,64.04948041558107,15.058941643216292
5502,/media/marda/TWOTB1/xBD/hurricanes/images/florence/hurricane-florence_00000411_pre_disaster.png,58,46,1,604,662,42,88,630,52.5098370264002,15.99360285918414
5503,/media/marda/TWOTB1/xBD/hurricanes/images/florence/hurricane-florence_00000411_pre_disaster.png,35,10,1,602,637,46,56,57,9.949592029552775,7.8005148224735255
5504,/media/marda/TWOTB1/xBD/hurricanes/images/florence/hurricane-florence_00000411_pre_disaster.png,72,40,1,446,518,76,116,664,64.36625904634285,13.759434791323315
5505,/media/marda/TWOTB1/xBD/hurricanes/images/florence/hurricane-florence_00000411_pre_disaster.png,67,46,1,428,495,109,155,590,64.2733105073555,12.25350301285642
5506,/media/marda/TWOTB1/xBD/hurricanes/images/florence/hurricane-florence_00000411_pre_disaster.png,29,16,1,413,442,110,126,79,10.852068911217874,9.739349901828907
5507,/media/marda/TWOTB1/xBD/hurricanes/images/florence/hurricane-florence_00000411_pre_disaster.png,70,42,1,544,614,119,161,917,48.728099859840675,25.024444151770627
5508,/media/marda/TWOTB1/xBD/hurricanes/images/florence/hurricane-florence_00000411_pre_disaster.png,65,48,1,406,471,142,190,599,63.48565830433727,12.603264602989855
5509,/media/marda/TWOTB1/xBD/hurricanes/images/florence/hurricane-florence_00000411_pre_disaster.png,23,19,1,279,302,145,164,157,15.282101307533525,13.806166950617405
5510,/media/marda/TWOTB1/xBD/hurricanes/images/florence/hurricane-florence_00000411_pre_disaster.png,71,39,1,515,586,164,203,619,58.852375380971786,14.058357738419357
5511,/media/marda/TWOTB1/xBD/hurricanes/images/florence/hurricane-florence_00000411_pre_disaster.png,54,53,1,379,433,165,218,678,58.8162029751958,15.387789350354799
5512,/media/marda/TWOTB1/xBD/hurricanes/images/florence/hurricane-florence_00000411_pre_disaster.png,47,60,1,351,398,174,234,691,64.8200136850001,14.23987569894184
5513,/media/marda/TWOTB1/xBD/hurricanes/images/florence/hurricane-florence_00000411_pre_disaster.png,65,34,1,283,348,191,225,715,62.95852566108589,15.171773094771174
5514,/media/marda/TWOTB1/xBD/hurricanes/images/florence/hurricane-florence_00000411_pre_disaster.png,70,41,1,492,562,196,237,543,58.15356089159198,12.421599826138031
5515,/media/marda/TWOTB1/xBD/hurricanes/images/florence/hurricane-florence_00000411_pre_disaster.png,55,46,1,299,354,226,272,821,43.197223488471735,25.3704564568461
5516,/media/marda/TWOTB1/xBD/hurricanes/images/florence/hurricane-florence_00000411_pre_disaster.png,73,45,1,465,538,231,276,683,65.2842466278472,13.906076719812914
5517,/media/marda/TWOTB1/xBD/hurricanes/images/florence/hurricane-florence_00000411_pre_disaster.png,62,42,1,193,255,256,298,747,63.47215325662108,16.207943532095506
5518,/media/marda/TWOTB1/xBD/hurricanes/images/florence/hurricane-florence_00000411_pre_disaster.png,69,44,1,438,507,261,305,608,63.109364258231125,12.834238001633143
5519,/media/marda/TWOTB1/xBD/hurricanes/images/florence/hurricane-florence_00000411_pre_disaster.png,58,52,1,374,432,268,320,680,55.541137404949865,16.34570450499087
5520,/media/marda/TWOTB1/xBD/hurricanes/images/florence/hurricane-florence_00000411_pre_disaster.png,53,61,1,407,460,289,350,725,62.59037349387646,15.387422868047603
5521,/media/marda/TWOTB1/xBD/hurricanes/images/florence/hurricane-florence_00000411_pre_disaster.png,48,59,1,262,310,313,372,633,55.569385134567426,15.214921703400899
5522,/media/marda/TWOTB1/xBD/hurricanes/images/florence/hurricane-florence_00000411_pre_disaster.png,55,43,1,445,500,319,362,664,37.16426310625138,23.720933689584296
5523,/media/marda/TWOTB1/xBD/hurricanes/images/florence/hurricane-florence_00000411_pre_disaster.png,50,64,1,294,344,331,395,758,62.66464267869415,16.10049435737826
5524,/media/marda/TWOTB1/xBD/hurricanes/images/florence/hurricane-florence_00000411_pre_disaster.png,52,66,1,327,379,352,418,794,62.25132227138771,17.02796866257549
5525,/media/marda/TWOTB1/xBD/hurricanes/images/florence/hurricane-florence_00000411_pre_disaster.png,50,60,1,364,414,374,434,691,53.85331764294492,17.447128476143376
5526,/media/marda/TWOTB1/xBD/hurricanes/images/florence/hurricane-florence_00000411_pre_disaster.png,52,64,1,396,448,392,456,699,54.05490075484824,17.27029136726407
5527,/media/marda/TWOTB1/xBD/hurricanes/images/florence/hurricane-florence_00000411_pre_disaster.png,12,51,1,0,12,585,636,190,27.32044047856957,10.715384269114049
5528,/media/marda/TWOTB1/xBD/hurricanes/images/florence/hurricane-florence_00000411_pre_disaster.png,45,44,1,666,711,610,654,221,18.32815397082976,16.140894527986024
5529,/media/marda/TWOTB1/xBD/hurricanes/images/florence/hurricane-florence_00000411_pre_disaster.png,30,62,1,24,54,616,678,520,41.92480929985621,18.315447890861968
5530,/media/marda/TWOTB1/xBD/hurricanes/images/florence/hurricane-florence_00000411_pre_disaster.png,29,57,1,10,39,633,690,504,28.97680518367044,24.13125540611383
5531,/media/marda/TWOTB1/xBD/hurricanes/images/florence/hurricane-florence_00000028_post_disaster.png,55,75,1,175,230,0,75,1874,86.28004894363134,28.75431044710954
5532,/media/marda/TWOTB1/xBD/hurricanes/images/florence/hurricane-florence_00000028_post_disaster.png,72,79,1,281,353,1,80,2049,88.13435509743854,32.623304816045106
5533,/media/marda/TWOTB1/xBD/hurricanes/images/florence/hurricane-florence_00000028_post_disaster.png,92,29,1,346,438,72,101,1955,86.08796118762213,30.026160430103214
5534,/media/marda/TWOTB1/xBD/hurricanes/images/florence/hurricane-florence_00000028_post_disaster.png,63,65,1,209,272,79,144,1520,71.91007862385452,28.046602928008376
5535,/media/marda/TWOTB1/xBD/hurricanes/images/florence/hurricane-florence_00000028_post_disaster.png,58,80,1,469,527,133,213,1730,83.58250058955018,27.959023095547476
5536,/media/marda/TWOTB1/xBD/hurricanes/images/florence/hurricane-florence_00000028_post_disaster.png,72,63,1,283,355,156,219,1514,71.15226981366017,28.475025662464827
5537,/media/marda/TWOTB1/xBD/hurricanes/images/florence/hurricane-florence_00000028_post_disaster.png,98,52,1,486,584,189,241,1804,89.09794667764095,27.17776141540809
5538,/media/marda/TWOTB1/xBD/hurricanes/images/florence/hurricane-florence_00000028_post_disaster.png,93,79,1,322,415,203,282,2084,91.80490623582943,31.823304369040386
5539,/media/marda/TWOTB1/xBD/hurricanes/images/florence/hurricane-florence_00000028_post_disaster.png,85,76,1,392,477,269,345,1852,85.1368743697973,31.171689647196406
5540,/media/marda/TWOTB1/xBD/hurricanes/images/florence/hurricane-florence_00000028_post_disaster.png,53,63,1,227,280,542,605,973,46.27929406593535,27.833955488179292
5541,/media/marda/TWOTB1/xBD/hurricanes/images/florence/hurricane-florence_00000028_post_disaster.png,59,68,1,241,300,565,633,958,61.57608065607344,22.004239441833878
5542,/media/marda/TWOTB1/xBD/hurricanes/images/florence/hurricane-florence_00000028_post_disaster.png,58,70,1,267,325,590,660,922,54.968059762574995,22.29747401130802
5543,/media/marda/TWOTB1/xBD/hurricanes/images/florence/hurricane-florence_00000028_post_disaster.png,52,69,1,185,237,604,673,643,60.12896982850495,14.27546365325557
5544,/media/marda/TWOTB1/xBD/hurricanes/images/florence/hurricane-florence_00000028_post_disaster.png,19,34,1,256,275,611,645,54,10.062461072716959,7.216662004929232
5545,/media/marda/TWOTB1/xBD/hurricanes/images/florence/hurricane-florence_00000028_post_disaster.png,53,70,1,207,260,626,696,773,56.54866723473714,18.418475490222043
5546,/media/marda/TWOTB1/xBD/hurricanes/images/florence/hurricane-florence_00000028_post_disaster.png,59,70,1,226,285,648,718,1022,56.924702090628024,23.908859793139413
5547,/media/marda/TWOTB1/xBD/hurricanes/images/florence/hurricane-florence_00000028_post_disaster.png,41,62,1,114,155,665,727,560,46.61410721602224,16.754763510414524
5548,/media/marda/TWOTB1/xBD/hurricanes/images/florence/hurricane-florence_00000028_post_disaster.png,59,70,1,254,313,674,744,819,62.24779699852355,17.369175068700027
5549,/media/marda/TWOTB1/xBD/hurricanes/images/florence/hurricane-florence_00000028_post_disaster.png,24,37,1,324,348,676,713,73,12.73829327594526,7.755294416752066
5550,/media/marda/TWOTB1/xBD/hurricanes/images/florence/hurricane-florence_00000028_post_disaster.png,49,67,1,134,183,687,754,783,54.94253491712299,19.43166291906601
5551,/media/marda/TWOTB1/xBD/hurricanes/images/florence/hurricane-florence_00000028_post_disaster.png,52,76,1,282,334,689,765,601,57.57240531774648,15.841714000007364
5552,/media/marda/TWOTB1/xBD/hurricanes/images/florence/hurricane-florence_00000028_post_disaster.png,54,74,1,154,208,704,778,732,63.44497020811703,15.128507535161042
5553,/media/marda/TWOTB1/xBD/hurricanes/images/florence/hurricane-florence_00000028_post_disaster.png,21,36,1,326,347,709,745,50,9.531164280244877,7.213661169127931
5554,/media/marda/TWOTB1/xBD/hurricanes/images/florence/hurricane-florence_00000028_post_disaster.png,20,45,1,92,112,711,756,149,16.926191017460873,11.78431679106226
5555,/media/marda/TWOTB1/xBD/hurricanes/images/florence/hurricane-florence_00000028_post_disaster.png,56,72,1,305,361,715,787,647,56.83467156254824,16.188627949115574
5556,/media/marda/TWOTB1/xBD/hurricanes/images/florence/hurricane-florence_00000028_post_disaster.png,37,64,1,78,115,730,794,494,43.17119664149673,16.158961800474664
5557,/media/marda/TWOTB1/xBD/hurricanes/images/florence/hurricane-florence_00000028_post_disaster.png,44,66,1,182,226,733,799,532,46.899807844078296,15.139156165451919
5558,/media/marda/TWOTB1/xBD/hurricanes/images/florence/hurricane-florence_00000028_post_disaster.png,18,38,1,229,247,735,773,50,8.517499240128604,7.933083051021756
5559,/media/marda/TWOTB1/xBD/hurricanes/images/florence/hurricane-florence_00000028_post_disaster.png,58,74,1,327,385,737,811,633,61.51051638167162,13.521555075771355
5560,/media/marda/TWOTB1/xBD/hurricanes/images/florence/hurricane-florence_00000028_post_disaster.png,44,68,1,95,139,749,817,791,46.14725790598539,22.64100343145701
5561,/media/marda/TWOTB1/xBD/hurricanes/images/florence/hurricane-florence_00000028_post_disaster.png,49,68,1,206,255,752,820,507,53.5424112338361,12.642956258385523
5562,/media/marda/TWOTB1/xBD/hurricanes/images/florence/hurricane-florence_00000028_post_disaster.png,53,89,1,117,170,757,846,1123,67.26861743484113,26.959481523580862
5563,/media/marda/TWOTB1/xBD/hurricanes/images/florence/hurricane-florence_00000028_post_disaster.png,24,44,1,202,226,758,802,122,15.963741169203585,10.242484931841137
5564,/media/marda/TWOTB1/xBD/hurricanes/images/florence/hurricane-florence_00000028_post_disaster.png,49,68,1,354,403,766,834,565,47.86165781597451,16.586874625137707
5565,/media/marda/TWOTB1/xBD/hurricanes/images/florence/hurricane-florence_00000028_post_disaster.png,48,66,1,231,279,776,842,506,50.32375072269038,13.43217168587599
5566,/media/marda/TWOTB1/xBD/hurricanes/images/florence/hurricane-florence_00000028_post_disaster.png,59,80,1,377,436,777,857,772,60.81327578132158,21.627961319663218
5567,/media/marda/TWOTB1/xBD/hurricanes/images/florence/hurricane-florence_00000028_post_disaster.png,42,72,1,0,42,787,859,769,45.52183554748723,23.007552738212883
5568,/media/marda/TWOTB1/xBD/hurricanes/images/florence/hurricane-florence_00000028_post_disaster.png,46,79,1,143,189,792,871,901,50.50932670298021,24.080056978666647
5569,/media/marda/TWOTB1/xBD/hurricanes/images/florence/hurricane-florence_00000028_post_disaster.png,24,47,1,209,233,794,841,120,13.713975555818047,11.714861739070429
5570,/media/marda/TWOTB1/xBD/hurricanes/images/florence/hurricane-florence_00000028_post_disaster.png,29,43,1,421,450,794,837,71,11.092441278687337,8.623583778400867
5571,/media/marda/TWOTB1/xBD/hurricanes/images/florence/hurricane-florence_00000028_post_disaster.png,57,81,1,246,303,796,877,764,64.00485152412371,16.779267174119855
5572,/media/marda/TWOTB1/xBD/hurricanes/images/florence/hurricane-florence_00000028_post_disaster.png,65,81,1,398,463,802,883,785,62.15215789886422,18.405378345234407
5573,/media/marda/TWOTB1/xBD/hurricanes/images/florence/hurricane-florence_00000028_post_disaster.png,45,76,1,16,61,807,883,693,58.1972960748895,15.801808915962669
5574,/media/marda/TWOTB1/xBD/hurricanes/images/florence/hurricane-florence_00000028_post_disaster.png,22,45,1,241,263,808,853,88,13.255321769296415,8.899749193179964
5575,/media/marda/TWOTB1/xBD/hurricanes/images/florence/hurricane-florence_00000028_post_disaster.png,52,81,1,163,215,812,893,1030,56.01275155041162,24.697222068488298
5576,/media/marda/TWOTB1/xBD/hurricanes/images/florence/hurricane-florence_00000028_post_disaster.png,30,46,1,444,474,816,862,98,11.661903789690601,11.313708498984761
5577,/media/marda/TWOTB1/xBD/hurricanes/images/florence/hurricane-florence_00000028_post_disaster.png,54,73,1,278,332,823,896,874,45.59816824402441,25.98691787081723
5578,/media/marda/TWOTB1/xBD/hurricanes/images/florence/hurricane-florence_00000028_post_disaster.png,59,74,1,424,483,828,902,602,54.777302205013925,14.67969153784609
5579,/media/marda/TWOTB1/xBD/hurricanes/images/florence/hurricane-florence_00000028_post_disaster.png,63,85,1,190,253,830,915,809,69.58205299863646,24.407413686950555
5580,/media/marda/TWOTB1/xBD/hurricanes/images/florence/hurricane-florence_00000028_post_disaster.png,41,71,1,47,88,831,902,587,50.41293823585789,16.900744348799098
5581,/media/marda/TWOTB1/xBD/hurricanes/images/florence/hurricane-florence_00000028_post_disaster.png,61,83,1,534,595,832,915,704,58.17198621949998,20.107308420644813
5582,/media/marda/TWOTB1/xBD/hurricanes/images/florence/hurricane-florence_00000028_post_disaster.png,60,88,1,296,356,844,932,916,65.05666736628265,23.661603569742034
5583,/media/marda/TWOTB1/xBD/hurricanes/images/florence/hurricane-florence_00000028_post_disaster.png,55,71,1,446,501,854,925,508,50.20769887473881,13.497502424328255
5584,/media/marda/TWOTB1/xBD/hurricanes/images/florence/hurricane-florence_00000028_post_disaster.png,63,68,1,561,624,854,922,679,44.100695113124786,20.587202470603938
5585,/media/marda/TWOTB1/xBD/hurricanes/images/florence/hurricane-florence_00000028_post_disaster.png,60,74,1,216,276,862,936,743,57.41201108746583,23.83556687999054
5586,/media/marda/TWOTB1/xBD/hurricanes/images/florence/hurricane-florence_00000028_post_disaster.png,64,89,1,466,530,864,953,721,71.47911925661613,19.10159502438511
5587,/media/marda/TWOTB1/xBD/hurricanes/images/florence/hurricane-florence_00000028_post_disaster.png,53,75,1,322,375,867,942,589,55.45687619661136,14.490926799192197
5588,/media/marda/TWOTB1/xBD/hurricanes/images/florence/hurricane-florence_00000028_post_disaster.png,75,80,1,598,673,872,952,1080,56.456037720207505,27.079881876872555
5589,/media/marda/TWOTB1/xBD/hurricanes/images/florence/hurricane-florence_00000028_post_disaster.png,39,50,1,539,578,876,926,164,18.153310741121345,12.118067215473243
5590,/media/marda/TWOTB1/xBD/hurricanes/images/florence/hurricane-florence_00000028_post_disaster.png,50,79,1,240,290,883,962,604,55.08324847918235,16.35405977767023
5591,/media/marda/TWOTB1/xBD/hurricanes/images/florence/hurricane-florence_00000028_post_disaster.png,54,87,1,114,168,886,973,839,65.11274250062021,18.094996586928694
5592,/media/marda/TWOTB1/xBD/hurricanes/images/florence/hurricane-florence_00000028_post_disaster.png,51,74,1,352,403,891,965,798,39.20109589800484,27.513541193073234
5593,/media/marda/TWOTB1/xBD/hurricanes/images/florence/hurricane-florence_00000028_post_disaster.png,71,88,1,487,558,894,982,1094,63.75552833564725,23.089507223546143
5594,/media/marda/TWOTB1/xBD/hurricanes/images/florence/hurricane-florence_00000028_post_disaster.png,31,53,1,390,421,898,951,123,19.145214465204745,8.620661789013736
5595,/media/marda/TWOTB1/xBD/hurricanes/images/florence/hurricane-florence_00000028_post_disaster.png,37,51,1,569,606,904,955,127,16.354084597068663,10.29625290723452
5596,/media/marda/TWOTB1/xBD/hurricanes/images/florence/hurricane-florence_00000028_post_disaster.png,67,80,1,584,651,905,985,902,49.86365407826206,24.60007187275411
5597,/media/marda/TWOTB1/xBD/hurricanes/images/florence/hurricane-florence_00000028_post_disaster.png,28,52,1,331,359,907,959,122,15.963741169203587,10.242484931841139
5598,/media/marda/TWOTB1/xBD/hurricanes/images/florence/hurricane-florence_00000028_post_disaster.png,12,47,1,86,98,910,957,62,11.724167133333351,7.163665163731003
5599,/media/marda/TWOTB1/xBD/hurricanes/images/florence/hurricane-florence_00000028_post_disaster.png,59,84,1,258,317,910,994,1036,55.1397279532714,25.373048401424338
5600,/media/marda/TWOTB1/xBD/hurricanes/images/florence/hurricane-florence_00000028_post_disaster.png,64,87,1,367,431,911,998,777,66.67448184504687,15.610798236872853
5601,/media/marda/TWOTB1/xBD/hurricanes/images/florence/hurricane-florence_00000028_post_disaster.png,42,74,1,142,184,918,992,491,48.40433018161793,13.540873494098653
5602,/media/marda/TWOTB1/xBD/hurricanes/images/florence/hurricane-florence_00000028_post_disaster.png,15,47,1,101,116,919,966,56,11.489125293076057,6.555882231762152
5603,/media/marda/TWOTB1/xBD/hurricanes/images/florence/hurricane-florence_00000028_post_disaster.png,87,115,1,515,602,920,1035,1836,90.5125898944977,41.26756201463387
5604,/media/marda/TWOTB1/xBD/hurricanes/images/florence/hurricane-florence_00000028_post_disaster.png,55,84,1,397,452,931,1015,685,55.9203420164153,19.862289845044618
5605,/media/marda/TWOTB1/xBD/hurricanes/images/florence/hurricane-florence_00000028_post_disaster.png,52,74,1,283,335,935,1009,578,49.98042029433896,15.432153408631198
5606,/media/marda/TWOTB1/xBD/hurricanes/images/florence/hurricane-florence_00000028_post_disaster.png,65,78,1,557,622,936,1014,832,46.45785714968721,23.983100246774416
5607,/media/marda/TWOTB1/xBD/hurricanes/images/florence/hurricane-florence_00000028_post_disaster.png,53,84,1,194,247,950,1034,1009,51.167585604890405,26.928907356665285
5608,/media/marda/TWOTB1/xBD/hurricanes/images/florence/hurricane-florence_00000028_post_disaster.png,59,78,1,306,365,951,1029,679,55.64628317211397,18.543422330564344
5609,/media/marda/TWOTB1/xBD/hurricanes/images/florence/hurricane-florence_00000028_post_disaster.png,70,80,1,409,479,959,1039,1104,59.00461156450663,25.517271245316376
5610,/media/marda/TWOTB1/xBD/hurricanes/images/florence/hurricane-florence_00000028_post_disaster.png,27,50,1,351,378,962,1012,103,13.623841070434988,10.136562287567074
5611,/media/marda/TWOTB1/xBD/hurricanes/images/florence/hurricane-florence_00000028_post_disaster.png,50,75,1,171,221,966,1041,786,49.711316857640576,22.188753117772652
5612,/media/marda/TWOTB1/xBD/hurricanes/images/florence/hurricane-florence_00000028_post_disaster.png,67,71,1,354,421,970,1041,938,50.074903948138065,27.243027821384928
5613,/media/marda/TWOTB1/xBD/hurricanes/images/florence/hurricane-florence_00000028_post_disaster.png,61,62,1,474,535,979,1041,581,38.295955906081794,21.251422681635756
5614,/media/marda/TWOTB1/xBD/hurricanes/images/florence/hurricane-florence_00000028_post_disaster.png,37,58,1,450,487,985,1043,193,20.47551304139328,12.533080197685946
5615,/media/marda/TWOTB1/xBD/hurricanes/images/florence/hurricane-florence_00000517_post_disaster.png,89,47,1,891,980,0,47,1400,52.94582258021037,35.16275026215616
5616,/media/marda/TWOTB1/xBD/hurricanes/images/florence/hurricane-florence_00000517_post_disaster.png,95,62,1,869,964,37,99,2205,55.10648678603302,52.94309004291405
5617,/media/marda/TWOTB1/xBD/hurricanes/images/florence/hurricane-florence_00000517_post_disaster.png,52,24,1,866,918,211,235,208,18.395221273326975,14.452997375005186
5618,/media/marda/TWOTB1/xBD/hurricanes/images/florence/hurricane-florence_00000517_post_disaster.png,50,26,1,830,880,348,374,161,18.832761819263848,11.344647467654644
5619,/media/marda/TWOTB1/xBD/hurricanes/images/florence/hurricane-florence_00000517_post_disaster.png,79,87,1,783,862,559,646,1580,71.54547887681589,29.473404855408653
5620,/media/marda/TWOTB1/xBD/hurricanes/images/florence/hurricane-florence_00000517_post_disaster.png,68,163,1,570,638,607,770,4563,156.68283856452092,38.84740261092108
5621,/media/marda/TWOTB1/xBD/hurricanes/images/florence/hurricane-florence_00000517_post_disaster.png,83,70,1,703,786,611,681,1745,53.8974901040949,43.611799014523086
5622,/media/marda/TWOTB1/xBD/hurricanes/images/florence/hurricane-florence_00000517_post_disaster.png,61,41,1,914,975,657,698,335,28.367105351686106,15.928131516873703
5623,/media/marda/TWOTB1/xBD/hurricanes/images/florence/hurricane-florence_00000517_post_disaster.png,60,49,1,761,821,667,716,605,31.491371932261714,25.402494494176036
5624,/media/marda/TWOTB1/xBD/hurricanes/images/florence/hurricane-florence_00000517_post_disaster.png,89,66,1,907,996,682,748,1600,58.447762910089224,39.364559943634575
5625,/media/marda/TWOTB1/xBD/hurricanes/images/florence/hurricane-florence_00000517_post_disaster.png,47,41,1,692,739,687,728,215,20.734967005945265,13.688444276179029
5626,/media/marda/TWOTB1/xBD/hurricanes/images/florence/hurricane-florence_00000517_post_disaster.png,64,62,1,675,739,708,770,944,40.413758630932165,32.45910515716674
5627,/media/marda/TWOTB1/xBD/hurricanes/images/florence/hurricane-florence_00000517_post_disaster.png,40,37,1,779,819,709,746,77,11.082329117375982,9.303524535662277
5628,/media/marda/TWOTB1/xBD/hurricanes/images/florence/hurricane-florence_00000517_post_disaster.png,57,56,1,422,479,832,888,825,46.32338539900673,23.795322403725088
5629,/media/marda/TWOTB1/xBD/hurricanes/images/florence/hurricane-florence_00000517_post_disaster.png,58,67,1,13,71,835,902,1538,63.274573719008195,34.03968802395768
5630,/media/marda/TWOTB1/xBD/hurricanes/images/florence/hurricane-florence_00000517_post_disaster.png,141,57,1,780,921,243,300,3426,121.19654662710381,37.48722784551398
5631,/media/marda/TWOTB1/xBD/hurricanes/images/florence/hurricane-florence_00000517_post_disaster.png,140,60,1,771,911,296,356,3364,121.37117894383962,36.8687147915013
5632,/media/marda/TWOTB1/xBD/hurricanes/images/florence/hurricane-florence_00000529_pre_disaster.png,74,69,1,813,887,33,102,1385,74.8901244493018,30.290865893159683
5633,/media/marda/TWOTB1/xBD/hurricanes/images/florence/hurricane-florence_00000529_pre_disaster.png,58,28,1,762,820,69,97,465,26.759401202126163,22.95898244911498
5634,/media/marda/TWOTB1/xBD/hurricanes/images/florence/hurricane-florence_00000529_pre_disaster.png,52,29,1,840,892,175,204,365,23.652127606709495,20.427791924417722
5635,/media/marda/TWOTB1/xBD/hurricanes/images/florence/hurricane-florence_00000529_pre_disaster.png,79,68,1,896,975,293,361,1920,64.08597194354766,39.891979159551624
5636,/media/marda/TWOTB1/xBD/hurricanes/images/florence/hurricane-florence_00000529_pre_disaster.png,50,26,1,961,1011,315,341,163,16.441962608315443,13.324286353367958
5637,/media/marda/TWOTB1/xBD/hurricanes/images/florence/hurricane-florence_00000529_pre_disaster.png,71,28,1,938,1009,410,438,273,38.47560662002221,9.557576443238515
5638,/media/marda/TWOTB1/xBD/hurricanes/images/florence/hurricane-florence_00000529_pre_disaster.png,73,31,1,938,1011,423,454,335,41.11523767944516,10.85287408560726
5639,/media/marda/TWOTB1/xBD/hurricanes/images/florence/hurricane-florence_00000529_pre_disaster.png,92,81,1,785,877,473,554,3593,71.32544981685156,67.07787845602515
5640,/media/marda/TWOTB1/xBD/hurricanes/images/florence/hurricane-florence_00000529_pre_disaster.png,64,59,1,421,485,607,666,1192,52.03947214928022,32.83837683449851
5641,/media/marda/TWOTB1/xBD/hurricanes/images/florence/hurricane-florence_00000529_pre_disaster.png,29,34,1,472,501,629,663,130,14.966629547095765,11.489125293076057
5642,/media/marda/TWOTB1/xBD/hurricanes/images/florence/hurricane-florence_00000529_pre_disaster.png,70,59,1,816,886,676,735,871,42.6433970644379,26.829472314503253
5643,/media/marda/TWOTB1/xBD/hurricanes/images/florence/hurricane-florence_00000529_pre_disaster.png,46,47,1,358,404,682,729,599,36.057785114583965,21.986431207646906
5644,/media/marda/TWOTB1/xBD/hurricanes/images/florence/hurricane-florence_00000529_pre_disaster.png,58,59,1,489,547,805,864,740,41.58012912535587,23.957141668759103
5645,/media/marda/TWOTB1/xBD/hurricanes/images/florence/hurricane-florence_00000529_pre_disaster.png,76,55,1,888,964,820,875,699,41.87967136253219,22.145083757041867
5646,/media/marda/TWOTB1/xBD/hurricanes/images/florence/hurricane-florence_00000529_pre_disaster.png,56,53,1,914,970,858,911,365,24.671438764692123,20.297910628847315
5647,/media/marda/TWOTB1/xBD/hurricanes/images/florence/hurricane-florence_00000529_pre_disaster.png,49,42,1,877,926,865,907,140,16.91513794336374,10.879814026670472
5648,/media/marda/TWOTB1/xBD/hurricanes/images/florence/hurricane-florence_00000529_pre_disaster.png,95,121,1,686,781,874,995,2604,100.8228236877787,39.23023740012819
5649,/media/marda/TWOTB1/xBD/hurricanes/images/florence/hurricane-florence_00000529_pre_disaster.png,50,66,1,259,309,915,981,671,42.14638623057001,21.078126818983996
5650,/media/marda/TWOTB1/xBD/hurricanes/images/florence/hurricane-florence_00000529_pre_disaster.png,30,72,1,76,106,932,1004,814,39.61149805564076,27.23233064827914
5651,/media/marda/TWOTB1/xBD/hurricanes/images/florence/hurricane-florence_00000192_pre_disaster.png,72,51,1,654,726,197,248,919,49.29773676735717,24.6187543135422
5652,/media/marda/TWOTB1/xBD/hurricanes/images/florence/hurricane-florence_00000192_pre_disaster.png,42,21,1,681,723,258,279,101,13.49107207277728,10.09550477471594
5653,/media/marda/TWOTB1/xBD/hurricanes/images/florence/hurricane-florence_00000192_pre_disaster.png,48,69,1,270,318,876,945,801,35.41022388540555,29.49606619698622
5654,/media/marda/TWOTB1/xBD/hurricanes/images/florence/hurricane-florence_00000334_post_disaster.png,27,16,1,460,487,158,174,103,11.639624337961381,11.278710653075768
5655,/media/marda/TWOTB1/xBD/hurricanes/images/florence/hurricane-florence_00000334_post_disaster.png,69,44,1,435,504,184,228,1291,51.0734738022323,34.09027375385639
5656,/media/marda/TWOTB1/xBD/hurricanes/images/florence/hurricane-florence_00000334_post_disaster.png,63,51,1,508,571,630,681,791,46.22732790195937,22.87799138270842
5657,/media/marda/TWOTB1/xBD/hurricanes/images/florence/hurricane-florence_00000334_post_disaster.png,38,35,1,569,607,670,705,122,18.95806755682773,8.646132600011722
5658,/media/marda/TWOTB1/xBD/hurricanes/images/florence/hurricane-florence_00000334_post_disaster.png,62,58,1,767,829,581,639,1001,39.66023166050718,33.284101026714
5659,/media/marda/TWOTB1/xBD/hurricanes/images/florence/hurricane-florence_00000334_post_disaster.png,86,38,1,883,969,611,649,600,60.18848819606476,13.326647482267134
5660,/media/marda/TWOTB1/xBD/hurricanes/images/florence/hurricane-florence_00000334_post_disaster.png,93,37,1,879,972,654,691,472,66.44261220164226,11.32234835381093
5661,/media/marda/TWOTB1/xBD/hurricanes/images/florence/hurricane-florence_00000334_post_disaster.png,42,36,1,800,842,704,740,68,11.148694980382976,8.134510929026565
5662,/media/marda/TWOTB1/xBD/hurricanes/images/florence/hurricane-florence_00000334_post_disaster.png,84,43,1,875,959,718,761,577,57.363323776720236,13.977000072219916
5663,/media/marda/TWOTB1/xBD/hurricanes/images/florence/hurricane-florence_00000334_post_disaster.png,93,41,1,866,959,746,787,651,68.21673161145154,12.6991255865152
5664,/media/marda/TWOTB1/xBD/hurricanes/images/florence/hurricane-florence_00000334_post_disaster.png,81,45,1,872,953,788,833,496,54.4006593279843,12.189858626671652
5665,/media/marda/TWOTB1/xBD/hurricanes/images/florence/hurricane-florence_00000078_post_disaster.png,21,52,1,62,83,880,932,385,23.863378131562907,21.398838178659634
5666,/media/marda/TWOTB1/xBD/hurricanes/images/florence/hurricane-florence_00000078_post_disaster.png,20,50,1,18,38,866,916,191,18.176955110765135,13.968813714465897
5667,/media/marda/TWOTB1/xBD/hurricanes/images/florence/hurricane-florence_00000078_post_disaster.png,71,84,1,99,170,903,987,2572,69.08157714930537,48.98593247555078
5668,/media/marda/TWOTB1/xBD/hurricanes/images/florence/hurricane-florence_00000316_pre_disaster.png,52,6,1,800,852,0,6,63,18.1139309583086,5.2622236559297395
5669,/media/marda/TWOTB1/xBD/hurricanes/images/florence/hurricane-florence_00000316_pre_disaster.png,60,35,1,984,1044,1,36,516,33.474114524614436,21.281353618126314
5670,/media/marda/TWOTB1/xBD/hurricanes/images/florence/hurricane-florence_00000316_pre_disaster.png,46,25,1,662,708,168,193,273,20.418858465694942,17.91534025497453
5671,/media/marda/TWOTB1/xBD/hurricanes/images/florence/hurricane-florence_00000316_pre_disaster.png,75,30,1,663,738,189,219,663,51.40960924472105,19.294123811881473
5672,/media/marda/TWOTB1/xBD/hurricanes/images/florence/hurricane-florence_00000316_pre_disaster.png,77,48,1,913,990,259,307,1061,39.28155861961121,35.347272661875266
5673,/media/marda/TWOTB1/xBD/hurricanes/images/florence/hurricane-florence_00000316_pre_disaster.png,66,45,1,750,816,260,305,884,40.047423929465076,29.002616600967425
5674,/media/marda/TWOTB1/xBD/hurricanes/images/florence/hurricane-florence_00000316_pre_disaster.png,49,27,1,732,781,268,295,253,19.984365705946487,16.945532880917213
5675,/media/marda/TWOTB1/xBD/hurricanes/images/florence/hurricane-florence_00000316_pre_disaster.png,45,47,1,571,616,298,345,615,37.44139577765963,21.946915169852105
5676,/media/marda/TWOTB1/xBD/hurricanes/images/florence/hurricane-florence_00000316_pre_disaster.png,50,30,1,768,818,316,346,230,19.917296204347494,15.113763554134646
5677,/media/marda/TWOTB1/xBD/hurricanes/images/florence/hurricane-florence_00000316_pre_disaster.png,52,59,1,585,637,337,396,1335,53.124581222150454,33.54596681228679
5678,/media/marda/TWOTB1/xBD/hurricanes/images/florence/hurricane-florence_00000316_pre_disaster.png,92,65,1,890,982,444,509,1876,56.90052486400683,43.978694607377605
5679,/media/marda/TWOTB1/xBD/hurricanes/images/florence/hurricane-florence_00000316_pre_disaster.png,66,49,1,948,1014,464,513,675,31.665687700486203,28.46918645592345
5680,/media/marda/TWOTB1/xBD/hurricanes/images/florence/hurricane-florence_00000316_pre_disaster.png,127,83,1,917,1044,554,637,2871,109.01948498849133,39.138020990671706
5681,/media/marda/TWOTB1/xBD/hurricanes/images/florence/hurricane-florence_00000316_pre_disaster.png,54,40,1,768,822,573,613,233,25.985633398629624,11.759191520456787
5682,/media/marda/TWOTB1/xBD/hurricanes/images/florence/hurricane-florence_00000316_pre_disaster.png,67,59,1,672,739,592,651,712,36.22029537451833,31.040863244910096
5683,/media/marda/TWOTB1/xBD/hurricanes/images/florence/hurricane-florence_00000316_pre_disaster.png,80,90,1,627,707,598,688,1731,71.24091537725451,33.88858114137605
5684,/media/marda/TWOTB1/xBD/hurricanes/images/florence/hurricane-florence_00000316_pre_disaster.png,96,71,1,838,934,607,678,1982,68.30366726175671,39.49180532458906
5685,/media/marda/TWOTB1/xBD/hurricanes/images/florence/hurricane-florence_00000316_pre_disaster.png,41,38,1,769,810,609,647,92,11.804286982585277,10.515315131322915
5686,/media/marda/TWOTB1/xBD/hurricanes/images/florence/hurricane-florence_00000316_pre_disaster.png,55,36,1,974,1029,676,712,152,18.237980323708182,11.213091207702485
5687,/media/marda/TWOTB1/xBD/hurricanes/images/florence/hurricane-florence_00000316_pre_disaster.png,61,81,1,406,467,928,1009,1165,41.05399643445186,37.42340807360726
5688,/media/marda/TWOTB1/xBD/hurricanes/images/florence/hurricane-florence_00000316_pre_disaster.png,31,49,1,491,522,941,990,83,11.561499741626143,9.74465134052907
5689,/media/marda/TWOTB1/xBD/hurricanes/images/florence/hurricane-florence_00000316_pre_disaster.png,48,68,1,454,502,967,1035,562,29.829548073502977,24.847023294298314
5690,/media/marda/TWOTB1/xBD/hurricanes/images/florence/hurricane-florence_00000316_pre_disaster.png,74,68,1,933,1007,974,1042,816,39.14150780607589,27.419905175036625
5691,/media/marda/TWOTB1/xBD/hurricanes/images/florence/hurricane-florence_00000316_pre_disaster.png,73,64,1,894,967,978,1042,670,33.66952781501463,26.610077045079255
5692,/media/marda/TWOTB1/xBD/hurricanes/images/florence/hurricane-florence_00000346_pre_disaster.png,62,72,1,0,62,0,72,2116,87.76518060833611,42.420628742337634
5693,/media/marda/TWOTB1/xBD/hurricanes/images/florence/hurricane-florence_00000346_pre_disaster.png,43,54,1,156,199,0,54,1439,55.09721002375535,35.89044089605173
5694,/media/marda/TWOTB1/xBD/hurricanes/images/florence/hurricane-florence_00000346_pre_disaster.png,36,46,1,262,298,0,46,1114,51.61571767528937,28.925095562640703
5695,/media/marda/TWOTB1/xBD/hurricanes/images/florence/hurricane-florence_00000346_pre_disaster.png,55,28,1,303,358,0,28,1031,47.7976499678536,28.889660607078557
5696,/media/marda/TWOTB1/xBD/hurricanes/images/florence/hurricane-florence_00000346_pre_disaster.png,34,10,1,368,402,0,10,185,24.916021432860873,9.921300184940536
5697,/media/marda/TWOTB1/xBD/hurricanes/images/florence/hurricane-florence_00000346_pre_disaster.png,57,10,1,441,498,0,10,281,44.24251131451852,8.769048530978633
5698,/media/marda/TWOTB1/xBD/hurricanes/images/florence/hurricane-florence_00000346_pre_disaster.png,55,22,1,849,904,0,22,391,26.349626912651527,19.53411628948181
5699,/media/marda/TWOTB1/xBD/hurricanes/images/florence/hurricane-florence_00000346_pre_disaster.png,66,26,1,758,824,31,57,738,38.31830565173678,25.405342754894594
5700,/media/marda/TWOTB1/xBD/hurricanes/images/florence/hurricane-florence_00000346_pre_disaster.png,76,30,1,708,784,37,67,1152,52.81447604269476,29.11680895826344
5701,/media/marda/TWOTB1/xBD/hurricanes/images/florence/hurricane-florence_00000346_pre_disaster.png,69,27,1,652,721,52,79,877,47.7475082150827,24.517089140735283
5702,/media/marda/TWOTB1/xBD/hurricanes/images/florence/hurricane-florence_00000346_pre_disaster.png,61,52,1,858,919,62,114,1030,58.069208596109426,25.171970388438844
5703,/media/marda/TWOTB1/xBD/hurricanes/images/florence/hurricane-florence_00000346_pre_disaster.png,68,28,1,583,651,75,103,987,51.21756298904859,25.64353357388666
5704,/media/marda/TWOTB1/xBD/hurricanes/images/florence/hurricane-florence_00000346_pre_disaster.png,79,29,1,465,544,82,111,1238,67.31284715970665,25.165118003748617
5705,/media/marda/TWOTB1/xBD/hurricanes/images/florence/hurricane-florence_00000346_pre_disaster.png,100,37,1,728,828,96,133,1720,75.77270198822563,31.340773876424166
5706,/media/marda/TWOTB1/xBD/hurricanes/images/florence/hurricane-florence_00000346_pre_disaster.png,40,65,1,180,220,106,171,1536,66.5374457278527,30.61869308264171
5707,/media/marda/TWOTB1/xBD/hurricanes/images/florence/hurricane-florence_00000346_pre_disaster.png,90,62,1,617,707,106,168,2555,73.69283886071952,50.54629388538008
5708,/media/marda/TWOTB1/xBD/hurricanes/images/florence/hurricane-florence_00000346_pre_disaster.png,52,46,1,78,130,124,170,1396,57.126120920671354,36.05702048748866
5709,/media/marda/TWOTB1/xBD/hurricanes/images/florence/hurricane-florence_00000346_pre_disaster.png,59,45,1,868,927,140,185,824,42.67526539885576,25.35739524693694
5710,/media/marda/TWOTB1/xBD/hurricanes/images/florence/hurricane-florence_00000346_pre_disaster.png,61,39,1,503,564,141,180,962,46.52622887535316,28.42712369185752
5711,/media/marda/TWOTB1/xBD/hurricanes/images/florence/hurricane-florence_00000346_pre_disaster.png,9,31,1,0,9,145,176,131,25.65729720930248,7.788200991364388
5712,/media/marda/TWOTB1/xBD/hurricanes/images/florence/hurricane-florence_00000346_pre_disaster.png,63,56,1,293,356,155,211,1812,62.11190913136831,43.53996730606684
5713,/media/marda/TWOTB1/xBD/hurricanes/images/florence/hurricane-florence_00000346_pre_disaster.png,61,36,1,433,494,155,191,990,51.60955257205221,26.73751208793449
5714,/media/marda/TWOTB1/xBD/hurricanes/images/florence/hurricane-florence_00000346_pre_disaster.png,50,30,1,374,424,168,198,732,39.99825426109829,24.225305297603068
5715,/media/marda/TWOTB1/xBD/hurricanes/images/florence/hurricane-florence_00000346_pre_disaster.png,68,41,1,164,232,191,232,1747,68.08241187050895,33.959054501844186
5716,/media/marda/TWOTB1/xBD/hurricanes/images/florence/hurricane-florence_00000346_pre_disaster.png,20,18,1,145,165,196,214,196,17.589463815433607,14.668237851538562
5717,/media/marda/TWOTB1/xBD/hurricanes/images/florence/hurricane-florence_00000346_pre_disaster.png,19,22,1,6,25,206,228,162,19.806485958374786,10.855328386137687
5718,/media/marda/TWOTB1/xBD/hurricanes/images/florence/hurricane-florence_00000346_pre_disaster.png,53,34,1,84,137,209,243,943,56.50612796845266,22.281003381080936
5719,/media/marda/TWOTB1/xBD/hurricanes/images/florence/hurricane-florence_00000346_pre_disaster.png,95,48,1,746,841,211,259,1823,70.53986469169563,36.425895904158985
5720,/media/marda/TWOTB1/xBD/hurricanes/images/florence/hurricane-florence_00000346_pre_disaster.png,60,49,1,881,941,212,261,813,43.248855273180766,25.100011536384777
5721,/media/marda/TWOTB1/xBD/hurricanes/images/florence/hurricane-florence_00000346_pre_disaster.png,15,29,1,46,61,215,244,242,22.404767412594953,14.486847748286202
5722,/media/marda/TWOTB1/xBD/hurricanes/images/florence/hurricane-florence_00000346_pre_disaster.png,19,35,1,0,19,225,260,369,26.085864398619226,19.108986673556235
5723,/media/marda/TWOTB1/xBD/hurricanes/images/florence/hurricane-florence_00000346_pre_disaster.png,43,28,1,683,726,236,264,274,21.279440759428038,17.247109126713564
5724,/media/marda/TWOTB1/xBD/hurricanes/images/florence/hurricane-florence_00000346_pre_disaster.png,69,53,1,613,682,238,291,1608,47.17540514132634,45.47711650183675
5725,/media/marda/TWOTB1/xBD/hurricanes/images/florence/hurricane-florence_00000346_pre_disaster.png,73,30,1,499,572,240,270,867,58.48630505098446,19.89888542532438
5726,/media/marda/TWOTB1/xBD/hurricanes/images/florence/hurricane-florence_00000346_pre_disaster.png,66,35,1,433,499,247,282,954,55.64168801192475,22.733972371991385
5727,/media/marda/TWOTB1/xBD/hurricanes/images/florence/hurricane-florence_00000346_pre_disaster.png,66,34,1,370,436,262,296,936,56.160299770719284,21.984879014413632
5728,/media/marda/TWOTB1/xBD/hurricanes/images/florence/hurricane-florence_00000346_pre_disaster.png,65,45,1,297,362,268,313,1295,52.70082842531652,34.35591107296578
5729,/media/marda/TWOTB1/xBD/hurricanes/images/florence/hurricane-florence_00000346_pre_disaster.png,55,60,1,183,238,284,344,1726,61.040366821328675,40.06459243283338
5730,/media/marda/TWOTB1/xBD/hurricanes/images/florence/hurricane-florence_00000346_pre_disaster.png,38,33,1,548,586,315,348,226,21.286666128190305,14.20494632211654
5731,/media/marda/TWOTB1/xBD/hurricanes/images/florence/hurricane-florence_00000346_pre_disaster.png,25,40,1,0,25,316,356,469,27.988481912159752,22.501123429219444
5732,/media/marda/TWOTB1/xBD/hurricanes/images/florence/hurricane-florence_00000346_pre_disaster.png,44,39,1,304,348,317,356,694,33.70202871021327,27.789630913165606
5733,/media/marda/TWOTB1/xBD/hurricanes/images/florence/hurricane-florence_00000346_pre_disaster.png,103,52,1,793,896,327,379,1341,79.6382635658408,22.396608106110513
5734,/media/marda/TWOTB1/xBD/hurricanes/images/florence/hurricane-florence_00000346_pre_disaster.png,71,61,1,514,585,330,391,1413,55.35730228099196,36.279707688960585
5735,/media/marda/TWOTB1/xBD/hurricanes/images/florence/hurricane-florence_00000346_pre_disaster.png,59,39,1,765,824,352,391,536,30.118506595925048,23.369788226087486
5736,/media/marda/TWOTB1/xBD/hurricanes/images/florence/hurricane-florence_00000346_pre_disaster.png,35,28,1,369,404,356,384,222,22.719605972139714,13.099880128963145
5737,/media/marda/TWOTB1/xBD/hurricanes/images/florence/hurricane-florence_00000346_pre_disaster.png,26,40,1,0,26,362,402,526,27.137998136883816,25.722765167532195
5738,/media/marda/TWOTB1/xBD/hurricanes/images/florence/hurricane-florence_00000346_pre_disaster.png,56,46,1,400,456,377,423,843,44.04158094870558,25.278234553089945
5739,/media/marda/TWOTB1/xBD/hurricanes/images/florence/hurricane-florence_00000346_pre_disaster.png,73,68,1,316,389,390,458,1660,60.354596339881674,45.460993642024896
5740,/media/marda/TWOTB1/xBD/hurricanes/images/florence/hurricane-florence_00000346_pre_disaster.png,40,46,1,6,46,398,444,743,42.5108391917508,23.33330219312386
5741,/media/marda/TWOTB1/xBD/hurricanes/images/florence/hurricane-florence_00000346_pre_disaster.png,20,36,1,48,68,398,434,248,18.781588267371895,17.686162083722195
5742,/media/marda/TWOTB1/xBD/hurricanes/images/florence/hurricane-florence_00000346_pre_disaster.png,79,75,1,182,261,398,473,1907,87.73820741137921,31.152759940042145
5743,/media/marda/TWOTB1/xBD/hurricanes/images/florence/hurricane-florence_00000346_pre_disaster.png,51,40,1,907,958,416,456,217,25.931014128709762,13.61046987627234
5744,/media/marda/TWOTB1/xBD/hurricanes/images/florence/hurricane-florence_00000346_pre_disaster.png,75,57,1,559,634,438,495,1353,55.01477978462667,35.49810305210323
5745,/media/marda/TWOTB1/xBD/hurricanes/images/florence/hurricane-florence_00000346_pre_disaster.png,67,68,1,891,958,439,507,1234,55.40838976102805,29.737111634123927
5746,/media/marda/TWOTB1/xBD/hurricanes/images/florence/hurricane-florence_00000346_pre_disaster.png,89,69,1,478,567,467,536,1851,78.71467123689004,32.05512096832086
5747,/media/marda/TWOTB1/xBD/hurricanes/images/florence/hurricane-florence_00000346_pre_disaster.png,18,33,1,120,138,483,516,157,16.554174974602834,12.672007036336119
5748,/media/marda/TWOTB1/xBD/hurricanes/images/florence/hurricane-florence_00000346_pre_disaster.png,35,58,1,60,95,497,555,847,36.92261626797356,30.523454947349773
5749,/media/marda/TWOTB1/xBD/hurricanes/images/florence/hurricane-florence_00000346_pre_disaster.png,42,45,1,93,135,498,543,589,42.063435116139516,18.572464523692886
5750,/media/marda/TWOTB1/xBD/hurricanes/images/florence/hurricane-florence_00000346_pre_disaster.png,63,85,1,594,657,504,589,1236,71.33535086792891,30.735542234598622
5751,/media/marda/TWOTB1/xBD/hurricanes/images/florence/hurricane-florence_00000346_pre_disaster.png,86,67,1,387,473,505,572,2126,69.66823647420695,40.10597665563058
5752,/media/marda/TWOTB1/xBD/hurricanes/images/florence/hurricane-florence_00000346_pre_disaster.png,58,62,1,252,310,535,597,1243,47.32459953452751,37.13161554311253
5753,/media/marda/TWOTB1/xBD/hurricanes/images/florence/hurricane-florence_00000346_pre_disaster.png,51,53,1,412,463,580,633,694,33.07915709224044,28.003061955181895
5754,/media/marda/TWOTB1/xBD/hurricanes/images/florence/hurricane-florence_00000346_pre_disaster.png,59,78,1,147,206,582,660,1569,57.44239670032168,43.45027004446793
5755,/media/marda/TWOTB1/xBD/hurricanes/images/florence/hurricane-florence_00000346_pre_disaster.png,42,55,1,69,111,613,668,826,41.38389766566693,27.862632573070474
5756,/media/marda/TWOTB1/xBD/hurricanes/images/florence/hurricane-florence_00000346_pre_disaster.png,52,93,1,292,344,621,714,1647,70.6430994533013,35.04719476212149
5757,/media/marda/TWOTB1/xBD/hurricanes/images/florence/hurricane-florence_00000346_pre_disaster.png,67,75,1,436,503,627,702,1397,49.712753444070856,40.71214264135999
5758,/media/marda/TWOTB1/xBD/hurricanes/images/florence/hurricane-florence_00000346_pre_disaster.png,60,50,1,739,799,639,689,527,33.09226855372111,21.08399324427915
5759,/media/marda/TWOTB1/xBD/hurricanes/images/florence/hurricane-florence_00000346_pre_disaster.png,19,57,1,0,19,641,698,429,31.992514693127283,18.14616016621138
5760,/media/marda/TWOTB1/xBD/hurricanes/images/florence/hurricane-florence_00000346_pre_disaster.png,94,71,1,950,1044,653,724,2265,63.75952323639317,47.095335793003926
5761,/media/marda/TWOTB1/xBD/hurricanes/images/florence/hurricane-florence_00000346_pre_disaster.png,64,75,1,532,596,665,740,1303,52.122378893078846,34.15851893165466
5762,/media/marda/TWOTB1/xBD/hurricanes/images/florence/hurricane-florence_00000346_pre_disaster.png,71,61,1,582,653,665,726,1105,53.12167975628496,27.4553509484562
5763,/media/marda/TWOTB1/xBD/hurricanes/images/florence/hurricane-florence_00000346_pre_disaster.png,36,63,1,102,138,686,749,694,37.29270973084018,24.742279458395792
5764,/media/marda/TWOTB1/xBD/hurricanes/images/florence/hurricane-florence_00000346_pre_disaster.png,70,81,1,456,526,693,774,1536,55.06880992015032,42.50816020820605
5765,/media/marda/TWOTB1/xBD/hurricanes/images/florence/hurricane-florence_00000346_pre_disaster.png,65,92,1,314,379,709,801,1697,59.55507063179591,47.24267845247257
5766,/media/marda/TWOTB1/xBD/hurricanes/images/florence/hurricane-florence_00000346_pre_disaster.png,64,57,1,767,831,712,769,621,34.81519110555229,24.000289979272235
5767,/media/marda/TWOTB1/xBD/hurricanes/images/florence/hurricane-florence_00000346_pre_disaster.png,38,56,1,2,40,721,777,716,39.23010447833593,24.01883165064325
5768,/media/marda/TWOTB1/xBD/hurricanes/images/florence/hurricane-florence_00000346_pre_disaster.png,42,74,1,120,162,724,798,1103,45.39177379923549,34.37503559025076
5769,/media/marda/TWOTB1/xBD/hurricanes/images/florence/hurricane-florence_00000346_pre_disaster.png,56,62,1,682,738,747,809,591,34.44231141669929,23.558379259166202
5770,/media/marda/TWOTB1/xBD/hurricanes/images/florence/hurricane-florence_00000346_pre_disaster.png,103,130,1,768,871,757,887,4163,100.44700834384325,55.52554503364052
5771,/media/marda/TWOTB1/xBD/hurricanes/images/florence/hurricane-florence_00000346_pre_disaster.png,39,61,1,24,63,775,836,927,39.45444601839858,31.142182319480252
5772,/media/marda/TWOTB1/xBD/hurricanes/images/florence/hurricane-florence_00000346_pre_disaster.png,32,61,1,257,289,781,842,482,32.87421179634819,19.53131987072338
5773,/media/marda/TWOTB1/xBD/hurricanes/images/florence/hurricane-florence_00000346_pre_disaster.png,40,48,1,653,693,785,833,194,17.02720599440605,15.290883026270075
5774,/media/marda/TWOTB1/xBD/hurricanes/images/florence/hurricane-florence_00000346_pre_disaster.png,41,90,1,142,183,787,877,1420,58.33509893954063,32.50010063332747
5775,/media/marda/TWOTB1/xBD/hurricanes/images/florence/hurricane-florence_00000346_pre_disaster.png,43,63,1,220,263,795,858,677,34.40444625185717,26.284661085653138
5776,/media/marda/TWOTB1/xBD/hurricanes/images/florence/hurricane-florence_00000346_pre_disaster.png,65,69,1,692,757,795,864,878,35.69669788089904,32.3196223918632
5777,/media/marda/TWOTB1/xBD/hurricanes/images/florence/hurricane-florence_00000346_pre_disaster.png,40,67,1,184,224,806,873,764,34.527408204366296,29.33192453541495
5778,/media/marda/TWOTB1/xBD/hurricanes/images/florence/hurricane-florence_00000346_pre_disaster.png,47,69,1,507,554,818,887,861,41.69819347913347,28.05466897643292
5779,/media/marda/TWOTB1/xBD/hurricanes/images/florence/hurricane-florence_00000346_pre_disaster.png,81,84,1,963,1044,840,924,1222,51.47184503967813,31.153584644889396
5780,/media/marda/TWOTB1/xBD/hurricanes/images/florence/hurricane-florence_00000346_pre_disaster.png,19,83,1,0,19,848,931,506,45.5398015117462,16.75786863320803
5781,/media/marda/TWOTB1/xBD/hurricanes/images/florence/hurricane-florence_00000346_pre_disaster.png,54,67,1,36,90,850,917,1034,59.925121725438295,22.964608432705436
5782,/media/marda/TWOTB1/xBD/hurricanes/images/florence/hurricane-florence_00000346_pre_disaster.png,82,104,1,351,433,850,954,2398,82.78390248101942,45.035276186617374
5783,/media/marda/TWOTB1/xBD/hurricanes/images/florence/hurricane-florence_00000346_pre_disaster.png,86,79,1,717,803,872,951,1236,62.477572721904494,27.771106598914756
5784,/media/marda/TWOTB1/xBD/hurricanes/images/florence/hurricane-florence_00000346_pre_disaster.png,48,53,1,684,732,881,934,238,20.239076123534527,15.686850437782956
5785,/media/marda/TWOTB1/xBD/hurricanes/images/florence/hurricane-florence_00000346_pre_disaster.png,49,64,1,287,336,884,948,680,40.80078404504124,22.07454029574309
5786,/media/marda/TWOTB1/xBD/hurricanes/images/florence/hurricane-florence_00000346_pre_disaster.png,64,85,1,697,761,900,985,968,44.88947031066585,29.74197343735894
5787,/media/marda/TWOTB1/xBD/hurricanes/images/florence/hurricane-florence_00000346_pre_disaster.png,57,93,1,231,288,902,995,1498,56.93417908696904,42.22103158581276
5788,/media/marda/TWOTB1/xBD/hurricanes/images/florence/hurricane-florence_00000346_pre_disaster.png,51,50,1,993,1044,906,956,95,14.18794539751061,8.826800060218579
5789,/media/marda/TWOTB1/xBD/hurricanes/images/florence/hurricane-florence_00000346_pre_disaster.png,61,107,1,186,247,912,1019,1859,78.91100847736318,35.45466733763895
5790,/media/marda/TWOTB1/xBD/hurricanes/images/florence/hurricane-florence_00000346_pre_disaster.png,53,96,1,581,634,928,1024,952,63.204043672297786,19.889982616590757
5791,/media/marda/TWOTB1/xBD/hurricanes/images/florence/hurricane-florence_00000346_pre_disaster.png,60,51,1,974,1034,930,981,244,23.260379114754166,14.095831595047558
5792,/media/marda/TWOTB1/xBD/hurricanes/images/florence/hurricane-florence_00000346_pre_disaster.png,126,111,1,5,131,931,1042,5059,130.51886254721248,54.058217855913085
5793,/media/marda/TWOTB1/xBD/hurricanes/images/florence/hurricane-florence_00000346_pre_disaster.png,58,95,1,394,452,941,1036,1338,62.153273321477315,28.51747995025412
5794,/media/marda/TWOTB1/xBD/hurricanes/images/florence/hurricane-florence_00000346_pre_disaster.png,39,60,1,567,606,946,1006,252,23.925266263944426,14.112240443830576
5795,/media/marda/TWOTB1/xBD/hurricanes/images/florence/hurricane-florence_00000346_pre_disaster.png,75,85,1,649,724,946,1031,1494,48.87839342360845,40.81245596297666
5796,/media/marda/TWOTB1/xBD/hurricanes/images/florence/hurricane-florence_00000346_pre_disaster.png,100,90,1,931,1031,947,1037,2162,67.4871108384085,45.53050543572576
5797,/media/marda/TWOTB1/xBD/hurricanes/images/florence/hurricane-florence_00000346_pre_disaster.png,79,55,1,530,609,989,1044,574,62.88859841732317,13.342606499606717
5798,/media/marda/TWOTB1/xBD/hurricanes/images/florence/hurricane-florence_00000216_post_disaster.png,26,18,1,400,426,91,109,150,18.16518364929213,11.103175356063236
5799,/media/marda/TWOTB1/xBD/hurricanes/images/florence/hurricane-florence_00000216_post_disaster.png,65,38,1,564,629,114,152,776,43.81110770945383,24.085936896935245
5800,/media/marda/TWOTB1/xBD/hurricanes/images/florence/hurricane-florence_00000216_post_disaster.png,35,48,1,3,38,138,186,876,39.42404111677091,31.888066990468076
5801,/media/marda/TWOTB1/xBD/hurricanes/images/florence/hurricane-florence_00000216_post_disaster.png,42,46,1,406,448,140,186,775,44.083977823743616,23.478186492211197
5802,/media/marda/TWOTB1/xBD/hurricanes/images/florence/hurricane-florence_00000216_post_disaster.png,38,30,1,539,577,167,197,235,29.830727883505734,14.258812397237635
5803,/media/marda/TWOTB1/xBD/hurricanes/images/florence/hurricane-florence_00000216_post_disaster.png,64,62,1,573,637,192,254,1569,60.32210431392044,34.64604968537675
5804,/media/marda/TWOTB1/xBD/hurricanes/images/florence/hurricane-florence_00000216_post_disaster.png,41,64,1,103,144,317,381,792,57.8847841095469,19.91744371711002
5805,/media/marda/TWOTB1/xBD/hurricanes/images/florence/hurricane-florence_00000216_post_disaster.png,34,32,1,164,198,479,511,293,32.34711113292184,12.129636746176587
5806,/media/marda/TWOTB1/xBD/hurricanes/images/florence/hurricane-florence_00000216_post_disaster.png,42,43,1,343,385,484,527,537,29.66104973908296,24.192446641495717
5807,/media/marda/TWOTB1/xBD/hurricanes/images/florence/hurricane-florence_00000216_post_disaster.png,44,32,1,67,111,505,537,369,48.96401154839759,10.129817601625872
5808,/media/marda/TWOTB1/xBD/hurricanes/images/florence/hurricane-florence_00000216_post_disaster.png,53,79,1,426,479,521,600,1257,61.618680705212945,27.2207595706022
5809,/media/marda/TWOTB1/xBD/hurricanes/images/florence/hurricane-florence_00000216_post_disaster.png,40,40,1,266,306,524,564,306,32.84250409621125,12.466320242020966
5810,/media/marda/TWOTB1/xBD/hurricanes/images/florence/hurricane-florence_00000216_post_disaster.png,47,49,1,152,199,562,611,821,46.16105955800494,23.730009391561634
5811,/media/marda/TWOTB1/xBD/hurricanes/images/florence/hurricane-florence_00000216_post_disaster.png,44,41,1,395,439,568,609,333,28.02635150484179,15.919106101418413
5812,/media/marda/TWOTB1/xBD/hurricanes/images/florence/hurricane-florence_00000216_post_disaster.png,59,57,1,318,377,623,680,921,49.14940831126117,25.01243869569053
5813,/media/marda/TWOTB1/xBD/hurricanes/images/florence/hurricane-florence_00000216_post_disaster.png,53,39,1,229,282,668,707,437,50.24202983284251,11.601939396916036
5814,/media/marda/TWOTB1/xBD/hurricanes/images/florence/hurricane-florence_00000216_post_disaster.png,45,47,1,415,460,765,812,420,31.986453632222837,17.605617259566557
5815,/media/marda/TWOTB1/xBD/hurricanes/images/florence/hurricane-florence_00000216_post_disaster.png,51,76,1,484,535,767,843,956,51.860991524091006,24.601814437543677
5816,/media/marda/TWOTB1/xBD/hurricanes/images/florence/hurricane-florence_00000216_post_disaster.png,55,51,1,52,107,833,884,511,60.8951236410068,11.233004241276394
5817,/media/marda/TWOTB1/xBD/hurricanes/images/florence/hurricane-florence_00000216_post_disaster.png,40,66,1,293,333,975,1041,598,34.46677315057831,23.224729139264948
5818,/media/marda/TWOTB1/xBD/hurricanes/images/florence/hurricane-florence_00000173_pre_disaster.png,55,18,1,840,895,10,28,240,23.08189929368069,13.905367968152307
5819,/media/marda/TWOTB1/xBD/hurricanes/images/florence/hurricane-florence_00000173_pre_disaster.png,73,45,1,832,905,22,67,1200,44.05483481894841,36.06535974476916
5820,/media/marda/TWOTB1/xBD/hurricanes/images/florence/hurricane-florence_00000173_pre_disaster.png,38,56,1,209,247,167,223,1027,52.02236777369153,26.39312937392838
5821,/media/marda/TWOTB1/xBD/hurricanes/images/florence/hurricane-florence_00000173_pre_disaster.png,29,28,1,207,236,216,244,266,19.742275241343865,18.029142040622325
5822,/media/marda/TWOTB1/xBD/hurricanes/images/florence/hurricane-florence_00000173_pre_disaster.png,61,53,1,628,689,230,283,1217,48.760467459318264,32.89665232648906
5823,/media/marda/TWOTB1/xBD/hurricanes/images/florence/hurricane-florence_00000173_pre_disaster.png,54,20,1,952,1006,238,258,124,19.22670279325634,8.688796810972702
5824,/media/marda/TWOTB1/xBD/hurricanes/images/florence/hurricane-florence_00000173_pre_disaster.png,61,52,1,220,281,250,302,1533,55.04749936359137,36.721905051269665
5825,/media/marda/TWOTB1/xBD/hurricanes/images/florence/hurricane-florence_00000173_pre_disaster.png,49,23,1,879,928,255,278,124,13.219871722978668,12.639680632338397
5826,/media/marda/TWOTB1/xBD/hurricanes/images/florence/hurricane-florence_00000173_pre_disaster.png,48,61,1,292,340,300,361,1184,49.23831840791067,31.981663733920207
5827,/media/marda/TWOTB1/xBD/hurricanes/images/florence/hurricane-florence_00000173_pre_disaster.png,93,55,1,945,1038,313,368,1545,55.40913598761613,37.94939633389697
5828,/media/marda/TWOTB1/xBD/hurricanes/images/florence/hurricane-florence_00000173_pre_disaster.png,73,60,1,631,704,318,378,1421,52.53324212641853,37.34197449616481
5829,/media/marda/TWOTB1/xBD/hurricanes/images/florence/hurricane-florence_00000173_pre_disaster.png,89,56,1,864,953,335,391,1566,53.08922317346076,39.50664924800215
5830,/media/marda/TWOTB1/xBD/hurricanes/images/florence/hurricane-florence_00000173_pre_disaster.png,37,31,1,377,414,336,367,259,23.067194631831523,15.009298757494312
5831,/media/marda/TWOTB1/xBD/hurricanes/images/florence/hurricane-florence_00000173_pre_disaster.png,78,55,1,795,873,354,409,1278,45.005368296078046,37.656981581247805
5832,/media/marda/TWOTB1/xBD/hurricanes/images/florence/hurricane-florence_00000173_pre_disaster.png,39,24,1,770,809,377,401,86,12.02927007545204,9.473298760880185
5833,/media/marda/TWOTB1/xBD/hurricanes/images/florence/hurricane-florence_00000173_pre_disaster.png,64,63,1,690,754,398,461,1114,49.1183648279686,29.799970935171597
5834,/media/marda/TWOTB1/xBD/hurricanes/images/florence/hurricane-florence_00000173_pre_disaster.png,83,70,1,908,991,486,556,1741,51.640937258785286,44.86749906793322
5835,/media/marda/TWOTB1/xBD/hurricanes/images/florence/hurricane-florence_00000173_pre_disaster.png,72,72,1,690,762,519,591,1422,55.45208433279799,33.819641479460124
5836,/media/marda/TWOTB1/xBD/hurricanes/images/florence/hurricane-florence_00000173_pre_disaster.png,90,82,1,940,1030,590,672,1943,59.555769711703874,45.547138802897514
5837,/media/marda/TWOTB1/xBD/hurricanes/images/florence/hurricane-florence_00000173_pre_disaster.png,74,82,1,722,796,602,684,1582,55.8506896389769,40.165363489945705
5838,/media/marda/TWOTB1/xBD/hurricanes/images/florence/hurricane-florence_00000173_pre_disaster.png,76,92,1,596,672,623,715,1993,69.449739109247,38.314353832151426
5839,/media/marda/TWOTB1/xBD/hurricanes/images/florence/hurricane-florence_00000173_pre_disaster.png,46,40,1,852,898,627,667,147,15.250872275316727,12.948203655689698
5840,/media/marda/TWOTB1/xBD/hurricanes/images/florence/hurricane-florence_00000173_pre_disaster.png,46,38,1,882,928,649,687,98,14.432596847019893,9.188843350985067
5841,/media/marda/TWOTB1/xBD/hurricanes/images/florence/hurricane-florence_00000173_pre_disaster.png,59,42,1,884,943,661,703,244,24.25759635468701,13.485699872838952
5842,/media/marda/TWOTB1/xBD/hurricanes/images/florence/hurricane-florence_00000173_pre_disaster.png,82,73,1,756,838,683,756,1517,56.833197421486474,36.70038698551816
5843,/media/marda/TWOTB1/xBD/hurricanes/images/florence/hurricane-florence_00000173_pre_disaster.png,74,71,1,970,1044,686,757,1175,45.30192588686998,33.666735637524184
5844,/media/marda/TWOTB1/xBD/hurricanes/images/florence/hurricane-florence_00000173_pre_disaster.png,91,91,1,348,439,696,787,3303,78.65647711559393,56.365114456708774
5845,/media/marda/TWOTB1/xBD/hurricanes/images/florence/hurricane-florence_00000173_pre_disaster.png,54,47,1,869,923,727,774,258,20.7496407928064,16.433518901919978
5846,/media/marda/TWOTB1/xBD/hurricanes/images/florence/hurricane-florence_00000173_pre_disaster.png,43,47,1,496,539,734,781,232,22.37292388768931,13.903474989620564
5847,/media/marda/TWOTB1/xBD/hurricanes/images/florence/hurricane-florence_00000173_pre_disaster.png,67,76,1,240,307,738,814,1930,60.103212335691445,42.972711220220866
5848,/media/marda/TWOTB1/xBD/hurricanes/images/florence/hurricane-florence_00000173_pre_disaster.png,57,44,1,983,1040,747,791,143,14.654442933593698,13.066399574155817
5849,/media/marda/TWOTB1/xBD/hurricanes/images/florence/hurricane-florence_00000173_pre_disaster.png,83,79,1,775,858,759,838,1431,54.32492123249246,37.258874732769705
5850,/media/marda/TWOTB1/xBD/hurricanes/images/florence/hurricane-florence_00000173_pre_disaster.png,52,83,1,488,540,814,897,1103,52.532058189961845,28.231555461791782
5851,/media/marda/TWOTB1/xBD/hurricanes/images/florence/hurricane-florence_00000173_pre_disaster.png,53,56,1,598,651,824,880,453,28.480785586230166,21.27408141692431
5852,/media/marda/TWOTB1/xBD/hurricanes/images/florence/hurricane-florence_00000173_pre_disaster.png,79,99,1,879,958,830,929,1686,71.5450054216464,31.874750598065408
5853,/media/marda/TWOTB1/xBD/hurricanes/images/florence/hurricane-florence_00000173_pre_disaster.png,68,62,1,681,749,875,937,806,40.012179809297486,27.06799468025899
5854,/media/marda/TWOTB1/xBD/hurricanes/images/florence/hurricane-florence_00000173_pre_disaster.png,54,44,1,972,1026,879,923,96,15.149158953706758,8.472147812147867
5855,/media/marda/TWOTB1/xBD/hurricanes/images/florence/hurricane-florence_00000173_pre_disaster.png,52,48,1,959,1011,892,940,103,16.280692671140336,8.509908618008398
5856,/media/marda/TWOTB1/xBD/hurricanes/images/florence/hurricane-florence_00000173_pre_disaster.png,82,77,1,962,1044,953,1030,1133,49.64385781918776,30.467319559563006
5857,/media/marda/TWOTB1/xBD/hurricanes/images/florence/hurricane-florence_00000320_pre_disaster.png,68,70,1,335,403,97,167,2200,67.1968816997523,45.258126366722145
5858,/media/marda/TWOTB1/xBD/hurricanes/images/florence/hurricane-florence_00000320_pre_disaster.png,29,23,1,266,295,131,154,179,22.497608286977304,10.64419852068971
5859,/media/marda/TWOTB1/xBD/hurricanes/images/florence/hurricane-florence_00000320_pre_disaster.png,45,36,1,295,340,180,216,537,27.4063501189104,26.07670811502925
5860,/media/marda/TWOTB1/xBD/hurricanes/images/florence/hurricane-florence_00000320_pre_disaster.png,83,67,1,436,519,245,312,1884,57.36071285860207,44.29322621121645
5861,/media/marda/TWOTB1/xBD/hurricanes/images/florence/hurricane-florence_00000320_pre_disaster.png,61,52,1,500,561,300,352,738,43.66354726820535,22.572904822654902
5862,/media/marda/TWOTB1/xBD/hurricanes/images/florence/hurricane-florence_00000320_pre_disaster.png,52,59,1,992,1044,379,438,351,50.3838268547019,10.168565094044013
5863,/media/marda/TWOTB1/xBD/hurricanes/images/florence/hurricane-florence_00000320_pre_disaster.png,65,49,1,808,873,413,462,393,41.19636965704227,12.737022238897882
5864,/media/marda/TWOTB1/xBD/hurricanes/images/florence/hurricane-florence_00000320_pre_disaster.png,66,54,1,805,871,510,564,611,29.84180202306191,27.098013915956095
5865,/media/marda/TWOTB1/xBD/hurricanes/images/florence/hurricane-florence_00000320_pre_disaster.png,54,49,1,697,751,561,610,368,27.95906448420085,17.607664342640142
5866,/media/marda/TWOTB1/xBD/hurricanes/images/florence/hurricane-florence_00000320_pre_disaster.png,76,67,1,945,1021,633,700,888,42.30623089714628,27.70356860125413
5867,/media/marda/TWOTB1/xBD/hurricanes/images/florence/hurricane-florence_00000320_pre_disaster.png,56,44,1,972,1028,728,772,142,15.821047614964643,12.038470160745643
5868,/media/marda/TWOTB1/xBD/hurricanes/images/florence/hurricane-florence_00000214_pre_disaster.png,42,55,1,50,92,0,55,1520,56.87161277609152,38.21306546402239
5869,/media/marda/TWOTB1/xBD/hurricanes/images/florence/hurricane-florence_00000214_pre_disaster.png,42,17,1,318,360,0,17,373,30.12374731200172,16.65428131702744
5870,/media/marda/TWOTB1/xBD/hurricanes/images/florence/hurricane-florence_00000214_pre_disaster.png,35,8,1,397,432,0,8,109,20.128078593860767,7.3550810125701505
5871,/media/marda/TWOTB1/xBD/hurricanes/images/florence/hurricane-florence_00000214_pre_disaster.png,112,113,1,555,667,0,113,5598,109.68100934192987,81.67339678885804
5872,/media/marda/TWOTB1/xBD/hurricanes/images/florence/hurricane-florence_00000214_pre_disaster.png,86,15,1,835,921,0,15,447,55.21800017535442,11.301767119844719
5873,/media/marda/TWOTB1/xBD/hurricanes/images/florence/hurricane-florence_00000214_pre_disaster.png,100,63,1,814,914,20,83,2871,68.73620360387612,56.20213344705363
5874,/media/marda/TWOTB1/xBD/hurricanes/images/florence/hurricane-florence_00000214_pre_disaster.png,25,22,1,127,152,22,44,278,19.872322342399503,18.659395671879157
5875,/media/marda/TWOTB1/xBD/hurricanes/images/florence/hurricane-florence_00000214_pre_disaster.png,60,39,1,412,472,30,69,1144,42.11123163919586,36.74590717228652
5876,/media/marda/TWOTB1/xBD/hurricanes/images/florence/hurricane-florence_00000214_pre_disaster.png,23,18,1,134,157,52,70,219,18.586570956880546,15.80066189477663
5877,/media/marda/TWOTB1/xBD/hurricanes/images/florence/hurricane-florence_00000214_pre_disaster.png,55,45,1,66,121,56,101,1354,54.46968993731309,38.024392265565695
5878,/media/marda/TWOTB1/xBD/hurricanes/images/florence/hurricane-florence_00000214_pre_disaster.png,16,13,1,65,81,63,76,147,17.47192929481836,12.097680817945303
5879,/media/marda/TWOTB1/xBD/hurricanes/images/florence/hurricane-florence_00000214_pre_disaster.png,24,17,1,136,160,67,84,226,20.00620687841578,15.1396901791663
5880,/media/marda/TWOTB1/xBD/hurricanes/images/florence/hurricane-florence_00000214_pre_disaster.png,11,10,1,48,59,73,83,72,11.394975789806628,8.565302288473575
5881,/media/marda/TWOTB1/xBD/hurricanes/images/florence/hurricane-florence_00000214_pre_disaster.png,40,17,1,413,453,74,91,246,25.552591006054097,12.691355835036843
5882,/media/marda/TWOTB1/xBD/hurricanes/images/florence/hurricane-florence_00000214_pre_disaster.png,33,19,1,382,415,79,98,243,19.34402155377192,16.505093780902282
5883,/media/marda/TWOTB1/xBD/hurricanes/images/florence/hurricane-florence_00000214_pre_disaster.png,14,10,1,50,64,81,91,82,14.410017935665962,7.661125668491506
5884,/media/marda/TWOTB1/xBD/hurricanes/images/florence/hurricane-florence_00000214_pre_disaster.png,76,45,1,968,1044,91,136,1274,44.252609529184774,38.32182528146885
5885,/media/marda/TWOTB1/xBD/hurricanes/images/florence/hurricane-florence_00000214_pre_disaster.png,21,22,1,57,78,103,125,264,22.18248257372172,15.835787874631746
5886,/media/marda/TWOTB1/xBD/hurricanes/images/florence/hurricane-florence_00000214_pre_disaster.png,40,22,1,323,363,113,135,325,27.986395872958397,15.3254693415601
5887,/media/marda/TWOTB1/xBD/hurricanes/images/florence/hurricane-florence_00000214_pre_disaster.png,77,63,1,924,1001,114,177,1737,57.69138130125056,39.86671353497537
5888,/media/marda/TWOTB1/xBD/hurricanes/images/florence/hurricane-florence_00000214_pre_disaster.png,38,25,1,287,325,129,154,417,29.930556021803678,18.561264176169388
5889,/media/marda/TWOTB1/xBD/hurricanes/images/florence/hurricane-florence_00000214_pre_disaster.png,71,52,1,848,919,132,184,1231,48.12712609701064,33.67656927297651
5890,/media/marda/TWOTB1/xBD/hurricanes/images/florence/hurricane-florence_00000214_pre_disaster.png,63,36,1,776,839,160,196,740,32.097481467348906,30.09543445529406
5891,/media/marda/TWOTB1/xBD/hurricanes/images/florence/hurricane-florence_00000214_pre_disaster.png,57,37,1,305,362,170,207,1050,45.73353928435892,29.991343988411316
5892,/media/marda/TWOTB1/xBD/hurricanes/images/florence/hurricane-florence_00000214_pre_disaster.png,67,34,1,731,798,172,206,817,42.36326235313428,25.681755953276074
5893,/media/marda/TWOTB1/xBD/hurricanes/images/florence/hurricane-florence_00000214_pre_disaster.png,51,54,1,240,291,174,228,1404,52.299310266566984,36.62753377044326
5894,/media/marda/TWOTB1/xBD/hurricanes/images/florence/hurricane-florence_00000214_pre_disaster.png,99,32,1,938,1037,182,214,856,64.85098021674791,18.25167086097329
5895,/media/marda/TWOTB1/xBD/hurricanes/images/florence/hurricane-florence_00000214_pre_disaster.png,50,26,1,906,956,184,210,218,22.515794938227586,12.9633387910527
5896,/media/marda/TWOTB1/xBD/hurricanes/images/florence/hurricane-florence_00000214_pre_disaster.png,70,51,1,689,759,185,236,1304,45.61769522141063,39.2317980544829
5897,/media/marda/TWOTB1/xBD/hurricanes/images/florence/hurricane-florence_00000214_pre_disaster.png,62,36,1,641,703,199,235,722,39.50342377987898,23.9038990925643
5898,/media/marda/TWOTB1/xBD/hurricanes/images/florence/hurricane-florence_00000214_pre_disaster.png,52,27,1,887,939,200,227,208,17.792584782261343,15.557303622312297
5899,/media/marda/TWOTB1/xBD/hurricanes/images/florence/hurricane-florence_00000214_pre_disaster.png,52,22,1,908,960,205,227,138,16.987132753755642,10.93934206724761
5900,/media/marda/TWOTB1/xBD/hurricanes/images/florence/hurricane-florence_00000214_pre_disaster.png,50,35,1,607,657,210,245,494,26.574140422518454,24.715548076409977
5901,/media/marda/TWOTB1/xBD/hurricanes/images/florence/hurricane-florence_00000214_pre_disaster.png,45,28,1,733,778,215,243,236,20.19786199396352,15.383533179314384
5902,/media/marda/TWOTB1/xBD/hurricanes/images/florence/hurricane-florence_00000214_pre_disaster.png,54,39,1,651,705,239,278,630,30.40953465610211,27.540025896653383
5903,/media/marda/TWOTB1/xBD/hurricanes/images/florence/hurricane-florence_00000214_pre_disaster.png,46,31,1,702,748,239,270,269,24.27669489080866,14.779038418793562
5904,/media/marda/TWOTB1/xBD/hurricanes/images/florence/hurricane-florence_00000214_pre_disaster.png,35,38,1,93,128,241,279,688,33.16841305831069,27.278354168258137
5905,/media/marda/TWOTB1/xBD/hurricanes/images/florence/hurricane-florence_00000214_pre_disaster.png,49,47,1,10,59,253,300,1309,52.628072554150684,32.95958248845585
5906,/media/marda/TWOTB1/xBD/hurricanes/images/florence/hurricane-florence_00000214_pre_disaster.png,50,49,1,585,635,265,314,783,42.155440952364366,24.753047813560997
5907,/media/marda/TWOTB1/xBD/hurricanes/images/florence/hurricane-florence_00000214_pre_disaster.png,45,49,1,427,472,268,317,736,42.214731645037716,23.27364587565494
5908,/media/marda/TWOTB1/xBD/hurricanes/images/florence/hurricane-florence_00000214_pre_disaster.png,116,88,1,728,844,275,363,4551,83.54558440985221,72.50931290486139
5909,/media/marda/TWOTB1/xBD/hurricanes/images/florence/hurricane-florence_00000214_pre_disaster.png,59,81,1,384,443,276,357,1844,79.17022171545034,31.019886093789633
5910,/media/marda/TWOTB1/xBD/hurricanes/images/florence/hurricane-florence_00000214_pre_disaster.png,40,27,1,616,656,276,303,213,19.284348543290292,14.758529099734833
5911,/media/marda/TWOTB1/xBD/hurricanes/images/florence/hurricane-florence_00000214_pre_disaster.png,52,57,1,491,543,277,334,1032,50.69276051549087,27.11585543033938
5912,/media/marda/TWOTB1/xBD/hurricanes/images/florence/hurricane-florence_00000214_pre_disaster.png,50,78,1,218,268,322,400,1697,71.33632674521947,31.586800542078795
5913,/media/marda/TWOTB1/xBD/hurricanes/images/florence/hurricane-florence_00000214_pre_disaster.png,60,55,1,627,687,344,399,995,42.0598055035298,31.349151366438797
5914,/media/marda/TWOTB1/xBD/hurricanes/images/florence/hurricane-florence_00000214_pre_disaster.png,56,67,1,516,572,365,432,1401,58.03830532980255,31.805948961251993
5915,/media/marda/TWOTB1/xBD/hurricanes/images/florence/hurricane-florence_00000214_pre_disaster.png,74,96,1,744,818,371,467,2120,90.64358931319649,31.172877912476533
5916,/media/marda/TWOTB1/xBD/hurricanes/images/florence/hurricane-florence_00000214_pre_disaster.png,57,38,1,987,1044,374,412,314,25.859939915880947,16.536055189897116
5917,/media/marda/TWOTB1/xBD/hurricanes/images/florence/hurricane-florence_00000214_pre_disaster.png,77,63,1,914,991,381,444,1384,49.54830735333744,37.28126697338107
5918,/media/marda/TWOTB1/xBD/hurricanes/images/florence/hurricane-florence_00000214_pre_disaster.png,50,35,1,692,742,395,430,246,22.00972799966592,14.969709368721022
5919,/media/marda/TWOTB1/xBD/hurricanes/images/florence/hurricane-florence_00000214_pre_disaster.png,30,52,1,0,30,398,450,715,38.01912067794251,26.27551161451552
5920,/media/marda/TWOTB1/xBD/hurricanes/images/florence/hurricane-florence_00000214_pre_disaster.png,46,59,1,271,317,401,460,996,40.97498930599128,32.46162470800155
5921,/media/marda/TWOTB1/xBD/hurricanes/images/florence/hurricane-florence_00000214_pre_disaster.png,12,31,1,40,52,416,447,108,15.549873601850607,9.382282223328408
5922,/media/marda/TWOTB1/xBD/hurricanes/images/florence/hurricane-florence_00000214_pre_disaster.png,82,56,1,628,710,422,478,1615,59.44244351106756,35.32780670072915
5923,/media/marda/TWOTB1/xBD/hurricanes/images/florence/hurricane-florence_00000214_pre_disaster.png,47,43,1,534,581,426,469,517,26.69508693795264,25.74074374877922
5924,/media/marda/TWOTB1/xBD/hurricanes/images/florence/hurricane-florence_00000214_pre_disaster.png,20,32,1,2,22,439,471,200,19.745530103566665,13.583682892689403
5925,/media/marda/TWOTB1/xBD/hurricanes/images/florence/hurricane-florence_00000214_pre_disaster.png,69,48,1,688,757,440,488,867,42.94469711380286,26.606038954141344
5926,/media/marda/TWOTB1/xBD/hurricanes/images/florence/hurricane-florence_00000214_pre_disaster.png,37,73,1,56,93,442,515,1320,61.323298696300924,30.273890645550757
5927,/media/marda/TWOTB1/xBD/hurricanes/images/florence/hurricane-florence_00000214_pre_disaster.png,12,30,1,23,35,450,480,108,13.54845613835007,10.714929147576044
5928,/media/marda/TWOTB1/xBD/hurricanes/images/florence/hurricane-florence_00000214_pre_disaster.png,40,65,1,172,212,466,531,1096,49.539398973628444,29.463621109517064
5929,/media/marda/TWOTB1/xBD/hurricanes/images/florence/hurricane-florence_00000214_pre_disaster.png,74,57,1,648,722,471,528,1258,51.483693194753826,32.431804895110126
5930,/media/marda/TWOTB1/xBD/hurricanes/images/florence/hurricane-florence_00000214_pre_disaster.png,48,52,1,546,594,474,526,676,36.01476495903142,24.99032145549896
5931,/media/marda/TWOTB1/xBD/hurricanes/images/florence/hurricane-florence_00000214_pre_disaster.png,64,44,1,980,1044,484,528,560,30.768978815810243,24.0599664058067
5932,/media/marda/TWOTB1/xBD/hurricanes/images/florence/hurricane-florence_00000214_pre_disaster.png,58,83,1,294,352,487,570,1831,70.35572810373633,34.703417566925225
5933,/media/marda/TWOTB1/xBD/hurricanes/images/florence/hurricane-florence_00000214_pre_disaster.png,61,70,1,439,500,487,557,1386,52.71549552560254,36.90962175388974
5934,/media/marda/TWOTB1/xBD/hurricanes/images/florence/hurricane-florence_00000214_pre_disaster.png,37,47,1,417,454,495,542,383,27.559580802495415,18.331052408134525
5935,/media/marda/TWOTB1/xBD/hurricanes/images/florence/hurricane-florence_00000214_pre_disaster.png,44,46,1,495,539,499,545,479,26.471647034836792,23.981717453649225
5936,/media/marda/TWOTB1/xBD/hurricanes/images/florence/hurricane-florence_00000214_pre_disaster.png,38,42,1,174,212,522,564,486,33.92391047195134,18.82484226245073
5937,/media/marda/TWOTB1/xBD/hurricanes/images/florence/hurricane-florence_00000214_pre_disaster.png,53,57,1,403,456,533,590,901,36.60413092248239,33.3559243978861
5938,/media/marda/TWOTB1/xBD/hurricanes/images/florence/hurricane-florence_00000214_pre_disaster.png,38,45,1,181,219,548,593,566,34.84152824969414,21.53507319391662
5939,/media/marda/TWOTB1/xBD/hurricanes/images/florence/hurricane-florence_00000214_pre_disaster.png,74,54,1,961,1035,553,607,779,35.08105141638889,29.389061018102655
5940,/media/marda/TWOTB1/xBD/hurricanes/images/florence/hurricane-florence_00000214_pre_disaster.png,55,60,1,653,708,558,618,736,37.961495387530825,25.88206695149378
5941,/media/marda/TWOTB1/xBD/hurricanes/images/florence/hurricane-florence_00000214_pre_disaster.png,38,47,1,188,226,572,619,606,33.99256339715477,23.419799023072734
5942,/media/marda/TWOTB1/xBD/hurricanes/images/florence/hurricane-florence_00000214_pre_disaster.png,45,47,1,240,285,588,635,669,39.23826735637576,22.537038099165034
5943,/media/marda/TWOTB1/xBD/hurricanes/images/florence/hurricane-florence_00000214_pre_disaster.png,42,35,1,846,888,590,625,68,9.852632352540299,9.436274836210513
5944,/media/marda/TWOTB1/xBD/hurricanes/images/florence/hurricane-florence_00000214_pre_disaster.png,75,57,1,851,926,599,656,929,43.88315743883872,27.730551112887404
5945,/media/marda/TWOTB1/xBD/hurricanes/images/florence/hurricane-florence_00000214_pre_disaster.png,12,39,1,90,102,613,652,117,15.275373144863632,10.18250247302953
5946,/media/marda/TWOTB1/xBD/hurricanes/images/florence/hurricane-florence_00000214_pre_disaster.png,51,59,1,430,481,613,672,800,36.076367790791416,29.338629603707588
5947,/media/marda/TWOTB1/xBD/hurricanes/images/florence/hurricane-florence_00000214_pre_disaster.png,42,53,1,116,158,618,671,739,40.13381954847166,24.23412726063491
5948,/media/marda/TWOTB1/xBD/hurricanes/images/florence/hurricane-florence_00000214_pre_disaster.png,54,52,1,990,1044,621,673,252,28.835565559554386,12.445971121509201
5949,/media/marda/TWOTB1/xBD/hurricanes/images/florence/hurricane-florence_00000214_pre_disaster.png,72,62,1,678,750,622,684,1047,50.372243520164425,27.59252378509818
5950,/media/marda/TWOTB1/xBD/hurricanes/images/florence/hurricane-florence_00000214_pre_disaster.png,31,47,1,344,375,652,699,298,22.916050871602042,17.323736696076352
5951,/media/marda/TWOTB1/xBD/hurricanes/images/florence/hurricane-florence_00000214_pre_disaster.png,69,74,1,720,789,655,729,1325,49.588014681959976,35.42374469461648
5952,/media/marda/TWOTB1/xBD/hurricanes/images/florence/hurricane-florence_00000214_pre_disaster.png,66,61,1,882,948,657,718,727,35.612688172027084,27.241981899330877
5953,/media/marda/TWOTB1/xBD/hurricanes/images/florence/hurricane-florence_00000214_pre_disaster.png,71,58,1,589,660,660,718,1147,53.94507087706949,27.99297034352695
5954,/media/marda/TWOTB1/xBD/hurricanes/images/florence/hurricane-florence_00000214_pre_disaster.png,51,58,1,239,290,686,744,950,44.40414128430814,28.510791925055027
5955,/media/marda/TWOTB1/xBD/hurricanes/images/florence/hurricane-florence_00000214_pre_disaster.png,44,76,1,324,368,688,764,961,50.317024359248144,25.497609514955826
5956,/media/marda/TWOTB1/xBD/hurricanes/images/florence/hurricane-florence_00000214_pre_disaster.png,39,70,1,151,190,696,766,858,44.347723464842936,26.147418526504385
5957,/media/marda/TWOTB1/xBD/hurricanes/images/florence/hurricane-florence_00000214_pre_disaster.png,26,45,1,302,328,698,743,144,17.39061512536953,11.167502428902363
5958,/media/marda/TWOTB1/xBD/hurricanes/images/florence/hurricane-florence_00000214_pre_disaster.png,69,65,1,894,963,707,772,776,37.00668086676028,27.818551179742403
5959,/media/marda/TWOTB1/xBD/hurricanes/images/florence/hurricane-florence_00000214_pre_disaster.png,35,66,1,123,158,711,777,754,40.59131375399856,24.680062533598107
5960,/media/marda/TWOTB1/xBD/hurricanes/images/florence/hurricane-florence_00000214_pre_disaster.png,38,67,1,228,266,729,796,710,37.27835853582874,26.011731318530803
5961,/media/marda/TWOTB1/xBD/hurricanes/images/florence/hurricane-florence_00000214_pre_disaster.png,23,40,1,267,290,729,769,145,16.704304492061016,11.66137071555665
5962,/media/marda/TWOTB1/xBD/hurricanes/images/florence/hurricane-florence_00000214_pre_disaster.png,27,56,1,66,93,735,791,536,27.765688851930165,25.701300204923527
5963,/media/marda/TWOTB1/xBD/hurricanes/images/florence/hurricane-florence_00000214_pre_disaster.png,76,54,1,726,802,737,791,566,52.2837411524595,16.04088169139763
5964,/media/marda/TWOTB1/xBD/hurricanes/images/florence/hurricane-florence_00000214_pre_disaster.png,52,75,1,7,59,743,818,1316,57.83517703240103,34.400961802899914
5965,/media/marda/TWOTB1/xBD/hurricanes/images/florence/hurricane-florence_00000214_pre_disaster.png,35,73,1,307,342,748,821,569,50.153048490731294,15.15393843557518
5966,/media/marda/TWOTB1/xBD/hurricanes/images/florence/hurricane-florence_00000214_pre_disaster.png,68,67,1,910,978,755,822,868,37.774655917267346,30.58553921276449
5967,/media/marda/TWOTB1/xBD/hurricanes/images/florence/hurricane-florence_00000214_pre_disaster.png,34,50,1,261,295,758,808,358,26.4177856651176,18.121256307465153
5968,/media/marda/TWOTB1/xBD/hurricanes/images/florence/hurricane-florence_00000214_pre_disaster.png,51,78,1,233,284,770,848,1290,52.188754485610545,32.86375693476311
5969,/media/marda/TWOTB1/xBD/hurricanes/images/florence/hurricane-florence_00000214_pre_disaster.png,56,68,1,618,674,771,839,891,41.299003648564764,28.525334210546532
5970,/media/marda/TWOTB1/xBD/hurricanes/images/florence/hurricane-florence_00000214_pre_disaster.png,18,43,1,53,71,784,827,180,18.399688239290995,12.906869301501137
5971,/media/marda/TWOTB1/xBD/hurricanes/images/florence/hurricane-florence_00000214_pre_disaster.png,37,76,1,168,205,795,871,849,46.43212317217672,24.597901759423937
5972,/media/marda/TWOTB1/xBD/hurricanes/images/florence/hurricane-florence_00000214_pre_disaster.png,68,65,1,763,831,796,861,803,38.35981348197965,27.897036107564357
5973,/media/marda/TWOTB1/xBD/hurricanes/images/florence/hurricane-florence_00000214_pre_disaster.png,57,74,1,721,778,812,886,837,43.320759210783834,25.678353902666785
5974,/media/marda/TWOTB1/xBD/hurricanes/images/florence/hurricane-florence_00000214_pre_disaster.png,53,73,1,255,308,819,892,1065,44.84438007661275,32.6552217254346
5975,/media/marda/TWOTB1/xBD/hurricanes/images/florence/hurricane-florence_00000214_pre_disaster.png,58,66,1,830,888,869,935,590,33.95724168891843,22.922517089943554
5976,/media/marda/TWOTB1/xBD/hurricanes/images/florence/hurricane-florence_00000214_pre_disaster.png,65,81,1,745,810,884,965,1165,47.26373748673291,33.32300729673574
5977,/media/marda/TWOTB1/xBD/hurricanes/images/florence/hurricane-florence_00000214_pre_disaster.png,47,79,1,425,472,899,978,711,49.07629103556632,21.335797391658964
5978,/media/marda/TWOTB1/xBD/hurricanes/images/florence/hurricane-florence_00000214_pre_disaster.png,51,59,1,788,839,912,971,297,22.812596569761897,17.220560322827094
5979,/media/marda/TWOTB1/xBD/hurricanes/images/florence/hurricane-florence_00000214_pre_disaster.png,104,78,1,932,1036,914,992,1851,71.91707225364395,33.68293262652469
5980,/media/marda/TWOTB1/xBD/hurricanes/images/florence/hurricane-florence_00000214_pre_disaster.png,30,56,1,40,70,916,972,458,31.162720451663105,19.21116823071669
5981,/media/marda/TWOTB1/xBD/hurricanes/images/florence/hurricane-florence_00000214_pre_disaster.png,56,80,1,661,717,924,1004,910,45.69903460913822,26.257540191920718
5982,/media/marda/TWOTB1/xBD/hurricanes/images/florence/hurricane-florence_00000214_pre_disaster.png,40,67,1,323,363,940,1007,570,29.584433091243067,25.485130604334607
5983,/media/marda/TWOTB1/xBD/hurricanes/images/florence/hurricane-florence_00000214_pre_disaster.png,20,63,1,76,96,948,1011,352,26.325978947589988,17.9123399744461
5984,/media/marda/TWOTB1/xBD/hurricanes/images/florence/hurricane-florence_00000214_pre_disaster.png,50,67,1,195,245,949,1016,1007,45.39255656110485,29.664682558408366
5985,/media/marda/TWOTB1/xBD/hurricanes/images/florence/hurricane-florence_00000214_pre_disaster.png,39,68,1,286,325,950,1018,642,31.480710785107043,26.898410543604143
5986,/media/marda/TWOTB1/xBD/hurricanes/images/florence/hurricane-florence_00000214_pre_disaster.png,50,61,1,779,829,952,1013,332,25.435586667670286,17.401044624095707
5987,/media/marda/TWOTB1/xBD/hurricanes/images/florence/hurricane-florence_00000214_pre_disaster.png,80,70,1,964,1044,954,1024,992,42.481418559295996,30.392580322544617
5988,/media/marda/TWOTB1/xBD/hurricanes/images/florence/hurricane-florence_00000214_pre_disaster.png,56,68,1,805,861,970,1038,493,33.086680033169955,19.90982454084166
5989,/media/marda/TWOTB1/xBD/hurricanes/images/florence/hurricane-florence_00000214_pre_disaster.png,55,62,1,646,701,980,1042,371,33.797065502469444,15.177717088655584
5990,/media/marda/TWOTB1/xBD/hurricanes/images/florence/hurricane-florence_00000214_pre_disaster.png,49,51,1,870,919,993,1044,124,15.090815014549522,10.872301890516091
5991,/media/marda/TWOTB1/xBD/hurricanes/images/florence/hurricane-florence_00000011_pre_disaster.png,58,21,1,152,210,0,21,649,48.1503921344392,19.199898742305933
5992,/media/marda/TWOTB1/xBD/hurricanes/images/florence/hurricane-florence_00000011_pre_disaster.png,71,36,1,429,500,0,36,1124,49.19475105294225,31.049725163967786
5993,/media/marda/TWOTB1/xBD/hurricanes/images/florence/hurricane-florence_00000011_pre_disaster.png,34,8,1,483,517,0,8,68,14.032289904255167,7.384264756527598
5994,/media/marda/TWOTB1/xBD/hurricanes/images/florence/hurricane-florence_00000011_pre_disaster.png,73,46,1,563,636,0,46,1257,44.753879221252085,37.38711643441745
5995,/media/marda/TWOTB1/xBD/hurricanes/images/florence/hurricane-florence_00000011_pre_disaster.png,57,14,1,597,654,0,14,238,27.94392644442717,13.075054266525854
5996,/media/marda/TWOTB1/xBD/hurricanes/images/florence/hurricane-florence_00000011_pre_disaster.png,21,17,1,116,137,13,30,173,15.954059341804108,14.527923444124749
5997,/media/marda/TWOTB1/xBD/hurricanes/images/florence/hurricane-florence_00000011_pre_disaster.png,125,97,1,628,753,13,110,4307,102.74957587442309,56.11637393825669
5998,/media/marda/TWOTB1/xBD/hurricanes/images/florence/hurricane-florence_00000011_pre_disaster.png,66,49,1,406,472,17,66,1290,44.24471042757183,39.10452549495294
5999,/media/marda/TWOTB1/xBD/hurricanes/images/florence/hurricane-florence_00000011_pre_disaster.png,73,55,1,529,602,26,81,1513,55.16048247134986,36.167219384231856
6000,/media/marda/TWOTB1/xBD/hurricanes/images/florence/hurricane-florence_00000011_pre_disaster.png,62,52,1,382,444,43,95,1260,48.967782932729584,34.282261346327566
6001,/media/marda/TWOTB1/xBD/hurricanes/images/florence/hurricane-florence_00000011_pre_disaster.png,63,82,1,70,133,55,137,2745,84.99087563864411,53.17976931089666
6002,/media/marda/TWOTB1/xBD/hurricanes/images/florence/hurricane-florence_00000011_pre_disaster.png,68,54,1,349,417,70,124,1439,53.720804207311794,35.50899279082663
6003,/media/marda/TWOTB1/xBD/hurricanes/images/florence/hurricane-florence_00000011_pre_disaster.png,68,51,1,479,547,89,140,1247,48.76746677383669,34.07760752076117
6004,/media/marda/TWOTB1/xBD/hurricanes/images/florence/hurricane-florence_00000011_pre_disaster.png,70,56,1,317,387,98,154,1415,57.387576303150745,32.94697421404676
6005,/media/marda/TWOTB1/xBD/hurricanes/images/florence/hurricane-florence_00000011_pre_disaster.png,66,59,1,223,289,108,167,1517,57.5848799343737,35.09767756661888
6006,/media/marda/TWOTB1/xBD/hurricanes/images/florence/hurricane-florence_00000011_pre_disaster.png,73,57,1,447,520,113,170,1645,54.18726334382709,39.66310131648111
6007,/media/marda/TWOTB1/xBD/hurricanes/images/florence/hurricane-florence_00000011_pre_disaster.png,64,47,1,296,360,130,177,1228,44.580442995647836,36.7679373846642
6008,/media/marda/TWOTB1/xBD/hurricanes/images/florence/hurricane-florence_00000011_pre_disaster.png,70,53,1,421,491,143,196,1400,52.81956502494081,34.92544244770404
6009,/media/marda/TWOTB1/xBD/hurricanes/images/florence/hurricane-florence_00000011_pre_disaster.png,69,58,1,263,332,151,209,1621,56.598018376923164,37.65702210075237
6010,/media/marda/TWOTB1/xBD/hurricanes/images/florence/hurricane-florence_00000011_pre_disaster.png,69,57,1,392,461,175,232,1408,55.17900580986003,33.92891147588177
6011,/media/marda/TWOTB1/xBD/hurricanes/images/florence/hurricane-florence_00000011_pre_disaster.png,64,56,1,237,301,183,239,1525,55.39580534756867,36.18629610484966
6012,/media/marda/TWOTB1/xBD/hurricanes/images/florence/hurricane-florence_00000011_pre_disaster.png,50,47,1,141,191,187,234,1224,42.11854905034,38.471822381623625
6013,/media/marda/TWOTB1/xBD/hurricanes/images/florence/hurricane-florence_00000011_pre_disaster.png,62,27,1,967,1029,190,217,244,25.723569200990763,12.686563280000572
6014,/media/marda/TWOTB1/xBD/hurricanes/images/florence/hurricane-florence_00000011_pre_disaster.png,66,56,1,363,429,203,259,1359,46.032172849342416,38.773538498497956
6015,/media/marda/TWOTB1/xBD/hurricanes/images/florence/hurricane-florence_00000011_pre_disaster.png,152,125,1,786,938,215,340,6463,117.64897094548334,74.00072649505273
6016,/media/marda/TWOTB1/xBD/hurricanes/images/florence/hurricane-florence_00000011_pre_disaster.png,62,63,1,105,167,226,289,1797,49.509125454175695,47.511465946832935
6017,/media/marda/TWOTB1/xBD/hurricanes/images/florence/hurricane-florence_00000011_pre_disaster.png,52,60,1,15,67,230,290,1453,56.84896348609323,34.16436787520257
6018,/media/marda/TWOTB1/xBD/hurricanes/images/florence/hurricane-florence_00000011_pre_disaster.png,59,52,1,337,396,230,282,1076,43.376558871418936,32.79721553573834
6019,/media/marda/TWOTB1/xBD/hurricanes/images/florence/hurricane-florence_00000011_pre_disaster.png,69,70,1,161,230,259,329,2042,53.83850592181586,50.23396859324751
6020,/media/marda/TWOTB1/xBD/hurricanes/images/florence/hurricane-florence_00000011_pre_disaster.png,48,55,1,67,115,260,315,1837,50.18996360510317,48.191681686677484
6021,/media/marda/TWOTB1/xBD/hurricanes/images/florence/hurricane-florence_00000011_pre_disaster.png,67,60,1,304,371,261,321,1433,51.07793936587221,37.50035296138306
6022,/media/marda/TWOTB1/xBD/hurricanes/images/florence/hurricane-florence_00000011_pre_disaster.png,106,120,1,78,184,294,414,4715,128.52431985295652,50.616666253808695
6023,/media/marda/TWOTB1/xBD/hurricanes/images/florence/hurricane-florence_00000011_pre_disaster.png,124,130,1,182,306,327,457,5209,145.1919913478382,48.12215795133465
6024,/media/marda/TWOTB1/xBD/hurricanes/images/florence/hurricane-florence_00000011_pre_disaster.png,76,62,1,968,1044,335,397,1103,43.37901454704127,35.65524080618991
6025,/media/marda/TWOTB1/xBD/hurricanes/images/florence/hurricane-florence_00000011_pre_disaster.png,123,100,1,705,828,350,450,4116,99.2705334542035,55.20014850545893
6026,/media/marda/TWOTB1/xBD/hurricanes/images/florence/hurricane-florence_00000011_pre_disaster.png,48,61,1,0,48,359,420,1788,49.076504034619994,47.925413608799026
6027,/media/marda/TWOTB1/xBD/hurricanes/images/florence/hurricane-florence_00000011_pre_disaster.png,93,53,1,938,1031,378,431,1211,50.095499066450685,32.83033232935504
6028,/media/marda/TWOTB1/xBD/hurricanes/images/florence/hurricane-florence_00000011_pre_disaster.png,64,73,1,39,103,383,456,2268,58.282047652708236,51.02326451075685
6029,/media/marda/TWOTB1/xBD/hurricanes/images/florence/hurricane-florence_00000011_pre_disaster.png,87,64,1,898,985,400,464,1395,45.71250798781686,40.900932972117786
6030,/media/marda/TWOTB1/xBD/hurricanes/images/florence/hurricane-florence_00000011_pre_disaster.png,69,81,1,139,208,424,505,2205,60.07931042921706,48.17484327832292
6031,/media/marda/TWOTB1/xBD/hurricanes/images/florence/hurricane-florence_00000011_pre_disaster.png,102,67,1,937,1039,445,512,1594,59.25610264758346,38.03636302647473
6032,/media/marda/TWOTB1/xBD/hurricanes/images/florence/hurricane-florence_00000011_pre_disaster.png,63,79,1,101,164,467,546,2030,56.30682902779249,47.22090434731295
6033,/media/marda/TWOTB1/xBD/hurricanes/images/florence/hurricane-florence_00000011_pre_disaster.png,56,68,1,3,59,501,569,2192,59.18266649090649,48.48974969279637
6034,/media/marda/TWOTB1/xBD/hurricanes/images/florence/hurricane-florence_00000011_pre_disaster.png,45,66,1,65,110,507,573,1435,46.4978229482111,39.93138074147207
6035,/media/marda/TWOTB1/xBD/hurricanes/images/florence/hurricane-florence_00000011_pre_disaster.png,87,73,1,798,885,514,587,1459,46.4245088288687,41.938419938428034
6036,/media/marda/TWOTB1/xBD/hurricanes/images/florence/hurricane-florence_00000011_pre_disaster.png,54,41,1,762,816,543,584,233,23.535431129055837,13.243237509610294
6037,/media/marda/TWOTB1/xBD/hurricanes/images/florence/hurricane-florence_00000011_pre_disaster.png,78,50,1,865,943,560,610,1100,49.72931340210406,30.118384217852
6038,/media/marda/TWOTB1/xBD/hurricanes/images/florence/hurricane-florence_00000011_pre_disaster.png,49,44,1,995,1044,603,647,94,17.068949094943367,8.463219165912896
6039,/media/marda/TWOTB1/xBD/hurricanes/images/florence/hurricane-florence_00000011_pre_disaster.png,79,66,1,807,886,622,688,743,53.30909966056682,19.43781614190354
6040,/media/marda/TWOTB1/xBD/hurricanes/images/florence/hurricane-florence_00000011_pre_disaster.png,77,66,1,954,1031,623,689,1429,48.42548584578425,39.22411527084506
6041,/media/marda/TWOTB1/xBD/hurricanes/images/florence/hurricane-florence_00000011_pre_disaster.png,68,52,1,762,830,624,676,536,37.722571128497385,19.224958192933947
6042,/media/marda/TWOTB1/xBD/hurricanes/images/florence/hurricane-florence_00000011_pre_disaster.png,83,71,1,822,905,651,722,1038,55.760490017014064,24.71243808659493
6043,/media/marda/TWOTB1/xBD/hurricanes/images/florence/hurricane-florence_00000011_pre_disaster.png,77,96,1,69,146,652,748,2654,67.9014993191704,52.12831743264113
6044,/media/marda/TWOTB1/xBD/hurricanes/images/florence/hurricane-florence_00000011_pre_disaster.png,61,53,1,733,794,664,717,477,28.508495279836872,22.706667709834758
6045,/media/marda/TWOTB1/xBD/hurricanes/images/florence/hurricane-florence_00000011_pre_disaster.png,72,68,1,849,921,673,741,813,44.2938300207866,24.562016772969955
6046,/media/marda/TWOTB1/xBD/hurricanes/images/florence/hurricane-florence_00000011_pre_disaster.png,84,75,1,697,781,683,758,1373,55.75307684004466,32.69704107622052
6047,/media/marda/TWOTB1/xBD/hurricanes/images/florence/hurricane-florence_00000011_pre_disaster.png,51,42,1,896,947,694,736,106,12.56771056648782,11.287654392433716
6048,/media/marda/TWOTB1/xBD/hurricanes/images/florence/hurricane-florence_00000011_pre_disaster.png,77,75,1,674,751,703,778,1046,58.93469359602579,23.71803991456136
6049,/media/marda/TWOTB1/xBD/hurricanes/images/florence/hurricane-florence_00000011_pre_disaster.png,68,63,1,872,940,705,768,574,36.12686705968268,21.0677939274959
6050,/media/marda/TWOTB1/xBD/hurricanes/images/florence/hurricane-florence_00000011_pre_disaster.png,86,76,1,891,977,718,794,935,58.80173643173184,21.220871962360246
6051,/media/marda/TWOTB1/xBD/hurricanes/images/florence/hurricane-florence_00000011_pre_disaster.png,80,72,1,762,842,728,800,874,56.08956471785312,21.20174614179799
6052,/media/marda/TWOTB1/xBD/hurricanes/images/florence/hurricane-florence_00000011_pre_disaster.png,73,66,1,921,994,744,810,648,39.17425463106327,22.079858026009486
6053,/media/marda/TWOTB1/xBD/hurricanes/images/florence/hurricane-florence_00000011_pre_disaster.png,79,76,1,783,862,748,824,1036,53.66931499314964,25.661393554996273
6054,/media/marda/TWOTB1/xBD/hurricanes/images/florence/hurricane-florence_00000011_pre_disaster.png,67,66,1,660,727,752,818,794,42.49239874268187,25.428535697390014
6055,/media/marda/TWOTB1/xBD/hurricanes/images/florence/hurricane-florence_00000011_pre_disaster.png,81,83,1,807,888,767,850,1141,60.04961252405151,25.529649926869737
6056,/media/marda/TWOTB1/xBD/hurricanes/images/florence/hurricane-florence_00000011_pre_disaster.png,87,81,1,955,1042,777,858,1378,48.563496378881744,38.1878708211584
6057,/media/marda/TWOTB1/xBD/hurricanes/images/florence/hurricane-florence_00000011_pre_disaster.png,81,83,1,832,913,790,873,945,59.44157842269044,22.557389158622676
6058,/media/marda/TWOTB1/xBD/hurricanes/images/florence/hurricane-florence_00000011_pre_disaster.png,71,75,1,745,816,798,873,726,50.65614124002948,19.67940790417714
6059,/media/marda/TWOTB1/xBD/hurricanes/images/florence/hurricane-florence_00000011_pre_disaster.png,85,81,1,855,940,815,896,1091,55.748206717262214,26.42978224670074
6060,/media/marda/TWOTB1/xBD/hurricanes/images/florence/hurricane-florence_00000011_pre_disaster.png,77,84,1,765,842,819,903,1015,58.855478192228716,23.09397675171547
6061,/media/marda/TWOTB1/xBD/hurricanes/images/florence/hurricane-florence_00000011_pre_disaster.png,71,79,1,663,734,841,920,874,53.49319257481899,21.80269926094103
6062,/media/marda/TWOTB1/xBD/hurricanes/images/florence/hurricane-florence_00000011_pre_disaster.png,72,77,1,787,859,847,924,776,49.730115082070874,21.00607521294562
6063,/media/marda/TWOTB1/xBD/hurricanes/images/florence/hurricane-florence_00000011_pre_disaster.png,115,124,1,391,506,859,983,3049,125.84925148338843,32.31257014378149
6064,/media/marda/TWOTB1/xBD/hurricanes/images/florence/hurricane-florence_00000011_pre_disaster.png,78,79,1,811,889,866,945,897,53.87694059162777,22.218332158527694
6065,/media/marda/TWOTB1/xBD/hurricanes/images/florence/hurricane-florence_00000011_pre_disaster.png,71,73,1,684,755,868,941,882,46.68130379526153,25.349574567659822
6066,/media/marda/TWOTB1/xBD/hurricanes/images/florence/hurricane-florence_00000011_pre_disaster.png,81,78,1,909,990,882,960,788,51.11995081500533,20.562875454214748
6067,/media/marda/TWOTB1/xBD/hurricanes/images/florence/hurricane-florence_00000011_pre_disaster.png,68,75,1,707,775,889,964,659,44.927286794979516,19.61133769275327
6068,/media/marda/TWOTB1/xBD/hurricanes/images/florence/hurricane-florence_00000011_pre_disaster.png,83,79,1,889,972,905,984,817,53.40652375004533,20.40790315102272
6069,/media/marda/TWOTB1/xBD/hurricanes/images/florence/hurricane-florence_00000011_pre_disaster.png,70,79,1,730,800,910,989,704,51.03168035900413,18.428003200496438
6070,/media/marda/TWOTB1/xBD/hurricanes/images/florence/hurricane-florence_00000011_pre_disaster.png,65,74,1,979,1044,914,988,561,37.01101360934444,20.108586185463608
6071,/media/marda/TWOTB1/xBD/hurricanes/images/florence/hurricane-florence_00000011_pre_disaster.png,82,80,1,867,949,926,1006,974,49.534565076943835,26.239955138867217
6072,/media/marda/TWOTB1/xBD/hurricanes/images/florence/hurricane-florence_00000011_pre_disaster.png,74,80,1,755,829,931,1011,884,49.81221459977258,24.383211183225686
6073,/media/marda/TWOTB1/xBD/hurricanes/images/florence/hurricane-florence_00000011_pre_disaster.png,76,82,1,660,736,947,1029,1109,49.609380402029736,30.59415070648573
6074,/media/marda/TWOTB1/xBD/hurricanes/images/florence/hurricane-florence_00000011_pre_disaster.png,70,64,1,958,1028,948,1012,467,28.321255225682595,21.830216572088126
6075,/media/marda/TWOTB1/xBD/hurricanes/images/florence/hurricane-florence_00000011_pre_disaster.png,86,86,1,849,935,953,1039,1094,58.51423923295579,24.950399264819083
6076,/media/marda/TWOTB1/xBD/hurricanes/images/florence/hurricane-florence_00000011_pre_disaster.png,107,83,1,224,331,959,1042,2529,82.75271138240497,44.28835227780998
6077,/media/marda/TWOTB1/xBD/hurricanes/images/florence/hurricane-florence_00000011_pre_disaster.png,85,69,1,819,904,973,1042,897,48.26691952484953,25.716728366920055
6078,/media/marda/TWOTB1/xBD/hurricanes/images/florence/hurricane-florence_00000011_pre_disaster.png,71,66,1,934,1005,976,1042,561,31.991049550614584,23.33266198265857
6079,/media/marda/TWOTB1/xBD/hurricanes/images/florence/hurricane-florence_00000011_pre_disaster.png,52,64,1,562,614,980,1044,412,25.257829544903565,21.400252017905437
6080,/media/marda/TWOTB1/xBD/hurricanes/images/florence/hurricane-florence_00000286_post_disaster.png,33,61,1,69,102,328,389,724,54.996849302552626,17.441505824149736
6081,/media/marda/TWOTB1/xBD/hurricanes/images/florence/hurricane-florence_00000286_post_disaster.png,17,28,1,189,206,431,459,100,12.241573664011561,11.144930427265065
6082,/media/marda/TWOTB1/xBD/hurricanes/images/florence/hurricane-florence_00000286_post_disaster.png,20,31,1,187,207,446,477,118,14.593341942236096,10.841717831286884
6083,/media/marda/TWOTB1/xBD/hurricanes/images/florence/hurricane-florence_00000286_post_disaster.png,23,36,1,206,229,469,505,212,20.12645656873524,14.146847463538492
6084,/media/marda/TWOTB1/xBD/hurricanes/images/florence/hurricane-florence_00000286_post_disaster.png,39,61,1,156,195,471,532,997,46.105482202638804,29.200693437252564
6085,/media/marda/TWOTB1/xBD/hurricanes/images/florence/hurricane-florence_00000286_post_disaster.png,41,76,1,200,241,621,697,1030,56.61539926105171,24.1734425386683
6086,/media/marda/TWOTB1/xBD/hurricanes/images/florence/hurricane-florence_00000286_post_disaster.png,35,47,1,264,299,628,675,417,28.876517356692673,19.564669595576028
6087,/media/marda/TWOTB1/xBD/hurricanes/images/florence/hurricane-florence_00000286_post_disaster.png,53,67,1,212,265,756,823,1051,47.499285223415605,29.922243737878375
6088,/media/marda/TWOTB1/xBD/hurricanes/images/florence/hurricane-florence_00000286_post_disaster.png,94,81,1,233,327,805,886,2066,79.69949091428751,40.0189802082441
6089,/media/marda/TWOTB1/xBD/hurricanes/images/florence/hurricane-florence_00000286_post_disaster.png,45,79,1,467,512,812,891,529,52.194319544444774,13.540204144523706
6090,/media/marda/TWOTB1/xBD/hurricanes/images/florence/hurricane-florence_00000286_post_disaster.png,50,75,1,420,470,837,912,540,50.019003275021866,14.419998211178436
6091,/media/marda/TWOTB1/xBD/hurricanes/images/florence/hurricane-florence_00000286_post_disaster.png,43,63,1,283,326,851,914,693,31.69848763935896,28.626789301873433
6092,/media/marda/TWOTB1/xBD/hurricanes/images/florence/hurricane-florence_00000286_post_disaster.png,51,51,1,923,974,902,953,112,14.305265255456726,10.53666815302356
6093,/media/marda/TWOTB1/xBD/hurricanes/images/florence/hurricane-florence_00000286_post_disaster.png,32,70,1,260,292,913,983,402,37.08587345641508,14.361131873383112
6094,/media/marda/TWOTB1/xBD/hurricanes/images/florence/hurricane-florence_00000286_post_disaster.png,68,92,1,976,1044,914,1006,864,47.063234724070625,28.127033605414063
6095,/media/marda/TWOTB1/xBD/hurricanes/images/florence/hurricane-florence_00000286_post_disaster.png,57,56,1,948,1005,933,989,268,20.895328728484298,16.622566570654914
6096,/media/marda/TWOTB1/xBD/hurricanes/images/florence/hurricane-florence_00000286_post_disaster.png,34,67,1,286,320,974,1041,408,35.65253210071322,15.324140710833149
6097,/media/marda/TWOTB1/xBD/hurricanes/images/florence/hurricane-florence_00000062_post_disaster.png,33,42,1,51,84,156,198,691,38.01560651262479,24.07935008005791
6098,/media/marda/TWOTB1/xBD/hurricanes/images/florence/hurricane-florence_00000062_post_disaster.png,27,19,1,236,263,171,190,183,20.26453052804543,12.094986283096697
6099,/media/marda/TWOTB1/xBD/hurricanes/images/florence/hurricane-florence_00000062_post_disaster.png,67,72,1,282,349,820,892,1392,58.651861502658676,31.377900104860583
6100,/media/marda/TWOTB1/xBD/hurricanes/images/florence/hurricane-florence_00000062_post_disaster.png,57,50,1,830,887,845,895,240,27.51742685201993,11.676904912373889
6101,/media/marda/TWOTB1/xBD/hurricanes/images/florence/hurricane-florence_00000062_post_disaster.png,54,52,1,870,924,939,991,203,23.486865323212815,11.58002476644707
6102,/media/marda/TWOTB1/xBD/hurricanes/images/florence/hurricane-florence_00000062_post_disaster.png,63,41,1,811,874,198,239,875,36.091600843996446,31.919303298290323
6103,/media/marda/TWOTB1/xBD/hurricanes/images/florence/hurricane-florence_00000331_pre_disaster.png,21,16,1,192,213,19,35,142,14.188057477793842,13.242056865818324
6104,/media/marda/TWOTB1/xBD/hurricanes/images/florence/hurricane-florence_00000331_pre_disaster.png,53,64,1,148,201,37,101,2039,61.144284703653895,44.60990550047406
6105,/media/marda/TWOTB1/xBD/hurricanes/images/florence/hurricane-florence_00000331_pre_disaster.png,28,18,1,360,388,134,152,158,15.77070822198573,12.922161063633872
6106,/media/marda/TWOTB1/xBD/hurricanes/images/florence/hurricane-florence_00000331_pre_disaster.png,41,58,1,216,257,163,221,1171,61.087929383731236,26.13543256952682
6107,/media/marda/TWOTB1/xBD/hurricanes/images/florence/hurricane-florence_00000331_pre_disaster.png,72,30,1,321,393,189,219,1315,67.6090286234382,25.706675544442607
6108,/media/marda/TWOTB1/xBD/hurricanes/images/florence/hurricane-florence_00000331_pre_disaster.png,16,21,1,15,31,268,289,153,17.45454784549901,11.478510608547197
6109,/media/marda/TWOTB1/xBD/hurricanes/images/florence/hurricane-florence_00000331_pre_disaster.png,28,59,1,89,117,287,346,1163,56.22220888197385,27.393664328561176
6110,/media/marda/TWOTB1/xBD/hurricanes/images/florence/hurricane-florence_00000331_pre_disaster.png,51,49,1,947,998,303,352,535,41.235164490202024,17.13716151403573
6111,/media/marda/TWOTB1/xBD/hurricanes/images/florence/hurricane-florence_00000331_pre_disaster.png,77,46,1,859,936,361,407,1261,47.49886677349319,35.161240638455304
6112,/media/marda/TWOTB1/xBD/hurricanes/images/florence/hurricane-florence_00000331_pre_disaster.png,72,52,1,200,272,372,424,1435,68.63387275604781,27.83003259233649
6113,/media/marda/TWOTB1/xBD/hurricanes/images/florence/hurricane-florence_00000331_pre_disaster.png,50,35,1,931,981,379,414,254,24.78321624370103,13.496251973462954
6114,/media/marda/TWOTB1/xBD/hurricanes/images/florence/hurricane-florence_00000331_pre_disaster.png,48,27,1,936,984,402,429,97,11.759329340840507,10.523275317905973
6115,/media/marda/TWOTB1/xBD/hurricanes/images/florence/hurricane-florence_00000331_pre_disaster.png,62,37,1,841,903,404,441,599,33.108855399151956,23.683760314604353
6116,/media/marda/TWOTB1/xBD/hurricanes/images/florence/hurricane-florence_00000331_pre_disaster.png,65,53,1,287,352,413,466,1158,59.658890975299926,25.616209813027428
6117,/media/marda/TWOTB1/xBD/hurricanes/images/florence/hurricane-florence_00000331_pre_disaster.png,61,35,1,917,978,416,451,399,27.771828137465963,18.877209317186622
6118,/media/marda/TWOTB1/xBD/hurricanes/images/florence/hurricane-florence_00000331_pre_disaster.png,51,26,1,923,974,446,472,136,17.386180019647735,10.426675117839974
6119,/media/marda/TWOTB1/xBD/hurricanes/images/florence/hurricane-florence_00000331_pre_disaster.png,85,47,1,918,1003,490,537,1046,54.61049981573085,25.337024839237788
6120,/media/marda/TWOTB1/xBD/hurricanes/images/florence/hurricane-florence_00000331_pre_disaster.png,57,78,1,279,336,570,648,1531,62.579654608173676,33.98958606425942
6121,/media/marda/TWOTB1/xBD/hurricanes/images/florence/hurricane-florence_00000331_pre_disaster.png,72,79,1,549,621,615,694,1429,54.86060495932955,34.76066434491701
6122,/media/marda/TWOTB1/xBD/hurricanes/images/florence/hurricane-florence_00000331_pre_disaster.png,45,93,1,48,93,627,720,1902,69.39953611204248,36.114865636187744
6123,/media/marda/TWOTB1/xBD/hurricanes/images/florence/hurricane-florence_00000331_pre_disaster.png,51,67,1,112,163,631,698,1302,43.3830333270125,39.73532628075651
6124,/media/marda/TWOTB1/xBD/hurricanes/images/florence/hurricane-florence_00000331_pre_disaster.png,20,51,1,0,20,667,718,398,26.14400545932943,20.337203828966025
6125,/media/marda/TWOTB1/xBD/hurricanes/images/florence/hurricane-florence_00000331_pre_disaster.png,57,91,1,277,334,669,760,2009,71.14351722200063,37.401178159564466
6126,/media/marda/TWOTB1/xBD/hurricanes/images/florence/hurricane-florence_00000331_pre_disaster.png,16,34,1,114,130,674,708,70,12.17795863310742,7.741181754673888
6127,/media/marda/TWOTB1/xBD/hurricanes/images/florence/hurricane-florence_00000331_pre_disaster.png,52,45,1,483,535,707,752,245,37.0081752091185,8.765159472925427
6128,/media/marda/TWOTB1/xBD/hurricanes/images/florence/hurricane-florence_00000331_pre_disaster.png,32,48,1,453,485,758,806,168,20.25232792276535,11.0775310622179
6129,/media/marda/TWOTB1/xBD/hurricanes/images/florence/hurricane-florence_00000331_pre_disaster.png,36,48,1,464,500,784,832,206,17.201255808253936,15.887729147470624
6130,/media/marda/TWOTB1/xBD/hurricanes/images/florence/hurricane-florence_00000331_pre_disaster.png,69,66,1,421,490,804,870,973,57.46292368242138,22.387577482717592
6131,/media/marda/TWOTB1/xBD/hurricanes/images/florence/hurricane-florence_00000331_pre_disaster.png,47,67,1,313,360,913,980,590,34.66425601446339,22.555115454363335
6132,/media/marda/TWOTB1/xBD/hurricanes/images/florence/hurricane-florence_00000331_pre_disaster.png,27,61,1,13,40,955,1016,295,29.892359496005888,13.176483791872503
6133,/media/marda/TWOTB1/xBD/hurricanes/images/florence/hurricane-florence_00000331_pre_disaster.png,41,65,1,93,134,977,1042,687,35.14947632457689,26.81282449408641
6134,/media/marda/TWOTB1/xBD/hurricanes/images/florence/hurricane-florence_00000331_pre_disaster.png,38,52,1,312,350,992,1044,159,22.216364284681895,11.031254106895378
6135,/media/marda/TWOTB1/xBD/hurricanes/images/florence/hurricane-florence_00000266_pre_disaster.png,62,48,1,982,1044,243,291,734,41.54814539230872,23.515408699758314
6136,/media/marda/TWOTB1/xBD/hurricanes/images/florence/hurricane-florence_00000266_pre_disaster.png,66,30,1,950,1016,261,291,424,29.771569233925113,18.760815283230755
6137,/media/marda/TWOTB1/xBD/hurricanes/images/florence/hurricane-florence_00000032_pre_disaster.png,31,11,1,126,157,0,11,171,24.31867940014419,10.007838958119235
6138,/media/marda/TWOTB1/xBD/hurricanes/images/florence/hurricane-florence_00000032_pre_disaster.png,31,10,1,242,273,0,10,151,23.443418226557306,8.975341179265522
6139,/media/marda/TWOTB1/xBD/hurricanes/images/florence/hurricane-florence_00000032_pre_disaster.png,25,17,1,195,220,15,32,185,18.976216864131143,12.98670309284052
6140,/media/marda/TWOTB1/xBD/hurricanes/images/florence/hurricane-florence_00000032_pre_disaster.png,55,61,1,416,471,19,80,1430,63.6578499512506,29.928402048451836
6141,/media/marda/TWOTB1/xBD/hurricanes/images/florence/hurricane-florence_00000032_pre_disaster.png,39,43,1,20,59,22,65,1048,48.60316930361198,32.635312184494445
6142,/media/marda/TWOTB1/xBD/hurricanes/images/florence/hurricane-florence_00000032_pre_disaster.png,12,13,1,80,92,84,97,128,13.461908178565245,12.65893786537315
6143,/media/marda/TWOTB1/xBD/hurricanes/images/florence/hurricane-florence_00000032_pre_disaster.png,31,44,1,29,60,91,135,1129,47.343593790626386,31.722601138523636
6144,/media/marda/TWOTB1/xBD/hurricanes/images/florence/hurricane-florence_00000032_pre_disaster.png,85,40,1,583,668,98,138,1712,67.16474475954907,33.93350846637444
6145,/media/marda/TWOTB1/xBD/hurricanes/images/florence/hurricane-florence_00000032_pre_disaster.png,62,36,1,719,781,150,186,344,43.39499606195503,10.584758262737132
6146,/media/marda/TWOTB1/xBD/hurricanes/images/florence/hurricane-florence_00000032_pre_disaster.png,52,34,1,576,628,204,238,384,31.628633314033436,16.311265970744234
6147,/media/marda/TWOTB1/xBD/hurricanes/images/florence/hurricane-florence_00000032_pre_disaster.png,42,78,1,2,44,865,943,1367,44.39001853438314,40.553829037356024
6148,/media/marda/TWOTB1/xBD/hurricanes/images/florence/hurricane-florence_00000032_pre_disaster.png,44,69,1,220,264,866,935,1002,40.81074471754867,34.246274447166286
6149,/media/marda/TWOTB1/xBD/hurricanes/images/florence/hurricane-florence_00000032_pre_disaster.png,50,68,1,140,190,884,952,1139,49.12467953667483,30.66306477320813
6150,/media/marda/TWOTB1/xBD/hurricanes/images/florence/hurricane-florence_00000032_pre_disaster.png,29,55,1,412,441,900,955,199,19.938680011187756,13.384980701684542
6151,/media/marda/TWOTB1/xBD/hurricanes/images/florence/hurricane-florence_00000032_pre_disaster.png,19,43,1,243,262,903,946,74,12.34534686080599,7.802998548181676
6152,/media/marda/TWOTB1/xBD/hurricanes/images/florence/hurricane-florence_00000032_pre_disaster.png,35,57,1,246,281,922,979,432,28.211053334384932,20.09934769390771
6153,/media/marda/TWOTB1/xBD/hurricanes/images/florence/hurricane-florence_00000032_pre_disaster.png,36,68,1,145,181,933,1001,615,35.0201557593744,25.138061111788236
6154,/media/marda/TWOTB1/xBD/hurricanes/images/florence/hurricane-florence_00000032_pre_disaster.png,42,72,1,153,195,970,1042,893,38.785644658036595,32.22322895358745
6155,/media/marda/TWOTB1/xBD/hurricanes/images/florence/hurricane-florence_00000001_pre_disaster.png,60,45,1,984,1044,103,148,715,44.8544368541824,21.218103391483222
6156,/media/marda/TWOTB1/xBD/hurricanes/images/florence/hurricane-florence_00000001_pre_disaster.png,72,51,1,806,878,113,164,1284,46.312139584674235,36.94259329602633
6157,/media/marda/TWOTB1/xBD/hurricanes/images/florence/hurricane-florence_00000001_pre_disaster.png,69,38,1,771,840,139,177,844,38.56638080101359,29.385304361040472
6158,/media/marda/TWOTB1/xBD/hurricanes/images/florence/hurricane-florence_00000001_pre_disaster.png,71,39,1,731,802,156,195,921,41.095859628510276,29.376293869312416
6159,/media/marda/TWOTB1/xBD/hurricanes/images/florence/hurricane-florence_00000001_pre_disaster.png,78,57,1,686,764,167,224,1429,49.88457644247281,38.11239771736745
6160,/media/marda/TWOTB1/xBD/hurricanes/images/florence/hurricane-florence_00000001_pre_disaster.png,69,49,1,659,728,198,247,1007,39.52667026110765,33.25094365702427
6161,/media/marda/TWOTB1/xBD/hurricanes/images/florence/hurricane-florence_00000001_pre_disaster.png,71,54,1,879,950,207,261,1350,47.81884803883908,37.60651220423249
6162,/media/marda/TWOTB1/xBD/hurricanes/images/florence/hurricane-florence_00000001_pre_disaster.png,75,58,1,621,696,222,280,1342,52.0796004865903,33.99677220566249
6163,/media/marda/TWOTB1/xBD/hurricanes/images/florence/hurricane-florence_00000001_pre_disaster.png,77,60,1,786,863,233,293,1290,51.60338817073421,33.21075975374659
6164,/media/marda/TWOTB1/xBD/hurricanes/images/florence/hurricane-florence_00000001_pre_disaster.png,78,58,1,747,825,255,313,1269,48.04297336564106,35.091379949339775
6165,/media/marda/TWOTB1/xBD/hurricanes/images/florence/hurricane-florence_00000001_pre_disaster.png,68,48,1,601,669,263,311,1005,39.54713792006741,33.202526767096295
6166,/media/marda/TWOTB1/xBD/hurricanes/images/florence/hurricane-florence_00000001_pre_disaster.png,74,54,1,710,784,284,338,1112,43.842896930550204,33.58842400517346
6167,/media/marda/TWOTB1/xBD/hurricanes/images/florence/hurricane-florence_00000001_pre_disaster.png,74,54,1,567,641,293,347,1264,50.193681380335654,33.46041641788633
6168,/media/marda/TWOTB1/xBD/hurricanes/images/florence/hurricane-florence_00000001_pre_disaster.png,78,61,1,681,759,316,377,1310,51.32100262767274,33.963794417159015
6169,/media/marda/TWOTB1/xBD/hurricanes/images/florence/hurricane-florence_00000001_pre_disaster.png,73,58,1,548,621,327,385,1249,49.19680981429341,33.67160494647078
6170,/media/marda/TWOTB1/xBD/hurricanes/images/florence/hurricane-florence_00000001_pre_disaster.png,74,59,1,525,599,363,422,1338,52.978302000588585,33.8863824822682
6171,/media/marda/TWOTB1/xBD/hurricanes/images/florence/hurricane-florence_00000001_pre_disaster.png,82,61,1,808,890,376,437,1332,48.06763070500219,36.78705309503813
6172,/media/marda/TWOTB1/xBD/hurricanes/images/florence/hurricane-florence_00000001_pre_disaster.png,70,55,1,635,705,389,444,1087,43.36962904673118,33.19829037291322
6173,/media/marda/TWOTB1/xBD/hurricanes/images/florence/hurricane-florence_00000001_pre_disaster.png,71,61,1,505,576,401,462,1196,49.86197508034542,31.886438013888355
6174,/media/marda/TWOTB1/xBD/hurricanes/images/florence/hurricane-florence_00000001_pre_disaster.png,77,59,1,613,690,424,483,1255,48.08821909799953,34.775344173330794
6175,/media/marda/TWOTB1/xBD/hurricanes/images/florence/hurricane-florence_00000001_pre_disaster.png,71,62,1,484,555,438,500,1260,51.12409546495687,32.781334365675775
6176,/media/marda/TWOTB1/xBD/hurricanes/images/florence/hurricane-florence_00000001_pre_disaster.png,83,58,1,926,1009,459,517,1095,44.620272357955116,32.512809319694355
6177,/media/marda/TWOTB1/xBD/hurricanes/images/florence/hurricane-florence_00000001_pre_disaster.png,64,56,1,598,662,461,517,1031,38.15926552949902,35.6567547149585
6178,/media/marda/TWOTB1/xBD/hurricanes/images/florence/hurricane-florence_00000001_pre_disaster.png,74,61,1,759,833,463,524,1175,42.84505291953218,36.058879630596415
6179,/media/marda/TWOTB1/xBD/hurricanes/images/florence/hurricane-florence_00000001_pre_disaster.png,65,58,1,470,535,480,538,1115,44.653103026803514,32.989878780560126
6180,/media/marda/TWOTB1/xBD/hurricanes/images/florence/hurricane-florence_00000001_pre_disaster.png,19,37,1,22,41,493,530,143,19.80990534720525,9.689105510455411
6181,/media/marda/TWOTB1/xBD/hurricanes/images/florence/hurricane-florence_00000001_pre_disaster.png,14,32,1,12,26,497,529,74,14.54126123882041,6.866743031488298
6182,/media/marda/TWOTB1/xBD/hurricanes/images/florence/hurricane-florence_00000001_pre_disaster.png,75,64,1,573,648,497,561,1251,50.77408521055102,32.720380411460184
6183,/media/marda/TWOTB1/xBD/hurricanes/images/florence/hurricane-florence_00000001_pre_disaster.png,77,70,1,826,903,506,576,1179,48.34924774461607,32.483463189460814
6184,/media/marda/TWOTB1/xBD/hurricanes/images/florence/hurricane-florence_00000001_pre_disaster.png,65,59,1,452,517,517,576,1037,41.55844098263767,32.90079515326114
6185,/media/marda/TWOTB1/xBD/hurricanes/images/florence/hurricane-florence_00000001_pre_disaster.png,76,69,1,551,627,534,603,1448,52.222217777467115,36.83093272502918
6186,/media/marda/TWOTB1/xBD/hurricanes/images/florence/hurricane-florence_00000001_pre_disaster.png,68,65,1,423,491,550,615,1286,52.63011760464589,32.1541585215451
6187,/media/marda/TWOTB1/xBD/hurricanes/images/florence/hurricane-florence_00000001_pre_disaster.png,89,64,1,861,950,563,627,1234,54.26503286170107,30.1611789599775
6188,/media/marda/TWOTB1/xBD/hurricanes/images/florence/hurricane-florence_00000001_pre_disaster.png,70,66,1,530,600,567,633,1263,43.43603579720922,39.08086167673806
6189,/media/marda/TWOTB1/xBD/hurricanes/images/florence/hurricane-florence_00000001_pre_disaster.png,22,45,1,40,62,573,618,481,26.46393860457362,24.19667650382442
6190,/media/marda/TWOTB1/xBD/hurricanes/images/florence/hurricane-florence_00000001_pre_disaster.png,9,33,1,68,77,584,617,110,15.024582512451678,9.737756610103043
6191,/media/marda/TWOTB1/xBD/hurricanes/images/florence/hurricane-florence_00000001_pre_disaster.png,72,74,1,589,661,584,658,1434,51.54097354448229,37.01038597194319
6192,/media/marda/TWOTB1/xBD/hurricanes/images/florence/hurricane-florence_00000001_pre_disaster.png,72,62,1,972,1044,585,647,871,39.722799332775054,29.72579396927959
6193,/media/marda/TWOTB1/xBD/hurricanes/images/florence/hurricane-florence_00000001_pre_disaster.png,63,62,1,409,472,590,652,1034,42.6465802616675,31.812798487322645
6194,/media/marda/TWOTB1/xBD/hurricanes/images/florence/hurricane-florence_00000001_pre_disaster.png,31,64,1,0,31,597,661,681,33.778399852842725,30.77027661417192
6195,/media/marda/TWOTB1/xBD/hurricanes/images/florence/hurricane-florence_00000001_pre_disaster.png,71,74,1,628,699,605,679,1256,48.17278394975758,34.663007793577826
6196,/media/marda/TWOTB1/xBD/hurricanes/images/florence/hurricane-florence_00000001_pre_disaster.png,81,65,1,950,1031,618,683,1069,38.84849775010978,35.96353550114518
6197,/media/marda/TWOTB1/xBD/hurricanes/images/florence/hurricane-florence_00000001_pre_disaster.png,67,71,1,381,448,622,693,1341,49.8677002446418,35.52844926772738
6198,/media/marda/TWOTB1/xBD/hurricanes/images/florence/hurricane-florence_00000001_pre_disaster.png,76,78,1,665,741,622,700,1476,55.98082016329684,34.73914059735881
6199,/media/marda/TWOTB1/xBD/hurricanes/images/florence/hurricane-florence_00000001_pre_disaster.png,88,70,1,816,904,634,704,1398,56.50523582377729,32.67677866577762
6200,/media/marda/TWOTB1/xBD/hurricanes/images/florence/hurricane-florence_00000001_pre_disaster.png,75,73,1,490,565,641,714,1472,50.09231734619153,39.05581175454184
6201,/media/marda/TWOTB1/xBD/hurricanes/images/florence/hurricane-florence_00000001_pre_disaster.png,77,77,1,699,776,645,722,1411,50.677945683455796,37.02649801329309
6202,/media/marda/TWOTB1/xBD/hurricanes/images/florence/hurricane-florence_00000001_pre_disaster.png,70,72,1,359,429,659,731,1445,53.09738560741859,36.16762148515797
6203,/media/marda/TWOTB1/xBD/hurricanes/images/florence/hurricane-florence_00000001_pre_disaster.png,87,70,1,795,882,673,743,1330,53.31162960127761,33.147952433503505
6204,/media/marda/TWOTB1/xBD/hurricanes/images/florence/hurricane-florence_00000001_pre_disaster.png,72,68,1,738,810,675,743,1056,39.618917798788516,35.425378709011675
6205,/media/marda/TWOTB1/xBD/hurricanes/images/florence/hurricane-florence_00000001_pre_disaster.png,62,64,1,544,606,679,743,971,41.824133338635754,31.054947933462277
6206,/media/marda/TWOTB1/xBD/hurricanes/images/florence/hurricane-florence_00000001_pre_disaster.png,73,82,1,575,648,697,779,1534,56.80242092761635,35.670400427771526
6207,/media/marda/TWOTB1/xBD/hurricanes/images/florence/hurricane-florence_00000001_pre_disaster.png,56,71,1,342,398,700,771,1166,42.57770473103825,35.8211752316
6208,/media/marda/TWOTB1/xBD/hurricanes/images/florence/hurricane-florence_00000001_pre_disaster.png,79,73,1,782,861,710,783,1305,48.678757304415726,35.689991370079
6209,/media/marda/TWOTB1/xBD/hurricanes/images/florence/hurricane-florence_00000001_pre_disaster.png,57,68,1,455,512,715,783,954,38.066627240927026,32.89988947070898
6210,/media/marda/TWOTB1/xBD/hurricanes/images/florence/hurricane-florence_00000001_pre_disaster.png,75,81,1,609,684,717,798,1426,51.58583020570574,36.80883704726112
6211,/media/marda/TWOTB1/xBD/hurricanes/images/florence/hurricane-florence_00000001_pre_disaster.png,69,73,1,653,722,738,811,1148,42.47700468897511,35.340438123982
6212,/media/marda/TWOTB1/xBD/hurricanes/images/florence/hurricane-florence_00000001_pre_disaster.png,66,76,1,234,300,748,824,1019,69.38331476093758,24.358698241138146
6213,/media/marda/TWOTB1/xBD/hurricanes/images/florence/hurricane-florence_00000001_pre_disaster.png,17,42,1,105,122,750,792,94,11.78191556051796,10.758236714916922
6214,/media/marda/TWOTB1/xBD/hurricanes/images/florence/hurricane-florence_00000001_pre_disaster.png,90,78,1,869,959,756,834,1489,55.18108428484808,35.9035948448847
6215,/media/marda/TWOTB1/xBD/hurricanes/images/florence/hurricane-florence_00000001_pre_disaster.png,30,55,1,171,201,758,813,358,22.344617724871355,21.39291018574608
6216,/media/marda/TWOTB1/xBD/hurricanes/images/florence/hurricane-florence_00000001_pre_disaster.png,67,75,1,419,486,758,833,1212,47.3761082761306,34.05798891351002
6217,/media/marda/TWOTB1/xBD/hurricanes/images/florence/hurricane-florence_00000001_pre_disaster.png,74,82,1,684,758,759,841,1474,55.5874423563947,34.79865842579039
6218,/media/marda/TWOTB1/xBD/hurricanes/images/florence/hurricane-florence_00000001_pre_disaster.png,78,73,1,743,821,782,855,1225,46.95180660466916,34.57126543822887
6219,/media/marda/TWOTB1/xBD/hurricanes/images/florence/hurricane-florence_00000001_pre_disaster.png,87,78,1,850,937,795,873,1286,51.13056189713047,33.44158242967378
6220,/media/marda/TWOTB1/xBD/hurricanes/images/florence/hurricane-florence_00000001_pre_disaster.png,73,73,1,728,801,818,891,1124,40.46462179939151,36.26139453000947
6221,/media/marda/TWOTB1/xBD/hurricanes/images/florence/hurricane-florence_00000001_pre_disaster.png,86,80,1,828,914,831,911,1393,54.3646695841432,34.05879449547254
6222,/media/marda/TWOTB1/xBD/hurricanes/images/florence/hurricane-florence_00000001_pre_disaster.png,54,46,1,987,1041,837,883,112,13.119195526608195,11.514973595188515
6223,/media/marda/TWOTB1/xBD/hurricanes/images/florence/hurricane-florence_00000001_pre_disaster.png,83,81,1,694,777,849,930,1455,51.27960011478597,37.655132132963246
6224,/media/marda/TWOTB1/xBD/hurricanes/images/florence/hurricane-florence_00000001_pre_disaster.png,69,83,1,408,477,851,934,1413,54.54970278644436,34.29270713081739
6225,/media/marda/TWOTB1/xBD/hurricanes/images/florence/hurricane-florence_00000001_pre_disaster.png,74,95,1,936,1010,855,950,1271,62.60589515475908,29.89503926779416
6226,/media/marda/TWOTB1/xBD/hurricanes/images/florence/hurricane-florence_00000001_pre_disaster.png,87,77,1,809,896,871,948,1364,53.310729054358426,33.83307092030147
6227,/media/marda/TWOTB1/xBD/hurricanes/images/florence/hurricane-florence_00000001_pre_disaster.png,60,78,1,440,500,886,964,989,39.54961568313199,33.12281769730176
6228,/media/marda/TWOTB1/xBD/hurricanes/images/florence/hurricane-florence_00000001_pre_disaster.png,73,79,1,682,755,891,970,1203,48.1896180752868,32.78190717088697
6229,/media/marda/TWOTB1/xBD/hurricanes/images/florence/hurricane-florence_00000001_pre_disaster.png,56,83,1,301,357,892,975,1125,47.47643667749687,31.320987126533385
6230,/media/marda/TWOTB1/xBD/hurricanes/images/florence/hurricane-florence_00000001_pre_disaster.png,83,85,1,786,869,901,986,1284,49.54266412492385,35.3404960321655
6231,/media/marda/TWOTB1/xBD/hurricanes/images/florence/hurricane-florence_00000001_pre_disaster.png,56,69,1,486,542,911,980,829,37.22862127659457,29.689506066596454
6232,/media/marda/TWOTB1/xBD/hurricanes/images/florence/hurricane-florence_00000001_pre_disaster.png,63,87,1,520,583,914,1001,1324,52.727998881433,33.510176341325035
6233,/media/marda/TWOTB1/xBD/hurricanes/images/florence/hurricane-florence_00000001_pre_disaster.png,60,84,1,327,387,922,1006,1250,49.52614362766875,33.36941770800813
6234,/media/marda/TWOTB1/xBD/hurricanes/images/florence/hurricane-florence_00000001_pre_disaster.png,80,84,1,657,737,924,1008,1552,55.35551547193036,36.867620099920956
6235,/media/marda/TWOTB1/xBD/hurricanes/images/florence/hurricane-florence_00000001_pre_disaster.png,67,90,1,559,626,925,1015,1493,52.75121873460554,37.4287526593573
6236,/media/marda/TWOTB1/xBD/hurricanes/images/florence/hurricane-florence_00000001_pre_disaster.png,82,80,1,860,942,933,1013,1131,47.57294007100581,35.5716947053231
6237,/media/marda/TWOTB1/xBD/hurricanes/images/florence/hurricane-florence_00000001_pre_disaster.png,77,81,1,770,847,941,1022,1176,47.97178676505303,32.388546592573235
6238,/media/marda/TWOTB1/xBD/hurricanes/images/florence/hurricane-florence_00000001_pre_disaster.png,31,80,1,85,116,943,1023,762,43.806725558567834,23.918681352802842
6239,/media/marda/TWOTB1/xBD/hurricanes/images/florence/hurricane-florence_00000001_pre_disaster.png,57,82,1,366,423,950,1032,1012,50.188648821136944,26.34569578316429
6240,/media/marda/TWOTB1/xBD/hurricanes/images/florence/hurricane-florence_00000001_pre_disaster.png,65,72,1,596,661,953,1025,982,38.67374670456179,33.17271950637206
6241,/media/marda/TWOTB1/xBD/hurricanes/images/florence/hurricane-florence_00000001_pre_disaster.png,72,76,1,642,714,966,1042,1174,47.45580874318054,32.376164115648805
6242,/media/marda/TWOTB1/xBD/hurricanes/images/florence/hurricane-florence_00000001_pre_disaster.png,61,66,1,397,458,976,1042,805,40.19994610460689,27.47240373743917
6243,/media/marda/TWOTB1/xBD/hurricanes/images/florence/hurricane-florence_00000001_pre_disaster.png,67,63,1,753,820,979,1042,639,34.142423289550784,25.397915930714472
6244,/media/marda/TWOTB1/xBD/hurricanes/images/florence/hurricane-florence_00000153_pre_disaster.png,57,20,1,127,184,0,20,566,46.00107328665246,19.611992389244072
6245,/media/marda/TWOTB1/xBD/hurricanes/images/florence/hurricane-florence_00000153_pre_disaster.png,60,44,1,376,436,0,44,1394,45.758303709206174,42.87763702530925
6246,/media/marda/TWOTB1/xBD/hurricanes/images/florence/hurricane-florence_00000153_pre_disaster.png,37,24,1,212,249,25,49,381,29.86527858168754,16.96692258401506
6247,/media/marda/TWOTB1/xBD/hurricanes/images/florence/hurricane-florence_00000153_pre_disaster.png,31,20,1,391,422,56,76,193,18.536785377291057,13.938479924464417
6248,/media/marda/TWOTB1/xBD/hurricanes/images/florence/hurricane-florence_00000153_pre_disaster.png,81,53,1,309,390,62,115,1887,65.33486268455361,41.75954965890176
6249,/media/marda/TWOTB1/xBD/hurricanes/images/florence/hurricane-florence_00000153_pre_disaster.png,84,60,1,737,821,154,214,1842,51.806543882961364,47.58788328335707
6250,/media/marda/TWOTB1/xBD/hurricanes/images/florence/hurricane-florence_00000153_pre_disaster.png,70,42,1,801,871,168,210,842,33.79458471831705,33.26041457190204
6251,/media/marda/TWOTB1/xBD/hurricanes/images/florence/hurricane-florence_00000153_pre_disaster.png,45,26,1,782,827,209,235,164,16.415954783323333,13.278267332024162
6252,/media/marda/TWOTB1/xBD/hurricanes/images/florence/hurricane-florence_00000153_pre_disaster.png,58,66,1,128,186,298,364,1360,62.68899427706624,28.663058643243396
6253,/media/marda/TWOTB1/xBD/hurricanes/images/florence/hurricane-florence_00000153_pre_disaster.png,30,37,1,115,145,365,402,323,25.80266844161328,16.611196667432054
6254,/media/marda/TWOTB1/xBD/hurricanes/images/florence/hurricane-florence_00000153_pre_disaster.png,29,42,1,98,127,396,438,303,28.7789010589042,14.01285369933412
6255,/media/marda/TWOTB1/xBD/hurricanes/images/florence/hurricane-florence_00000153_pre_disaster.png,72,70,1,584,656,613,683,1314,44.5161772070541,39.14856014439257
6256,/media/marda/TWOTB1/xBD/hurricanes/images/florence/hurricane-florence_00000153_pre_disaster.png,52,64,1,610,662,728,792,644,35.1644627298893,24.36617716943499
6257,/media/marda/TWOTB1/xBD/hurricanes/images/florence/hurricane-florence_00000153_pre_disaster.png,106,93,1,836,942,828,921,2260,78.65108011457589,38.804004704218094
6258,/media/marda/TWOTB1/xBD/hurricanes/images/florence/hurricane-florence_00000480_post_disaster.png,80,50,1,832,912,190,240,924,57.97259824970772,23.1278802943972
6259,/media/marda/TWOTB1/xBD/hurricanes/images/florence/hurricane-florence_00000480_post_disaster.png,46,21,1,821,867,238,259,101,12.396668224956086,10.72800040398209
6260,/media/marda/TWOTB1/xBD/hurricanes/images/florence/hurricane-florence_00000480_post_disaster.png,47,57,1,135,182,465,522,1563,48.04705699089038,43.41536674568197
6261,/media/marda/TWOTB1/xBD/hurricanes/images/florence/hurricane-florence_00000480_post_disaster.png,48,52,1,335,383,485,537,725,38.20482259036366,24.828595933381788
6262,/media/marda/TWOTB1/xBD/hurricanes/images/florence/hurricane-florence_00000480_post_disaster.png,68,75,1,424,492,490,565,1503,48.45716342687951,41.13260280388583
6263,/media/marda/TWOTB1/xBD/hurricanes/images/florence/hurricane-florence_00000480_post_disaster.png,37,44,1,302,339,493,537,267,26.91914023185688,13.259270767909717
6264,/media/marda/TWOTB1/xBD/hurricanes/images/florence/hurricane-florence_00000480_post_disaster.png,17,39,1,92,109,509,548,249,19.77425324235318,16.867032562106942
6265,/media/marda/TWOTB1/xBD/hurricanes/images/florence/hurricane-florence_00000480_post_disaster.png,16,33,1,152,168,511,544,145,14.046229092683127,13.760513222185102
6266,/media/marda/TWOTB1/xBD/hurricanes/images/florence/hurricane-florence_00000480_post_disaster.png,42,49,1,346,388,530,579,484,30.2214101839296,21.022131425915102
6267,/media/marda/TWOTB1/xBD/hurricanes/images/florence/hurricane-florence_00000480_post_disaster.png,17,32,1,153,170,531,563,156,14.966629547095765,13.808210118138652
6268,/media/marda/TWOTB1/xBD/hurricanes/images/florence/hurricane-florence_00000480_post_disaster.png,19,43,1,101,120,538,581,320,25.478109104763558,16.767621892974688
6269,/media/marda/TWOTB1/xBD/hurricanes/images/florence/hurricane-florence_00000480_post_disaster.png,37,47,1,234,271,541,588,408,24.32486450419594,22.20207572257935
6270,/media/marda/TWOTB1/xBD/hurricanes/images/florence/hurricane-florence_00000480_post_disaster.png,17,26,1,156,173,545,571,61,14.060841351813774,5.796775260366202
6271,/media/marda/TWOTB1/xBD/hurricanes/images/florence/hurricane-florence_00000480_post_disaster.png,51,62,1,200,251,564,626,577,55.44246798019676,13.93678726018069
6272,/media/marda/TWOTB1/xBD/hurricanes/images/florence/hurricane-florence_00000114_post_disaster.png,58,18,1,985,1043,0,18,267,19.158322963485922,18.72552731064451
6273,/media/marda/TWOTB1/xBD/hurricanes/images/florence/hurricane-florence_00000114_post_disaster.png,65,34,1,978,1043,48,82,495,33.362981886752166,19.870653206857128
6274,/media/marda/TWOTB1/xBD/hurricanes/images/florence/hurricane-florence_00000114_post_disaster.png,44,39,1,430,474,51,90,698,40.05444376975696,23.180574999430466
6275,/media/marda/TWOTB1/xBD/hurricanes/images/florence/hurricane-florence_00000114_post_disaster.png,36,25,1,491,527,61,86,319,25.0057039107069,16.734052613801097
6276,/media/marda/TWOTB1/xBD/hurricanes/images/florence/hurricane-florence_00000114_post_disaster.png,34,16,1,457,491,63,79,136,17.403009510955457,10.458037773848446
6277,/media/marda/TWOTB1/xBD/hurricanes/images/florence/hurricane-florence_00000114_post_disaster.png,41,30,1,316,357,70,100,707,32.14888627895113,28.89545330069105
6278,/media/marda/TWOTB1/xBD/hurricanes/images/florence/hurricane-florence_00000114_post_disaster.png,66,28,1,687,753,169,197,716,41.756308466515755,22.418267951711123
6279,/media/marda/TWOTB1/xBD/hurricanes/images/florence/hurricane-florence_00000114_post_disaster.png,56,44,1,500,556,245,289,686,37.18362385819848,24.263746773235916
6280,/media/marda/TWOTB1/xBD/hurricanes/images/florence/hurricane-florence_00000114_post_disaster.png,33,41,1,107,140,346,387,642,34.37354153021851,26.272078451385447
6281,/media/marda/TWOTB1/xBD/hurricanes/images/florence/hurricane-florence_00000114_post_disaster.png,46,48,1,372,418,364,412,749,34.3225676923177,28.867049115628344
6282,/media/marda/TWOTB1/xBD/hurricanes/images/florence/hurricane-florence_00000114_post_disaster.png,45,41,1,186,231,391,432,854,40.929820343851816,27.721003869497466
6283,/media/marda/TWOTB1/xBD/hurricanes/images/florence/hurricane-florence_00000404_pre_disaster.png,62,7,1,929,991,0,7,97,24.578672366602266,5.883034000826257
6284,/media/marda/TWOTB1/xBD/hurricanes/images/florence/hurricane-florence_00000404_pre_disaster.png,48,3,1,966,1014,0,3,19,12.69858887860888,2.1644626732323204
6285,/media/marda/TWOTB1/xBD/hurricanes/images/florence/hurricane-florence_00000404_pre_disaster.png,69,26,1,975,1044,42,68,392,33.99644939768484,16.834040223107568
6286,/media/marda/TWOTB1/xBD/hurricanes/images/florence/hurricane-florence_00000404_pre_disaster.png,75,35,1,950,1025,56,91,499,41.97906129265549,17.872255671577822
6287,/media/marda/TWOTB1/xBD/hurricanes/images/florence/hurricane-florence_00000404_pre_disaster.png,74,36,1,918,992,62,98,561,42.341648098266866,19.150511279445716
6288,/media/marda/TWOTB1/xBD/hurricanes/images/florence/hurricane-florence_00000404_pre_disaster.png,59,31,1,908,967,98,129,416,31.963390527901034,17.698596966989772
6289,/media/marda/TWOTB1/xBD/hurricanes/images/florence/hurricane-florence_00000404_pre_disaster.png,29,32,1,65,94,215,247,403,29.437879994586805,18.233065403379225
6290,/media/marda/TWOTB1/xBD/hurricanes/images/florence/hurricane-florence_00000404_pre_disaster.png,7,26,1,0,7,283,309,69,17.294017957376585,6.072888593264467
6291,/media/marda/TWOTB1/xBD/hurricanes/images/florence/hurricane-florence_00000404_pre_disaster.png,73,60,1,419,492,450,510,1611,53.87933917565287,39.52117919488285
6292,/media/marda/TWOTB1/xBD/hurricanes/images/florence/hurricane-florence_00000404_pre_disaster.png,287,352,1,757,1044,483,835,51276,312.0259927019807,219.09701290710322
6293,/media/marda/TWOTB1/xBD/hurricanes/images/florence/hurricane-florence_00000404_pre_disaster.png,49,49,1,492,541,581,630,563,28.4989234158268,26.071578480965773
6294,/media/marda/TWOTB1/xBD/hurricanes/images/florence/hurricane-florence_00000404_pre_disaster.png,50,90,1,256,306,653,743,1486,69.68819926864474,28.41877695377932
6295,/media/marda/TWOTB1/xBD/hurricanes/images/florence/hurricane-florence_00000404_pre_disaster.png,44,59,1,325,369,710,769,579,34.887676827838945,21.921351359106254
6296,/media/marda/TWOTB1/xBD/hurricanes/images/florence/hurricane-florence_00000404_pre_disaster.png,84,115,1,960,1044,853,968,2331,82.93746299260776,41.990731302471545
6297,/media/marda/TWOTB1/xBD/hurricanes/images/florence/hurricane-florence_00000404_pre_disaster.png,43,87,1,257,300,866,953,1053,57.912893494865536,24.270221794045277
6298,/media/marda/TWOTB1/xBD/hurricanes/images/florence/hurricane-florence_00000404_pre_disaster.png,44,78,1,355,399,899,977,856,41.80622897561374,27.20453284393534
6299,/media/marda/TWOTB1/xBD/hurricanes/images/florence/hurricane-florence_00000404_pre_disaster.png,47,48,1,997,1044,939,987,72,12.498613443764096,7.575592402905817
6300,/media/marda/TWOTB1/xBD/hurricanes/images/florence/hurricane-florence_00000041_pre_disaster.png,64,54,1,980,1044,358,412,902,45.937671393672,25.78589682058426
6301,/media/marda/TWOTB1/xBD/hurricanes/images/florence/hurricane-florence_00000041_pre_disaster.png,72,46,1,372,444,475,521,796,65.6097278213023,16.15007716553018
6302,/media/marda/TWOTB1/xBD/hurricanes/images/florence/hurricane-florence_00000041_pre_disaster.png,116,71,1,928,1044,553,624,3562,87.35383380000668,53.95773225590768
6303,/media/marda/TWOTB1/xBD/hurricanes/images/florence/hurricane-florence_00000041_pre_disaster.png,50,33,1,858,908,575,608,184,19.715125527125313,12.408189385401199
6304,/media/marda/TWOTB1/xBD/hurricanes/images/florence/hurricane-florence_00000041_pre_disaster.png,115,69,1,929,1044,618,687,3112,86.49518784460258,47.64152110754385
6305,/media/marda/TWOTB1/xBD/hurricanes/images/florence/hurricane-florence_00000041_pre_disaster.png,44,31,1,863,907,662,693,62,13.991796069665128,5.942202252938773
6306,/media/marda/TWOTB1/xBD/hurricanes/images/florence/hurricane-florence_00000041_pre_disaster.png,109,62,1,935,1044,679,741,2414,79.85630711252722,40.08040013471375
6307,/media/marda/TWOTB1/xBD/hurricanes/images/florence/hurricane-florence_00000041_pre_disaster.png,106,64,1,938,1044,734,798,2190,76.61371726039302,37.8775132449264
6308,/media/marda/TWOTB1/xBD/hurricanes/images/florence/hurricane-florence_00000172_post_disaster.png,58,64,1,478,536,609,673,919,35.742877299712426,34.316214150049326
6309,/media/marda/TWOTB1/xBD/hurricanes/images/florence/hurricane-florence_00000172_post_disaster.png,47,49,1,555,602,620,669,435,28.506691955468295,20.471429328781756
6310,/media/marda/TWOTB1/xBD/hurricanes/images/florence/hurricane-florence_00000172_post_disaster.png,52,67,1,8,60,674,741,1428,47.73133466086197,40.32071678200391
6311,/media/marda/TWOTB1/xBD/hurricanes/images/florence/hurricane-florence_00000172_post_disaster.png,49,74,1,195,244,729,803,1117,47.157792214422194,32.17306675697212
6312,/media/marda/TWOTB1/xBD/hurricanes/images/florence/hurricane-florence_00000172_post_disaster.png,43,57,1,158,201,875,932,826,42.3168511210042,26.08063694391253
6313,/media/marda/TWOTB1/xBD/hurricanes/images/florence/hurricane-florence_00000172_post_disaster.png,49,64,1,184,233,921,985,890,45.14279558116185,26.49856411794304
6314,/media/marda/TWOTB1/xBD/hurricanes/images/florence/hurricane-florence_00000172_post_disaster.png,37,55,1,413,450,983,1038,166,21.62419456883461,10.309393683917994
6315,/media/marda/TWOTB1/xBD/hurricanes/images/florence/hurricane-florence_00000172_post_disaster.png,32,50,1,371,403,993,1043,168,21.630510977201293,10.365306988675382
6316,/media/marda/TWOTB1/xBD/hurricanes/images/florence/hurricane-florence_00000172_post_disaster.png,43,49,1,601,644,994,1043,89,16.883649707944144,8.151904401497287
6317,/media/marda/TWOTB1/xBD/hurricanes/images/florence/hurricane-florence_00000437_post_disaster.png,26,26,1,0,26,0,26,376,29.922037851590346,18.651004565840722
6318,/media/marda/TWOTB1/xBD/hurricanes/images/florence/hurricane-florence_00000437_post_disaster.png,37,56,1,287,324,69,125,744,61.832680765889506,16.077978258689807
6319,/media/marda/TWOTB1/xBD/hurricanes/images/florence/hurricane-florence_00000437_post_disaster.png,16,27,1,0,16,125,152,200,20.52267360110119,13.492126157973182
6320,/media/marda/TWOTB1/xBD/hurricanes/images/florence/hurricane-florence_00000437_post_disaster.png,10,14,1,3,13,162,176,49,9.453244276508485,7.00037038733998
6321,/media/marda/TWOTB1/xBD/hurricanes/images/florence/hurricane-florence_00000437_post_disaster.png,62,37,1,879,941,396,433,309,26.551943017755676,15.92071217381379
6322,/media/marda/TWOTB1/xBD/hurricanes/images/florence/hurricane-florence_00000437_post_disaster.png,97,64,1,796,893,429,493,1475,58.86830449829248,39.18578652118309
6323,/media/marda/TWOTB1/xBD/hurricanes/images/florence/hurricane-florence_00000437_post_disaster.png,42,26,1,833,875,466,492,50,8.517499240128604,7.933083051021756
6324,/media/marda/TWOTB1/xBD/hurricanes/images/florence/hurricane-florence_00000437_post_disaster.png,44,27,1,826,870,473,500,62,11.724167133333351,7.163665163731003
6325,/media/marda/TWOTB1/xBD/hurricanes/images/florence/hurricane-florence_00000437_post_disaster.png,59,41,1,808,867,490,531,264,24.277092130322785,15.757087017209237
6326,/media/marda/TWOTB1/xBD/hurricanes/images/florence/hurricane-florence_00000437_post_disaster.png,53,38,1,873,926,530,568,189,17.584759927536382,14.188966233963104
6327,/media/marda/TWOTB1/xBD/hurricanes/images/florence/hurricane-florence_00000437_post_disaster.png,76,73,1,629,705,588,661,1170,61.3028872982578,25.406895925443656
6328,/media/marda/TWOTB1/xBD/hurricanes/images/florence/hurricane-florence_00000534_post_disaster.png,140,28,1,826,966,0,28,1825,111.649680125767,23.612252966061764
6329,/media/marda/TWOTB1/xBD/hurricanes/images/florence/hurricane-florence_00000534_post_disaster.png,47,28,1,733,780,48,76,446,30.107985885095683,19.658692787940314
6330,/media/marda/TWOTB1/xBD/hurricanes/images/florence/hurricane-florence_00000534_post_disaster.png,48,34,1,414,462,160,194,658,31.982234208101097,27.46946205359863
6331,/media/marda/TWOTB1/xBD/hurricanes/images/florence/hurricane-florence_00000534_post_disaster.png,37,35,1,203,240,280,315,342,31.9164995696346,14.286669193656097
6332,/media/marda/TWOTB1/xBD/hurricanes/images/florence/hurricane-florence_00000534_post_disaster.png,59,59,1,162,221,282,341,1087,63.94982375064683,22.282584009284623
6333,/media/marda/TWOTB1/xBD/hurricanes/images/florence/hurricane-florence_00000534_post_disaster.png,37,33,1,408,445,387,420,225,17.530132063735508,17.1848141604507
6334,/media/marda/TWOTB1/xBD/hurricanes/images/florence/hurricane-florence_00000534_post_disaster.png,45,42,1,424,469,398,440,368,26.43344884269695,18.597835073633725
6335,/media/marda/TWOTB1/xBD/hurricanes/images/florence/hurricane-florence_00000534_post_disaster.png,65,65,1,321,386,430,495,1321,58.493238725809725,33.257609088146054
6336,/media/marda/TWOTB1/xBD/hurricanes/images/florence/hurricane-florence_00000534_post_disaster.png,53,62,1,234,287,558,620,1011,43.54650324272034,31.38875589815213
6337,/media/marda/TWOTB1/xBD/hurricanes/images/florence/hurricane-florence_00000534_post_disaster.png,33,35,1,486,519,586,621,166,15.746988533652583,14.199922890547624
6338,/media/marda/TWOTB1/xBD/hurricanes/images/florence/hurricane-florence_00000534_post_disaster.png,41,57,1,253,294,601,658,545,27.35927408443544,26.579255438445333
6339,/media/marda/TWOTB1/xBD/hurricanes/images/florence/hurricane-florence_00000534_post_disaster.png,61,77,1,411,472,799,876,962,49.90507797607824,25.435607911218657
6340,/media/marda/TWOTB1/xBD/hurricanes/images/florence/hurricane-florence_00000534_post_disaster.png,32,51,1,381,413,831,882,187,19.161922648694134,12.840475050896275
6341,/media/marda/TWOTB1/xBD/hurricanes/images/florence/hurricane-florence_00000534_post_disaster.png,28,44,1,392,420,846,890,73,10.426526937472167,9.446924153109965
6342,/media/marda/TWOTB1/xBD/hurricanes/images/florence/hurricane-florence_00000534_post_disaster.png,101,93,1,843,944,947,1040,1283,80.06646691641366,25.028069494185786
6343,/media/marda/TWOTB1/xBD/hurricanes/images/florence/hurricane-florence_00000534_post_disaster.png,62,54,1,969,1031,970,1024,309,24.412910901823608,17.068151978624076
6344,/media/marda/TWOTB1/xBD/hurricanes/images/florence/hurricane-florence_00000534_post_disaster.png,128,71,1,653,781,552,623,3006,111.54421975855246,35.95453039602231
6345,/media/marda/TWOTB1/xBD/hurricanes/images/florence/hurricane-florence_00000534_post_disaster.png,232,96,1,562,794,609,705,6312,238.9458137854212,35.18011617196028
6346,/media/marda/TWOTB1/xBD/hurricanes/images/florence/hurricane-florence_00000530_pre_disaster.png,91,87,1,494,585,733,820,1816,78.40036346315676,30.804415776591252
6347,/media/marda/TWOTB1/xBD/hurricanes/images/florence/hurricane-florence_00000530_pre_disaster.png,50,68,1,117,167,754,822,819,50.0700814089148,21.71139017571727
6348,/media/marda/TWOTB1/xBD/hurricanes/images/florence/hurricane-florence_00000530_pre_disaster.png,32,44,1,552,584,795,839,86,11.41666875286302,10.188508206097385
6349,/media/marda/TWOTB1/xBD/hurricanes/images/florence/hurricane-florence_00000530_pre_disaster.png,46,73,1,216,262,860,933,737,42.262295871781426,23.114509493691212
6350,/media/marda/TWOTB1/xBD/hurricanes/images/florence/hurricane-florence_00000530_pre_disaster.png,63,100,1,285,348,910,1010,1554,68.80546250903757,31.314601791837212
6351,/media/marda/TWOTB1/xBD/hurricanes/images/florence/hurricane-florence_00000530_pre_disaster.png,44,65,1,220,264,974,1039,462,38.950693264838534,15.75924762394702
6352,/media/marda/TWOTB1/xBD/hurricanes/images/florence/hurricane-florence_00000530_pre_disaster.png,28,60,1,289,317,983,1043,164,21.33690053892139,10.300608188389294
6353,/media/marda/TWOTB1/xBD/hurricanes/images/florence/hurricane-florence_00000445_post_disaster.png,40,18,1,630,670,0,18,265,19.727442383528693,17.918957423926297
6354,/media/marda/TWOTB1/xBD/hurricanes/images/florence/hurricane-florence_00000445_post_disaster.png,34,11,1,666,700,0,11,92,12.408522780703125,9.777980500360076
6355,/media/marda/TWOTB1/xBD/hurricanes/images/florence/hurricane-florence_00000445_post_disaster.png,64,45,1,791,855,0,45,961,51.36874473675875,24.89113075957779
6356,/media/marda/TWOTB1/xBD/hurricanes/images/florence/hurricane-florence_00000445_post_disaster.png,47,15,1,502,549,1,16,264,29.39378154979112,12.72285656266259
6357,/media/marda/TWOTB1/xBD/hurricanes/images/florence/hurricane-florence_00000445_post_disaster.png,94,49,1,364,458,12,61,2754,87.94666155179047,41.49201846472777
6358,/media/marda/TWOTB1/xBD/hurricanes/images/florence/hurricane-florence_00000445_post_disaster.png,37,22,1,511,548,21,43,271,21.35785369153672,16.985824097615502
6359,/media/marda/TWOTB1/xBD/hurricanes/images/florence/hurricane-florence_00000445_post_disaster.png,31,66,1,6,37,455,521,740,55.21917558338198,17.836059390533734
6360,/media/marda/TWOTB1/xBD/hurricanes/images/florence/hurricane-florence_00000445_post_disaster.png,10,47,1,0,10,522,569,144,24.81149362356733,8.85894088197871
6361,/media/marda/TWOTB1/xBD/hurricanes/images/florence/hurricane-florence_00000306_pre_disaster.png,45,3,1,508,553,0,3,75,28.844410203711913,3.265986323710904
6362,/media/marda/TWOTB1/xBD/hurricanes/images/florence/hurricane-florence_00000306_pre_disaster.png,43,33,1,502,545,34,67,639,36.74998619006804,23.04264761821314
6363,/media/marda/TWOTB1/xBD/hurricanes/images/florence/hurricane-florence_00000306_pre_disaster.png,45,31,1,494,539,95,126,597,32.69372486467165,24.314866932302266
6364,/media/marda/TWOTB1/xBD/hurricanes/images/florence/hurricane-florence_00000306_pre_disaster.png,29,12,1,464,493,108,120,74,14.153763017713242,7.112658529504411
6365,/media/marda/TWOTB1/xBD/hurricanes/images/florence/hurricane-florence_00000306_pre_disaster.png,48,37,1,470,518,146,183,744,34.28054198473808,28.979513163062176
6366,/media/marda/TWOTB1/xBD/hurricanes/images/florence/hurricane-florence_00000306_pre_disaster.png,40,49,1,457,497,197,246,788,44.21418583544794,23.816287809572568
6367,/media/marda/TWOTB1/xBD/hurricanes/images/florence/hurricane-florence_00000306_pre_disaster.png,26,16,1,433,459,209,225,68,11.148694980382976,8.134510929026565
6368,/media/marda/TWOTB1/xBD/hurricanes/images/florence/hurricane-florence_00000306_pre_disaster.png,85,44,1,426,511,244,288,1840,70.35586726728879,34.96650603209044
6369,/media/marda/TWOTB1/xBD/hurricanes/images/florence/hurricane-florence_00000306_pre_disaster.png,30,34,1,367,397,295,329,324,26.14829791348924,16.570682058434866
6370,/media/marda/TWOTB1/xBD/hurricanes/images/florence/hurricane-florence_00000306_pre_disaster.png,45,52,1,459,504,302,354,968,43.70233043196847,29.395175293308796
6371,/media/marda/TWOTB1/xBD/hurricanes/images/florence/hurricane-florence_00000306_pre_disaster.png,44,25,1,615,659,319,344,260,23.065125189341593,14.966629547095765
6372,/media/marda/TWOTB1/xBD/hurricanes/images/florence/hurricane-florence_00000306_pre_disaster.png,50,62,1,583,633,380,442,1116,54.642562321969,27.27199364023627
6373,/media/marda/TWOTB1/xBD/hurricanes/images/florence/hurricane-florence_00000306_pre_disaster.png,24,30,1,413,437,565,595,73,10.54359503579634,9.216286721484693
6374,/media/marda/TWOTB1/xBD/hurricanes/images/florence/hurricane-florence_00000306_pre_disaster.png,53,71,1,429,482,572,643,1453,56.10524159693441,35.235403792741785
6375,/media/marda/TWOTB1/xBD/hurricanes/images/florence/hurricane-florence_00000306_pre_disaster.png,30,55,1,0,30,582,637,961,37.617251216524444,34.12749188085611
6376,/media/marda/TWOTB1/xBD/hurricanes/images/florence/hurricane-florence_00000306_pre_disaster.png,31,51,1,40,71,657,708,536,28.801884777401348,24.882003711480365
6377,/media/marda/TWOTB1/xBD/hurricanes/images/florence/hurricane-florence_00000306_pre_disaster.png,47,54,1,391,438,657,711,836,35.79433096073148,31.1277532276505
6378,/media/marda/TWOTB1/xBD/hurricanes/images/florence/hurricane-florence_00000306_pre_disaster.png,48,62,1,564,612,682,744,921,42.52580355598769,28.78006970565363
6379,/media/marda/TWOTB1/xBD/hurricanes/images/florence/hurricane-florence_00000306_pre_disaster.png,30,42,1,313,343,733,775,206,19.856719551097882,13.930549279628348
6380,/media/marda/TWOTB1/xBD/hurricanes/images/florence/hurricane-florence_00000306_pre_disaster.png,40,86,1,92,132,734,820,1156,62.08429453240656,24.853828119006995
6381,/media/marda/TWOTB1/xBD/hurricanes/images/florence/hurricane-florence_00000306_pre_disaster.png,34,38,1,676,710,742,780,79,10.218090085191601,9.855592096780684
6382,/media/marda/TWOTB1/xBD/hurricanes/images/florence/hurricane-florence_00000306_pre_disaster.png,59,73,1,659,718,761,834,1280,49.33127070432,34.6432353864481
6383,/media/marda/TWOTB1/xBD/hurricanes/images/florence/hurricane-florence_00000306_pre_disaster.png,98,104,1,576,674,769,873,3216,87.69210139592934,59.81430402653766
6384,/media/marda/TWOTB1/xBD/hurricanes/images/florence/hurricane-florence_00000306_pre_disaster.png,55,62,1,279,334,779,841,1136,50.64616844082004,32.518742064628356
6385,/media/marda/TWOTB1/xBD/hurricanes/images/florence/hurricane-florence_00000306_pre_disaster.png,64,77,1,432,496,781,858,1477,60.592611270217,35.634865988466636
6386,/media/marda/TWOTB1/xBD/hurricanes/images/florence/hurricane-florence_00000306_pre_disaster.png,79,76,1,965,1044,802,878,1186,53.8101529252926,34.21996620725971
6387,/media/marda/TWOTB1/xBD/hurricanes/images/florence/hurricane-florence_00000306_pre_disaster.png,55,57,1,182,237,804,861,1015,55.59317935426621,24.367615297649493
6388,/media/marda/TWOTB1/xBD/hurricanes/images/florence/hurricane-florence_00000306_pre_disaster.png,63,92,1,561,624,833,925,1863,63.12337226910183,39.25457543440248
6389,/media/marda/TWOTB1/xBD/hurricanes/images/florence/hurricane-florence_00000306_pre_disaster.png,55,64,1,650,705,834,898,902,35.298252410757755,34.13990860472603
6390,/media/marda/TWOTB1/xBD/hurricanes/images/florence/hurricane-florence_00000306_pre_disaster.png,43,46,1,643,686,865,911,224,21.524616603505283,13.95841125873654
6391,/media/marda/TWOTB1/xBD/hurricanes/images/florence/hurricane-florence_00000306_pre_disaster.png,57,60,1,987,1044,980,1040,363,26.110442973344597,18.57005377536352
6392,/media/marda/TWOTB1/xBD/hurricanes/images/florence/hurricane-florence_00000306_pre_disaster.png,54,57,1,908,962,987,1044,265,19.86716168418894,17.823717958331642
6393,/media/marda/TWOTB1/xBD/hurricanes/images/florence/hurricane-florence_00000306_pre_disaster.png,68,48,1,796,864,996,1044,215,40.65040978426805,7.166096975605578
6394,/media/marda/TWOTB1/xBD/hurricanes/images/florence/hurricane-florence_00000252_post_disaster.png,69,62,1,856,925,393,455,1021,47.44594011140919,28.476467866623207
6395,/media/marda/TWOTB1/xBD/hurricanes/images/florence/hurricane-florence_00000067_post_disaster.png,45,63,1,144,189,509,572,961,42.12055933200558,30.065999292861672
6396,/media/marda/TWOTB1/xBD/hurricanes/images/florence/hurricane-florence_00000067_post_disaster.png,25,56,1,0,25,530,586,587,33.797771436642726,24.00137387228714
6397,/media/marda/TWOTB1/xBD/hurricanes/images/florence/hurricane-florence_00000067_post_disaster.png,75,73,1,92,167,562,635,1884,70.9907443903561,42.33543048789739
6398,/media/marda/TWOTB1/xBD/hurricanes/images/florence/hurricane-florence_00000067_post_disaster.png,55,68,1,64,119,730,798,1128,52.57127097518613,30.585651960493372
6399,/media/marda/TWOTB1/xBD/hurricanes/images/florence/hurricane-florence_00000067_post_disaster.png,60,74,1,115,175,760,834,1373,54.47587311503693,36.838953903528626
6400,/media/marda/TWOTB1/xBD/hurricanes/images/florence/hurricane-florence_00000067_post_disaster.png,64,77,1,188,252,791,868,1478,57.653495325080286,34.45064593346966
6401,/media/marda/TWOTB1/xBD/hurricanes/images/florence/hurricane-florence_00000067_post_disaster.png,24,55,1,59,83,805,860,305,23.605483770730928,17.650523354925827
6402,/media/marda/TWOTB1/xBD/hurricanes/images/florence/hurricane-florence_00000067_post_disaster.png,34,71,1,73,107,813,884,515,42.82119859425713,17.146891026287967
6403,/media/marda/TWOTB1/xBD/hurricanes/images/florence/hurricane-florence_00000067_post_disaster.png,20,50,1,150,170,834,884,166,16.38348598139491,13.597153816763035
6404,/media/marda/TWOTB1/xBD/hurricanes/images/florence/hurricane-florence_00000067_post_disaster.png,54,67,1,253,307,838,905,610,49.43267525418824,17.704950111181947
6405,/media/marda/TWOTB1/xBD/hurricanes/images/florence/hurricane-florence_00000067_post_disaster.png,17,48,1,117,134,841,889,140,14.32997878085071,12.689843036997488
6406,/media/marda/TWOTB1/xBD/hurricanes/images/florence/hurricane-florence_00000067_post_disaster.png,41,68,1,152,193,846,914,709,33.328058818225,28.446436575871722
6407,/media/marda/TWOTB1/xBD/hurricanes/images/florence/hurricane-florence_00000067_post_disaster.png,50,78,1,74,124,857,935,1063,51.36181215133975,30.29944133671327
6408,/media/marda/TWOTB1/xBD/hurricanes/images/florence/hurricane-florence_00000067_post_disaster.png,76,86,1,653,729,867,953,1508,53.02685351145226,38.25060537339541
6409,/media/marda/TWOTB1/xBD/hurricanes/images/florence/hurricane-florence_00000067_post_disaster.png,97,83,1,790,887,902,985,1542,70.53442713375328,28.847194236433495
6410,/media/marda/TWOTB1/xBD/hurricanes/images/florence/hurricane-florence_00000067_post_disaster.png,54,69,1,400,454,906,975,647,38.802450535463464,22.1715841185056
6411,/media/marda/TWOTB1/xBD/hurricanes/images/florence/hurricane-florence_00000067_post_disaster.png,22,57,1,51,73,923,980,230,20.77801531670558,14.829910768841184
6412,/media/marda/TWOTB1/xBD/hurricanes/images/florence/hurricane-florence_00000067_post_disaster.png,20,57,1,62,82,962,1019,204,20.272609009172445,13.474804027111611
6413,/media/marda/TWOTB1/xBD/hurricanes/images/florence/hurricane-florence_00000067_post_disaster.png,27,58,1,26,53,963,1021,280,28.17278567668882,13.277119503770304
6414,/media/marda/TWOTB1/xBD/hurricanes/images/florence/hurricane-florence_00000067_post_disaster.png,82,68,1,288,370,973,1041,1352,74.37333194548593,28.532791134987164
6415,/media/marda/TWOTB1/xBD/hurricanes/images/florence/hurricane-florence_00000067_post_disaster.png,54,59,1,529,583,984,1043,302,35.60006918627635,11.221420619578993
6416,/media/marda/TWOTB1/xBD/hurricanes/images/florence/hurricane-florence_00000374_post_disaster.png,86,25,1,213,299,0,25,1012,73.53625731973538,20.619452403669527
6417,/media/marda/TWOTB1/xBD/hurricanes/images/florence/hurricane-florence_00000374_post_disaster.png,148,40,1,896,1044,0,40,2711,123.66200233490899,37.478135336338624
6418,/media/marda/TWOTB1/xBD/hurricanes/images/florence/hurricane-florence_00000374_post_disaster.png,142,127,1,243,385,18,145,9772,135.7345149970615,97.13745362665868
6419,/media/marda/TWOTB1/xBD/hurricanes/images/florence/hurricane-florence_00000374_post_disaster.png,76,38,1,802,878,31,69,1079,41.30338606105049,34.39960844384552
6420,/media/marda/TWOTB1/xBD/hurricanes/images/florence/hurricane-florence_00000374_post_disaster.png,60,35,1,741,801,44,79,791,33.82735531590339,31.22645400235514
6421,/media/marda/TWOTB1/xBD/hurricanes/images/florence/hurricane-florence_00000374_post_disaster.png,125,81,1,919,1044,57,138,4135,97.7109894186973,60.66712740340022
6422,/media/marda/TWOTB1/xBD/hurricanes/images/florence/hurricane-florence_00000374_post_disaster.png,66,28,1,822,888,83,111,609,35.659071659742935,22.57646404477732
6423,/media/marda/TWOTB1/xBD/hurricanes/images/florence/hurricane-florence_00000374_post_disaster.png,81,74,1,56,137,96,170,3789,73.4645794085461,68.0537941767652
6424,/media/marda/TWOTB1/xBD/hurricanes/images/florence/hurricane-florence_00000374_post_disaster.png,90,43,1,806,896,105,148,1388,60.633866076060045,30.229948879504384
6425,/media/marda/TWOTB1/xBD/hurricanes/images/florence/hurricane-florence_00000374_post_disaster.png,49,30,1,642,691,113,143,438,24.840212318674045,23.1846990601905
6426,/media/marda/TWOTB1/xBD/hurricanes/images/florence/hurricane-florence_00000374_post_disaster.png,229,173,1,597,826,124,297,20660,184.52420940548475,152.0144180615699
6427,/media/marda/TWOTB1/xBD/hurricanes/images/florence/hurricane-florence_00000374_post_disaster.png,51,32,1,486,537,134,166,602,32.15502130001213,24.744638634462117
6428,/media/marda/TWOTB1/xBD/hurricanes/images/florence/hurricane-florence_00000374_post_disaster.png,55,48,1,412,467,158,206,944,43.55067255864696,31.08651764232299
6429,/media/marda/TWOTB1/xBD/hurricanes/images/florence/hurricane-florence_00000374_post_disaster.png,83,78,1,961,1044,168,246,2097,78.6002679663609,35.17770621370573
6430,/media/marda/TWOTB1/xBD/hurricanes/images/florence/hurricane-florence_00000374_post_disaster.png,64,54,1,505,569,184,238,1426,49.96366631949321,39.28125785819511
6431,/media/marda/TWOTB1/xBD/hurricanes/images/florence/hurricane-florence_00000374_post_disaster.png,28,23,1,422,450,199,222,124,13.902321555621084,12.616085837427928
6432,/media/marda/TWOTB1/xBD/hurricanes/images/florence/hurricane-florence_00000374_post_disaster.png,55,78,1,318,373,211,289,1713,73.04124446917638,32.0732540860517
6433,/media/marda/TWOTB1/xBD/hurricanes/images/florence/hurricane-florence_00000374_post_disaster.png,43,31,1,427,470,218,249,408,26.51794466204066,21.11849304615077
6434,/media/marda/TWOTB1/xBD/hurricanes/images/florence/hurricane-florence_00000374_post_disaster.png,52,39,1,394,446,239,278,525,31.585940084155894,22.695552799860828
6435,/media/marda/TWOTB1/xBD/hurricanes/images/florence/hurricane-florence_00000374_post_disaster.png,34,22,1,496,530,246,268,138,14.230298063479495,13.07470429443246
6436,/media/marda/TWOTB1/xBD/hurricanes/images/florence/hurricane-florence_00000374_post_disaster.png,36,32,1,443,479,249,281,287,23.738491613628078,16.21745474604539
6437,/media/marda/TWOTB1/xBD/hurricanes/images/florence/hurricane-florence_00000374_post_disaster.png,115,132,1,414,529,278,410,7757,124.78547772095588,87.91017526955987
6438,/media/marda/TWOTB1/xBD/hurricanes/images/florence/hurricane-florence_00000374_post_disaster.png,101,64,1,515,616,298,362,2609,79.67559156799376,44.52384453392119
6439,/media/marda/TWOTB1/xBD/hurricanes/images/florence/hurricane-florence_00000374_post_disaster.png,212,131,1,0,212,303,434,10420,235.31027621288052,67.87152443245026
6440,/media/marda/TWOTB1/xBD/hurricanes/images/florence/hurricane-florence_00000374_post_disaster.png,65,50,1,350,415,323,373,1138,52.620060816328554,28.859579684835634
6441,/media/marda/TWOTB1/xBD/hurricanes/images/florence/hurricane-florence_00000374_post_disaster.png,34,31,1,410,444,330,361,229,19.982187238310036,15.183945595654206
6442,/media/marda/TWOTB1/xBD/hurricanes/images/florence/hurricane-florence_00000374_post_disaster.png,97,88,1,849,946,366,454,2940,75.10206044095402,52.079514411444805
6443,/media/marda/TWOTB1/xBD/hurricanes/images/florence/hurricane-florence_00000374_post_disaster.png,88,84,1,716,804,375,459,2656,77.80791755398016,45.49172829007753
6444,/media/marda/TWOTB1/xBD/hurricanes/images/florence/hurricane-florence_00000374_post_disaster.png,29,37,1,98,127,398,435,325,25.12769652071382,17.27142439693383
6445,/media/marda/TWOTB1/xBD/hurricanes/images/florence/hurricane-florence_00000374_post_disaster.png,63,63,1,355,418,411,474,1441,45.15511536513212,42.45809432207905
6446,/media/marda/TWOTB1/xBD/hurricanes/images/florence/hurricane-florence_00000374_post_disaster.png,123,146,1,906,1029,432,578,5737,131.40069039504615,62.99674348212642
6447,/media/marda/TWOTB1/xBD/hurricanes/images/florence/hurricane-florence_00000374_post_disaster.png,124,89,1,497,621,441,530,4373,105.14187999445046,55.30332601929289
6448,/media/marda/TWOTB1/xBD/hurricanes/images/florence/hurricane-florence_00000374_post_disaster.png,84,96,1,621,705,463,559,3006,80.85117453010639,49.87580866949736
6449,/media/marda/TWOTB1/xBD/hurricanes/images/florence/hurricane-florence_00000374_post_disaster.png,110,95,1,394,504,474,569,4725,89.14185978539874,70.09032344539335
6450,/media/marda/TWOTB1/xBD/hurricanes/images/florence/hurricane-florence_00000374_post_disaster.png,75,63,1,0,75,479,542,1903,85.0260993693797,29.549797744493972
6451,/media/marda/TWOTB1/xBD/hurricanes/images/florence/hurricane-florence_00000374_post_disaster.png,87,85,1,69,156,483,568,3761,80.33414936793754,62.11100450566871
6452,/media/marda/TWOTB1/xBD/hurricanes/images/florence/hurricane-florence_00000374_post_disaster.png,83,98,1,550,633,500,598,2828,80.71616875812076,46.72838806271674
6453,/media/marda/TWOTB1/xBD/hurricanes/images/florence/hurricane-florence_00000374_post_disaster.png,50,51,1,36,86,535,586,812,54.69122380422338,19.688262101001012
6454,/media/marda/TWOTB1/xBD/hurricanes/images/florence/hurricane-florence_00000374_post_disaster.png,71,51,1,813,884,535,586,740,41.280760614127125,23.830415916817525
6455,/media/marda/TWOTB1/xBD/hurricanes/images/florence/hurricane-florence_00000374_post_disaster.png,115,97,1,614,729,537,634,4237,84.21349410340154,66.93150853443565
6456,/media/marda/TWOTB1/xBD/hurricanes/images/florence/hurricane-florence_00000374_post_disaster.png,128,188,1,226,354,543,731,11735,183.60362325175603,84.59992604977876
6457,/media/marda/TWOTB1/xBD/hurricanes/images/florence/hurricane-florence_00000374_post_disaster.png,82,60,1,418,500,546,606,1603,70.74316722302028,29.626187086071177
6458,/media/marda/TWOTB1/xBD/hurricanes/images/florence/hurricane-florence_00000374_post_disaster.png,110,112,1,480,590,557,669,5461,86.58274600614655,83.72373986328662
6459,/media/marda/TWOTB1/xBD/hurricanes/images/florence/hurricane-florence_00000374_post_disaster.png,78,62,1,859,937,559,621,1258,44.76896218885429,37.06129347491627
6460,/media/marda/TWOTB1/xBD/hurricanes/images/florence/hurricane-florence_00000374_post_disaster.png,76,81,1,804,880,571,652,1544,67.34359230825555,30.29387861969835
6461,/media/marda/TWOTB1/xBD/hurricanes/images/florence/hurricane-florence_00000374_post_disaster.png,80,83,1,765,845,583,666,1915,66.55509556648279,37.995690722514084
6462,/media/marda/TWOTB1/xBD/hurricanes/images/florence/hurricane-florence_00000374_post_disaster.png,173,214,1,88,261,591,805,16669,198.61290854343406,121.98740180175034
6463,/media/marda/TWOTB1/xBD/hurricanes/images/florence/hurricane-florence_00000374_post_disaster.png,32,77,1,58,90,604,681,889,59.14632100917138,19.837486370048786
6464,/media/marda/TWOTB1/xBD/hurricanes/images/florence/hurricane-florence_00000374_post_disaster.png,195,137,1,438,633,641,778,12421,184.91656427574165,90.18302944743176
6465,/media/marda/TWOTB1/xBD/hurricanes/images/florence/hurricane-florence_00000374_post_disaster.png,121,98,1,853,974,641,739,3577,79.93446751243398,67.7340816392582
6466,/media/marda/TWOTB1/xBD/hurricanes/images/florence/hurricane-florence_00000374_post_disaster.png,70,79,1,824,894,668,747,1146,59.91760498483697,25.392554034783586
6467,/media/marda/TWOTB1/xBD/hurricanes/images/florence/hurricane-florence_00000374_post_disaster.png,101,78,1,789,890,709,787,1823,67.33252992334806,40.921181052502725
6468,/media/marda/TWOTB1/xBD/hurricanes/images/florence/hurricane-florence_00000374_post_disaster.png,93,97,1,664,757,715,812,2342,71.04478155174053,53.80622385099435
6469,/media/marda/TWOTB1/xBD/hurricanes/images/florence/hurricane-florence_00000374_post_disaster.png,82,93,1,599,681,742,835,2320,61.540194842251175,50.938308625267204
6470,/media/marda/TWOTB1/xBD/hurricanes/images/florence/hurricane-florence_00000374_post_disaster.png,54,47,1,938,992,743,790,229,19.568933401035988,15.526801313643334
6471,/media/marda/TWOTB1/xBD/hurricanes/images/florence/hurricane-florence_00000374_post_disaster.png,185,143,1,128,313,746,889,11353,191.05583739704042,79.87510873496522
6472,/media/marda/TWOTB1/xBD/hurricanes/images/florence/hurricane-florence_00000374_post_disaster.png,137,129,1,485,622,756,885,7664,122.97891862856707,81.81505415365305
6473,/media/marda/TWOTB1/xBD/hurricanes/images/florence/hurricane-florence_00000374_post_disaster.png,89,103,1,642,731,802,905,2424,73.26743594246668,46.810057673456775
6474,/media/marda/TWOTB1/xBD/hurricanes/images/florence/hurricane-florence_00000374_post_disaster.png,76,75,1,968,1044,808,883,1266,42.817520612887726,39.051439692464584
6475,/media/marda/TWOTB1/xBD/hurricanes/images/florence/hurricane-florence_00000374_post_disaster.png,37,92,1,10,47,816,908,1476,59.640805956044,33.310427153386804
6476,/media/marda/TWOTB1/xBD/hurricanes/images/florence/hurricane-florence_00000374_post_disaster.png,145,188,1,304,449,821,1009,10925,169.64735919628603,90.07543648440956
6477,/media/marda/TWOTB1/xBD/hurricanes/images/florence/hurricane-florence_00000374_post_disaster.png,176,139,1,499,675,823,962,9127,150.16720965643788,83.5893299130074
6478,/media/marda/TWOTB1/xBD/hurricanes/images/florence/hurricane-florence_00000374_post_disaster.png,76,81,1,927,1003,828,909,1304,46.90036515895196,36.826968711866854
6479,/media/marda/TWOTB1/xBD/hurricanes/images/florence/hurricane-florence_00000374_post_disaster.png,84,77,1,837,921,841,918,1356,48.75874554919177,37.456284656121774
6480,/media/marda/TWOTB1/xBD/hurricanes/images/florence/hurricane-florence_00000374_post_disaster.png,185,146,1,127,312,855,1001,10510,185.94405023752137,79.28123979010392
6481,/media/marda/TWOTB1/xBD/hurricanes/images/florence/hurricane-florence_00000374_post_disaster.png,63,63,1,979,1042,860,923,469,29.301534016525725,21.688210068749065
6482,/media/marda/TWOTB1/xBD/hurricanes/images/florence/hurricane-florence_00000374_post_disaster.png,53,53,1,913,966,877,930,223,20.846661501390656,14.312327316514477
6483,/media/marda/TWOTB1/xBD/hurricanes/images/florence/hurricane-florence_00000374_post_disaster.png,83,80,1,853,936,878,958,1330,50.11549229185572,38.58177033876593
6484,/media/marda/TWOTB1/xBD/hurricanes/images/florence/hurricane-florence_00000374_post_disaster.png,82,95,1,747,829,882,977,1933,62.10291725702615,41.41905553954742
6485,/media/marda/TWOTB1/xBD/hurricanes/images/florence/hurricane-florence_00000374_post_disaster.png,57,54,1,929,986,902,956,222,21.25478446178986,13.90656266011059
6486,/media/marda/TWOTB1/xBD/hurricanes/images/florence/hurricane-florence_00000374_post_disaster.png,50,65,1,289,339,904,969,669,41.14405844467088,21.71671493180007
6487,/media/marda/TWOTB1/xBD/hurricanes/images/florence/hurricane-florence_00000374_post_disaster.png,101,125,1,709,810,910,1035,3445,97.94920830090162,47.304362252591794
6488,/media/marda/TWOTB1/xBD/hurricanes/images/florence/hurricane-florence_00000374_post_disaster.png,51,83,1,606,657,923,1006,788,48.63758141924781,22.13702243701281
6489,/media/marda/TWOTB1/xBD/hurricanes/images/florence/hurricane-florence_00000374_post_disaster.png,73,113,1,59,132,928,1041,3436,92.07680299464083,55.53943001867144
6490,/media/marda/TWOTB1/xBD/hurricanes/images/florence/hurricane-florence_00000374_post_disaster.png,115,107,1,530,645,934,1041,4665,87.93374833966901,70.92961452172894
6491,/media/marda/TWOTB1/xBD/hurricanes/images/florence/hurricane-florence_00000374_post_disaster.png,99,91,1,253,352,950,1041,3274,90.3138929104199,50.13579920734901
6492,/media/marda/TWOTB1/xBD/hurricanes/images/florence/hurricane-florence_00000374_post_disaster.png,93,74,1,894,987,967,1041,1392,60.414497765807866,31.0440503589828
6493,/media/marda/TWOTB1/xBD/hurricanes/images/florence/hurricane-florence_00000374_post_disaster.png,42,65,1,2,44,976,1041,837,40.549532023514764,28.066109337715403
6494,/media/marda/TWOTB1/xBD/hurricanes/images/florence/hurricane-florence_00000374_post_disaster.png,63,60,1,436,499,981,1041,762,45.567660784940664,22.921473056693873
6495,/media/marda/TWOTB1/xBD/hurricanes/images/florence/hurricane-florence_00000374_post_disaster.png,41,57,1,624,665,986,1043,191,17.590727137462594,15.342681477755276
6496,/media/marda/TWOTB1/xBD/hurricanes/images/florence/hurricane-florence_00000374_post_disaster.png,29,54,1,202,231,989,1043,217,20.598938137579182,14.092340698488744
6497,/media/marda/TWOTB1/xBD/hurricanes/images/florence/hurricane-florence_00000374_post_disaster.png,101,116,1,284,385,717,833,5232,84.85757872861954,81.28994994175305
6498,/media/marda/TWOTB1/xBD/hurricanes/images/florence/hurricane-florence_00000374_post_disaster.png,106,107,1,705,811,772,879,4099,78.78517881024634,69.02389398126277
6499,/media/marda/TWOTB1/xBD/hurricanes/images/florence/hurricane-florence_00000344_pre_disaster.png,50,16,1,129,179,0,16,508,48.96973125594249,14.429612996105963
6500,/media/marda/TWOTB1/xBD/hurricanes/images/florence/hurricane-florence_00000344_pre_disaster.png,35,22,1,183,218,18,40,542,31.99070653734708,22.52554094208279
6501,/media/marda/TWOTB1/xBD/hurricanes/images/florence/hurricane-florence_00000344_pre_disaster.png,49,25,1,250,299,23,48,818,45.80135824323046,23.859236855789977
6502,/media/marda/TWOTB1/xBD/hurricanes/images/florence/hurricane-florence_00000344_pre_disaster.png,67,28,1,381,448,26,54,1209,57.56313679277652,27.941199410441712
6503,/media/marda/TWOTB1/xBD/hurricanes/images/florence/hurricane-florence_00000344_pre_disaster.png,52,49,1,916,968,26,75,727,56.26070722960485,17.17259569356296
6504,/media/marda/TWOTB1/xBD/hurricanes/images/florence/hurricane-florence_00000344_pre_disaster.png,47,47,1,866,913,28,75,701,53.9655273984617,17.246090947237153
6505,/media/marda/TWOTB1/xBD/hurricanes/images/florence/hurricane-florence_00000344_pre_disaster.png,68,22,1,743,811,34,56,722,44.60728343467524,21.49744858478926
6506,/media/marda/TWOTB1/xBD/hurricanes/images/florence/hurricane-florence_00000344_pre_disaster.png,78,19,1,966,1044,42,61,568,43.33204651523827,18.78315640142821
6507,/media/marda/TWOTB1/xBD/hurricanes/images/florence/hurricane-florence_00000344_pre_disaster.png,46,35,1,827,873,49,84,443,39.37885787453612,15.014681021556536
6508,/media/marda/TWOTB1/xBD/hurricanes/images/florence/hurricane-florence_00000143_pre_disaster.png,201,159,1,761,962,33,192,6288,231.12509419124055,36.319805082187145
6509,/media/marda/TWOTB1/xBD/hurricanes/images/florence/hurricane-florence_00000143_pre_disaster.png,204,158,1,719,923,77,235,6436,233.04950290861885,36.724636886115455
6510,/media/marda/TWOTB1/xBD/hurricanes/images/florence/hurricane-florence_00000143_pre_disaster.png,132,113,1,912,1044,214,327,3497,131.76424884007673,35.43949431720832
6511,/media/marda/TWOTB1/xBD/hurricanes/images/florence/hurricane-florence_00000143_pre_disaster.png,58,30,1,981,1039,237,267,226,20.739251591778356,14.539695594429206
6512,/media/marda/TWOTB1/xBD/hurricanes/images/florence/hurricane-florence_00000143_pre_disaster.png,73,64,1,842,915,684,748,586,50.20720459862595,17.567066934991196
6513,/media/marda/TWOTB1/xBD/hurricanes/images/florence/hurricane-florence_00000143_pre_disaster.png,49,42,1,808,857,693,735,132,15.806547103459033,11.218822394551607
6514,/media/marda/TWOTB1/xBD/hurricanes/images/florence/hurricane-florence_00000458_post_disaster.png,85,37,1,393,478,0,37,1229,53.94448027253851,36.564678712422
6515,/media/marda/TWOTB1/xBD/hurricanes/images/florence/hurricane-florence_00000458_post_disaster.png,64,53,1,979,1043,0,53,863,62.56841801966848,20.461580865514563
6516,/media/marda/TWOTB1/xBD/hurricanes/images/florence/hurricane-florence_00000458_post_disaster.png,74,53,1,78,152,52,105,2143,68.14415940775676,44.58952304380487
6517,/media/marda/TWOTB1/xBD/hurricanes/images/florence/hurricane-florence_00000458_post_disaster.png,80,53,1,464,544,105,158,1554,56.38031422884023,39.78694528055564
6518,/media/marda/TWOTB1/xBD/hurricanes/images/florence/hurricane-florence_00000458_post_disaster.png,90,63,1,921,1011,133,196,1919,65.99434199832383,40.27930571592048
6519,/media/marda/TWOTB1/xBD/hurricanes/images/florence/hurricane-florence_00000458_post_disaster.png,79,65,1,795,874,144,209,2132,67.265888027533,46.632155211596306
6520,/media/marda/TWOTB1/xBD/hurricanes/images/florence/hurricane-florence_00000458_post_disaster.png,56,58,1,987,1043,144,202,809,58.90983961589077,18.125356520642125
6521,/media/marda/TWOTB1/xBD/hurricanes/images/florence/hurricane-florence_00000458_post_disaster.png,76,56,1,872,948,148,204,1824,57.00095005168543,43.88192866795211
6522,/media/marda/TWOTB1/xBD/hurricanes/images/florence/hurricane-florence_00000458_post_disaster.png,19,29,1,0,19,168,197,276,21.695229868780398,17.83023541618701
6523,/media/marda/TWOTB1/xBD/hurricanes/images/florence/hurricane-florence_00000458_post_disaster.png,18,30,1,0,18,197,227,273,22.61499223542057,17.310934713032136
6524,/media/marda/TWOTB1/xBD/hurricanes/images/florence/hurricane-florence_00000458_post_disaster.png,75,68,1,145,220,445,513,1731,59.47855633807092,41.220917113682646
6525,/media/marda/TWOTB1/xBD/hurricanes/images/florence/hurricane-florence_00000458_post_disaster.png,75,68,1,898,973,446,514,1243,56.02797154724055,31.80016073150321
6526,/media/marda/TWOTB1/xBD/hurricanes/images/florence/hurricane-florence_00000458_post_disaster.png,80,68,1,943,1023,446,514,1623,53.30552250275413,41.13791803070427
6527,/media/marda/TWOTB1/xBD/hurricanes/images/florence/hurricane-florence_00000458_post_disaster.png,72,68,1,853,925,462,530,1219,49.9565547401361,32.41002455104897
6528,/media/marda/TWOTB1/xBD/hurricanes/images/florence/hurricane-florence_00000458_post_disaster.png,58,57,1,985,1043,464,521,428,42.29090668514954,15.236409631864035
6529,/media/marda/TWOTB1/xBD/hurricanes/images/florence/hurricane-florence_00000458_post_disaster.png,73,70,1,366,439,491,561,1556,52.74075858305211,39.863960049681
6530,/media/marda/TWOTB1/xBD/hurricanes/images/florence/hurricane-florence_00000458_post_disaster.png,60,77,1,194,254,501,578,1566,53.23866987372817,42.89610936877908
6531,/media/marda/TWOTB1/xBD/hurricanes/images/florence/hurricane-florence_00000458_post_disaster.png,78,70,1,923,1001,560,630,1427,54.1470296978569,35.39301773200918
6532,/media/marda/TWOTB1/xBD/hurricanes/images/florence/hurricane-florence_00000458_post_disaster.png,79,57,1,880,959,569,626,1129,45.21072842115897,33.56594093564635
6533,/media/marda/TWOTB1/xBD/hurricanes/images/florence/hurricane-florence_00000458_post_disaster.png,61,64,1,982,1043,575,639,561,45.48312147559773,18.4763775838367
6534,/media/marda/TWOTB1/xBD/hurricanes/images/florence/hurricane-florence_00000458_post_disaster.png,61,75,1,284,345,601,676,1475,47.97924096027215,41.954607924557905
6535,/media/marda/TWOTB1/xBD/hurricanes/images/florence/hurricane-florence_00000458_post_disaster.png,86,71,1,903,989,625,696,1401,56.60331940052017,32.92626065609904
6536,/media/marda/TWOTB1/xBD/hurricanes/images/florence/hurricane-florence_00000458_post_disaster.png,77,67,1,574,651,650,717,1618,54.85095225246337,40.04326373878593
6537,/media/marda/TWOTB1/xBD/hurricanes/images/florence/hurricane-florence_00000458_post_disaster.png,75,61,1,900,975,680,741,778,41.405724435672965,28.83613391544541
6538,/media/marda/TWOTB1/xBD/hurricanes/images/florence/hurricane-florence_00000458_post_disaster.png,80,80,1,538,618,716,796,1742,60.65184643894725,40.781895250137424
6539,/media/marda/TWOTB1/xBD/hurricanes/images/florence/hurricane-florence_00000458_post_disaster.png,89,74,1,922,1011,721,795,1419,53.93434703864585,34.74429144382492
6540,/media/marda/TWOTB1/xBD/hurricanes/images/florence/hurricane-florence_00000458_post_disaster.png,61,64,1,982,1043,729,793,449,32.95044742434889,21.047096543394147
6541,/media/marda/TWOTB1/xBD/hurricanes/images/florence/hurricane-florence_00000458_post_disaster.png,71,83,1,972,1043,791,874,1115,48.00098557603555,34.23993738165875
6542,/media/marda/TWOTB1/xBD/hurricanes/images/florence/hurricane-florence_00000458_post_disaster.png,81,77,1,535,616,799,876,1896,57.856625980430266,46.887018247923116
6543,/media/marda/TWOTB1/xBD/hurricanes/images/florence/hurricane-florence_00000458_post_disaster.png,75,91,1,890,965,804,895,1543,59.975718340578865,35.32902385511952
6544,/media/marda/TWOTB1/xBD/hurricanes/images/florence/hurricane-florence_00000458_post_disaster.png,63,79,1,390,453,863,942,1718,56.43553864372477,41.00918007777012
6545,/media/marda/TWOTB1/xBD/hurricanes/images/florence/hurricane-florence_00000458_post_disaster.png,89,106,1,36,125,899,1005,2556,96.86173805910718,37.735821196478774
6546,/media/marda/TWOTB1/xBD/hurricanes/images/florence/hurricane-florence_00000458_post_disaster.png,81,91,1,947,1028,910,1001,1487,54.9772140979739,38.1090699390107
6547,/media/marda/TWOTB1/xBD/hurricanes/images/florence/hurricane-florence_00000458_post_disaster.png,60,85,1,400,460,919,1004,1631,51.522972706737725,43.97302191912897
6548,/media/marda/TWOTB1/xBD/hurricanes/images/florence/hurricane-florence_00000458_post_disaster.png,74,91,1,903,977,919,1010,1188,52.331158350878376,33.97613755097854
6549,/media/marda/TWOTB1/xBD/hurricanes/images/florence/hurricane-florence_00000458_post_disaster.png,87,84,1,539,626,957,1041,2201,65.80800961295668,47.38405759648408
6550,/media/marda/TWOTB1/xBD/hurricanes/images/florence/hurricane-florence_00000002_post_disaster.png,19,35,1,105,124,489,524,131,19.134867051332844,9.213919515782786
6551,/media/marda/TWOTB1/xBD/hurricanes/images/florence/hurricane-florence_00000002_post_disaster.png,46,60,1,6,52,511,571,972,40.93772380745823,31.685254716665657
6552,/media/marda/TWOTB1/xBD/hurricanes/images/florence/hurricane-florence_00000002_post_disaster.png,16,57,1,0,16,594,651,284,29.724374521819175,14.475322359861883
6553,/media/marda/TWOTB1/xBD/hurricanes/images/florence/hurricane-florence_00000002_post_disaster.png,20,51,1,104,124,842,893,187,17.907634026189974,14.064695410705562
6554,/media/marda/TWOTB1/xBD/hurricanes/images/florence/hurricane-florence_00000002_post_disaster.png,21,54,1,19,40,930,984,240,19.699500553830614,16.12534961332155
6555,/media/marda/TWOTB1/xBD/hurricanes/images/florence/hurricane-florence_00000002_post_disaster.png,48,72,1,6,54,969,1041,946,51.30712156208704,27.034689276321778
6556,/media/marda/TWOTB1/xBD/hurricanes/images/florence/hurricane-florence_00000050_post_disaster.png,62,58,1,438,500,316,374,1034,47.56652998274081,28.812348924949255
6557,/media/marda/TWOTB1/xBD/hurricanes/images/florence/hurricane-florence_00000050_post_disaster.png,78,80,1,511,589,102,182,3152,81.00369075526456,54.28635579349613
6558,/media/marda/TWOTB1/xBD/hurricanes/images/florence/hurricane-florence_00000050_post_disaster.png,50,42,1,467,517,259,301,766,32.8022309557462,31.040324279349566
6559,/media/marda/TWOTB1/xBD/hurricanes/images/florence/hurricane-florence_00000050_post_disaster.png,43,68,1,367,410,137,205,1336,71.70623927643669,24.871769690892286
6560,/media/marda/TWOTB1/xBD/hurricanes/images/florence/hurricane-florence_00000050_post_disaster.png,61,55,1,422,483,159,214,1765,51.36357199437959,46.48054693532784
6561,/media/marda/TWOTB1/xBD/hurricanes/images/florence/hurricane-florence_00000050_post_disaster.png,47,59,1,319,366,320,379,916,45.93676542072459,26.85312624252511
6562,/media/marda/TWOTB1/xBD/hurricanes/images/florence/hurricane-florence_00000264_pre_disaster.png,97,29,1,947,1044,127,156,812,65.61453896561008,16.31372503987583
6563,/media/marda/TWOTB1/xBD/hurricanes/images/florence/hurricane-florence_00000264_pre_disaster.png,65,28,1,563,628,151,179,785,45.9989719224572,22.612201148521603
6564,/media/marda/TWOTB1/xBD/hurricanes/images/florence/hurricane-florence_00000264_pre_disaster.png,54,27,1,504,558,160,187,579,35.657436893446906,22.030235199930473
6565,/media/marda/TWOTB1/xBD/hurricanes/images/florence/hurricane-florence_00000264_pre_disaster.png,70,47,1,644,714,179,226,1412,47.795879423935006,40.37492129350542
6566,/media/marda/TWOTB1/xBD/hurricanes/images/florence/hurricane-florence_00000264_pre_disaster.png,40,23,1,507,547,207,230,256,22.708121306123306,14.861089089763535
6567,/media/marda/TWOTB1/xBD/hurricanes/images/florence/hurricane-florence_00000514_pre_disaster.png,78,35,1,810,888,156,191,1114,48.90823342858419,30.310067195109603
6568,/media/marda/TWOTB1/xBD/hurricanes/images/florence/hurricane-florence_00000514_pre_disaster.png,44,29,1,706,750,199,228,272,22.706294418067976,16.27445904874957
6569,/media/marda/TWOTB1/xBD/hurricanes/images/florence/hurricane-florence_00000514_pre_disaster.png,46,54,1,459,505,546,600,480,34.767399894148184,18.439951016455375
6570,/media/marda/TWOTB1/xBD/hurricanes/images/florence/hurricane-florence_00000170_post_disaster.png,40,14,1,601,641,72,86,119,13.865182905883758,11.3604826353438
6571,/media/marda/TWOTB1/xBD/hurricanes/images/florence/hurricane-florence_00000170_post_disaster.png,100,43,1,603,703,123,166,1845,82.65321076437601,29.588916991540515
6572,/media/marda/TWOTB1/xBD/hurricanes/images/florence/hurricane-florence_00000170_post_disaster.png,45,18,1,722,767,134,152,150,16.296238204546054,12.18847170907476
6573,/media/marda/TWOTB1/xBD/hurricanes/images/florence/hurricane-florence_00000170_post_disaster.png,41,18,1,686,727,144,162,124,13.378591465300746,12.458663058356963
6574,/media/marda/TWOTB1/xBD/hurricanes/images/florence/hurricane-florence_00000170_post_disaster.png,59,30,1,744,803,165,195,520,30.970162438271654,22.449336453136443
6575,/media/marda/TWOTB1/xBD/hurricanes/images/florence/hurricane-florence_00000170_post_disaster.png,89,65,1,716,805,368,433,1927,60.31415041643165,43.0175130751713
6576,/media/marda/TWOTB1/xBD/hurricanes/images/florence/hurricane-florence_00000170_post_disaster.png,101,66,1,657,758,477,543,2040,78.69309071166676,43.31435131455791
6577,/media/marda/TWOTB1/xBD/hurricanes/images/florence/hurricane-florence_00000170_post_disaster.png,106,56,1,724,830,545,601,1449,74.77106914694865,27.584965890804458
6578,/media/marda/TWOTB1/xBD/hurricanes/images/florence/hurricane-florence_00000170_post_disaster.png,37,42,1,609,646,690,732,136,13.937857034140224,13.149591127947668
6579,/media/marda/TWOTB1/xBD/hurricanes/images/florence/hurricane-florence_00000170_post_disaster.png,40,52,1,716,756,905,957,92,16.98447330147785,7.310315324912255
6580,/media/marda/TWOTB1/xBD/hurricanes/images/florence/hurricane-florence_00000170_post_disaster.png,71,76,1,607,678,928,1004,1096,47.10362463361392,31.822520062826623
6581,/media/marda/TWOTB1/xBD/hurricanes/images/florence/hurricane-florence_00000421_post_disaster.png,107,44,1,408,515,55,99,2581,98.29684239917509,34.870935312264166
6582,/media/marda/TWOTB1/xBD/hurricanes/images/florence/hurricane-florence_00000421_post_disaster.png,170,42,1,789,959,78,120,3759,153.45383148641915,32.72357083098303
6583,/media/marda/TWOTB1/xBD/hurricanes/images/florence/hurricane-florence_00000421_post_disaster.png,104,49,1,395,499,130,179,2635,98.03005929906071,35.68541284676709
6584,/media/marda/TWOTB1/xBD/hurricanes/images/florence/hurricane-florence_00000421_post_disaster.png,128,75,1,363,491,158,233,3539,136.14590549024817,42.121867775639714
6585,/media/marda/TWOTB1/xBD/hurricanes/images/florence/hurricane-florence_00000421_post_disaster.png,56,59,1,527,583,195,254,1825,60.24969265007197,40.27350569681469
6586,/media/marda/TWOTB1/xBD/hurricanes/images/florence/hurricane-florence_00000421_post_disaster.png,122,58,1,377,499,238,296,3067,122.46108043346696,33.4088249282876
6587,/media/marda/TWOTB1/xBD/hurricanes/images/florence/hurricane-florence_00000421_post_disaster.png,31,18,1,600,631,312,330,37,7.424365877053523,6.36617392414642
6588,/media/marda/TWOTB1/xBD/hurricanes/images/florence/hurricane-florence_00000421_post_disaster.png,33,22,1,601,634,325,347,69,9.957750617574623,8.969720678405217
6589,/media/marda/TWOTB1/xBD/hurricanes/images/florence/hurricane-florence_00000421_post_disaster.png,34,21,1,611,645,325,346,74,10.355589381103238,9.154100781578054
6590,/media/marda/TWOTB1/xBD/hurricanes/images/florence/hurricane-florence_00000421_post_disaster.png,63,78,1,681,744,348,426,1893,70.15001005870242,36.102095071017004
6591,/media/marda/TWOTB1/xBD/hurricanes/images/florence/hurricane-florence_00000421_post_disaster.png,99,76,1,435,534,378,454,2696,92.82683980522324,42.44441840282924
6592,/media/marda/TWOTB1/xBD/hurricanes/images/florence/hurricane-florence_00000421_post_disaster.png,135,91,1,424,559,422,513,3591,141.04368428306796,39.67285858153395
6593,/media/marda/TWOTB1/xBD/hurricanes/images/florence/hurricane-florence_00000421_post_disaster.png,107,72,1,631,738,447,519,3208,82.61017580239401,52.95249768012126
6594,/media/marda/TWOTB1/xBD/hurricanes/images/florence/hurricane-florence_00000421_post_disaster.png,93,68,1,426,519,468,536,2351,80.09862682423258,40.109719846410414
6595,/media/marda/TWOTB1/xBD/hurricanes/images/florence/hurricane-florence_00000421_post_disaster.png,50,50,1,568,618,491,541,645,32.6674498474757,27.072931461974754
6596,/media/marda/TWOTB1/xBD/hurricanes/images/florence/hurricane-florence_00000421_post_disaster.png,63,46,1,507,570,495,541,857,45.91589095332728,24.720247816318757
6597,/media/marda/TWOTB1/xBD/hurricanes/images/florence/hurricane-florence_00000421_post_disaster.png,40,36,1,508,548,535,571,253,22.237057046041247,15.132714685281462
6598,/media/marda/TWOTB1/xBD/hurricanes/images/florence/hurricane-florence_00000421_post_disaster.png,96,87,1,491,587,624,711,2662,78.74896199043886,45.157396726349745
6599,/media/marda/TWOTB1/xBD/hurricanes/images/florence/hurricane-florence_00000421_post_disaster.png,69,89,1,568,637,644,733,2534,71.06573500628635,47.44449311203083
6600,/media/marda/TWOTB1/xBD/hurricanes/images/florence/hurricane-florence_00000421_post_disaster.png,64,69,1,771,835,788,857,710,32.15939623641115,29.232845708662456
6601,/media/marda/TWOTB1/xBD/hurricanes/images/florence/hurricane-florence_00000421_post_disaster.png,70,75,1,792,862,809,884,897,42.21033657415504,28.285419931598643
6602,/media/marda/TWOTB1/xBD/hurricanes/images/florence/hurricane-florence_00000421_post_disaster.png,97,78,1,762,859,876,954,1653,70.69413923304512,35.59661077900847
6603,/media/marda/TWOTB1/xBD/hurricanes/images/florence/hurricane-florence_00000202_pre_disaster.png,41,35,1,150,191,0,35,907,37.746815876043634,33.69184864528814
6604,/media/marda/TWOTB1/xBD/hurricanes/images/florence/hurricane-florence_00000202_pre_disaster.png,57,17,1,568,625,0,17,303,29.47438635157825,15.832949985232936
6605,/media/marda/TWOTB1/xBD/hurricanes/images/florence/hurricane-florence_00000202_pre_disaster.png,51,18,1,854,905,0,18,143,23.49458830308574,8.210875273062657
6606,/media/marda/TWOTB1/xBD/hurricanes/images/florence/hurricane-florence_00000202_pre_disaster.png,101,32,1,916,1017,0,32,1056,55.45060948747665,29.3053549457404
6607,/media/marda/TWOTB1/xBD/hurricanes/images/florence/hurricane-florence_00000202_pre_disaster.png,39,40,1,333,372,5,45,732,41.42108496275289,23.61830018479905
6608,/media/marda/TWOTB1/xBD/hurricanes/images/florence/hurricane-florence_00000202_pre_disaster.png,56,39,1,611,667,6,45,582,40.078178253547236,19.944965501934043
6609,/media/marda/TWOTB1/xBD/hurricanes/images/florence/hurricane-florence_00000202_pre_disaster.png,59,44,1,744,803,24,68,735,41.72438667329568,24.357228672863595
6610,/media/marda/TWOTB1/xBD/hurricanes/images/florence/hurricane-florence_00000202_pre_disaster.png,57,27,1,764,821,68,95,398,24.440100423607895,21.69466901286097
6611,/media/marda/TWOTB1/xBD/hurricanes/images/florence/hurricane-florence_00000202_pre_disaster.png,57,35,1,710,767,73,108,609,35.72454686834,22.13518461210095
6612,/media/marda/TWOTB1/xBD/hurricanes/images/florence/hurricane-florence_00000202_pre_disaster.png,55,31,1,708,763,117,148,380,23.097292880049636,21.794569531403724
6613,/media/marda/TWOTB1/xBD/hurricanes/images/florence/hurricane-florence_00000202_pre_disaster.png,82,59,1,951,1033,128,187,1805,54.237511323982865,44.04441529535745
6614,/media/marda/TWOTB1/xBD/hurricanes/images/florence/hurricane-florence_00000202_pre_disaster.png,75,49,1,674,749,142,191,1047,49.83081415782194,28.043667641412945
6615,/media/marda/TWOTB1/xBD/hurricanes/images/florence/hurricane-florence_00000202_pre_disaster.png,45,28,1,484,529,145,173,321,27.046230834575812,15.728597902579127
6616,/media/marda/TWOTB1/xBD/hurricanes/images/florence/hurricane-florence_00000202_pre_disaster.png,73,55,1,508,581,153,208,1234,52.34132580732695,35.82320958941591
6617,/media/marda/TWOTB1/xBD/hurricanes/images/florence/hurricane-florence_00000202_pre_disaster.png,50,28,1,762,812,161,189,240,25.04923210604432,12.823464768747023
6618,/media/marda/TWOTB1/xBD/hurricanes/images/florence/hurricane-florence_00000202_pre_disaster.png,50,17,1,909,959,191,208,90,12.399479486862164,9.776821660857772
6619,/media/marda/TWOTB1/xBD/hurricanes/images/florence/hurricane-florence_00000202_pre_disaster.png,58,32,1,753,811,195,227,394,30.064454429397426,17.511800209769955
6620,/media/marda/TWOTB1/xBD/hurricanes/images/florence/hurricane-florence_00000202_pre_disaster.png,48,42,1,173,221,197,239,1008,44.96024824361512,30.499213734814816
6621,/media/marda/TWOTB1/xBD/hurricanes/images/florence/hurricane-florence_00000202_pre_disaster.png,76,63,1,968,1044,199,262,1646,57.70239470719854,38.0738313016326
6622,/media/marda/TWOTB1/xBD/hurricanes/images/florence/hurricane-florence_00000202_pre_disaster.png,51,38,1,392,443,215,253,473,36.1268766352791,17.50176141428892
6623,/media/marda/TWOTB1/xBD/hurricanes/images/florence/hurricane-florence_00000202_pre_disaster.png,24,31,1,24,48,217,248,354,23.81144617171178,19.661656519916335
6624,/media/marda/TWOTB1/xBD/hurricanes/images/florence/hurricane-florence_00000202_pre_disaster.png,39,45,1,74,113,217,262,1031,38.07551185561116,35.546853192942855
6625,/media/marda/TWOTB1/xBD/hurricanes/images/florence/hurricane-florence_00000202_pre_disaster.png,63,57,1,457,520,223,280,1183,50.31772106960604,31.326000219834924
6626,/media/marda/TWOTB1/xBD/hurricanes/images/florence/hurricane-florence_00000202_pre_disaster.png,25,49,1,0,25,231,280,741,40.44143150023446,24.723489778622856
6627,/media/marda/TWOTB1/xBD/hurricanes/images/florence/hurricane-florence_00000202_pre_disaster.png,80,52,1,599,679,237,289,1296,59.665833198636996,28.362893899037058
6628,/media/marda/TWOTB1/xBD/hurricanes/images/florence/hurricane-florence_00000202_pre_disaster.png,59,36,1,939,998,243,279,383,28.186189733547167,18.06098126118793
6629,/media/marda/TWOTB1/xBD/hurricanes/images/florence/hurricane-florence_00000202_pre_disaster.png,45,29,1,585,630,275,304,238,21.157739246828484,15.031594297117413
6630,/media/marda/TWOTB1/xBD/hurricanes/images/florence/hurricane-florence_00000202_pre_disaster.png,79,60,1,655,734,279,339,1526,49.30065457136541,41.61404747153206
6631,/media/marda/TWOTB1/xBD/hurricanes/images/florence/hurricane-florence_00000202_pre_disaster.png,53,67,1,267,320,283,350,1696,60.88337628366664,38.714169156935995
6632,/media/marda/TWOTB1/xBD/hurricanes/images/florence/hurricane-florence_00000202_pre_disaster.png,43,32,1,158,201,294,326,657,40.86225352368587,21.217945105795398
6633,/media/marda/TWOTB1/xBD/hurricanes/images/florence/hurricane-florence_00000202_pre_disaster.png,63,64,1,981,1044,294,358,935,62.862571304730494,21.305152950354724
6634,/media/marda/TWOTB1/xBD/hurricanes/images/florence/hurricane-florence_00000202_pre_disaster.png,20,37,1,124,144,305,342,335,26.094421278667017,16.89710799368494
6635,/media/marda/TWOTB1/xBD/hurricanes/images/florence/hurricane-florence_00000202_pre_disaster.png,73,55,1,511,584,315,370,1211,47.88254604682486,33.92633482957741
6636,/media/marda/TWOTB1/xBD/hurricanes/images/florence/hurricane-florence_00000202_pre_disaster.png,83,57,1,866,949,327,384,1569,51.16986765344631,39.809016662426735
6637,/media/marda/TWOTB1/xBD/hurricanes/images/florence/hurricane-florence_00000202_pre_disaster.png,92,91,1,672,764,333,424,2150,88.18839096245814,37.87389053640246
6638,/media/marda/TWOTB1/xBD/hurricanes/images/florence/hurricane-florence_00000202_pre_disaster.png,43,63,1,146,189,350,413,1202,49.29062824227847,34.1948409698173
6639,/media/marda/TWOTB1/xBD/hurricanes/images/florence/hurricane-florence_00000202_pre_disaster.png,56,42,1,246,302,353,395,927,49.455756819106526,24.6405998123214
6640,/media/marda/TWOTB1/xBD/hurricanes/images/florence/hurricane-florence_00000202_pre_disaster.png,65,60,1,478,543,362,422,1181,42.929335828784026,36.65437038493045
6641,/media/marda/TWOTB1/xBD/hurricanes/images/florence/hurricane-florence_00000202_pre_disaster.png,26,45,1,115,141,374,419,510,35.021267817089694,19.742947797108616
6642,/media/marda/TWOTB1/xBD/hurricanes/images/florence/hurricane-florence_00000202_pre_disaster.png,57,53,1,236,293,416,469,1023,53.96934182723285,27.454128779176436
6643,/media/marda/TWOTB1/xBD/hurricanes/images/florence/hurricane-florence_00000202_pre_disaster.png,31,38,1,282,313,454,492,364,22.19480479730359,21.62968986992247
6644,/media/marda/TWOTB1/xBD/hurricanes/images/florence/hurricane-florence_00000202_pre_disaster.png,86,89,1,916,1002,465,554,2095,80.02669358204315,39.40187970090498
6645,/media/marda/TWOTB1/xBD/hurricanes/images/florence/hurricane-florence_00000202_pre_disaster.png,53,48,1,402,455,484,532,645,36.960708333192855,22.892559798343903
6646,/media/marda/TWOTB1/xBD/hurricanes/images/florence/hurricane-florence_00000202_pre_disaster.png,48,45,1,233,281,485,530,879,42.05190296216172,27.55642597887103
6647,/media/marda/TWOTB1/xBD/hurricanes/images/florence/hurricane-florence_00000202_pre_disaster.png,55,46,1,709,764,502,548,482,28.02126261398671,22.723492097335765
6648,/media/marda/TWOTB1/xBD/hurricanes/images/florence/hurricane-florence_00000202_pre_disaster.png,70,70,1,748,818,506,576,1323,47.16843050918058,36.80494019611162
6649,/media/marda/TWOTB1/xBD/hurricanes/images/florence/hurricane-florence_00000202_pre_disaster.png,51,64,1,363,414,524,588,941,41.7310866100302,30.041162284480787
6650,/media/marda/TWOTB1/xBD/hurricanes/images/florence/hurricane-florence_00000202_pre_disaster.png,58,61,1,398,456,533,594,796,43.369007324255044,24.48491603531551
6651,/media/marda/TWOTB1/xBD/hurricanes/images/florence/hurricane-florence_00000202_pre_disaster.png,75,84,1,937,1012,544,628,1469,68.41968131907238,28.40540472499418
6652,/media/marda/TWOTB1/xBD/hurricanes/images/florence/hurricane-florence_00000202_pre_disaster.png,68,73,1,769,837,610,683,1325,49.520173431932065,35.411271470520155
6653,/media/marda/TWOTB1/xBD/hurricanes/images/florence/hurricane-florence_00000202_pre_disaster.png,91,77,1,950,1041,640,717,1569,62.271934788555434,38.15158275458675
6654,/media/marda/TWOTB1/xBD/hurricanes/images/florence/hurricane-florence_00000202_pre_disaster.png,38,58,1,53,91,703,761,773,40.801226664948054,25.185647210182353
6655,/media/marda/TWOTB1/xBD/hurricanes/images/florence/hurricane-florence_00000202_pre_disaster.png,86,93,1,788,874,713,806,2116,64.53297629049978,47.96413287676218
6656,/media/marda/TWOTB1/xBD/hurricanes/images/florence/hurricane-florence_00000202_pre_disaster.png,76,70,1,967,1043,715,785,982,43.09390084472453,30.52451778569339
6657,/media/marda/TWOTB1/xBD/hurricanes/images/florence/hurricane-florence_00000202_pre_disaster.png,16,52,1,37,53,739,791,306,25.11020171779233,16.32804423188568
6658,/media/marda/TWOTB1/xBD/hurricanes/images/florence/hurricane-florence_00000202_pre_disaster.png,67,61,1,686,753,753,814,842,41.06821869784789,27.097182274009874
6659,/media/marda/TWOTB1/xBD/hurricanes/images/florence/hurricane-florence_00000202_pre_disaster.png,66,105,1,205,271,796,901,2438,69.36591590650549,47.73949463141405
6660,/media/marda/TWOTB1/xBD/hurricanes/images/florence/hurricane-florence_00000202_pre_disaster.png,55,67,1,32,87,798,865,1199,57.59345706067033,27.742439072008263
6661,/media/marda/TWOTB1/xBD/hurricanes/images/florence/hurricane-florence_00000202_pre_disaster.png,54,78,1,990,1044,801,879,392,46.6831518279706,12.172651465266675
6662,/media/marda/TWOTB1/xBD/hurricanes/images/florence/hurricane-florence_00000202_pre_disaster.png,42,101,1,16,58,877,978,1606,72.46057969817198,29.58632713017146
6663,/media/marda/TWOTB1/xBD/hurricanes/images/florence/hurricane-florence_00000202_pre_disaster.png,90,93,1,739,829,885,978,2298,59.55488725701357,50.97240178691655
6664,/media/marda/TWOTB1/xBD/hurricanes/images/florence/hurricane-florence_00000202_pre_disaster.png,35,61,1,188,223,942,1003,462,28.057372342084335,22.017989874119532
6665,/media/marda/TWOTB1/xBD/hurricanes/images/florence/hurricane-florence_00000202_pre_disaster.png,75,85,1,894,969,944,1029,1247,48.40461521707153,34.14118709329567
6666,/media/marda/TWOTB1/xBD/hurricanes/images/florence/hurricane-florence_00000202_pre_disaster.png,58,69,1,120,178,957,1026,1362,58.04871264839645,31.221637039420262
6667,/media/marda/TWOTB1/xBD/hurricanes/images/florence/hurricane-florence_00000401_post_disaster.png,45,20,1,180,225,14,34,685,43.96345462343421,20.832285059592007
6668,/media/marda/TWOTB1/xBD/hurricanes/images/florence/hurricane-florence_00000401_post_disaster.png,14,18,1,178,192,196,214,110,14.236069060978641,10.442386154521275
6669,/media/marda/TWOTB1/xBD/hurricanes/images/florence/hurricane-florence_00000401_post_disaster.png,43,40,1,188,231,220,260,659,39.663471259859314,23.922324090178122
6670,/media/marda/TWOTB1/xBD/hurricanes/images/florence/hurricane-florence_00000401_post_disaster.png,36,49,1,207,243,273,322,755,42.12473895354693,23.854023093442144
6671,/media/marda/TWOTB1/xBD/hurricanes/images/florence/hurricane-florence_00000401_post_disaster.png,23,39,1,194,217,296,335,282,27.028335068104855,14.262358879990249
6672,/media/marda/TWOTB1/xBD/hurricanes/images/florence/hurricane-florence_00000401_post_disaster.png,40,44,1,195,235,345,389,745,38.00656090173705,27.404560860591292
6673,/media/marda/TWOTB1/xBD/hurricanes/images/florence/hurricane-florence_00000301_pre_disaster.png,46,52,1,123,169,131,183,1158,51.07925187620649,32.89913837604835
6674,/media/marda/TWOTB1/xBD/hurricanes/images/florence/hurricane-florence_00000301_pre_disaster.png,20,16,1,202,222,161,177,91,13.876997068485343,8.820878193401512
6675,/media/marda/TWOTB1/xBD/hurricanes/images/florence/hurricane-florence_00000301_pre_disaster.png,17,17,1,184,201,164,181,97,12.161914027985116,10.709144938800144
6676,/media/marda/TWOTB1/xBD/hurricanes/images/florence/hurricane-florence_00000301_pre_disaster.png,38,33,1,225,263,168,201,855,34.278731231990356,33.241919588601746
6677,/media/marda/TWOTB1/xBD/hurricanes/images/florence/hurricane-florence_00000301_pre_disaster.png,24,24,1,270,294,202,226,127,14.241183660455258,11.944672574926955
6678,/media/marda/TWOTB1/xBD/hurricanes/images/florence/hurricane-florence_00000301_pre_disaster.png,64,40,1,535,599,232,272,917,45.44896818021805,27.118980026623824
6679,/media/marda/TWOTB1/xBD/hurricanes/images/florence/hurricane-florence_00000301_pre_disaster.png,13,72,1,0,13,466,538,677,62.54004211664144,14.442131607548713
6680,/media/marda/TWOTB1/xBD/hurricanes/images/florence/hurricane-florence_00000301_pre_disaster.png,74,73,1,165,239,518,591,2482,70.69010539777142,47.80281532775482
6681,/media/marda/TWOTB1/xBD/hurricanes/images/florence/hurricane-florence_00000301_pre_disaster.png,42,57,1,173,215,574,631,997,37.55810310005373,34.86386787163585
6682,/media/marda/TWOTB1/xBD/hurricanes/images/florence/hurricane-florence_00000301_pre_disaster.png,38,61,1,10,48,610,671,1216,42.92464297181391,36.882169090861204
6683,/media/marda/TWOTB1/xBD/hurricanes/images/florence/hurricane-florence_00000301_pre_disaster.png,23,47,1,3,26,749,796,358,25.07231440847476,18.9231031994611
6684,/media/marda/TWOTB1/xBD/hurricanes/images/florence/hurricane-florence_00000301_pre_disaster.png,24,40,1,170,194,756,796,184,22.15230794534029,11.169967047755005
6685,/media/marda/TWOTB1/xBD/hurricanes/images/florence/hurricane-florence_00000301_pre_disaster.png,91,80,1,667,758,860,940,2259,67.8930591089584,44.062252114386574
6686,/media/marda/TWOTB1/xBD/hurricanes/images/florence/hurricane-florence_00000301_pre_disaster.png,29,53,1,230,259,867,920,311,20.520907795975372,20.113329084453408
6687,/media/marda/TWOTB1/xBD/hurricanes/images/florence/hurricane-florence_00000301_pre_disaster.png,26,57,1,131,157,947,1004,250,19.8936081599013,16.825553969492606
6688,/media/marda/TWOTB1/xBD/hurricanes/images/florence/hurricane-florence_00000301_pre_disaster.png,12,46,1,49,61,949,995,120,13.808210118138652,11.489125293076057
6689,/media/marda/TWOTB1/xBD/hurricanes/images/florence/hurricane-florence_00000301_pre_disaster.png,24,63,1,128,152,979,1042,491,29.913817726696777,21.789788001082744
6690,/media/marda/TWOTB1/xBD/hurricanes/images/florence/hurricane-florence_00000155_post_disaster.png,47,15,1,973,1020,173,188,62,9.67820372683389,8.456869215608755
6691,/media/marda/TWOTB1/xBD/hurricanes/images/florence/hurricane-florence_00000155_post_disaster.png,52,28,1,909,961,303,331,124,15.847971027046828,10.506674137073942
6692,/media/marda/TWOTB1/xBD/hurricanes/images/florence/hurricane-florence_00000155_post_disaster.png,62,55,1,981,1043,508,563,428,34.95215343332064,16.83404963132492
6693,/media/marda/TWOTB1/xBD/hurricanes/images/florence/hurricane-florence_00000155_post_disaster.png,75,77,1,719,794,573,650,1358,61.787817310544504,28.933334196858393
6694,/media/marda/TWOTB1/xBD/hurricanes/images/florence/hurricane-florence_00000155_post_disaster.png,71,73,1,857,928,763,836,882,45.53047884456622,25.64646154903165
6695,/media/marda/TWOTB1/xBD/hurricanes/images/florence/hurricane-florence_00000155_post_disaster.png,46,54,1,584,630,786,840,346,22.889129607393343,19.83738743070008
6696,/media/marda/TWOTB1/xBD/hurricanes/images/florence/hurricane-florence_00000155_post_disaster.png,44,54,1,577,621,806,860,301,21.34130233825062,18.678842088482355
6697,/media/marda/TWOTB1/xBD/hurricanes/images/florence/hurricane-florence_00000155_post_disaster.png,60,74,1,600,660,813,887,811,40.66199008473148,27.80357386973288
6698,/media/marda/TWOTB1/xBD/hurricanes/images/florence/hurricane-florence_00000155_post_disaster.png,31,39,1,662,693,818,857,43,8.164468109336834,7.011246487717036
6699,/media/marda/TWOTB1/xBD/hurricanes/images/florence/hurricane-florence_00000155_post_disaster.png,42,56,1,575,617,888,944,288,20.731096531806436,18.41329345300438
6700,/media/marda/TWOTB1/xBD/hurricanes/images/florence/hurricane-florence_00000155_post_disaster.png,34,45,1,631,665,894,939,57,9.789635414721864,7.7863458220141215
6701,/media/marda/TWOTB1/xBD/hurricanes/images/florence/hurricane-florence_00000155_post_disaster.png,66,77,1,577,643,910,987,1114,44.822350725449596,33.40711508388456
6702,/media/marda/TWOTB1/xBD/hurricanes/images/florence/hurricane-florence_00000155_post_disaster.png,48,66,1,544,592,931,997,573,28.879999892703818,26.358726253925326
6703,/media/marda/TWOTB1/xBD/hurricanes/images/florence/hurricane-florence_00000253_pre_disaster.png,67,40,1,714,781,205,245,944,39.346615742842495,32.05019901057654
6704,/media/marda/TWOTB1/xBD/hurricanes/images/florence/hurricane-florence_00000253_pre_disaster.png,88,118,1,602,690,430,548,3918,112.26317153796911,56.281951212482944
6705,/media/marda/TWOTB1/xBD/hurricanes/images/florence/hurricane-florence_00000253_pre_disaster.png,55,53,1,668,723,744,797,333,28.385416431900868,15.70659082300479
6706,/media/marda/TWOTB1/xBD/hurricanes/images/florence/hurricane-florence_00000063_pre_disaster.png,32,35,1,344,376,0,35,363,40.004339431860636,12.1170382592631
6707,/media/marda/TWOTB1/xBD/hurricanes/images/florence/hurricane-florence_00000063_pre_disaster.png,35,26,1,390,425,0,26,345,28.739403648522632,16.081295737354942
6708,/media/marda/TWOTB1/xBD/hurricanes/images/florence/hurricane-florence_00000063_pre_disaster.png,31,7,1,446,477,0,7,66,15.146972296366496,6.1171522499347555
6709,/media/marda/TWOTB1/xBD/hurricanes/images/florence/hurricane-florence_00000063_pre_disaster.png,40,47,1,289,329,4,51,649,49.93421892677449,20.04351374174079
6710,/media/marda/TWOTB1/xBD/hurricanes/images/florence/hurricane-florence_00000063_pre_disaster.png,30,44,1,249,279,15,59,539,48.90048017854826,14.710337783980737
6711,/media/marda/TWOTB1/xBD/hurricanes/images/florence/hurricane-florence_00000063_pre_disaster.png,48,47,1,539,587,34,81,608,52.51632712905231,15.392353240090209
6712,/media/marda/TWOTB1/xBD/hurricanes/images/florence/hurricane-florence_00000063_pre_disaster.png,66,48,1,887,953,37,85,1013,48.783255621390275,27.566464678521797
6713,/media/marda/TWOTB1/xBD/hurricanes/images/florence/hurricane-florence_00000063_pre_disaster.png,56,25,1,706,762,43,68,503,29.343444767870725,22.664471037287456
6714,/media/marda/TWOTB1/xBD/hurricanes/images/florence/hurricane-florence_00000063_pre_disaster.png,80,61,1,759,839,43,104,1863,59.66774618185656,44.36801122898492
6715,/media/marda/TWOTB1/xBD/hurricanes/images/florence/hurricane-florence_00000063_pre_disaster.png,46,46,1,492,538,45,91,589,49.96096458727048,15.784353170150142
6716,/media/marda/TWOTB1/xBD/hurricanes/images/florence/hurricane-florence_00000063_pre_disaster.png,40,48,1,450,490,53,101,509,52.41151619364833,12.98345201637725
6717,/media/marda/TWOTB1/xBD/hurricanes/images/florence/hurricane-florence_00000063_pre_disaster.png,39,42,1,398,437,74,116,546,46.07929602375257,15.842948124225439
6718,/media/marda/TWOTB1/xBD/hurricanes/images/florence/hurricane-florence_00000063_pre_disaster.png,37,43,1,349,386,83,126,596,45.80317871955641,17.401177931702243
6719,/media/marda/TWOTB1/xBD/hurricanes/images/florence/hurricane-florence_00000063_pre_disaster.png,36,48,1,301,337,94,142,648,52.44810383334266,16.504735103300423
6720,/media/marda/TWOTB1/xBD/hurricanes/images/florence/hurricane-florence_00000063_pre_disaster.png,31,48,1,270,301,109,157,534,47.041115031065516,15.168112002833446
6721,/media/marda/TWOTB1/xBD/hurricanes/images/florence/hurricane-florence_00000063_pre_disaster.png,62,49,1,824,886,165,214,798,46.633018990813355,22.84517979626492
6722,/media/marda/TWOTB1/xBD/hurricanes/images/florence/hurricane-florence_00000063_pre_disaster.png,52,36,1,929,981,290,326,364,29.970856289863512,16.152531569081365
6723,/media/marda/TWOTB1/xBD/hurricanes/images/florence/hurricane-florence_00000063_pre_disaster.png,84,37,1,947,1031,325,362,537,52.37694854611532,13.631155294258773
6724,/media/marda/TWOTB1/xBD/hurricanes/images/florence/hurricane-florence_00000063_pre_disaster.png,56,40,1,796,852,332,372,438,26.182645785143222,22.213563248363467
6725,/media/marda/TWOTB1/xBD/hurricanes/images/florence/hurricane-florence_00000063_pre_disaster.png,72,48,1,837,909,335,383,714,42.794038915460106,24.67448613330363
6726,/media/marda/TWOTB1/xBD/hurricanes/images/florence/hurricane-florence_00000063_pre_disaster.png,86,36,1,947,1033,369,405,563,53.55160191127071,14.047409462306412
6727,/media/marda/TWOTB1/xBD/hurricanes/images/florence/hurricane-florence_00000063_pre_disaster.png,74,33,1,966,1040,412,445,328,40.18771864221245,10.913001960862287
6728,/media/marda/TWOTB1/xBD/hurricanes/images/florence/hurricane-florence_00000063_pre_disaster.png,81,42,1,857,938,421,463,523,53.01690352423947,13.173886116551976
6729,/media/marda/TWOTB1/xBD/hurricanes/images/florence/hurricane-florence_00000063_pre_disaster.png,42,28,1,845,887,437,465,92,11.634412038136189,10.554996084754272
6730,/media/marda/TWOTB1/xBD/hurricanes/images/florence/hurricane-florence_00000156_post_disaster.png,47,45,1,196,243,318,363,804,40.76075595688809,26.09953085468151
6731,/media/marda/TWOTB1/xBD/hurricanes/images/florence/hurricane-florence_00000156_post_disaster.png,21,27,1,272,293,361,388,126,15.460675566990657,10.997606776095687
6732,/media/marda/TWOTB1/xBD/hurricanes/images/florence/hurricane-florence_00000156_post_disaster.png,20,24,1,269,289,376,400,82,11.165219909949816,9.912854968713752
6733,/media/marda/TWOTB1/xBD/hurricanes/images/florence/hurricane-florence_00000156_post_disaster.png,21,26,1,328,349,420,446,78,10.57674055686882,9.8413991769168
6734,/media/marda/TWOTB1/xBD/hurricanes/images/florence/hurricane-florence_00000156_post_disaster.png,52,38,1,341,393,460,498,732,44.37260311876328,21.86010187543345
6735,/media/marda/TWOTB1/xBD/hurricanes/images/florence/hurricane-florence_00000101_post_disaster.png,56,46,1,506,562,73,119,965,43.34992155387939,30.062351572958317
6736,/media/marda/TWOTB1/xBD/hurricanes/images/florence/hurricane-florence_00000496_pre_disaster.png,34,76,1,0,34,786,862,767,47.8176067511754,22.57049723591278
6737,/media/marda/TWOTB1/xBD/hurricanes/images/florence/hurricane-florence_00000485_post_disaster.png,67,12,1,670,737,0,12,275,41.38790627514201,11.524069426358563
6738,/media/marda/TWOTB1/xBD/hurricanes/images/florence/hurricane-florence_00000485_post_disaster.png,84,37,1,928,1012,0,37,886,48.43929596313881,24.617787980873874
6739,/media/marda/TWOTB1/xBD/hurricanes/images/florence/hurricane-florence_00000485_post_disaster.png,47,27,1,477,524,16,43,425,25.5747591025989,22.214420671522593
6740,/media/marda/TWOTB1/xBD/hurricanes/images/florence/hurricane-florence_00000485_post_disaster.png,88,73,1,249,337,20,93,2663,71.73711697781211,52.31445173055305
6741,/media/marda/TWOTB1/xBD/hurricanes/images/florence/hurricane-florence_00000485_post_disaster.png,24,18,1,243,267,30,48,157,15.736486036481965,13.247519208719478
6742,/media/marda/TWOTB1/xBD/hurricanes/images/florence/hurricane-florence_00000485_post_disaster.png,22,16,1,239,261,47,63,116,16.77749259778487,9.088724975453424
6743,/media/marda/TWOTB1/xBD/hurricanes/images/florence/hurricane-florence_00000485_post_disaster.png,47,32,1,538,585,48,80,561,32.90046437167643,22.750920542267846
6744,/media/marda/TWOTB1/xBD/hurricanes/images/florence/hurricane-florence_00000485_post_disaster.png,72,62,1,182,254,79,141,1965,71.7757151013244,36.15404889854598
6745,/media/marda/TWOTB1/xBD/hurricanes/images/florence/hurricane-florence_00000485_post_disaster.png,32,18,1,468,500,86,104,205,17.304360277640285,15.906494188866237
6746,/media/marda/TWOTB1/xBD/hurricanes/images/florence/hurricane-florence_00000485_post_disaster.png,53,36,1,488,541,92,128,825,35.54025027095829,31.39631665019368
6747,/media/marda/TWOTB1/xBD/hurricanes/images/florence/hurricane-florence_00000485_post_disaster.png,69,44,1,681,750,93,137,693,53.838794789256895,17.195512934366718
6748,/media/marda/TWOTB1/xBD/hurricanes/images/florence/hurricane-florence_00000485_post_disaster.png,37,29,1,343,380,99,128,507,30.15454608645503,22.623301116211138
6749,/media/marda/TWOTB1/xBD/hurricanes/images/florence/hurricane-florence_00000485_post_disaster.png,104,76,1,799,903,100,176,2411,83.19325657797428,38.24377299521256
6750,/media/marda/TWOTB1/xBD/hurricanes/images/florence/hurricane-florence_00000485_post_disaster.png,44,40,1,273,317,101,141,791,33.946049940184345,31.130723774232045
6751,/media/marda/TWOTB1/xBD/hurricanes/images/florence/hurricane-florence_00000485_post_disaster.png,73,69,1,347,420,110,179,2020,69.19984084871822,42.7222171440932
6752,/media/marda/TWOTB1/xBD/hurricanes/images/florence/hurricane-florence_00000485_post_disaster.png,92,67,1,618,710,123,190,1892,76.70702671923284,32.51354287170901
6753,/media/marda/TWOTB1/xBD/hurricanes/images/florence/hurricane-florence_00000485_post_disaster.png,71,39,1,860,931,167,206,583,38.95773059352928,19.98502203366101
6754,/media/marda/TWOTB1/xBD/hurricanes/images/florence/hurricane-florence_00000485_post_disaster.png,54,41,1,597,651,175,216,492,39.094233197900394,17.40105526045296
6755,/media/marda/TWOTB1/xBD/hurricanes/images/florence/hurricane-florence_00000485_post_disaster.png,36,29,1,435,471,178,207,382,25.789102160445168,19.85164760045563
6756,/media/marda/TWOTB1/xBD/hurricanes/images/florence/hurricane-florence_00000485_post_disaster.png,37,18,1,351,388,205,223,188,27.33347611702193,9.473900034637424
6757,/media/marda/TWOTB1/xBD/hurricanes/images/florence/hurricane-florence_00000485_post_disaster.png,78,57,1,726,804,205,262,1126,52.274308264712126,28.73002710467208
6758,/media/marda/TWOTB1/xBD/hurricanes/images/florence/hurricane-florence_00000485_post_disaster.png,93,54,1,411,504,213,267,1872,80.75988826612574,33.42655911469965
6759,/media/marda/TWOTB1/xBD/hurricanes/images/florence/hurricane-florence_00000485_post_disaster.png,44,35,1,399,443,233,268,641,30.51220845246841,27.94849852239791
6760,/media/marda/TWOTB1/xBD/hurricanes/images/florence/hurricane-florence_00000485_post_disaster.png,71,42,1,757,828,243,285,756,35.48830572349173,28.821078031402035
6761,/media/marda/TWOTB1/xBD/hurricanes/images/florence/hurricane-florence_00000485_post_disaster.png,50,58,1,124,174,245,303,1188,46.08797261426609,34.81386176919911
6762,/media/marda/TWOTB1/xBD/hurricanes/images/florence/hurricane-florence_00000485_post_disaster.png,76,74,1,247,323,256,330,2044,67.32434903114871,40.55165782618426
6763,/media/marda/TWOTB1/xBD/hurricanes/images/florence/hurricane-florence_00000485_post_disaster.png,94,53,1,710,804,264,317,1408,69.61980587404015,26.990587578250846
6764,/media/marda/TWOTB1/xBD/hurricanes/images/florence/hurricane-florence_00000485_post_disaster.png,90,24,1,840,930,275,299,752,64.18849320317474,15.652496589862857
6765,/media/marda/TWOTB1/xBD/hurricanes/images/florence/hurricane-florence_00000485_post_disaster.png,61,31,1,776,837,295,326,405,32.21328099548321,16.811930668365143
6766,/media/marda/TWOTB1/xBD/hurricanes/images/florence/hurricane-florence_00000485_post_disaster.png,51,26,1,875,926,295,321,231,19.11849123387976,16.061415245816818
6767,/media/marda/TWOTB1/xBD/hurricanes/images/florence/hurricane-florence_00000485_post_disaster.png,26,28,1,316,342,305,333,106,17.085305890673215,8.245506111690993
6768,/media/marda/TWOTB1/xBD/hurricanes/images/florence/hurricane-florence_00000485_post_disaster.png,126,114,1,318,444,309,423,4866,124.51678202448085,56.199636268955985
6769,/media/marda/TWOTB1/xBD/hurricanes/images/florence/hurricane-florence_00000485_post_disaster.png,74,63,1,623,697,318,381,1372,45.25518078136508,44.41771806410571
6770,/media/marda/TWOTB1/xBD/hurricanes/images/florence/hurricane-florence_00000485_post_disaster.png,42,42,1,252,294,388,430,463,34.696444510788496,17.829107147510953
6771,/media/marda/TWOTB1/xBD/hurricanes/images/florence/hurricane-florence_00000485_post_disaster.png,108,95,1,561,669,416,511,2394,102.83861961946816,41.367599518921985
6772,/media/marda/TWOTB1/xBD/hurricanes/images/florence/hurricane-florence_00000485_post_disaster.png,61,65,1,309,370,419,484,705,65.78702298145306,14.292960605690235
6773,/media/marda/TWOTB1/xBD/hurricanes/images/florence/hurricane-florence_00000485_post_disaster.png,57,47,1,617,674,424,471,413,37.64587556417774,14.66150448426025
6774,/media/marda/TWOTB1/xBD/hurricanes/images/florence/hurricane-florence_00000485_post_disaster.png,65,55,1,632,697,439,494,789,36.777738351730754,28.63063264052673
6775,/media/marda/TWOTB1/xBD/hurricanes/images/florence/hurricane-florence_00000485_post_disaster.png,45,38,1,588,633,469,507,252,19.06800122189063,17.685934574766748
6776,/media/marda/TWOTB1/xBD/hurricanes/images/florence/hurricane-florence_00000485_post_disaster.png,41,48,1,213,254,481,529,436,37.51654405915605,15.564072146181779
6777,/media/marda/TWOTB1/xBD/hurricanes/images/florence/hurricane-florence_00000485_post_disaster.png,37,32,1,632,669,507,539,78,10.808103853568742,9.72928164530833
6778,/media/marda/TWOTB1/xBD/hurricanes/images/florence/hurricane-florence_00000485_post_disaster.png,67,73,1,976,1043,529,602,968,53.310586033715694,24.276273490400918
6779,/media/marda/TWOTB1/xBD/hurricanes/images/florence/hurricane-florence_00000485_post_disaster.png,59,87,1,184,243,547,634,1676,63.46075030318232,42.39191092982694
6780,/media/marda/TWOTB1/xBD/hurricanes/images/florence/hurricane-florence_00000485_post_disaster.png,39,62,1,89,128,600,662,593,42.850150847952804,18.48088867486179
6781,/media/marda/TWOTB1/xBD/hurricanes/images/florence/hurricane-florence_00000485_post_disaster.png,54,70,1,117,171,619,689,1121,46.02463584844318,32.78850205405738
6782,/media/marda/TWOTB1/xBD/hurricanes/images/florence/hurricane-florence_00000485_post_disaster.png,64,47,1,979,1043,620,667,269,29.60100723505047,12.113018478111035
6783,/media/marda/TWOTB1/xBD/hurricanes/images/florence/hurricane-florence_00000485_post_disaster.png,67,61,1,525,592,627,688,903,47.577414694678026,25.51452652389439
6784,/media/marda/TWOTB1/xBD/hurricanes/images/florence/hurricane-florence_00000485_post_disaster.png,25,54,1,35,60,633,687,423,27.02656266332347,20.946646241728548
6785,/media/marda/TWOTB1/xBD/hurricanes/images/florence/hurricane-florence_00000485_post_disaster.png,33,33,1,606,639,639,672,59,9.717979688328967,8.229845824962297
6786,/media/marda/TWOTB1/xBD/hurricanes/images/florence/hurricane-florence_00000485_post_disaster.png,70,60,1,909,979,669,729,791,33.39657487233805,31.702421977575465
6787,/media/marda/TWOTB1/xBD/hurricanes/images/florence/hurricane-florence_00000485_post_disaster.png,34,53,1,244,278,731,784,312,24.994492009231028,16.687104560568457
6788,/media/marda/TWOTB1/xBD/hurricanes/images/florence/hurricane-florence_00000485_post_disaster.png,50,76,1,62,112,737,813,1062,52.39085747729196,26.957112965165603
6789,/media/marda/TWOTB1/xBD/hurricanes/images/florence/hurricane-florence_00000485_post_disaster.png,18,46,1,25,43,739,785,165,15.89210996718547,13.796363543888845
6790,/media/marda/TWOTB1/xBD/hurricanes/images/florence/hurricane-florence_00000485_post_disaster.png,59,81,1,221,280,784,865,1182,53.39913828667415,29.570988331896228
6791,/media/marda/TWOTB1/xBD/hurricanes/images/florence/hurricane-florence_00000485_post_disaster.png,6,44,1,0,6,793,837,39,10.749310623292258,5.484781433190123
6792,/media/marda/TWOTB1/xBD/hurricanes/images/florence/hurricane-florence_00000485_post_disaster.png,199,132,1,844,1043,892,1024,4791,197.69998622159622,32.3331313286629
6793,/media/marda/TWOTB1/xBD/hurricanes/images/florence/hurricane-florence_00000485_post_disaster.png,46,88,1,223,269,896,984,1118,53.740974003245725,27.799523079601567
6794,/media/marda/TWOTB1/xBD/hurricanes/images/florence/hurricane-florence_00000485_post_disaster.png,60,65,1,747,807,952,1017,532,31.066280274971408,22.817073257959034
6795,/media/marda/TWOTB1/xBD/hurricanes/images/florence/hurricane-florence_00000485_post_disaster.png,28,64,1,0,28,977,1041,455,32.12361982733355,20.702650302353987
6796,/media/marda/TWOTB1/xBD/hurricanes/images/florence/hurricane-florence_00000224_pre_disaster.png,25,14,1,72,97,0,14,240,24.99462214945469,13.163279194849004
6797,/media/marda/TWOTB1/xBD/hurricanes/images/florence/hurricane-florence_00000224_pre_disaster.png,64,32,1,276,340,0,32,1027,56.93796975373427,23.70186314480892
6798,/media/marda/TWOTB1/xBD/hurricanes/images/florence/hurricane-florence_00000224_pre_disaster.png,65,37,1,197,262,25,62,1139,62.14157603879894,24.096407335809573
6799,/media/marda/TWOTB1/xBD/hurricanes/images/florence/hurricane-florence_00000224_pre_disaster.png,83,40,1,446,529,62,102,1467,69.96231788944964,27.529807634897125
6800,/media/marda/TWOTB1/xBD/hurricanes/images/florence/hurricane-florence_00000224_pre_disaster.png,38,18,1,521,559,71,89,214,17.76541780108155,15.787412915098194
6801,/media/marda/TWOTB1/xBD/hurricanes/images/florence/hurricane-florence_00000224_pre_disaster.png,58,30,1,358,416,88,118,785,47.12143049914923,21.9874698921742
6802,/media/marda/TWOTB1/xBD/hurricanes/images/florence/hurricane-florence_00000224_pre_disaster.png,64,58,1,671,735,166,224,1306,54.20206819281226,32.3980313774705
6803,/media/marda/TWOTB1/xBD/hurricanes/images/florence/hurricane-florence_00000224_pre_disaster.png,53,39,1,130,183,169,208,1089,51.43680233016131,27.896536577513853
6804,/media/marda/TWOTB1/xBD/hurricanes/images/florence/hurricane-florence_00000224_pre_disaster.png,47,42,1,537,584,174,216,551,40.72988813590524,19.09796207973216
6805,/media/marda/TWOTB1/xBD/hurricanes/images/florence/hurricane-florence_00000224_pre_disaster.png,65,60,1,580,645,186,246,1421,60.00583913983769,31.631919197087274
6806,/media/marda/TWOTB1/xBD/hurricanes/images/florence/hurricane-florence_00000224_pre_disaster.png,62,47,1,45,107,199,246,1412,63.8635449365568,29.284160532158573
6807,/media/marda/TWOTB1/xBD/hurricanes/images/florence/hurricane-florence_00000224_pre_disaster.png,37,28,1,553,590,208,236,214,19.874807425952994,14.281223212513035
6808,/media/marda/TWOTB1/xBD/hurricanes/images/florence/hurricane-florence_00000224_pre_disaster.png,13,22,1,18,31,213,235,108,14.071619621562194,10.217951400758404
6809,/media/marda/TWOTB1/xBD/hurricanes/images/florence/hurricane-florence_00000224_pre_disaster.png,47,27,1,634,681,214,241,260,20.17244113221449,16.94216276401482
6810,/media/marda/TWOTB1/xBD/hurricanes/images/florence/hurricane-florence_00000224_pre_disaster.png,16,19,1,110,126,245,264,82,11.91710727045179,9.336229629342597
6811,/media/marda/TWOTB1/xBD/hurricanes/images/florence/hurricane-florence_00000224_pre_disaster.png,10,28,1,0,10,247,275,129,20.015996634739505,9.225482815873503
6812,/media/marda/TWOTB1/xBD/hurricanes/images/florence/hurricane-florence_00000224_pre_disaster.png,39,27,1,660,699,253,280,158,18.710932783725728,11.207587401092335
6813,/media/marda/TWOTB1/xBD/hurricanes/images/florence/hurricane-florence_00000224_pre_disaster.png,66,67,1,655,721,410,477,786,62.35808041636895,16.72029988777459
6814,/media/marda/TWOTB1/xBD/hurricanes/images/florence/hurricane-florence_00000224_pre_disaster.png,37,31,1,651,688,468,499,121,13.254816143598303,11.926076574131107
6815,/media/marda/TWOTB1/xBD/hurricanes/images/florence/hurricane-florence_00000224_pre_disaster.png,71,42,1,918,989,481,523,565,35.20257797724877,21.457267049232613
6816,/media/marda/TWOTB1/xBD/hurricanes/images/florence/hurricane-florence_00000224_pre_disaster.png,45,39,1,677,722,515,554,178,18.97011422247473,14.010418168765572
6817,/media/marda/TWOTB1/xBD/hurricanes/images/florence/hurricane-florence_00000224_pre_disaster.png,68,58,1,696,764,516,574,611,45.46201229121681,22.969986091980665
6818,/media/marda/TWOTB1/xBD/hurricanes/images/florence/hurricane-florence_00000224_pre_disaster.png,64,64,1,647,711,575,639,709,52.4831898091243,18.536364896649584
6819,/media/marda/TWOTB1/xBD/hurricanes/images/florence/hurricane-florence_00000224_pre_disaster.png,60,58,1,574,634,666,724,436,47.03460834540454,12.392243002936347
6820,/media/marda/TWOTB1/xBD/hurricanes/images/florence/hurricane-florence_00000224_pre_disaster.png,38,47,1,558,596,680,727,260,22.06093712031022,15.340213621897004
6821,/media/marda/TWOTB1/xBD/hurricanes/images/florence/hurricane-florence_00000224_pre_disaster.png,28,40,1,475,503,736,776,72,10.127654814476266,9.609588347360633
6822,/media/marda/TWOTB1/xBD/hurricanes/images/florence/hurricane-florence_00000224_pre_disaster.png,81,88,1,474,555,737,825,1842,65.91153559067159,37.79683498657671
6823,/media/marda/TWOTB1/xBD/hurricanes/images/florence/hurricane-florence_00000477_post_disaster.png,21,28,1,201,222,491,519,110,13.269975230507708,11.178387738087915
6824,/media/marda/TWOTB1/xBD/hurricanes/images/florence/hurricane-florence_00000477_post_disaster.png,34,50,1,196,230,515,565,546,27.97155619601539,26.201572854856717
6825,/media/marda/TWOTB1/xBD/hurricanes/images/florence/hurricane-florence_00000477_post_disaster.png,62,49,1,497,559,518,567,836,46.76852078712188,23.64261745623322
6826,/media/marda/TWOTB1/xBD/hurricanes/images/florence/hurricane-florence_00000477_post_disaster.png,33,44,1,110,143,536,580,555,30.99914366049652,23.797939055494552
6827,/media/marda/TWOTB1/xBD/hurricanes/images/florence/hurricane-florence_00000477_post_disaster.png,40,62,1,438,478,558,620,507,46.201635041698395,14.677252798541662
6828,/media/marda/TWOTB1/xBD/hurricanes/images/florence/hurricane-florence_00000477_post_disaster.png,48,50,1,300,348,653,703,667,37.85998042554561,24.21037944160782
6829,/media/marda/TWOTB1/xBD/hurricanes/images/florence/hurricane-florence_00000477_post_disaster.png,31,49,1,170,201,676,725,533,29.034707041067378,24.226061872224285
6830,/media/marda/TWOTB1/xBD/hurricanes/images/florence/hurricane-florence_00000477_post_disaster.png,56,63,1,520,576,708,771,667,30.508222075193913,29.19626357252773
6831,/media/marda/TWOTB1/xBD/hurricanes/images/florence/hurricane-florence_00000477_post_disaster.png,34,85,1,282,316,837,922,747,58.98904257928013,16.841074949995456
6832,/media/marda/TWOTB1/xBD/hurricanes/images/florence/hurricane-florence_00000477_post_disaster.png,34,65,1,0,34,878,943,883,37.04470840769764,31.87874356572243
6833,/media/marda/TWOTB1/xBD/hurricanes/images/florence/hurricane-florence_00000477_post_disaster.png,60,57,1,253,313,935,992,930,54.2199720430654,22.62243345038835
6834,/media/marda/TWOTB1/xBD/hurricanes/images/florence/hurricane-florence_00000477_post_disaster.png,70,49,1,398,468,671,720,1300,62.23715054071371,27.85069753035944
6835,/media/marda/TWOTB1/xBD/hurricanes/images/florence/hurricane-florence_00000485_pre_disaster.png,67,12,1,670,737,0,12,275,41.38790627514201,11.524069426358563
6836,/media/marda/TWOTB1/xBD/hurricanes/images/florence/hurricane-florence_00000485_pre_disaster.png,84,37,1,928,1012,0,37,886,48.43929596313881,24.617787980873874
6837,/media/marda/TWOTB1/xBD/hurricanes/images/florence/hurricane-florence_00000485_pre_disaster.png,47,27,1,477,524,16,43,425,25.5747591025989,22.214420671522593
6838,/media/marda/TWOTB1/xBD/hurricanes/images/florence/hurricane-florence_00000485_pre_disaster.png,88,73,1,249,337,20,93,2663,71.73711697781211,52.31445173055305
6839,/media/marda/TWOTB1/xBD/hurricanes/images/florence/hurricane-florence_00000485_pre_disaster.png,24,18,1,243,267,30,48,157,15.736486036481965,13.247519208719478
6840,/media/marda/TWOTB1/xBD/hurricanes/images/florence/hurricane-florence_00000485_pre_disaster.png,22,16,1,239,261,47,63,116,16.77749259778487,9.088724975453424
6841,/media/marda/TWOTB1/xBD/hurricanes/images/florence/hurricane-florence_00000485_pre_disaster.png,47,32,1,538,585,48,80,561,32.90046437167643,22.750920542267846
6842,/media/marda/TWOTB1/xBD/hurricanes/images/florence/hurricane-florence_00000485_pre_disaster.png,72,62,1,182,254,79,141,1965,71.7757151013244,36.15404889854598
6843,/media/marda/TWOTB1/xBD/hurricanes/images/florence/hurricane-florence_00000485_pre_disaster.png,32,18,1,468,500,86,104,205,17.304360277640285,15.906494188866237
6844,/media/marda/TWOTB1/xBD/hurricanes/images/florence/hurricane-florence_00000485_pre_disaster.png,53,36,1,488,541,92,128,825,35.54025027095829,31.39631665019368
6845,/media/marda/TWOTB1/xBD/hurricanes/images/florence/hurricane-florence_00000485_pre_disaster.png,69,44,1,681,750,93,137,693,53.838794789256895,17.195512934366718
6846,/media/marda/TWOTB1/xBD/hurricanes/images/florence/hurricane-florence_00000485_pre_disaster.png,37,29,1,343,380,99,128,507,30.15454608645503,22.623301116211138
6847,/media/marda/TWOTB1/xBD/hurricanes/images/florence/hurricane-florence_00000485_pre_disaster.png,104,76,1,799,903,100,176,2411,83.19325657797428,38.24377299521256
6848,/media/marda/TWOTB1/xBD/hurricanes/images/florence/hurricane-florence_00000485_pre_disaster.png,44,40,1,273,317,101,141,791,33.946049940184345,31.130723774232045
6849,/media/marda/TWOTB1/xBD/hurricanes/images/florence/hurricane-florence_00000485_pre_disaster.png,73,69,1,347,420,110,179,2020,69.19984084871822,42.7222171440932
6850,/media/marda/TWOTB1/xBD/hurricanes/images/florence/hurricane-florence_00000485_pre_disaster.png,92,67,1,618,710,123,190,1892,76.70702671923284,32.51354287170901
6851,/media/marda/TWOTB1/xBD/hurricanes/images/florence/hurricane-florence_00000485_pre_disaster.png,71,39,1,860,931,167,206,583,38.95773059352928,19.98502203366101
6852,/media/marda/TWOTB1/xBD/hurricanes/images/florence/hurricane-florence_00000485_pre_disaster.png,54,41,1,597,651,175,216,492,39.094233197900394,17.40105526045296
6853,/media/marda/TWOTB1/xBD/hurricanes/images/florence/hurricane-florence_00000485_pre_disaster.png,36,29,1,435,471,178,207,382,25.789102160445168,19.85164760045563
6854,/media/marda/TWOTB1/xBD/hurricanes/images/florence/hurricane-florence_00000485_pre_disaster.png,37,18,1,351,388,205,223,188,27.33347611702193,9.473900034637424
6855,/media/marda/TWOTB1/xBD/hurricanes/images/florence/hurricane-florence_00000485_pre_disaster.png,78,57,1,726,804,205,262,1126,52.274308264712126,28.73002710467208
6856,/media/marda/TWOTB1/xBD/hurricanes/images/florence/hurricane-florence_00000485_pre_disaster.png,93,54,1,411,504,213,267,1872,80.75988826612574,33.42655911469965
6857,/media/marda/TWOTB1/xBD/hurricanes/images/florence/hurricane-florence_00000485_pre_disaster.png,44,35,1,399,443,233,268,641,30.51220845246841,27.94849852239791
6858,/media/marda/TWOTB1/xBD/hurricanes/images/florence/hurricane-florence_00000485_pre_disaster.png,71,42,1,757,828,243,285,756,35.48830572349173,28.821078031402035
6859,/media/marda/TWOTB1/xBD/hurricanes/images/florence/hurricane-florence_00000485_pre_disaster.png,50,58,1,124,174,245,303,1188,46.08797261426609,34.81386176919911
6860,/media/marda/TWOTB1/xBD/hurricanes/images/florence/hurricane-florence_00000485_pre_disaster.png,76,74,1,247,323,256,330,2044,67.32434903114871,40.55165782618426
6861,/media/marda/TWOTB1/xBD/hurricanes/images/florence/hurricane-florence_00000485_pre_disaster.png,94,53,1,710,804,264,317,1408,69.61980587404015,26.990587578250846
6862,/media/marda/TWOTB1/xBD/hurricanes/images/florence/hurricane-florence_00000485_pre_disaster.png,90,24,1,840,930,275,299,752,64.18849320317474,15.652496589862857
6863,/media/marda/TWOTB1/xBD/hurricanes/images/florence/hurricane-florence_00000485_pre_disaster.png,61,31,1,776,837,295,326,405,32.21328099548321,16.811930668365143
6864,/media/marda/TWOTB1/xBD/hurricanes/images/florence/hurricane-florence_00000485_pre_disaster.png,51,26,1,875,926,295,321,231,19.11849123387976,16.061415245816818
6865,/media/marda/TWOTB1/xBD/hurricanes/images/florence/hurricane-florence_00000485_pre_disaster.png,26,28,1,316,342,305,333,106,17.085305890673215,8.245506111690993
6866,/media/marda/TWOTB1/xBD/hurricanes/images/florence/hurricane-florence_00000485_pre_disaster.png,126,114,1,318,444,309,423,4866,124.51678202448085,56.199636268955985
6867,/media/marda/TWOTB1/xBD/hurricanes/images/florence/hurricane-florence_00000485_pre_disaster.png,74,63,1,623,697,318,381,1372,45.25518078136508,44.41771806410571
6868,/media/marda/TWOTB1/xBD/hurricanes/images/florence/hurricane-florence_00000485_pre_disaster.png,42,42,1,252,294,388,430,463,34.696444510788496,17.829107147510953
6869,/media/marda/TWOTB1/xBD/hurricanes/images/florence/hurricane-florence_00000485_pre_disaster.png,108,95,1,561,669,416,511,2394,102.83861961946816,41.367599518921985
6870,/media/marda/TWOTB1/xBD/hurricanes/images/florence/hurricane-florence_00000485_pre_disaster.png,61,65,1,309,370,419,484,705,65.78702298145306,14.292960605690235
6871,/media/marda/TWOTB1/xBD/hurricanes/images/florence/hurricane-florence_00000485_pre_disaster.png,57,47,1,617,674,424,471,413,37.64587556417774,14.66150448426025
6872,/media/marda/TWOTB1/xBD/hurricanes/images/florence/hurricane-florence_00000485_pre_disaster.png,65,55,1,632,697,439,494,789,36.777738351730754,28.63063264052673
6873,/media/marda/TWOTB1/xBD/hurricanes/images/florence/hurricane-florence_00000485_pre_disaster.png,45,38,1,588,633,469,507,252,19.06800122189063,17.685934574766748
6874,/media/marda/TWOTB1/xBD/hurricanes/images/florence/hurricane-florence_00000485_pre_disaster.png,41,48,1,213,254,481,529,436,37.51654405915605,15.564072146181779
6875,/media/marda/TWOTB1/xBD/hurricanes/images/florence/hurricane-florence_00000485_pre_disaster.png,37,32,1,632,669,507,539,78,10.808103853568742,9.72928164530833
6876,/media/marda/TWOTB1/xBD/hurricanes/images/florence/hurricane-florence_00000485_pre_disaster.png,68,73,1,976,1044,529,602,997,53.348280269851585,24.834060091205664
6877,/media/marda/TWOTB1/xBD/hurricanes/images/florence/hurricane-florence_00000485_pre_disaster.png,59,87,1,184,243,547,634,1676,63.46075030318232,42.39191092982694
6878,/media/marda/TWOTB1/xBD/hurricanes/images/florence/hurricane-florence_00000485_pre_disaster.png,39,62,1,89,128,600,662,593,42.850150847952804,18.48088867486179
6879,/media/marda/TWOTB1/xBD/hurricanes/images/florence/hurricane-florence_00000485_pre_disaster.png,54,70,1,117,171,619,689,1121,46.02463584844318,32.78850205405738
6880,/media/marda/TWOTB1/xBD/hurricanes/images/florence/hurricane-florence_00000485_pre_disaster.png,65,47,1,979,1044,620,667,278,30.149026077135005,12.28455750925673
6881,/media/marda/TWOTB1/xBD/hurricanes/images/florence/hurricane-florence_00000485_pre_disaster.png,67,61,1,525,592,627,688,903,47.577414694678026,25.51452652389439
6882,/media/marda/TWOTB1/xBD/hurricanes/images/florence/hurricane-florence_00000485_pre_disaster.png,25,54,1,35,60,633,687,423,27.02656266332347,20.946646241728548
6883,/media/marda/TWOTB1/xBD/hurricanes/images/florence/hurricane-florence_00000485_pre_disaster.png,33,33,1,606,639,639,672,59,9.717979688328967,8.229845824962297
6884,/media/marda/TWOTB1/xBD/hurricanes/images/florence/hurricane-florence_00000485_pre_disaster.png,70,60,1,909,979,669,729,791,33.39657487233805,31.702421977575465
6885,/media/marda/TWOTB1/xBD/hurricanes/images/florence/hurricane-florence_00000485_pre_disaster.png,34,53,1,244,278,731,784,312,24.994492009231028,16.687104560568457
6886,/media/marda/TWOTB1/xBD/hurricanes/images/florence/hurricane-florence_00000485_pre_disaster.png,50,76,1,62,112,737,813,1062,52.39085747729196,26.957112965165603
6887,/media/marda/TWOTB1/xBD/hurricanes/images/florence/hurricane-florence_00000485_pre_disaster.png,18,46,1,25,43,739,785,165,15.89210996718547,13.796363543888845
6888,/media/marda/TWOTB1/xBD/hurricanes/images/florence/hurricane-florence_00000485_pre_disaster.png,59,81,1,221,280,784,865,1182,53.39913828667415,29.570988331896228
6889,/media/marda/TWOTB1/xBD/hurricanes/images/florence/hurricane-florence_00000485_pre_disaster.png,6,44,1,0,6,793,837,39,10.749310623292258,5.484781433190123
6890,/media/marda/TWOTB1/xBD/hurricanes/images/florence/hurricane-florence_00000485_pre_disaster.png,200,131,1,844,1044,892,1023,4740,198.7293299971514,31.823178787581973
6891,/media/marda/TWOTB1/xBD/hurricanes/images/florence/hurricane-florence_00000485_pre_disaster.png,46,88,1,223,269,896,984,1118,53.740974003245725,27.799523079601567
6892,/media/marda/TWOTB1/xBD/hurricanes/images/florence/hurricane-florence_00000485_pre_disaster.png,60,65,1,747,807,952,1017,532,31.066280274971408,22.817073257959034
6893,/media/marda/TWOTB1/xBD/hurricanes/images/florence/hurricane-florence_00000485_pre_disaster.png,28,65,1,0,28,977,1042,477,32.26434692658986,21.472807766320194
6894,/media/marda/TWOTB1/xBD/hurricanes/images/florence/hurricane-florence_00000134_post_disaster.png,93,66,1,785,878,437,503,1495,52.34374117703592,40.025084633513046
6895,/media/marda/TWOTB1/xBD/hurricanes/images/florence/hurricane-florence_00000134_post_disaster.png,53,42,1,730,783,463,505,602,28.88323781829119,27.78325455595094
6896,/media/marda/TWOTB1/xBD/hurricanes/images/florence/hurricane-florence_00000134_post_disaster.png,31,39,1,343,374,619,658,252,20.85089190002344,16.207171429307735
6897,/media/marda/TWOTB1/xBD/hurricanes/images/florence/hurricane-florence_00000134_post_disaster.png,77,90,1,844,921,854,944,1611,59.2609426022708,36.27753849711873
6898,/media/marda/TWOTB1/xBD/hurricanes/images/florence/hurricane-florence_00000134_post_disaster.png,55,66,1,988,1043,975,1041,360,34.44472447724427,14.215691821305587
6899,/media/marda/TWOTB1/xBD/hurricanes/images/florence/hurricane-florence_00000324_pre_disaster.png,28,62,1,0,28,376,438,895,47.0755919105705,28.147685681142942
6900,/media/marda/TWOTB1/xBD/hurricanes/images/florence/hurricane-florence_00000324_pre_disaster.png,16,48,1,0,16,691,739,195,17.371690317130653,14.875958638485805
6901,/media/marda/TWOTB1/xBD/hurricanes/images/florence/hurricane-florence_00000394_pre_disaster.png,43,18,1,584,627,9,27,180,21.458583944047284,11.243798391858956
6902,/media/marda/TWOTB1/xBD/hurricanes/images/florence/hurricane-florence_00000394_pre_disaster.png,49,25,1,539,588,39,64,464,27.496479945691945,22.305026139231156
6903,/media/marda/TWOTB1/xBD/hurricanes/images/florence/hurricane-florence_00000394_pre_disaster.png,46,17,1,591,637,65,82,179,20.852101549186845,11.500621585872198
6904,/media/marda/TWOTB1/xBD/hurricanes/images/florence/hurricane-florence_00000394_pre_disaster.png,39,20,1,520,559,87,107,218,19.43582260511546,15.031101468122724
6905,/media/marda/TWOTB1/xBD/hurricanes/images/florence/hurricane-florence_00000394_pre_disaster.png,56,35,1,680,736,157,192,496,29.11137334359055,22.551866218512885
6906,/media/marda/TWOTB1/xBD/hurricanes/images/florence/hurricane-florence_00000061_post_disaster.png,48,26,1,700,748,202,228,246,19.043653982770724,17.263287990479032
6907,/media/marda/TWOTB1/xBD/hurricanes/images/florence/hurricane-florence_00000061_post_disaster.png,79,47,1,721,800,206,253,1173,51.35376213488042,31.800889284407305
6908,/media/marda/TWOTB1/xBD/hurricanes/images/florence/hurricane-florence_00000061_post_disaster.png,41,27,1,665,706,216,243,156,19.133595403714416,10.927539309269218
6909,/media/marda/TWOTB1/xBD/hurricanes/images/florence/hurricane-florence_00000061_post_disaster.png,56,55,1,404,460,280,335,1214,48.650527026077086,33.099054969087874
6910,/media/marda/TWOTB1/xBD/hurricanes/images/florence/hurricane-florence_00000061_post_disaster.png,30,27,1,379,409,322,349,142,17.379297331154678,10.943621026731892
6911,/media/marda/TWOTB1/xBD/hurricanes/images/florence/hurricane-florence_00000061_post_disaster.png,42,51,1,243,285,342,393,848,36.931976093306496,30.667191097385583
6912,/media/marda/TWOTB1/xBD/hurricanes/images/florence/hurricane-florence_00000061_post_disaster.png,92,80,1,854,946,790,870,1746,57.97548019434702,39.26765226554888
6913,/media/marda/TWOTB1/xBD/hurricanes/images/florence/hurricane-florence_00000061_post_disaster.png,65,57,1,839,904,855,912,485,33.81800184541738,19.178177767590217
6914,/media/marda/TWOTB1/xBD/hurricanes/images/florence/hurricane-florence_00000309_pre_disaster.png,79,36,1,903,982,537,573,441,48.69617428705457,13.07665036045735
6915,/media/marda/TWOTB1/xBD/hurricanes/images/florence/hurricane-florence_00000309_pre_disaster.png,80,41,1,604,684,567,608,653,62.58473182966854,13.929892652682472
6916,/media/marda/TWOTB1/xBD/hurricanes/images/florence/hurricane-florence_00000309_pre_disaster.png,9,39,1,0,9,657,696,119,15.292692004910785,10.426974946601502
6917,/media/marda/TWOTB1/xBD/hurricanes/images/florence/hurricane-florence_00000309_pre_disaster.png,49,65,1,454,503,660,725,469,48.315815698994285,12.974173800468163
6918,/media/marda/TWOTB1/xBD/hurricanes/images/florence/hurricane-florence_00000309_pre_disaster.png,45,42,1,34,79,666,708,492,50.232777036577126,13.0845212583183
6919,/media/marda/TWOTB1/xBD/hurricanes/images/florence/hurricane-florence_00000309_pre_disaster.png,38,49,1,94,132,667,716,402,42.73424315154201,18.72405364485781
6920,/media/marda/TWOTB1/xBD/hurricanes/images/florence/hurricane-florence_00000309_pre_disaster.png,48,40,1,581,629,667,707,212,27.752901081103058,10.251694313599574
6921,/media/marda/TWOTB1/xBD/hurricanes/images/florence/hurricane-florence_00000309_pre_disaster.png,43,40,1,235,278,719,759,344,39.69709111751198,11.50822428277826
6922,/media/marda/TWOTB1/xBD/hurricanes/images/florence/hurricane-florence_00000309_pre_disaster.png,38,43,1,309,347,724,767,330,29.998231171705797,14.68609944250678
6923,/media/marda/TWOTB1/xBD/hurricanes/images/florence/hurricane-florence_00000309_pre_disaster.png,81,50,1,517,598,764,814,706,68.41102174172643,13.787895866501064
6924,/media/marda/TWOTB1/xBD/hurricanes/images/florence/hurricane-florence_00000309_pre_disaster.png,62,52,1,964,1026,790,842,378,26.174921085676043,19.329304939295035
6925,/media/marda/TWOTB1/xBD/hurricanes/images/florence/hurricane-florence_00000309_pre_disaster.png,72,64,1,806,878,797,861,854,40.066565658566745,28.553789628102955
6926,/media/marda/TWOTB1/xBD/hurricanes/images/florence/hurricane-florence_00000309_pre_disaster.png,78,49,1,931,1009,813,862,442,47.79213592983421,12.374917428879131
6927,/media/marda/TWOTB1/xBD/hurricanes/images/florence/hurricane-florence_00000309_pre_disaster.png,47,47,1,977,1024,817,864,93,16.728255629263465,7.461831770236174
6928,/media/marda/TWOTB1/xBD/hurricanes/images/florence/hurricane-florence_00000309_pre_disaster.png,67,79,1,248,315,877,956,1623,62.29919132491495,37.447377543723384
6929,/media/marda/TWOTB1/xBD/hurricanes/images/florence/hurricane-florence_00000309_pre_disaster.png,54,97,1,381,435,905,1002,1657,63.2793060412897,35.70738285322306
6930,/media/marda/TWOTB1/xBD/hurricanes/images/florence/hurricane-florence_00000309_pre_disaster.png,64,68,1,837,901,933,1001,784,33.424355356985515,31.332317573555528
6931,/media/marda/TWOTB1/xBD/hurricanes/images/florence/hurricane-florence_00000309_pre_disaster.png,84,66,1,721,805,939,1005,1298,62.00967822806064,27.66118179112902
6932,/media/marda/TWOTB1/xBD/hurricanes/images/florence/hurricane-florence_00000309_pre_disaster.png,73,67,1,928,1001,942,1009,748,39.96190505341096,24.80441415491833
6933,/media/marda/TWOTB1/xBD/hurricanes/images/florence/hurricane-florence_00000309_pre_disaster.png,73,80,1,529,602,956,1036,1454,51.91325666231695,37.628419696040886
6934,/media/marda/TWOTB1/xBD/hurricanes/images/florence/hurricane-florence_00000309_pre_disaster.png,23,52,1,220,243,959,1011,168,16.62236615608759,13.620492100176058
6935,/media/marda/TWOTB1/xBD/hurricanes/images/florence/hurricane-florence_00000309_pre_disaster.png,56,59,1,940,996,984,1043,198,16.710945208501446,15.844808351747876
6936,/media/marda/TWOTB1/xBD/hurricanes/images/florence/hurricane-florence_00000309_pre_disaster.png,58,49,1,902,960,995,1044,119,22.242549158966153,7.711348587097362
6937,/media/marda/TWOTB1/xBD/hurricanes/images/florence/hurricane-florence_00000109_pre_disaster.png,29,18,1,10,39,0,18,444,31.143044298584627,19.213379976720486
6938,/media/marda/TWOTB1/xBD/hurricanes/images/florence/hurricane-florence_00000109_pre_disaster.png,34,35,1,136,170,35,70,407,40.89343777187059,13.342986591000752
6939,/media/marda/TWOTB1/xBD/hurricanes/images/florence/hurricane-florence_00000109_pre_disaster.png,48,33,1,329,377,97,130,724,36.76829635832322,27.24241356198164
6940,/media/marda/TWOTB1/xBD/hurricanes/images/florence/hurricane-florence_00000109_pre_disaster.png,54,33,1,385,439,112,145,769,42.49499445111122,23.797637487119577
6941,/media/marda/TWOTB1/xBD/hurricanes/images/florence/hurricane-florence_00000109_pre_disaster.png,55,34,1,436,491,128,162,782,41.72545215944572,24.926806969108764
6942,/media/marda/TWOTB1/xBD/hurricanes/images/florence/hurricane-florence_00000109_pre_disaster.png,37,18,1,491,528,156,174,175,17.41426526167992,13.325064386563094
6943,/media/marda/TWOTB1/xBD/hurricanes/images/florence/hurricane-florence_00000109_pre_disaster.png,56,36,1,637,693,189,225,553,30.208697724529067,24.30749145953605
6944,/media/marda/TWOTB1/xBD/hurricanes/images/florence/hurricane-florence_00000109_pre_disaster.png,46,20,1,760,806,197,217,170,17.090903214250833,13.355013689356882
6945,/media/marda/TWOTB1/xBD/hurricanes/images/florence/hurricane-florence_00000109_pre_disaster.png,54,33,1,857,911,243,276,368,24.73301576878528,19.89620516908582
6946,/media/marda/TWOTB1/xBD/hurricanes/images/florence/hurricane-florence_00000305_pre_disaster.png,18,5,1,234,252,0,5,27,9.055859441242617,4.555365507922765
6947,/media/marda/TWOTB1/xBD/hurricanes/images/florence/hurricane-florence_00000305_pre_disaster.png,53,32,1,307,360,0,32,929,38.578255428614156,32.370267476160556
6948,/media/marda/TWOTB1/xBD/hurricanes/images/florence/hurricane-florence_00000305_pre_disaster.png,34,16,1,349,383,0,16,259,21.15204102202599,16.181986139775614
6949,/media/marda/TWOTB1/xBD/hurricanes/images/florence/hurricane-florence_00000305_pre_disaster.png,33,25,1,428,461,1,26,312,26.417983151596726,15.72903241604567
6950,/media/marda/TWOTB1/xBD/hurricanes/images/florence/hurricane-florence_00000305_pre_disaster.png,41,33,1,201,242,3,36,489,35.697967770119725,18.38510505533424
6951,/media/marda/TWOTB1/xBD/hurricanes/images/florence/hurricane-florence_00000305_pre_disaster.png,78,74,1,433,511,8,82,2364,84.01763576439785,41.15938925052904
6952,/media/marda/TWOTB1/xBD/hurricanes/images/florence/hurricane-florence_00000305_pre_disaster.png,56,24,1,389,445,20,44,757,43.24256833347007,23.833283639411437
6953,/media/marda/TWOTB1/xBD/hurricanes/images/florence/hurricane-florence_00000305_pre_disaster.png,48,32,1,462,510,62,94,710,33.334799438209664,28.60637043550074
6954,/media/marda/TWOTB1/xBD/hurricanes/images/florence/hurricane-florence_00000305_pre_disaster.png,73,50,1,385,458,100,150,1308,63.88328863243546,35.510550179127776
6955,/media/marda/TWOTB1/xBD/hurricanes/images/florence/hurricane-florence_00000305_pre_disaster.png,49,36,1,446,495,126,162,590,30.247008988895278,26.287326888699678
6956,/media/marda/TWOTB1/xBD/hurricanes/images/florence/hurricane-florence_00000305_pre_disaster.png,52,46,1,686,738,342,388,655,35.88399757398938,24.217301824920472
6957,/media/marda/TWOTB1/xBD/hurricanes/images/florence/hurricane-florence_00000305_pre_disaster.png,45,47,1,0,45,346,393,743,49.06607952771851,22.794719889297326
6958,/media/marda/TWOTB1/xBD/hurricanes/images/florence/hurricane-florence_00000305_pre_disaster.png,65,51,1,964,1029,602,653,602,28.973962499760052,27.737344146459066
6959,/media/marda/TWOTB1/xBD/hurricanes/images/florence/hurricane-florence_00000305_pre_disaster.png,71,55,1,911,982,628,683,776,39.11426083633509,27.963390472734115
6960,/media/marda/TWOTB1/xBD/hurricanes/images/florence/hurricane-florence_00000305_pre_disaster.png,83,54,1,961,1044,640,694,806,48.77687735852492,28.208740559425205
6961,/media/marda/TWOTB1/xBD/hurricanes/images/florence/hurricane-florence_00000305_pre_disaster.png,67,67,1,891,958,667,734,1146,46.39129422200208,32.99166095107238
6962,/media/marda/TWOTB1/xBD/hurricanes/images/florence/hurricane-florence_00000305_pre_disaster.png,62,75,1,818,880,790,865,967,45.144212447933995,28.611934309220313
6963,/media/marda/TWOTB1/xBD/hurricanes/images/florence/hurricane-florence_00000305_pre_disaster.png,59,68,1,725,784,830,898,736,36.15123152146405,27.289858557464516
6964,/media/marda/TWOTB1/xBD/hurricanes/images/florence/hurricane-florence_00000305_pre_disaster.png,51,49,1,792,843,845,894,236,19.35016555297412,16.25221329355478
6965,/media/marda/TWOTB1/xBD/hurricanes/images/florence/hurricane-florence_00000305_pre_disaster.png,55,61,1,814,869,847,908,522,29.59484976983141,23.712829240807615
6966,/media/marda/TWOTB1/xBD/hurricanes/images/florence/hurricane-florence_00000305_pre_disaster.png,46,41,1,838,884,866,907,109,15.72328549216739,9.268102703511817
6967,/media/marda/TWOTB1/xBD/hurricanes/images/florence/hurricane-florence_00000379_post_disaster.png,72,49,1,448,520,187,236,1318,51.95206362954522,38.62069092913416
6968,/media/marda/TWOTB1/xBD/hurricanes/images/florence/hurricane-florence_00000379_post_disaster.png,94,39,1,606,700,214,253,1124,76.68492108399508,19.414983649505057
6969,/media/marda/TWOTB1/xBD/hurricanes/images/florence/hurricane-florence_00000379_post_disaster.png,60,42,1,737,797,310,352,701,31.716974318183766,29.532480669105862
6970,/media/marda/TWOTB1/xBD/hurricanes/images/florence/hurricane-florence_00000379_post_disaster.png,73,45,1,827,900,338,383,940,40.314140902938476,32.35706616644175
6971,/media/marda/TWOTB1/xBD/hurricanes/images/florence/hurricane-florence_00000075_pre_disaster.png,53,24,1,771,824,199,223,224,22.975124631411255,12.791068819237383
6972,/media/marda/TWOTB1/xBD/hurricanes/images/florence/hurricane-florence_00000075_pre_disaster.png,72,55,1,810,882,202,257,1021,49.67894459868116,27.971346858521823
6973,/media/marda/TWOTB1/xBD/hurricanes/images/florence/hurricane-florence_00000075_pre_disaster.png,63,59,1,877,940,294,353,915,49.022385496131974,24.86240106494802
6974,/media/marda/TWOTB1/xBD/hurricanes/images/florence/hurricane-florence_00000075_pre_disaster.png,55,24,1,818,873,303,327,186,24.582452190129036,10.08352005069515
6975,/media/marda/TWOTB1/xBD/hurricanes/images/florence/hurricane-florence_00000075_pre_disaster.png,43,28,1,828,871,328,356,112,15.688139257333985,9.63013133345746
6976,/media/marda/TWOTB1/xBD/hurricanes/images/florence/hurricane-florence_00000075_pre_disaster.png,44,22,1,959,1003,340,362,39,10.157991197156447,5.2947284868758615
6977,/media/marda/TWOTB1/xBD/hurricanes/images/florence/hurricane-florence_00000075_pre_disaster.png,62,62,1,890,952,354,416,709,55.79145823017785,16.826106971524784
6978,/media/marda/TWOTB1/xBD/hurricanes/images/florence/hurricane-florence_00000075_pre_disaster.png,71,62,1,923,994,423,485,1291,47.731075937406374,36.005952435302206
6979,/media/marda/TWOTB1/xBD/hurricanes/images/florence/hurricane-florence_00000075_pre_disaster.png,59,31,1,882,941,459,490,211,22.92473419526419,12.873929845996459
6980,/media/marda/TWOTB1/xBD/hurricanes/images/florence/hurricane-florence_00000075_pre_disaster.png,63,55,1,883,946,485,540,867,39.66373362319443,28.89043351943513
6981,/media/marda/TWOTB1/xBD/hurricanes/images/florence/hurricane-florence_00000075_pre_disaster.png,54,42,1,858,912,490,532,422,25.366214467093155,22.258618868821948
6982,/media/marda/TWOTB1/xBD/hurricanes/images/florence/hurricane-florence_00000075_pre_disaster.png,70,68,1,952,1022,510,578,1109,49.82599060038498,29.638397739028836
6983,/media/marda/TWOTB1/xBD/hurricanes/images/florence/hurricane-florence_00000075_pre_disaster.png,52,47,1,839,891,515,562,409,26.753763220779994,20.37242514711102
6984,/media/marda/TWOTB1/xBD/hurricanes/images/florence/hurricane-florence_00000075_pre_disaster.png,66,43,1,951,1017,609,652,398,32.56455508393733,16.186129915877334
6985,/media/marda/TWOTB1/xBD/hurricanes/images/florence/hurricane-florence_00000075_pre_disaster.png,79,48,1,759,838,714,762,519,55.24709847916999,12.558740279421194
6986,/media/marda/TWOTB1/xBD/hurricanes/images/florence/hurricane-florence_00000075_pre_disaster.png,65,47,1,594,659,747,794,414,46.12000228172394,11.936212680159395
6987,/media/marda/TWOTB1/xBD/hurricanes/images/florence/hurricane-florence_00000075_pre_disaster.png,60,43,1,813,873,756,799,276,31.9756886742517,11.610893278900969
6988,/media/marda/TWOTB1/xBD/hurricanes/images/florence/hurricane-florence_00000075_pre_disaster.png,43,60,1,691,734,760,820,422,34.844330468735606,16.203552037763817
6989,/media/marda/TWOTB1/xBD/hurricanes/images/florence/hurricane-florence_00000075_pre_disaster.png,65,57,1,917,982,760,817,385,30.735530843892334,16.748669440430113
6990,/media/marda/TWOTB1/xBD/hurricanes/images/florence/hurricane-florence_00000075_pre_disaster.png,58,70,1,723,781,773,843,533,44.95428998625442,16.29746723274371
6991,/media/marda/TWOTB1/xBD/hurricanes/images/florence/hurricane-florence_00000075_pre_disaster.png,48,39,1,884,932,782,821,97,12.915490910832396,10.159016270798155
6992,/media/marda/TWOTB1/xBD/hurricanes/images/florence/hurricane-florence_00000075_pre_disaster.png,36,53,1,504,540,788,841,177,21.27630568042606,11.149833392197463
6993,/media/marda/TWOTB1/xBD/hurricanes/images/florence/hurricane-florence_00000075_pre_disaster.png,73,49,1,784,857,796,845,434,48.233004486008944,12.017016377395636
6994,/media/marda/TWOTB1/xBD/hurricanes/images/florence/hurricane-florence_00000075_pre_disaster.png,57,76,1,521,578,812,888,901,44.82244705724254,32.320270740470264
6995,/media/marda/TWOTB1/xBD/hurricanes/images/florence/hurricane-florence_00000075_pre_disaster.png,34,46,1,496,530,813,859,90,14.739535464382833,8.180701196839944
6996,/media/marda/TWOTB1/xBD/hurricanes/images/florence/hurricane-florence_00000075_pre_disaster.png,55,47,1,734,789,824,871,267,30.42935951309428,11.786559866243268
6997,/media/marda/TWOTB1/xBD/hurricanes/images/florence/hurricane-florence_00000075_pre_disaster.png,48,46,1,640,688,825,871,253,26.279637953508402,12.904460201506394
6998,/media/marda/TWOTB1/xBD/hurricanes/images/florence/hurricane-florence_00000075_pre_disaster.png,22,46,1,128,150,957,1003,180,20.752509888364507,11.489125293076057
6999,/media/marda/TWOTB1/xBD/hurricanes/images/florence/hurricane-florence_00000075_pre_disaster.png,88,75,1,949,1037,967,1042,1359,48.769754138792436,39.14217833373814
7000,/media/marda/TWOTB1/xBD/hurricanes/images/florence/hurricane-florence_00000075_pre_disaster.png,11,45,1,85,96,973,1018,79,12.913033362661182,8.257740504251675
7001,/media/marda/TWOTB1/xBD/hurricanes/images/florence/hurricane-florence_00000273_pre_disaster.png,90,36,1,288,378,0,36,1603,75.91210430147818,30.957585792028652
7002,/media/marda/TWOTB1/xBD/hurricanes/images/florence/hurricane-florence_00000273_pre_disaster.png,49,30,1,712,761,43,73,344,32.667498184711086,14.11646786948298
7003,/media/marda/TWOTB1/xBD/hurricanes/images/florence/hurricane-florence_00000273_pre_disaster.png,78,43,1,474,552,46,89,1434,61.071390039875624,31.89064653638549
7004,/media/marda/TWOTB1/xBD/hurricanes/images/florence/hurricane-florence_00000273_pre_disaster.png,84,57,1,624,708,82,139,1888,50.94631889296132,48.90402012225518
7005,/media/marda/TWOTB1/xBD/hurricanes/images/florence/hurricane-florence_00000273_pre_disaster.png,78,72,1,729,807,196,268,1729,58.705808970035186,41.069507674758995
7006,/media/marda/TWOTB1/xBD/hurricanes/images/florence/hurricane-florence_00000273_pre_disaster.png,54,40,1,294,348,198,238,852,45.51989123717976,24.99489125660256
7007,/media/marda/TWOTB1/xBD/hurricanes/images/florence/hurricane-florence_00000273_pre_disaster.png,38,26,1,354,392,208,234,270,27.79792755352648,12.913070020874578
7008,/media/marda/TWOTB1/xBD/hurricanes/images/florence/hurricane-florence_00000273_pre_disaster.png,51,58,1,286,337,228,286,1240,49.43505548925741,34.90444757434489
7009,/media/marda/TWOTB1/xBD/hurricanes/images/florence/hurricane-florence_00000273_pre_disaster.png,32,27,1,277,309,336,363,209,23.190388335443895,12.09345967545535
7010,/media/marda/TWOTB1/xBD/hurricanes/images/florence/hurricane-florence_00000273_pre_disaster.png,41,48,1,231,272,367,415,710,33.14921387874958,28.721102484575805
7011,/media/marda/TWOTB1/xBD/hurricanes/images/florence/hurricane-florence_00000273_pre_disaster.png,23,28,1,270,293,374,402,151,14.656531733981598,13.84467102316414
7012,/media/marda/TWOTB1/xBD/hurricanes/images/florence/hurricane-florence_00000273_pre_disaster.png,23,27,1,302,325,442,469,121,12.649110640673518,12.649110640673518
7013,/media/marda/TWOTB1/xBD/hurricanes/images/florence/hurricane-florence_00000273_pre_disaster.png,33,32,1,188,221,489,521,228,30.38966912335241,9.958602622369979
7014,/media/marda/TWOTB1/xBD/hurricanes/images/florence/hurricane-florence_00000273_pre_disaster.png,49,63,1,170,219,497,560,1094,39.73780532795611,37.72668407743046
7015,/media/marda/TWOTB1/xBD/hurricanes/images/florence/hurricane-florence_00000273_pre_disaster.png,60,62,1,300,360,507,569,1220,51.26237408823156,33.83689357371451
7016,/media/marda/TWOTB1/xBD/hurricanes/images/florence/hurricane-florence_00000273_pre_disaster.png,25,41,1,261,286,562,603,209,21.285494870268984,13.146922975580214
7017,/media/marda/TWOTB1/xBD/hurricanes/images/florence/hurricane-florence_00000273_pre_disaster.png,28,65,1,296,324,715,780,460,40.74517067360233,15.099833768041778
7018,/media/marda/TWOTB1/xBD/hurricanes/images/florence/hurricane-florence_00000273_pre_disaster.png,64,70,1,335,399,821,891,1489,55.07590795352697,36.11390137304011
7019,/media/marda/TWOTB1/xBD/hurricanes/images/florence/hurricane-florence_00000273_pre_disaster.png,48,92,1,41,89,879,971,1315,63.283894917184305,27.705882103679713
7020,/media/marda/TWOTB1/xBD/hurricanes/images/florence/hurricane-florence_00000273_pre_disaster.png,28,58,1,142,170,885,943,264,20.67591982625066,17.085075931805846
7021,/media/marda/TWOTB1/xBD/hurricanes/images/florence/hurricane-florence_00000273_pre_disaster.png,73,111,1,141,214,925,1036,1835,89.6091389347032,29.44733717806463
7022,/media/marda/TWOTB1/xBD/hurricanes/images/florence/hurricane-florence_00000273_pre_disaster.png,24,45,1,393,417,934,979,85,11.147372866272212,10.118968209588605
7023,/media/marda/TWOTB1/xBD/hurricanes/images/florence/hurricane-florence_00000101_pre_disaster.png,56,47,1,506,562,72,119,978,43.878222712774985,30.225008543442094
7024,/media/marda/TWOTB1/xBD/hurricanes/images/florence/hurricane-florence_00000207_pre_disaster.png,44,38,1,218,262,195,233,646,30.624678046849354,27.86362612667892
7025,/media/marda/TWOTB1/xBD/hurricanes/images/florence/hurricane-florence_00000207_pre_disaster.png,25,29,1,127,152,222,251,196,22.891046284519195,11.489125293076057
7026,/media/marda/TWOTB1/xBD/hurricanes/images/florence/hurricane-florence_00000207_pre_disaster.png,56,64,1,140,196,236,300,1282,63.48863735124379,26.855562137327155
7027,/media/marda/TWOTB1/xBD/hurricanes/images/florence/hurricane-florence_00000207_pre_disaster.png,28,25,1,208,236,249,274,177,17.997738836554657,13.11087289285172
7028,/media/marda/TWOTB1/xBD/hurricanes/images/florence/hurricane-florence_00000207_pre_disaster.png,76,44,1,650,726,315,359,1090,53.71648172053785,26.929593456601165
7029,/media/marda/TWOTB1/xBD/hurricanes/images/florence/hurricane-florence_00000207_pre_disaster.png,48,37,1,420,468,392,429,297,36.37551267353167,10.89910517698655
7030,/media/marda/TWOTB1/xBD/hurricanes/images/florence/hurricane-florence_00000207_pre_disaster.png,55,50,1,400,455,427,477,656,35.960796478331396,24.746931314921056
7031,/media/marda/TWOTB1/xBD/hurricanes/images/florence/hurricane-florence_00000207_pre_disaster.png,70,62,1,508,578,443,505,1173,51.95198311387942,30.255936526887233
7032,/media/marda/TWOTB1/xBD/hurricanes/images/florence/hurricane-florence_00000207_pre_disaster.png,62,61,1,364,426,516,577,719,59.468730675179586,16.03720036577384
7033,/media/marda/TWOTB1/xBD/hurricanes/images/florence/hurricane-florence_00000287_pre_disaster.png,48,38,1,56,104,87,125,869,43.57008019904576,26.731650559285395
7034,/media/marda/TWOTB1/xBD/hurricanes/images/florence/hurricane-florence_00000287_pre_disaster.png,30,36,1,0,30,96,132,651,33.8967041632372,26.036653651870676
7035,/media/marda/TWOTB1/xBD/hurricanes/images/florence/hurricane-florence_00000287_pre_disaster.png,23,29,1,63,86,126,155,325,23.590244748593072,18.159435059922973
7036,/media/marda/TWOTB1/xBD/hurricanes/images/florence/hurricane-florence_00000287_pre_disaster.png,38,46,1,594,632,800,846,110,12.894642952807475,11.52589257491749
7037,/media/marda/TWOTB1/xBD/hurricanes/images/florence/hurricane-florence_00000287_pre_disaster.png,55,67,1,514,569,852,919,535,38.84183776910991,18.37797101074646
7038,/media/marda/TWOTB1/xBD/hurricanes/images/florence/hurricane-florence_00000287_pre_disaster.png,37,44,1,665,702,858,902,80,11.11051966537664,9.852098901517333
7039,/media/marda/TWOTB1/xBD/hurricanes/images/florence/hurricane-florence_00000094_post_disaster.png,76,61,1,307,383,0,61,2447,70.41198259888297,51.73717269716795
7040,/media/marda/TWOTB1/xBD/hurricanes/images/florence/hurricane-florence_00000094_post_disaster.png,46,73,1,118,164,9,82,1869,74.86153021427121,34.72230055400747
7041,/media/marda/TWOTB1/xBD/hurricanes/images/florence/hurricane-florence_00000094_post_disaster.png,64,45,1,594,658,81,126,1301,45.92677515021213,37.84624560893303
7042,/media/marda/TWOTB1/xBD/hurricanes/images/florence/hurricane-florence_00000094_post_disaster.png,62,41,1,127,189,92,133,1488,62.69952788110509,31.283469815420542
7043,/media/marda/TWOTB1/xBD/hurricanes/images/florence/hurricane-florence_00000094_post_disaster.png,62,45,1,42,104,95,140,1957,63.283193461457486,42.100828736564566
7044,/media/marda/TWOTB1/xBD/hurricanes/images/florence/hurricane-florence_00000094_post_disaster.png,53,52,1,420,473,121,173,1133,45.6888098979578,33.254923989107375
7045,/media/marda/TWOTB1/xBD/hurricanes/images/florence/hurricane-florence_00000094_post_disaster.png,60,50,1,376,436,154,204,1407,45.54616363941867,40.850341790527324
7046,/media/marda/TWOTB1/xBD/hurricanes/images/florence/hurricane-florence_00000094_post_disaster.png,53,34,1,623,676,170,204,638,29.702120001577008,28.357232397364857
7047,/media/marda/TWOTB1/xBD/hurricanes/images/florence/hurricane-florence_00000094_post_disaster.png,67,51,1,269,336,185,236,1864,55.90667181223044,44.29810895366225
7048,/media/marda/TWOTB1/xBD/hurricanes/images/florence/hurricane-florence_00000094_post_disaster.png,64,51,1,164,228,199,250,1520,59.992123661623594,33.803423115979484
7049,/media/marda/TWOTB1/xBD/hurricanes/images/florence/hurricane-florence_00000094_post_disaster.png,25,32,1,216,241,204,236,240,24.54560388062502,13.101399294303619
7050,/media/marda/TWOTB1/xBD/hurricanes/images/florence/hurricane-florence_00000094_post_disaster.png,58,51,1,634,692,219,270,1237,47.270704673952515,35.314163702911536
7051,/media/marda/TWOTB1/xBD/hurricanes/images/florence/hurricane-florence_00000094_post_disaster.png,52,45,1,92,144,241,286,1127,51.8032869421171,29.465194325618615
7052,/media/marda/TWOTB1/xBD/hurricanes/images/florence/hurricane-florence_00000094_post_disaster.png,53,45,1,24,77,268,313,1283,55.7703754504134,31.59186305846533
7053,/media/marda/TWOTB1/xBD/hurricanes/images/florence/hurricane-florence_00000094_post_disaster.png,68,75,1,638,706,276,351,1598,68.02234909571015,33.5634302389352
7054,/media/marda/TWOTB1/xBD/hurricanes/images/florence/hurricane-florence_00000094_post_disaster.png,92,139,1,446,538,317,456,5327,139.5337633418362,50.696753101557604
7055,/media/marda/TWOTB1/xBD/hurricanes/images/florence/hurricane-florence_00000094_post_disaster.png,46,61,1,0,46,340,401,1534,53.902706575090306,41.56319355515785
7056,/media/marda/TWOTB1/xBD/hurricanes/images/florence/hurricane-florence_00000094_post_disaster.png,52,35,1,686,738,389,424,437,26.43751683381466,21.70737227543527
7057,/media/marda/TWOTB1/xBD/hurricanes/images/florence/hurricane-florence_00000094_post_disaster.png,38,60,1,0,38,391,451,1076,43.98800845125316,34.181981882199445
7058,/media/marda/TWOTB1/xBD/hurricanes/images/florence/hurricane-florence_00000094_post_disaster.png,79,40,1,711,790,407,447,1072,57.48325449360241,24.753088087006837
7059,/media/marda/TWOTB1/xBD/hurricanes/images/florence/hurricane-florence_00000094_post_disaster.png,56,51,1,664,720,409,460,742,35.29471692510877,28.06152230626104
7060,/media/marda/TWOTB1/xBD/hurricanes/images/florence/hurricane-florence_00000094_post_disaster.png,70,88,1,386,456,431,519,2854,70.86841255756663,53.578203388719466
7061,/media/marda/TWOTB1/xBD/hurricanes/images/florence/hurricane-florence_00000094_post_disaster.png,36,74,1,37,73,448,522,1284,58.73469615608459,30.51208662584947
7062,/media/marda/TWOTB1/xBD/hurricanes/images/florence/hurricane-florence_00000094_post_disaster.png,152,110,1,418,570,481,591,8004,142.5399348698724,74.63803635661428
7063,/media/marda/TWOTB1/xBD/hurricanes/images/florence/hurricane-florence_00000094_post_disaster.png,67,41,1,878,945,531,572,619,35.84858904266746,22.803492000687765
7064,/media/marda/TWOTB1/xBD/hurricanes/images/florence/hurricane-florence_00000094_post_disaster.png,64,73,1,713,777,565,638,1170,54.92365911052841,28.258650395693333
7065,/media/marda/TWOTB1/xBD/hurricanes/images/florence/hurricane-florence_00000094_post_disaster.png,188,135,1,387,575,568,703,12062,176.87943700200384,92.10297773619008
7066,/media/marda/TWOTB1/xBD/hurricanes/images/florence/hurricane-florence_00000094_post_disaster.png,68,55,1,717,785,622,677,797,39.33521612270574,26.537221714476864
7067,/media/marda/TWOTB1/xBD/hurricanes/images/florence/hurricane-florence_00000094_post_disaster.png,76,87,1,563,639,692,779,2132,57.921147593470074,48.644720009732254
7068,/media/marda/TWOTB1/xBD/hurricanes/images/florence/hurricane-florence_00000094_post_disaster.png,72,65,1,746,818,707,772,979,42.36747357046285,30.25791015610296
7069,/media/marda/TWOTB1/xBD/hurricanes/images/florence/hurricane-florence_00000094_post_disaster.png,40,49,1,522,562,709,758,283,20.200135785507353,18.64977266741628
7070,/media/marda/TWOTB1/xBD/hurricanes/images/florence/hurricane-florence_00000094_post_disaster.png,69,77,1,466,535,720,797,1233,55.95761136518948,28.986205427679426
7071,/media/marda/TWOTB1/xBD/hurricanes/images/florence/hurricane-florence_00000094_post_disaster.png,52,79,1,0,52,743,822,1570,49.455564297495556,41.85603794169503
7072,/media/marda/TWOTB1/xBD/hurricanes/images/florence/hurricane-florence_00000094_post_disaster.png,72,76,1,518,590,767,843,1723,53.63817118983901,42.86069674387899
7073,/media/marda/TWOTB1/xBD/hurricanes/images/florence/hurricane-florence_00000094_post_disaster.png,165,142,1,177,342,781,923,9511,148.2539901429784,97.49997783134448
7074,/media/marda/TWOTB1/xBD/hurricanes/images/florence/hurricane-florence_00000094_post_disaster.png,79,76,1,600,679,784,860,1488,54.24378017462495,39.81156306267198
7075,/media/marda/TWOTB1/xBD/hurricanes/images/florence/hurricane-florence_00000094_post_disaster.png,68,51,1,902,970,792,843,542,34.939252590931936,20.438008988139472
7076,/media/marda/TWOTB1/xBD/hurricanes/images/florence/hurricane-florence_00000094_post_disaster.png,40,53,1,569,609,807,860,295,20.42280564441619,19.33255038260181
7077,/media/marda/TWOTB1/xBD/hurricanes/images/florence/hurricane-florence_00000094_post_disaster.png,115,84,1,840,955,825,909,3855,89.04224312713185,56.74148928616234
7078,/media/marda/TWOTB1/xBD/hurricanes/images/florence/hurricane-florence_00000094_post_disaster.png,56,50,1,931,987,835,885,302,22.034699802544168,18.250161148977032
7079,/media/marda/TWOTB1/xBD/hurricanes/images/florence/hurricane-florence_00000094_post_disaster.png,57,59,1,95,152,984,1043,706,51.670232741790414,18.800885505502666
7080,/media/marda/TWOTB1/xBD/hurricanes/images/florence/hurricane-florence_00000047_post_disaster.png,73,49,1,317,390,245,294,1343,68.38273252505742,30.857876703984765
7081,/media/marda/TWOTB1/xBD/hurricanes/images/florence/hurricane-florence_00000047_post_disaster.png,53,17,1,493,546,286,303,295,37.849334618218386,10.295469586590405
7082,/media/marda/TWOTB1/xBD/hurricanes/images/florence/hurricane-florence_00000047_post_disaster.png,68,47,1,633,701,488,535,1152,47.00012995351657,32.06617916098672
7083,/media/marda/TWOTB1/xBD/hurricanes/images/florence/hurricane-florence_00000047_post_disaster.png,55,52,1,695,750,491,543,860,38.698939973202386,29.479973595982287
7084,/media/marda/TWOTB1/xBD/hurricanes/images/florence/hurricane-florence_00000047_post_disaster.png,87,47,1,826,913,498,545,1248,58.40906362762575,27.882383111061156
7085,/media/marda/TWOTB1/xBD/hurricanes/images/florence/hurricane-florence_00000047_post_disaster.png,39,48,1,392,431,509,557,568,30.92204516567259,24.305599262386146
7086,/media/marda/TWOTB1/xBD/hurricanes/images/florence/hurricane-florence_00000047_post_disaster.png,37,56,1,353,390,512,568,812,40.52317580566768,26.524469145835813
7087,/media/marda/TWOTB1/xBD/hurricanes/images/florence/hurricane-florence_00000047_post_disaster.png,40,34,1,681,721,514,548,169,15.500708080604841,14.465654717216296
7088,/media/marda/TWOTB1/xBD/hurricanes/images/florence/hurricane-florence_00000047_post_disaster.png,44,36,1,674,718,537,573,269,20.708094966011497,17.249911814150508
7089,/media/marda/TWOTB1/xBD/hurricanes/images/florence/hurricane-florence_00000047_post_disaster.png,39,39,1,413,452,642,681,337,25.966515307470896,17.274319947490245
7090,/media/marda/TWOTB1/xBD/hurricanes/images/florence/hurricane-florence_00000047_post_disaster.png,57,87,1,347,404,646,733,1923,64.59122160497623,40.59001789021522
7091,/media/marda/TWOTB1/xBD/hurricanes/images/florence/hurricane-florence_00000047_post_disaster.png,58,63,1,410,468,658,721,1618,47.97008109893148,44.96136586073763
7092,/media/marda/TWOTB1/xBD/hurricanes/images/florence/hurricane-florence_00000047_post_disaster.png,46,59,1,46,92,703,762,1049,46.98802957700125,29.493630725324845
7093,/media/marda/TWOTB1/xBD/hurricanes/images/florence/hurricane-florence_00000047_post_disaster.png,35,47,1,69,104,759,806,468,35.74406524642073,17.734708421399542
7094,/media/marda/TWOTB1/xBD/hurricanes/images/florence/hurricane-florence_00000047_post_disaster.png,124,145,1,919,1043,869,1014,8473,120.5105242608046,93.87640659830195
7095,/media/marda/TWOTB1/xBD/hurricanes/images/florence/hurricane-florence_00000047_post_disaster.png,41,80,1,171,212,961,1041,1275,51.80569158200423,34.41883696928886
7096,/media/marda/TWOTB1/xBD/hurricanes/images/florence/hurricane-florence_00000047_post_disaster.png,80,59,1,950,1030,984,1043,617,46.52890343614476,17.99781233050507
7097,/media/marda/TWOTB1/xBD/hurricanes/images/florence/hurricane-florence_00000207_post_disaster.png,44,38,1,218,262,195,233,646,30.624678046849354,27.86362612667892
7098,/media/marda/TWOTB1/xBD/hurricanes/images/florence/hurricane-florence_00000207_post_disaster.png,56,64,1,140,196,236,300,1282,63.48863735124379,26.855562137327155
7099,/media/marda/TWOTB1/xBD/hurricanes/images/florence/hurricane-florence_00000207_post_disaster.png,28,25,1,208,236,249,274,177,17.997738836554657,13.11087289285172
7100,/media/marda/TWOTB1/xBD/hurricanes/images/florence/hurricane-florence_00000207_post_disaster.png,76,44,1,650,726,315,359,1090,53.71648172053785,26.929593456601165
7101,/media/marda/TWOTB1/xBD/hurricanes/images/florence/hurricane-florence_00000207_post_disaster.png,48,37,1,420,468,392,429,297,36.37551267353167,10.89910517698655
7102,/media/marda/TWOTB1/xBD/hurricanes/images/florence/hurricane-florence_00000207_post_disaster.png,55,50,1,400,455,427,477,656,35.960796478331396,24.746931314921056
7103,/media/marda/TWOTB1/xBD/hurricanes/images/florence/hurricane-florence_00000207_post_disaster.png,70,62,1,508,578,443,505,1173,51.95198311387942,30.255936526887233
7104,/media/marda/TWOTB1/xBD/hurricanes/images/florence/hurricane-florence_00000207_post_disaster.png,62,61,1,364,426,516,577,719,59.468730675179586,16.03720036577384
7105,/media/marda/TWOTB1/xBD/hurricanes/images/florence/hurricane-florence_00000409_pre_disaster.png,66,37,1,434,500,0,37,1200,47.05683089919826,35.37542240268947
7106,/media/marda/TWOTB1/xBD/hurricanes/images/florence/hurricane-florence_00000409_pre_disaster.png,77,43,1,581,658,0,43,1479,55.960871751948005,37.725763655755244
7107,/media/marda/TWOTB1/xBD/hurricanes/images/florence/hurricane-florence_00000409_pre_disaster.png,76,48,1,968,1044,12,60,1286,45.70611052568078,36.8627057714081
7108,/media/marda/TWOTB1/xBD/hurricanes/images/florence/hurricane-florence_00000409_pre_disaster.png,82,65,1,448,530,98,163,1986,60.09518275046401,47.80876999589661
7109,/media/marda/TWOTB1/xBD/hurricanes/images/florence/hurricane-florence_00000409_pre_disaster.png,76,58,1,264,340,128,186,2117,62.5216012208976,46.24886756488823
7110,/media/marda/TWOTB1/xBD/hurricanes/images/florence/hurricane-florence_00000409_pre_disaster.png,78,66,1,492,570,153,219,1912,63.58721968925899,42.1836308518652
7111,/media/marda/TWOTB1/xBD/hurricanes/images/florence/hurricane-florence_00000409_pre_disaster.png,91,83,1,711,802,170,253,2598,73.70109760133779,49.60802819359816
7112,/media/marda/TWOTB1/xBD/hurricanes/images/florence/hurricane-florence_00000409_pre_disaster.png,89,71,1,293,382,199,270,2506,70.66040140259271,51.30379034462957
7113,/media/marda/TWOTB1/xBD/hurricanes/images/florence/hurricane-florence_00000409_pre_disaster.png,55,71,1,55,110,207,278,1990,61.50565680984872,44.57115958668875
7114,/media/marda/TWOTB1/xBD/hurricanes/images/florence/hurricane-florence_00000409_pre_disaster.png,7,27,1,0,7,221,248,72,18.309838792656787,6.009749357297524
7115,/media/marda/TWOTB1/xBD/hurricanes/images/florence/hurricane-florence_00000409_pre_disaster.png,41,66,1,136,177,231,297,1278,56.555354665934324,31.559484639730083
7116,/media/marda/TWOTB1/xBD/hurricanes/images/florence/hurricane-florence_00000409_pre_disaster.png,95,77,1,577,672,278,355,2555,63.13872100386712,55.49387394530978
7117,/media/marda/TWOTB1/xBD/hurricanes/images/florence/hurricane-florence_00000409_pre_disaster.png,81,59,1,419,500,329,388,1988,65.38046447581777,41.33560926255082
7118,/media/marda/TWOTB1/xBD/hurricanes/images/florence/hurricane-florence_00000409_pre_disaster.png,52,70,1,92,144,349,419,1774,57.36777055616887,44.62468840131155
7119,/media/marda/TWOTB1/xBD/hurricanes/images/florence/hurricane-florence_00000409_pre_disaster.png,74,51,1,218,292,362,413,2032,70.3028253083835,39.61023515708867
7120,/media/marda/TWOTB1/xBD/hurricanes/images/florence/hurricane-florence_00000409_pre_disaster.png,86,74,1,846,932,375,449,1716,53.46200707209923,43.36128001958533
7121,/media/marda/TWOTB1/xBD/hurricanes/images/florence/hurricane-florence_00000409_pre_disaster.png,99,82,1,921,1020,478,560,2223,63.13563374589599,51.64430882395609
7122,/media/marda/TWOTB1/xBD/hurricanes/images/florence/hurricane-florence_00000409_pre_disaster.png,87,92,1,771,858,539,631,2237,67.0926939915284,48.76164792252352
7123,/media/marda/TWOTB1/xBD/hurricanes/images/florence/hurricane-florence_00000409_pre_disaster.png,96,79,1,835,931,666,745,1814,55.72950940950129,47.046271583498296
7124,/media/marda/TWOTB1/xBD/hurricanes/images/florence/hurricane-florence_00000409_pre_disaster.png,48,93,1,0,48,696,789,2095,75.83015874634177,39.052894168693655
7125,/media/marda/TWOTB1/xBD/hurricanes/images/florence/hurricane-florence_00000409_pre_disaster.png,96,86,1,868,964,801,887,2176,63.841009233266384,47.6809085557286
7126,/media/marda/TWOTB1/xBD/hurricanes/images/florence/hurricane-florence_00000409_pre_disaster.png,70,84,1,351,421,812,896,1689,51.38307849666353,45.92644718789319
7127,/media/marda/TWOTB1/xBD/hurricanes/images/florence/hurricane-florence_00000409_pre_disaster.png,16,81,1,0,16,856,937,726,54.42906791023788,17.62846869215576
7128,/media/marda/TWOTB1/xBD/hurricanes/images/florence/hurricane-florence_00000409_pre_disaster.png,67,92,1,106,173,864,956,2357,65.31917237892165,50.6136789090695
7129,/media/marda/TWOTB1/xBD/hurricanes/images/florence/hurricane-florence_00000409_pre_disaster.png,112,88,1,853,965,868,956,2558,73.62788724326992,52.515880672113965
7130,/media/marda/TWOTB1/xBD/hurricanes/images/florence/hurricane-florence_00000409_pre_disaster.png,88,84,1,457,545,879,963,2140,65.98222152087929,45.18208216987212
7131,/media/marda/TWOTB1/xBD/hurricanes/images/florence/hurricane-florence_00000409_pre_disaster.png,87,92,1,224,311,938,1030,2535,73.27849971063083,48.36660396388583
7132,/media/marda/TWOTB1/xBD/hurricanes/images/florence/hurricane-florence_00000409_pre_disaster.png,88,98,1,570,658,944,1042,2480,61.37915706376706,54.84164206195801
7133,/media/marda/TWOTB1/xBD/hurricanes/images/florence/hurricane-florence_00000409_pre_disaster.png,82,79,1,647,729,963,1042,1672,53.421676577706485,40.64265225674009
7134,/media/marda/TWOTB1/xBD/hurricanes/images/florence/hurricane-florence_00000409_pre_disaster.png,74,72,1,309,383,970,1042,1278,55.919913957976235,33.273368449660204
7135,/media/marda/TWOTB1/xBD/hurricanes/images/florence/hurricane-florence_00000409_pre_disaster.png,86,56,1,717,803,988,1044,479,61.50734709009822,13.103642489685557
7136,/media/marda/TWOTB1/xBD/hurricanes/images/florence/hurricane-florence_00000131_pre_disaster.png,45,10,1,483,528,0,10,186,27.9017366136082,9.16284106170074
7137,/media/marda/TWOTB1/xBD/hurricanes/images/florence/hurricane-florence_00000131_pre_disaster.png,40,17,1,490,530,28,45,222,20.055525593722336,14.652196360226046
7138,/media/marda/TWOTB1/xBD/hurricanes/images/florence/hurricane-florence_00000131_pre_disaster.png,31,15,1,442,473,85,100,170,15.563325001844806,13.949893328749583
7139,/media/marda/TWOTB1/xBD/hurricanes/images/florence/hurricane-florence_00000131_pre_disaster.png,42,27,1,469,511,86,113,384,25.039092289315207,20.433056211604764
7140,/media/marda/TWOTB1/xBD/hurricanes/images/florence/hurricane-florence_00000435_pre_disaster.png,46,25,1,470,516,80,105,258,32.818491407786716,10.509543172089924
7141,/media/marda/TWOTB1/xBD/hurricanes/images/florence/hurricane-florence_00000435_pre_disaster.png,36,19,1,499,535,106,125,119,13.378625617002482,12.00676628506171
7142,/media/marda/TWOTB1/xBD/hurricanes/images/florence/hurricane-florence_00000435_pre_disaster.png,43,31,1,336,379,127,158,428,28.627630587521956,19.78569439637211
7143,/media/marda/TWOTB1/xBD/hurricanes/images/florence/hurricane-florence_00000435_pre_disaster.png,62,53,1,292,354,134,187,1045,58.56390568574005,24.122353483367917
7144,/media/marda/TWOTB1/xBD/hurricanes/images/florence/hurricane-florence_00000435_pre_disaster.png,37,21,1,564,601,166,187,145,13.904105074798395,13.904105074798395
7145,/media/marda/TWOTB1/xBD/hurricanes/images/florence/hurricane-florence_00000435_pre_disaster.png,42,32,1,344,386,185,217,415,27.579480878184164,20.057289856377572
7146,/media/marda/TWOTB1/xBD/hurricanes/images/florence/hurricane-florence_00000435_pre_disaster.png,61,61,1,342,403,219,280,1216,58.274239372736666,29.432326291522557
7147,/media/marda/TWOTB1/xBD/hurricanes/images/florence/hurricane-florence_00000435_pre_disaster.png,49,43,1,299,348,246,289,627,36.857048383263454,22.64761736387479
7148,/media/marda/TWOTB1/xBD/hurricanes/images/florence/hurricane-florence_00000435_pre_disaster.png,65,66,1,836,901,727,793,549,40.90034907007873,17.94128456116457
7149,/media/marda/TWOTB1/xBD/hurricanes/images/florence/hurricane-florence_00000435_pre_disaster.png,86,58,1,773,859,846,904,693,62.82915850806358,16.272419813034958
7150,/media/marda/TWOTB1/xBD/hurricanes/images/florence/hurricane-florence_00000078_pre_disaster.png,20,50,1,18,38,866,916,191,18.176955110765135,13.968813714465897
7151,/media/marda/TWOTB1/xBD/hurricanes/images/florence/hurricane-florence_00000078_pre_disaster.png,21,52,1,62,83,880,932,385,23.863378131562907,21.398838178659634
7152,/media/marda/TWOTB1/xBD/hurricanes/images/florence/hurricane-florence_00000078_pre_disaster.png,10,60,1,0,10,894,954,240,27.688746209726915,11.489125293076057
7153,/media/marda/TWOTB1/xBD/hurricanes/images/florence/hurricane-florence_00000078_pre_disaster.png,71,84,1,99,170,903,987,2572,69.08157714930537,48.98593247555078
7154,/media/marda/TWOTB1/xBD/hurricanes/images/florence/hurricane-florence_00000342_pre_disaster.png,27,42,1,116,143,0,42,673,45.525043876330685,21.286280872260146
7155,/media/marda/TWOTB1/xBD/hurricanes/images/florence/hurricane-florence_00000342_pre_disaster.png,13,13,1,16,29,13,26,155,15.482069149321514,13.340058011824867
7156,/media/marda/TWOTB1/xBD/hurricanes/images/florence/hurricane-florence_00000342_pre_disaster.png,78,54,1,470,548,218,272,1601,59.001370742038326,36.1237267839738
7157,/media/marda/TWOTB1/xBD/hurricanes/images/florence/hurricane-florence_00000342_pre_disaster.png,28,26,1,432,460,232,258,162,18.921174243893823,11.52191812724663
7158,/media/marda/TWOTB1/xBD/hurricanes/images/florence/hurricane-florence_00000342_pre_disaster.png,57,45,1,418,475,347,392,684,43.42704029321374,22.282709448213396
7159,/media/marda/TWOTB1/xBD/hurricanes/images/florence/hurricane-florence_00000342_pre_disaster.png,21,23,1,33,54,366,389,170,22.64549320666378,10.007687912686954
7160,/media/marda/TWOTB1/xBD/hurricanes/images/florence/hurricane-florence_00000342_pre_disaster.png,29,18,1,429,458,386,404,78,14.966629547095765,6.831300510639732
7161,/media/marda/TWOTB1/xBD/hurricanes/images/florence/hurricane-florence_00000342_pre_disaster.png,22,65,1,0,22,413,478,898,52.21700794665543,22.8859712572271
7162,/media/marda/TWOTB1/xBD/hurricanes/images/florence/hurricane-florence_00000400_pre_disaster.png,50,52,1,0,50,491,543,1227,56.45845634210092,29.02212926676371
7163,/media/marda/TWOTB1/xBD/hurricanes/images/florence/hurricane-florence_00000400_pre_disaster.png,19,32,1,74,93,496,528,204,21.41571638321682,12.731966172297762
7164,/media/marda/TWOTB1/xBD/hurricanes/images/florence/hurricane-florence_00000400_pre_disaster.png,26,35,1,167,193,535,570,309,25.44894819426311,16.186998728827437
7165,/media/marda/TWOTB1/xBD/hurricanes/images/florence/hurricane-florence_00000400_pre_disaster.png,58,60,1,116,174,592,652,1186,57.0125737640106,27.772722950090383
7166,/media/marda/TWOTB1/xBD/hurricanes/images/florence/hurricane-florence_00000400_pre_disaster.png,41,57,1,386,427,757,814,605,30.684303199824704,27.55178566256898
7167,/media/marda/TWOTB1/xBD/hurricanes/images/florence/hurricane-florence_00000400_pre_disaster.png,20,39,1,346,366,798,837,52,8.822175282350482,7.797207334834404
7168,/media/marda/TWOTB1/xBD/hurricanes/images/florence/hurricane-florence_00000400_pre_disaster.png,23,47,1,391,414,805,852,113,16.39954773721334,9.226720193899611
7169,/media/marda/TWOTB1/xBD/hurricanes/images/florence/hurricane-florence_00000400_pre_disaster.png,24,55,1,309,333,815,870,211,25.702664145098776,10.984931227502276
7170,/media/marda/TWOTB1/xBD/hurricanes/images/florence/hurricane-florence_00000400_pre_disaster.png,55,72,1,30,85,845,917,1159,57.217572622246124,27.02894272386625
7171,/media/marda/TWOTB1/xBD/hurricanes/images/florence/hurricane-florence_00000400_pre_disaster.png,62,73,1,362,424,857,930,1257,47.716766825919194,36.961739204001404
7172,/media/marda/TWOTB1/xBD/hurricanes/images/florence/hurricane-florence_00000400_pre_disaster.png,27,50,1,196,223,882,932,210,18.149107010496767,15.501047612332966
7173,/media/marda/TWOTB1/xBD/hurricanes/images/florence/hurricane-florence_00000296_pre_disaster.png,55,9,1,822,877,0,9,117,20.141765250974064,8.629092617029153
7174,/media/marda/TWOTB1/xBD/hurricanes/images/florence/hurricane-florence_00000296_pre_disaster.png,80,57,1,912,992,219,276,840,60.51845454038739,18.35247405757586
7175,/media/marda/TWOTB1/xBD/hurricanes/images/florence/hurricane-florence_00000296_pre_disaster.png,52,24,1,992,1044,286,310,118,15.071000762493968,10.523538168327711
7176,/media/marda/TWOTB1/xBD/hurricanes/images/florence/hurricane-florence_00000296_pre_disaster.png,73,53,1,765,838,289,342,935,45.63917439916349,27.30110043819274
7177,/media/marda/TWOTB1/xBD/hurricanes/images/florence/hurricane-florence_00000296_pre_disaster.png,39,30,1,515,554,336,366,164,18.153310741121345,12.118067215473243
7178,/media/marda/TWOTB1/xBD/hurricanes/images/florence/hurricane-florence_00000296_pre_disaster.png,75,60,1,844,919,336,396,1093,47.59755666238218,33.10567100211753
7179,/media/marda/TWOTB1/xBD/hurricanes/images/florence/hurricane-florence_00000296_pre_disaster.png,64,59,1,480,544,341,400,1178,50.01055828134366,32.25262935062003
7180,/media/marda/TWOTB1/xBD/hurricanes/images/florence/hurricane-florence_00000296_pre_disaster.png,44,43,1,454,498,404,447,404,24.32307901480784,21.96590210699099
7181,/media/marda/TWOTB1/xBD/hurricanes/images/florence/hurricane-florence_00000296_pre_disaster.png,109,77,1,383,492,423,500,2718,93.84376948824689,47.519204604144136
7182,/media/marda/TWOTB1/xBD/hurricanes/images/florence/hurricane-florence_00000296_pre_disaster.png,35,67,1,59,94,486,553,967,55.226102162359155,24.179996205783254
7183,/media/marda/TWOTB1/xBD/hurricanes/images/florence/hurricane-florence_00000296_pre_disaster.png,25,39,1,125,150,506,545,251,21.911914682450522,15.079825768770185
7184,/media/marda/TWOTB1/xBD/hurricanes/images/florence/hurricane-florence_00000296_pre_disaster.png,19,35,1,103,122,514,549,136,15.659658501224978,11.644793694715519
7185,/media/marda/TWOTB1/xBD/hurricanes/images/florence/hurricane-florence_00000296_pre_disaster.png,55,69,1,69,124,541,610,1450,54.17668751301885,36.96555734410062
7186,/media/marda/TWOTB1/xBD/hurricanes/images/florence/hurricane-florence_00000296_pre_disaster.png,63,73,1,143,206,542,615,1265,72.8414458282164,30.159313993012415
7187,/media/marda/TWOTB1/xBD/hurricanes/images/florence/hurricane-florence_00000296_pre_disaster.png,21,42,1,45,66,544,586,274,20.21028221124584,18.13767211844195
7188,/media/marda/TWOTB1/xBD/hurricanes/images/florence/hurricane-florence_00000296_pre_disaster.png,40,43,1,335,375,546,589,302,28.991146247198678,13.91995312142527
7189,/media/marda/TWOTB1/xBD/hurricanes/images/florence/hurricane-florence_00000296_pre_disaster.png,50,69,1,305,355,573,642,1062,49.048551713985795,28.783055424946237
7190,/media/marda/TWOTB1/xBD/hurricanes/images/florence/hurricane-florence_00000296_pre_disaster.png,41,49,1,180,221,588,637,713,36.722906850392185,25.51920082947793
7191,/media/marda/TWOTB1/xBD/hurricanes/images/florence/hurricane-florence_00000296_pre_disaster.png,45,46,1,421,466,601,647,331,24.39836538373262,18.203926514395448
7192,/media/marda/TWOTB1/xBD/hurricanes/images/florence/hurricane-florence_00000296_pre_disaster.png,41,44,1,447,488,609,653,273,26.478391943720016,13.695425287284863
7193,/media/marda/TWOTB1/xBD/hurricanes/images/florence/hurricane-florence_00000296_pre_disaster.png,55,55,1,541,596,617,672,485,39.19224283468511,17.459174454901852
7194,/media/marda/TWOTB1/xBD/hurricanes/images/florence/hurricane-florence_00000296_pre_disaster.png,48,54,1,398,446,633,687,717,33.937733541667725,27.562464768160364
7195,/media/marda/TWOTB1/xBD/hurricanes/images/florence/hurricane-florence_00000296_pre_disaster.png,72,59,1,495,567,645,704,1126,57.67678379815174,25.818251350727103
7196,/media/marda/TWOTB1/xBD/hurricanes/images/florence/hurricane-florence_00000296_pre_disaster.png,81,62,1,742,823,688,750,1130,57.30620187044595,26.03419315221916
7197,/media/marda/TWOTB1/xBD/hurricanes/images/florence/hurricane-florence_00000296_pre_disaster.png,56,79,1,0,56,693,772,1931,61.77029580874606,43.510438494823845
7198,/media/marda/TWOTB1/xBD/hurricanes/images/florence/hurricane-florence_00000296_pre_disaster.png,55,44,1,873,928,700,744,222,21.929895200545616,13.445537562999563
7199,/media/marda/TWOTB1/xBD/hurricanes/images/florence/hurricane-florence_00000296_pre_disaster.png,75,57,1,863,938,730,787,839,43.73726139844019,25.446029646679722
7200,/media/marda/TWOTB1/xBD/hurricanes/images/florence/hurricane-florence_00000296_pre_disaster.png,73,72,1,398,471,745,817,1622,59.154993434583616,36.046304436718984
7201,/media/marda/TWOTB1/xBD/hurricanes/images/florence/hurricane-florence_00000296_pre_disaster.png,64,56,1,593,657,794,850,579,43.14388388279932,17.83317004637302
7202,/media/marda/TWOTB1/xBD/hurricanes/images/florence/hurricane-florence_00000296_pre_disaster.png,60,67,1,424,484,808,875,937,44.566010755942585,28.012292230360302
7203,/media/marda/TWOTB1/xBD/hurricanes/images/florence/hurricane-florence_00000296_pre_disaster.png,30,49,1,373,403,824,873,186,19.83204215041161,12.260227647020308
7204,/media/marda/TWOTB1/xBD/hurricanes/images/florence/hurricane-florence_00000296_pre_disaster.png,37,59,1,392,429,834,893,366,26.458258313858092,18.52137521320231
7205,/media/marda/TWOTB1/xBD/hurricanes/images/florence/hurricane-florence_00000296_pre_disaster.png,28,48,1,417,445,840,888,131,15.580406521039269,11.318835352654066
7206,/media/marda/TWOTB1/xBD/hurricanes/images/florence/hurricane-florence_00000296_pre_disaster.png,54,74,1,356,410,880,954,841,39.13395375489562,28.68849245523618
7207,/media/marda/TWOTB1/xBD/hurricanes/images/florence/hurricane-florence_00000296_pre_disaster.png,89,90,1,755,844,892,982,2229,60.80097824091417,50.507333402126285
7208,/media/marda/TWOTB1/xBD/hurricanes/images/florence/hurricane-florence_00000296_pre_disaster.png,94,75,1,837,931,905,980,1212,68.15334017823288,23.55316226751357
7209,/media/marda/TWOTB1/xBD/hurricanes/images/florence/hurricane-florence_00000296_pre_disaster.png,36,60,1,341,377,918,978,275,24.067027229316455,15.299605526580093
7210,/media/marda/TWOTB1/xBD/hurricanes/images/florence/hurricane-florence_00000296_pre_disaster.png,50,58,1,744,794,954,1012,332,22.46806126944615,19.371845104624803
7211,/media/marda/TWOTB1/xBD/hurricanes/images/florence/hurricane-florence_00000536_post_disaster.png,304,92,1,739,1043,907,999,10364,310.0037130475094,44.50571819273414
7212,/media/marda/TWOTB1/xBD/hurricanes/images/florence/hurricane-florence_00000536_post_disaster.png,48,49,1,993,1041,964,1013,85,14.39709430640591,7.835228366814603
7213,/media/marda/TWOTB1/xBD/hurricanes/images/florence/hurricane-florence_00000536_post_disaster.png,202,52,1,736,938,991,1043,1026,165.25414436186992,9.495793653408331
7214,/media/marda/TWOTB1/xBD/hurricanes/images/florence/hurricane-florence_00000536_post_disaster.png,49,48,1,991,1040,993,1041,50,8.679021276136377,7.357566832069698
7215,/media/marda/TWOTB1/xBD/hurricanes/images/florence/hurricane-florence_00000196_post_disaster.png,129,248,1,153,282,0,248,17331,282.0744474381509,85.52572441666976
7216,/media/marda/TWOTB1/xBD/hurricanes/images/florence/hurricane-florence_00000196_post_disaster.png,52,49,1,6,58,13,62,1655,52.84595122621936,41.616996137853754
7217,/media/marda/TWOTB1/xBD/hurricanes/images/florence/hurricane-florence_00000196_post_disaster.png,16,18,1,82,98,14,32,179,17.043234764599433,13.964602571384551
7218,/media/marda/TWOTB1/xBD/hurricanes/images/florence/hurricane-florence_00000196_post_disaster.png,17,19,1,60,77,27,46,229,18.08376438287428,16.98577654886036
7219,/media/marda/TWOTB1/xBD/hurricanes/images/florence/hurricane-florence_00000196_post_disaster.png,17,14,1,131,148,46,60,106,12.71224325733803,11.246081231450225
7220,/media/marda/TWOTB1/xBD/hurricanes/images/florence/hurricane-florence_00000196_post_disaster.png,25,28,1,56,81,49,77,482,27.71273501867004,23.136089591246183
7221,/media/marda/TWOTB1/xBD/hurricanes/images/florence/hurricane-florence_00000196_post_disaster.png,42,36,1,26,68,78,114,1026,45.254327493324055,29.866313351365374
7222,/media/marda/TWOTB1/xBD/hurricanes/images/florence/hurricane-florence_00000196_post_disaster.png,19,36,1,154,173,133,169,275,34.58368615942064,10.640763832191853
7223,/media/marda/TWOTB1/xBD/hurricanes/images/florence/hurricane-florence_00000196_post_disaster.png,37,43,1,44,81,144,187,1005,38.23280578557146,34.729594052427466
7224,/media/marda/TWOTB1/xBD/hurricanes/images/florence/hurricane-florence_00000196_post_disaster.png,134,276,1,93,227,192,468,14586,315.26271646632244,70.7155797357188
7225,/media/marda/TWOTB1/xBD/hurricanes/images/florence/hurricane-florence_00000196_post_disaster.png,62,44,1,981,1043,234,278,381,39.120080970908425,16.92983988068261
7226,/media/marda/TWOTB1/xBD/hurricanes/images/florence/hurricane-florence_00000196_post_disaster.png,78,39,1,938,1016,246,285,919,44.42178387591687,27.12062953284902
7227,/media/marda/TWOTB1/xBD/hurricanes/images/florence/hurricane-florence_00000196_post_disaster.png,103,189,1,197,300,255,444,8433,206.5468732941257,56.10455247225523
7228,/media/marda/TWOTB1/xBD/hurricanes/images/florence/hurricane-florence_00000196_post_disaster.png,46,35,1,766,812,261,296,363,28.178838676915337,17.149237063649192
7229,/media/marda/TWOTB1/xBD/hurricanes/images/florence/hurricane-florence_00000196_post_disaster.png,45,27,1,774,819,291,318,217,18.548303580158496,15.21643138322049
7230,/media/marda/TWOTB1/xBD/hurricanes/images/florence/hurricane-florence_00000196_post_disaster.png,48,31,1,731,779,305,336,288,20.911548817535152,18.3871513395952
7231,/media/marda/TWOTB1/xBD/hurricanes/images/florence/hurricane-florence_00000196_post_disaster.png,66,39,1,752,818,310,349,622,37.81711809408773,21.755673742231206
7232,/media/marda/TWOTB1/xBD/hurricanes/images/florence/hurricane-florence_00000196_post_disaster.png,65,76,1,612,677,467,543,1317,57.571871172668814,33.713367808305996
7233,/media/marda/TWOTB1/xBD/hurricanes/images/florence/hurricane-florence_00000196_post_disaster.png,39,92,1,0,39,490,582,1300,77.5592156733078,37.254047620913965
7234,/media/marda/TWOTB1/xBD/hurricanes/images/florence/hurricane-florence_00000196_post_disaster.png,63,50,1,741,804,511,561,735,35.95320317432171,27.30121210468881
7235,/media/marda/TWOTB1/xBD/hurricanes/images/florence/hurricane-florence_00000196_post_disaster.png,45,63,1,436,481,528,591,808,47.25426070843134,22.720082678719177
7236,/media/marda/TWOTB1/xBD/hurricanes/images/florence/hurricane-florence_00000196_post_disaster.png,48,50,1,591,639,537,587,363,29.757425177659382,16.29924370280745
7237,/media/marda/TWOTB1/xBD/hurricanes/images/florence/hurricane-florence_00000196_post_disaster.png,113,92,1,163,276,551,643,4418,111.20937277511237,60.7729765267286
7238,/media/marda/TWOTB1/xBD/hurricanes/images/florence/hurricane-florence_00000196_post_disaster.png,63,79,1,645,708,561,640,1383,62.45893043500376,29.572912738090064
7239,/media/marda/TWOTB1/xBD/hurricanes/images/florence/hurricane-florence_00000196_post_disaster.png,30,46,1,294,324,573,619,333,26.236290096216326,16.90142758262437
7240,/media/marda/TWOTB1/xBD/hurricanes/images/florence/hurricane-florence_00000196_post_disaster.png,64,63,1,765,829,579,642,918,42.40566175792048,28.887723891189168
7241,/media/marda/TWOTB1/xBD/hurricanes/images/florence/hurricane-florence_00000196_post_disaster.png,24,39,1,285,309,590,629,143,14.531144860497937,13.269824301208098
7242,/media/marda/TWOTB1/xBD/hurricanes/images/florence/hurricane-florence_00000196_post_disaster.png,25,43,1,269,294,595,638,212,17.57761503671544,16.17731828543675
7243,/media/marda/TWOTB1/xBD/hurricanes/images/florence/hurricane-florence_00000196_post_disaster.png,52,70,1,599,651,603,673,901,47.68682141900817,24.8089634286421
7244,/media/marda/TWOTB1/xBD/hurricanes/images/florence/hurricane-florence_00000196_post_disaster.png,81,67,1,939,1020,604,671,1228,42.38657881539355,39.96827808251832
7245,/media/marda/TWOTB1/xBD/hurricanes/images/florence/hurricane-florence_00000196_post_disaster.png,39,51,1,66,105,606,657,644,38.78146692360895,21.77094971818087
7246,/media/marda/TWOTB1/xBD/hurricanes/images/florence/hurricane-florence_00000196_post_disaster.png,31,50,1,0,31,621,671,606,34.65400382042947,23.220159026287924
7247,/media/marda/TWOTB1/xBD/hurricanes/images/florence/hurricane-florence_00000196_post_disaster.png,68,56,1,897,965,628,684,719,32.28577559287074,29.956351141338025
7248,/media/marda/TWOTB1/xBD/hurricanes/images/florence/hurricane-florence_00000196_post_disaster.png,64,58,1,783,847,631,689,838,35.132390147369314,31.661207922862538
7249,/media/marda/TWOTB1/xBD/hurricanes/images/florence/hurricane-florence_00000196_post_disaster.png,46,59,1,164,210,637,696,921,43.12005452453421,28.372253322405683
7250,/media/marda/TWOTB1/xBD/hurricanes/images/florence/hurricane-florence_00000196_post_disaster.png,54,53,1,671,725,642,695,536,28.25260840169509,25.158740147810246
7251,/media/marda/TWOTB1/xBD/hurricanes/images/florence/hurricane-florence_00000196_post_disaster.png,20,44,1,69,89,649,693,296,21.038760964407338,18.835496873932883
7252,/media/marda/TWOTB1/xBD/hurricanes/images/florence/hurricane-florence_00000196_post_disaster.png,71,59,1,858,929,655,714,858,35.28685581146002,32.24336869802826
7253,/media/marda/TWOTB1/xBD/hurricanes/images/florence/hurricane-florence_00000196_post_disaster.png,49,64,1,56,105,669,733,1251,46.49352464206782,35.655133201077746
7254,/media/marda/TWOTB1/xBD/hurricanes/images/florence/hurricane-florence_00000196_post_disaster.png,83,66,1,798,881,671,737,1286,52.97863076049059,35.24395157685813
7255,/media/marda/TWOTB1/xBD/hurricanes/images/florence/hurricane-florence_00000196_post_disaster.png,64,63,1,358,422,677,740,1320,51.978545443005345,33.894106094636825
7256,/media/marda/TWOTB1/xBD/hurricanes/images/florence/hurricane-florence_00000196_post_disaster.png,76,78,1,667,743,683,761,1821,55.52810697836818,44.299172507300305
7257,/media/marda/TWOTB1/xBD/hurricanes/images/florence/hurricane-florence_00000196_post_disaster.png,25,52,1,241,266,686,738,230,23.473060418118266,14.32863307237231
7258,/media/marda/TWOTB1/xBD/hurricanes/images/florence/hurricane-florence_00000196_post_disaster.png,13,45,1,26,39,698,743,165,16.955006323477004,12.947497684560501
7259,/media/marda/TWOTB1/xBD/hurricanes/images/florence/hurricane-florence_00000196_post_disaster.png,64,112,1,59,123,707,819,2951,97.94685691762277,45.64784260854219
7260,/media/marda/TWOTB1/xBD/hurricanes/images/florence/hurricane-florence_00000196_post_disaster.png,49,74,1,195,244,708,782,1406,46.244992415437025,40.73961173302797
7261,/media/marda/TWOTB1/xBD/hurricanes/images/florence/hurricane-florence_00000196_post_disaster.png,26,42,1,243,269,708,750,159,17.32529352182004,12.334108681880018
7262,/media/marda/TWOTB1/xBD/hurricanes/images/florence/hurricane-florence_00000196_post_disaster.png,48,46,1,542,590,709,755,309,30.250072232680957,13.572377305583856
7263,/media/marda/TWOTB1/xBD/hurricanes/images/florence/hurricane-florence_00000196_post_disaster.png,64,62,1,489,553,713,775,1037,47.4596168937791,30.391092960103375
7264,/media/marda/TWOTB1/xBD/hurricanes/images/florence/hurricane-florence_00000196_post_disaster.png,34,63,1,10,44,729,792,749,35.297616981931796,33.00460257516386
7265,/media/marda/TWOTB1/xBD/hurricanes/images/florence/hurricane-florence_00000196_post_disaster.png,62,82,1,546,608,730,812,1475,55.04733721430322,35.42636976533291
7266,/media/marda/TWOTB1/xBD/hurricanes/images/florence/hurricane-florence_00000196_post_disaster.png,76,59,1,957,1033,737,796,779,39.09474891267436,26.170121153193755
7267,/media/marda/TWOTB1/xBD/hurricanes/images/florence/hurricane-florence_00000196_post_disaster.png,64,75,1,502,566,751,826,1513,45.18888244338467,43.525103028146205
7268,/media/marda/TWOTB1/xBD/hurricanes/images/florence/hurricane-florence_00000196_post_disaster.png,71,79,1,886,957,754,833,1187,51.30746946502506,30.632368187114743
7269,/media/marda/TWOTB1/xBD/hurricanes/images/florence/hurricane-florence_00000196_post_disaster.png,39,74,1,236,275,762,836,959,45.789732434294656,27.514010109066707
7270,/media/marda/TWOTB1/xBD/hurricanes/images/florence/hurricane-florence_00000196_post_disaster.png,8,41,1,0,8,785,826,90,13.01761541557354,9.171908804302648
7271,/media/marda/TWOTB1/xBD/hurricanes/images/florence/hurricane-florence_00000196_post_disaster.png,37,71,1,106,143,784,855,843,40.62194728542255,27.552184030174182
7272,/media/marda/TWOTB1/xBD/hurricanes/images/florence/hurricane-florence_00000196_post_disaster.png,37,44,1,679,716,794,838,107,12.648848047237138,11.162916881459749
7273,/media/marda/TWOTB1/xBD/hurricanes/images/florence/hurricane-florence_00000196_post_disaster.png,66,84,1,700,766,794,878,1446,53.929279218670466,35.019378712817776
7274,/media/marda/TWOTB1/xBD/hurricanes/images/florence/hurricane-florence_00000196_post_disaster.png,76,65,1,833,909,798,863,966,44.26631428512531,29.012421500910083
7275,/media/marda/TWOTB1/xBD/hurricanes/images/florence/hurricane-florence_00000196_post_disaster.png,36,70,1,345,381,805,875,598,39.840282708331706,20.054845399563764
7276,/media/marda/TWOTB1/xBD/hurricanes/images/florence/hurricane-florence_00000196_post_disaster.png,33,61,1,116,149,821,882,556,28.055702300986226,26.48559221249059
7277,/media/marda/TWOTB1/xBD/hurricanes/images/florence/hurricane-florence_00000196_post_disaster.png,52,64,1,279,331,827,891,913,43.615056299178036,27.955212127722564
7278,/media/marda/TWOTB1/xBD/hurricanes/images/florence/hurricane-florence_00000196_post_disaster.png,58,65,1,594,652,836,901,783,35.54955887014262,29.45244801115476
7279,/media/marda/TWOTB1/xBD/hurricanes/images/florence/hurricane-florence_00000196_post_disaster.png,85,76,1,846,931,837,913,1413,51.06194218651833,38.337760591705916
7280,/media/marda/TWOTB1/xBD/hurricanes/images/florence/hurricane-florence_00000196_post_disaster.png,51,66,1,217,268,844,910,1026,46.529538684529314,29.10528484189058
7281,/media/marda/TWOTB1/xBD/hurricanes/images/florence/hurricane-florence_00000196_post_disaster.png,55,67,1,427,482,864,931,978,38.03009647292739,35.13570307278102
7282,/media/marda/TWOTB1/xBD/hurricanes/images/florence/hurricane-florence_00000196_post_disaster.png,28,62,1,113,141,865,927,480,30.811011669264428,20.67511497817837
7283,/media/marda/TWOTB1/xBD/hurricanes/images/florence/hurricane-florence_00000196_post_disaster.png,68,72,1,716,784,867,939,1014,43.22718800182887,32.95310448928429
7284,/media/marda/TWOTB1/xBD/hurricanes/images/florence/hurricane-florence_00000196_post_disaster.png,54,54,1,536,590,883,937,445,36.507474316712376,16.194582374512798
7285,/media/marda/TWOTB1/xBD/hurricanes/images/florence/hurricane-florence_00000196_post_disaster.png,76,77,1,862,938,897,974,1266,41.650266758973906,40.34312563019269
7286,/media/marda/TWOTB1/xBD/hurricanes/images/florence/hurricane-florence_00000196_post_disaster.png,21,68,1,0,21,898,966,465,30.12381208788675,20.879597831405608
7287,/media/marda/TWOTB1/xBD/hurricanes/images/florence/hurricane-florence_00000196_post_disaster.png,46,80,1,279,325,899,979,1054,44.72141935069954,31.246343614039514
7288,/media/marda/TWOTB1/xBD/hurricanes/images/florence/hurricane-florence_00000196_post_disaster.png,26,46,1,419,445,905,951,60,9.462950117283022,8.633739859800158
7289,/media/marda/TWOTB1/xBD/hurricanes/images/florence/hurricane-florence_00000196_post_disaster.png,62,74,1,695,757,918,992,714,41.99094930020311,22.615841935618118
7290,/media/marda/TWOTB1/xBD/hurricanes/images/florence/hurricane-florence_00000196_post_disaster.png,51,62,1,423,474,923,985,615,36.058350530436215,22.319824014002908
7291,/media/marda/TWOTB1/xBD/hurricanes/images/florence/hurricane-florence_00000196_post_disaster.png,60,66,1,569,629,934,1000,696,39.96101912774739,23.69950758164691
7292,/media/marda/TWOTB1/xBD/hurricanes/images/florence/hurricane-florence_00000196_post_disaster.png,75,72,1,886,961,942,1014,811,41.890249601103875,26.795024834090878
7293,/media/marda/TWOTB1/xBD/hurricanes/images/florence/hurricane-florence_00000196_post_disaster.png,81,83,1,736,817,945,1028,1571,48.840417261483935,42.52520287534576
7294,/media/marda/TWOTB1/xBD/hurricanes/images/florence/hurricane-florence_00000196_post_disaster.png,58,70,1,131,189,946,1016,1220,54.74950059146991,29.64232005012878
7295,/media/marda/TWOTB1/xBD/hurricanes/images/florence/hurricane-florence_00000196_post_disaster.png,67,71,1,434,501,969,1040,1163,54.420053473877104,28.18407115987156
7296,/media/marda/TWOTB1/xBD/hurricanes/images/florence/hurricane-florence_00000196_post_disaster.png,90,64,1,883,973,977,1041,944,54.16146449987877,25.811721221145834
7297,/media/marda/TWOTB1/xBD/hurricanes/images/florence/hurricane-florence_00000196_post_disaster.png,52,61,1,147,199,980,1041,817,50.84367594538209,21.054762185253608
7298,/media/marda/TWOTB1/xBD/hurricanes/images/florence/hurricane-florence_00000196_post_disaster.png,30,58,1,26,56,985,1043,404,31.298894495838123,17.466329458811437
7299,/media/marda/TWOTB1/xBD/hurricanes/images/florence/hurricane-florence_00000052_pre_disaster.png,25,20,1,245,270,144,164,171,17.244913956508352,13.203110167889173
7300,/media/marda/TWOTB1/xBD/hurricanes/images/florence/hurricane-florence_00000052_pre_disaster.png,22,37,1,0,22,168,205,575,32.78242240195967,23.306721382698196
7301,/media/marda/TWOTB1/xBD/hurricanes/images/florence/hurricane-florence_00000052_pre_disaster.png,30,36,1,208,238,180,216,436,31.915715442163744,18.946211895844932
7302,/media/marda/TWOTB1/xBD/hurricanes/images/florence/hurricane-florence_00000052_pre_disaster.png,48,46,1,449,497,298,344,730,34.75703773736644,28.132837719656283
7303,/media/marda/TWOTB1/xBD/hurricanes/images/florence/hurricane-florence_00000052_pre_disaster.png,40,35,1,118,158,305,340,546,38.56284913936204,19.141993916641205
7304,/media/marda/TWOTB1/xBD/hurricanes/images/florence/hurricane-florence_00000052_pre_disaster.png,41,36,1,434,475,327,363,420,25.562100479332678,21.631405499683932
7305,/media/marda/TWOTB1/xBD/hurricanes/images/florence/hurricane-florence_00000052_pre_disaster.png,7,22,1,81,88,336,358,54,9.638093752437017,7.494406829767874
7306,/media/marda/TWOTB1/xBD/hurricanes/images/florence/hurricane-florence_00000052_pre_disaster.png,41,41,1,183,224,340,381,650,37.7565371009924,22.577465559973717
7307,/media/marda/TWOTB1/xBD/hurricanes/images/florence/hurricane-florence_00000052_pre_disaster.png,22,23,1,212,234,340,363,96,14.423374130682536,8.823164009061733
7308,/media/marda/TWOTB1/xBD/hurricanes/images/florence/hurricane-florence_00000052_pre_disaster.png,27,23,1,425,452,356,379,77,10.55588999393662,9.879886005155614
7309,/media/marda/TWOTB1/xBD/hurricanes/images/florence/hurricane-florence_00000052_pre_disaster.png,59,38,1,9,68,365,403,813,66.45708690822441,16.263929825551806
7310,/media/marda/TWOTB1/xBD/hurricanes/images/florence/hurricane-florence_00000052_pre_disaster.png,44,31,1,447,491,378,409,371,29.786844957840355,16.384464285917105
7311,/media/marda/TWOTB1/xBD/hurricanes/images/florence/hurricane-florence_00000052_pre_disaster.png,76,57,1,405,481,408,465,1620,64.11204984274792,33.45386855999165
7312,/media/marda/TWOTB1/xBD/hurricanes/images/florence/hurricane-florence_00000052_pre_disaster.png,29,56,1,0,29,490,546,845,37.42673622644786,30.234731316420685
7313,/media/marda/TWOTB1/xBD/hurricanes/images/florence/hurricane-florence_00000052_pre_disaster.png,25,36,1,52,77,509,545,192,26.418895478613248,9.691389894075943
7314,/media/marda/TWOTB1/xBD/hurricanes/images/florence/hurricane-florence_00000052_pre_disaster.png,111,89,1,810,921,644,733,1872,91.17940822076463,27.358258902151583
7315,/media/marda/TWOTB1/xBD/hurricanes/images/florence/hurricane-florence_00000052_pre_disaster.png,25,46,1,109,134,747,793,220,18.799486524635626,15.68725757459526
7316,/media/marda/TWOTB1/xBD/hurricanes/images/florence/hurricane-florence_00000052_pre_disaster.png,39,57,1,142,181,749,806,643,36.259074689669966,23.392239441669997
7317,/media/marda/TWOTB1/xBD/hurricanes/images/florence/hurricane-florence_00000052_pre_disaster.png,55,48,1,818,873,964,1012,221,26.716969041671945,11.097720554754986
7318,/media/marda/TWOTB1/xBD/hurricanes/images/florence/hurricane-florence_00000139_pre_disaster.png,64,54,1,499,563,332,386,965,36.963385876943555,34.68204755781576
7319,/media/marda/TWOTB1/xBD/hurricanes/images/florence/hurricane-florence_00000139_pre_disaster.png,70,76,1,451,521,409,485,1601,61.77357805697686,37.95366854281974
7320,/media/marda/TWOTB1/xBD/hurricanes/images/florence/hurricane-florence_00000139_pre_disaster.png,30,36,1,230,260,513,549,193,21.209747525755013,13.93672884341332
7321,/media/marda/TWOTB1/xBD/hurricanes/images/florence/hurricane-florence_00000139_pre_disaster.png,45,61,1,248,293,543,604,790,41.63305722124704,26.397444494016995
7322,/media/marda/TWOTB1/xBD/hurricanes/images/florence/hurricane-florence_00000139_pre_disaster.png,11,48,1,0,11,560,608,160,28.100095622807746,8.943901608865165
7323,/media/marda/TWOTB1/xBD/hurricanes/images/florence/hurricane-florence_00000139_pre_disaster.png,29,45,1,297,326,712,757,152,15.70246614042177,13.002652948598822
7324,/media/marda/TWOTB1/xBD/hurricanes/images/florence/hurricane-florence_00000139_pre_disaster.png,28,45,1,281,309,743,788,155,16.55791451086211,12.632378489491302
7325,/media/marda/TWOTB1/xBD/hurricanes/images/florence/hurricane-florence_00000441_pre_disaster.png,43,53,1,50,93,514,567,1021,43.101620035048555,31.36833546555397
7326,/media/marda/TWOTB1/xBD/hurricanes/images/florence/hurricane-florence_00000441_pre_disaster.png,18,37,1,9,27,528,565,212,18.545205553189884,15.135082524005176
7327,/media/marda/TWOTB1/xBD/hurricanes/images/florence/hurricane-florence_00000441_pre_disaster.png,47,36,1,891,938,667,703,132,13.808210118138652,12.649110640673518
7328,/media/marda/TWOTB1/xBD/hurricanes/images/florence/hurricane-florence_00000441_pre_disaster.png,58,43,1,895,953,682,725,272,25.64964343964302,15.050361963268728
7329,/media/marda/TWOTB1/xBD/hurricanes/images/florence/hurricane-florence_00000441_pre_disaster.png,57,43,1,930,987,685,728,379,23.104394556159328,21.571015440261746
7330,/media/marda/TWOTB1/xBD/hurricanes/images/florence/hurricane-florence_00000441_pre_disaster.png,21,76,1,98,119,782,858,647,53.425855126252294,16.162680236815625
7331,/media/marda/TWOTB1/xBD/hurricanes/images/florence/hurricane-florence_00000441_pre_disaster.png,49,84,1,883,932,795,879,637,57.51701159458987,14.825426761127634
7332,/media/marda/TWOTB1/xBD/hurricanes/images/florence/hurricane-florence_00000441_pre_disaster.png,51,48,1,982,1033,811,859,158,17.498075114467504,12.076123112934447
7333,/media/marda/TWOTB1/xBD/hurricanes/images/florence/hurricane-florence_00000441_pre_disaster.png,76,58,1,922,998,830,888,758,43.44122175077989,23.91936343352667
7334,/media/marda/TWOTB1/xBD/hurricanes/images/florence/hurricane-florence_00000441_pre_disaster.png,23,89,1,58,81,865,954,762,63.44742107747638,16.01950101577741
7335,/media/marda/TWOTB1/xBD/hurricanes/images/florence/hurricane-florence_00000441_pre_disaster.png,34,85,1,109,143,910,995,1018,53.001273851991066,25.63558544652514
7336,/media/marda/TWOTB1/xBD/hurricanes/images/florence/hurricane-florence_00000226_pre_disaster.png,45,42,1,573,618,465,507,343,23.158942526275762,19.449711198487236
7337,/media/marda/TWOTB1/xBD/hurricanes/images/florence/hurricane-florence_00000226_pre_disaster.png,48,62,1,582,630,512,574,507,47.5804793836878,14.21311055093115
7338,/media/marda/TWOTB1/xBD/hurricanes/images/florence/hurricane-florence_00000226_pre_disaster.png,45,52,1,390,435,643,695,556,32.73729160694425,22.40959225853783
7339,/media/marda/TWOTB1/xBD/hurricanes/images/florence/hurricane-florence_00000226_pre_disaster.png,54,47,1,655,709,650,697,284,33.01386643417504,11.508728003109162
7340,/media/marda/TWOTB1/xBD/hurricanes/images/florence/hurricane-florence_00000226_pre_disaster.png,59,78,1,736,795,693,771,706,54.97384025894015,17.149446524005228
7341,/media/marda/TWOTB1/xBD/hurricanes/images/florence/hurricane-florence_00000226_pre_disaster.png,76,44,1,509,585,700,744,581,62.71117276129184,12.39220853667968
7342,/media/marda/TWOTB1/xBD/hurricanes/images/florence/hurricane-florence_00000226_pre_disaster.png,76,85,1,879,955,728,813,1071,62.16947956210443,23.001102382508765
7343,/media/marda/TWOTB1/xBD/hurricanes/images/florence/hurricane-florence_00000226_pre_disaster.png,72,85,1,814,886,806,891,1283,49.70829349293716,34.94380256576115
7344,/media/marda/TWOTB1/xBD/hurricanes/images/florence/hurricane-florence_00000226_pre_disaster.png,50,75,1,384,434,817,892,651,51.81881622726618,16.621127270809968
7345,/media/marda/TWOTB1/xBD/hurricanes/images/florence/hurricane-florence_00000226_pre_disaster.png,62,55,1,565,627,836,891,771,44.64050041863423,22.933164877855134
7346,/media/marda/TWOTB1/xBD/hurricanes/images/florence/hurricane-florence_00000226_pre_disaster.png,50,48,1,462,512,849,897,320,36.25252079404969,11.821790730553253
7347,/media/marda/TWOTB1/xBD/hurricanes/images/florence/hurricane-florence_00000226_pre_disaster.png,87,72,1,838,925,893,965,1159,55.469630870071164,27.63050136565512
7348,/media/marda/TWOTB1/xBD/hurricanes/images/florence/hurricane-florence_00000226_pre_disaster.png,54,72,1,685,739,911,983,920,39.415850391023454,31.17174513039325
7349,/media/marda/TWOTB1/xBD/hurricanes/images/florence/hurricane-florence_00000226_pre_disaster.png,66,71,1,605,671,929,1000,1111,47.63530004125515,32.80354991928641
7350,/media/marda/TWOTB1/xBD/hurricanes/images/florence/hurricane-florence_00000226_pre_disaster.png,66,59,1,477,543,932,991,923,53.66335077577613,22.660625117115824
7351,/media/marda/TWOTB1/xBD/hurricanes/images/florence/hurricane-florence_00000226_pre_disaster.png,35,48,1,539,574,938,986,160,16.804836122736997,12.74445890918691
7352,/media/marda/TWOTB1/xBD/hurricanes/images/florence/hurricane-florence_00000226_pre_disaster.png,52,59,1,406,458,949,1008,793,41.601390799196224,25.41333738108961
7353,/media/marda/TWOTB1/xBD/hurricanes/images/florence/hurricane-florence_00000226_pre_disaster.png,33,49,1,560,593,981,1030,169,14.966629547095765,14.966629547095765
7354,/media/marda/TWOTB1/xBD/hurricanes/images/florence/hurricane-florence_00000483_post_disaster.png,27,37,1,222,249,0,37,649,40.547191213433635,21.35741327636449
7355,/media/marda/TWOTB1/xBD/hurricanes/images/florence/hurricane-florence_00000483_post_disaster.png,38,7,1,272,310,0,7,142,32.0414341060329,6.028953954775115
7356,/media/marda/TWOTB1/xBD/hurricanes/images/florence/hurricane-florence_00000483_post_disaster.png,66,37,1,663,729,8,45,1040,45.254146609699056,37.05880436414607
7357,/media/marda/TWOTB1/xBD/hurricanes/images/florence/hurricane-florence_00000483_post_disaster.png,36,31,1,271,307,24,55,611,33.62757333298511,25.138019055687753
7358,/media/marda/TWOTB1/xBD/hurricanes/images/florence/hurricane-florence_00000483_post_disaster.png,34,15,1,409,443,53,68,230,20.40225359317232,15.103594231733805
7359,/media/marda/TWOTB1/xBD/hurricanes/images/florence/hurricane-florence_00000483_post_disaster.png,54,25,1,793,847,61,86,417,25.073571785219247,21.94710589409663
7360,/media/marda/TWOTB1/xBD/hurricanes/images/florence/hurricane-florence_00000483_post_disaster.png,59,33,1,262,321,67,100,1291,50.71721821438075,32.920080912271615
7361,/media/marda/TWOTB1/xBD/hurricanes/images/florence/hurricane-florence_00000483_post_disaster.png,70,40,1,767,837,89,129,1123,45.57599132334845,33.8275510236217
7362,/media/marda/TWOTB1/xBD/hurricanes/images/florence/hurricane-florence_00000483_post_disaster.png,43,36,1,854,897,512,548,176,18.439088914585774,12.649110640673518
7363,/media/marda/TWOTB1/xBD/hurricanes/images/florence/hurricane-florence_00000483_post_disaster.png,215,126,1,705,920,759,885,5967,203.3580896931947,39.36893614257489
7364,/media/marda/TWOTB1/xBD/hurricanes/images/florence/hurricane-florence_00000483_post_disaster.png,57,51,1,895,952,805,856,255,21.057386910826192,16.07580386618749
7365,/media/marda/TWOTB1/xBD/hurricanes/images/florence/hurricane-florence_00000483_post_disaster.png,240,141,1,669,909,822,963,7795,247.27644397993458,41.99271569029784
7366,/media/marda/TWOTB1/xBD/hurricanes/images/florence/hurricane-florence_00000042_pre_disaster.png,60,14,1,706,766,0,14,369,33.99391910380539,14.343443478870064
7367,/media/marda/TWOTB1/xBD/hurricanes/images/florence/hurricane-florence_00000042_pre_disaster.png,64,59,1,675,739,37,96,1512,60.930244585634995,32.98070476923345
7368,/media/marda/TWOTB1/xBD/hurricanes/images/florence/hurricane-florence_00000042_pre_disaster.png,38,11,1,616,654,47,58,120,15.388075147362175,10.482070879640208
7369,/media/marda/TWOTB1/xBD/hurricanes/images/florence/hurricane-florence_00000042_pre_disaster.png,39,14,1,637,676,51,65,152,16.005068936516796,12.622714473991547
7370,/media/marda/TWOTB1/xBD/hurricanes/images/florence/hurricane-florence_00000042_pre_disaster.png,56,47,1,655,711,119,166,1005,43.83026326440241,30.170434657837603
7371,/media/marda/TWOTB1/xBD/hurricanes/images/florence/hurricane-florence_00000042_pre_disaster.png,57,61,1,586,643,524,585,930,39.40109201828352,31.449250925434097
7372,/media/marda/TWOTB1/xBD/hurricanes/images/florence/hurricane-florence_00000042_pre_disaster.png,36,36,1,525,561,535,571,169,15.559209751916791,14.488416513601013
7373,/media/marda/TWOTB1/xBD/hurricanes/images/florence/hurricane-florence_00000042_pre_disaster.png,42,40,1,556,598,559,599,273,22.438513189460945,16.208285315755617
7374,/media/marda/TWOTB1/xBD/hurricanes/images/florence/hurricane-florence_00000042_pre_disaster.png,28,31,1,404,432,586,617,100,12.927375575025053,10.345383547372501
7375,/media/marda/TWOTB1/xBD/hurricanes/images/florence/hurricane-florence_00000042_pre_disaster.png,55,57,1,348,403,591,648,758,46.43435483023289,23.560440604598874
7376,/media/marda/TWOTB1/xBD/hurricanes/images/florence/hurricane-florence_00000042_pre_disaster.png,34,36,1,492,526,617,653,154,15.094117211203107,13.420341195816693
7377,/media/marda/TWOTB1/xBD/hurricanes/images/florence/hurricane-florence_00000042_pre_disaster.png,66,62,1,387,453,618,680,1349,54.00297196387003,33.618264119067135
7378,/media/marda/TWOTB1/xBD/hurricanes/images/florence/hurricane-florence_00000042_pre_disaster.png,73,51,1,541,614,630,681,662,57.52170086890324,15.313734126967
7379,/media/marda/TWOTB1/xBD/hurricanes/images/florence/hurricane-florence_00000042_pre_disaster.png,55,42,1,479,534,657,699,480,39.3880040609584,16.497373443623342
7380,/media/marda/TWOTB1/xBD/hurricanes/images/florence/hurricane-florence_00000042_pre_disaster.png,82,64,1,286,368,687,751,1263,75.14901737806287,28.0771023118689
7381,/media/marda/TWOTB1/xBD/hurricanes/images/florence/hurricane-florence_00000042_pre_disaster.png,57,74,1,274,331,742,816,1116,48.514458803751616,30.40252583647342
7382,/media/marda/TWOTB1/xBD/hurricanes/images/florence/hurricane-florence_00000042_pre_disaster.png,61,80,1,206,267,803,883,1081,62.97393048077855,24.932499016592068
7383,/media/marda/TWOTB1/xBD/hurricanes/images/florence/hurricane-florence_00000067_pre_disaster.png,45,63,1,144,189,509,572,961,42.12055933200558,30.065999292861672
7384,/media/marda/TWOTB1/xBD/hurricanes/images/florence/hurricane-florence_00000067_pre_disaster.png,25,56,1,0,25,530,586,587,33.797771436642726,24.00137387228714
7385,/media/marda/TWOTB1/xBD/hurricanes/images/florence/hurricane-florence_00000067_pre_disaster.png,75,73,1,92,167,562,635,1884,70.9907443903561,42.33543048789739
7386,/media/marda/TWOTB1/xBD/hurricanes/images/florence/hurricane-florence_00000067_pre_disaster.png,55,68,1,64,119,730,798,1128,52.57127097518613,30.585651960493372
7387,/media/marda/TWOTB1/xBD/hurricanes/images/florence/hurricane-florence_00000067_pre_disaster.png,60,74,1,115,175,760,834,1373,54.47587311503693,36.838953903528626
7388,/media/marda/TWOTB1/xBD/hurricanes/images/florence/hurricane-florence_00000067_pre_disaster.png,64,77,1,188,252,791,868,1478,57.653495325080286,34.45064593346966
7389,/media/marda/TWOTB1/xBD/hurricanes/images/florence/hurricane-florence_00000067_pre_disaster.png,24,55,1,59,83,805,860,305,23.605483770730928,17.650523354925827
7390,/media/marda/TWOTB1/xBD/hurricanes/images/florence/hurricane-florence_00000067_pre_disaster.png,34,71,1,73,107,813,884,515,42.82119859425713,17.146891026287967
7391,/media/marda/TWOTB1/xBD/hurricanes/images/florence/hurricane-florence_00000067_pre_disaster.png,20,50,1,150,170,834,884,166,16.38348598139491,13.597153816763035
7392,/media/marda/TWOTB1/xBD/hurricanes/images/florence/hurricane-florence_00000067_pre_disaster.png,54,67,1,253,307,838,905,610,49.43267525418824,17.704950111181947
7393,/media/marda/TWOTB1/xBD/hurricanes/images/florence/hurricane-florence_00000067_pre_disaster.png,17,48,1,117,134,841,889,140,14.32997878085071,12.689843036997488
7394,/media/marda/TWOTB1/xBD/hurricanes/images/florence/hurricane-florence_00000067_pre_disaster.png,41,68,1,152,193,846,914,709,33.328058818225,28.446436575871722
7395,/media/marda/TWOTB1/xBD/hurricanes/images/florence/hurricane-florence_00000067_pre_disaster.png,50,78,1,74,124,857,935,1063,51.36181215133975,30.29944133671327
7396,/media/marda/TWOTB1/xBD/hurricanes/images/florence/hurricane-florence_00000067_pre_disaster.png,76,86,1,653,729,867,953,1508,53.02685351145226,38.25060537339541
7397,/media/marda/TWOTB1/xBD/hurricanes/images/florence/hurricane-florence_00000067_pre_disaster.png,97,83,1,790,887,902,985,1542,70.53442713375328,28.847194236433495
7398,/media/marda/TWOTB1/xBD/hurricanes/images/florence/hurricane-florence_00000067_pre_disaster.png,54,69,1,400,454,906,975,647,38.802450535463464,22.1715841185056
7399,/media/marda/TWOTB1/xBD/hurricanes/images/florence/hurricane-florence_00000067_pre_disaster.png,22,57,1,51,73,923,980,230,20.77801531670558,14.829910768841184
7400,/media/marda/TWOTB1/xBD/hurricanes/images/florence/hurricane-florence_00000067_pre_disaster.png,20,57,1,62,82,962,1019,204,20.272609009172445,13.474804027111611
7401,/media/marda/TWOTB1/xBD/hurricanes/images/florence/hurricane-florence_00000067_pre_disaster.png,27,58,1,26,53,963,1021,280,28.17278567668882,13.277119503770304
7402,/media/marda/TWOTB1/xBD/hurricanes/images/florence/hurricane-florence_00000067_pre_disaster.png,82,69,1,288,370,973,1042,1399,74.4514032104907,29.472311027490495
7403,/media/marda/TWOTB1/xBD/hurricanes/images/florence/hurricane-florence_00000067_pre_disaster.png,54,60,1,529,583,984,1044,321,35.83117548843236,11.805397004677808
7404,/media/marda/TWOTB1/xBD/hurricanes/images/florence/hurricane-florence_00000379_pre_disaster.png,72,49,1,448,520,187,236,1318,51.95206362954522,38.62069092913416
7405,/media/marda/TWOTB1/xBD/hurricanes/images/florence/hurricane-florence_00000379_pre_disaster.png,94,39,1,606,700,214,253,1124,76.68492108399508,19.414983649505057
7406,/media/marda/TWOTB1/xBD/hurricanes/images/florence/hurricane-florence_00000379_pre_disaster.png,60,42,1,737,797,310,352,701,31.716974318183766,29.532480669105862
7407,/media/marda/TWOTB1/xBD/hurricanes/images/florence/hurricane-florence_00000379_pre_disaster.png,73,45,1,827,900,338,383,940,40.314140902938476,32.35706616644175
7408,/media/marda/TWOTB1/xBD/hurricanes/images/florence/hurricane-florence_00000071_pre_disaster.png,58,34,1,49,107,160,194,1217,58.99150492660706,27.49034456204977
7409,/media/marda/TWOTB1/xBD/hurricanes/images/florence/hurricane-florence_00000071_pre_disaster.png,16,17,1,19,35,171,188,162,17.052634602615726,12.452374825011841
7410,/media/marda/TWOTB1/xBD/hurricanes/images/florence/hurricane-florence_00000071_pre_disaster.png,31,89,1,0,31,255,344,1043,83.69034722989582,22.59603252276563
7411,/media/marda/TWOTB1/xBD/hurricanes/images/florence/hurricane-florence_00000071_pre_disaster.png,10,33,1,87,97,258,291,238,27.529550176957695,11.436305098839513
7412,/media/marda/TWOTB1/xBD/hurricanes/images/florence/hurricane-florence_00000540_post_disaster.png,61,58,1,576,637,561,619,1022,39.369078257069454,34.1981084439173
7413,/media/marda/TWOTB1/xBD/hurricanes/images/florence/hurricane-florence_00000283_post_disaster.png,51,43,1,82,133,0,43,1059,49.12380527636927,30.08842202099575
7414,/media/marda/TWOTB1/xBD/hurricanes/images/florence/hurricane-florence_00000283_post_disaster.png,45,40,1,13,58,47,87,897,44.783168938876734,26.737946577606184
7415,/media/marda/TWOTB1/xBD/hurricanes/images/florence/hurricane-florence_00000283_post_disaster.png,16,16,1,86,102,82,98,109,15.227303298314771,9.63255320919004
7416,/media/marda/TWOTB1/xBD/hurricanes/images/florence/hurricane-florence_00000283_post_disaster.png,15,13,1,131,146,91,104,72,12.147250847468525,7.994394675733197
7417,/media/marda/TWOTB1/xBD/hurricanes/images/florence/hurricane-florence_00000283_post_disaster.png,58,69,1,71,129,107,176,1899,65.02092595327065,38.96166520609673
7418,/media/marda/TWOTB1/xBD/hurricanes/images/florence/hurricane-florence_00000283_post_disaster.png,54,51,1,311,365,152,203,1007,45.24717650724566,30.424642072131217
7419,/media/marda/TWOTB1/xBD/hurricanes/images/florence/hurricane-florence_00000283_post_disaster.png,43,51,1,124,167,183,234,934,47.80935189398132,26.074090119059118
7420,/media/marda/TWOTB1/xBD/hurricanes/images/florence/hurricane-florence_00000283_post_disaster.png,49,36,1,389,438,194,230,543,34.40470310754599,21.437507919110907
7421,/media/marda/TWOTB1/xBD/hurricanes/images/florence/hurricane-florence_00000283_post_disaster.png,67,39,1,795,862,197,236,876,36.47700895047176,32.37079652590814
7422,/media/marda/TWOTB1/xBD/hurricanes/images/florence/hurricane-florence_00000283_post_disaster.png,72,48,1,905,977,227,275,576,45.915652927527105,16.761009599128624
7423,/media/marda/TWOTB1/xBD/hurricanes/images/florence/hurricane-florence_00000283_post_disaster.png,81,44,1,726,807,246,290,693,61.742924524470844,15.003690281905211
7424,/media/marda/TWOTB1/xBD/hurricanes/images/florence/hurricane-florence_00000283_post_disaster.png,42,30,1,707,749,247,277,155,23.76633879649175,8.654406211294962
7425,/media/marda/TWOTB1/xBD/hurricanes/images/florence/hurricane-florence_00000283_post_disaster.png,44,64,1,170,214,252,316,721,65.44523054888836,14.708833048474759
7426,/media/marda/TWOTB1/xBD/hurricanes/images/florence/hurricane-florence_00000283_post_disaster.png,33,31,1,337,370,252,283,247,21.657752060896694,15.256226903738273
7427,/media/marda/TWOTB1/xBD/hurricanes/images/florence/hurricane-florence_00000283_post_disaster.png,77,50,1,652,729,288,338,792,61.03777846449325,17.265331486440335
7428,/media/marda/TWOTB1/xBD/hurricanes/images/florence/hurricane-florence_00000283_post_disaster.png,48,22,1,921,969,290,312,140,14.085188656307952,13.384399665049042
7429,/media/marda/TWOTB1/xBD/hurricanes/images/florence/hurricane-florence_00000283_post_disaster.png,37,28,1,638,675,301,329,121,15.838393682726336,10.266698781467944
7430,/media/marda/TWOTB1/xBD/hurricanes/images/florence/hurricane-florence_00000283_post_disaster.png,36,31,1,526,562,306,337,168,18.02737477735089,12.519107170689876
7431,/media/marda/TWOTB1/xBD/hurricanes/images/florence/hurricane-florence_00000283_post_disaster.png,35,22,1,621,656,308,330,55,9.930213200760429,7.490100772960014
7432,/media/marda/TWOTB1/xBD/hurricanes/images/florence/hurricane-florence_00000283_post_disaster.png,59,49,1,921,980,308,357,508,40.65397078961843,16.80245295105403
7433,/media/marda/TWOTB1/xBD/hurricanes/images/florence/hurricane-florence_00000283_post_disaster.png,38,25,1,625,663,316,341,91,12.67569376176543,9.65689081558118
7434,/media/marda/TWOTB1/xBD/hurricanes/images/florence/hurricane-florence_00000283_post_disaster.png,41,33,1,534,575,328,361,265,20.628516134465407,16.7667834412949
7435,/media/marda/TWOTB1/xBD/hurricanes/images/florence/hurricane-florence_00000283_post_disaster.png,74,56,1,584,658,331,387,842,61.610326688545825,18.244745359051844
7436,/media/marda/TWOTB1/xBD/hurricanes/images/florence/hurricane-florence_00000283_post_disaster.png,43,66,1,227,270,335,401,664,60.786050303608086,15.745072262916192
7437,/media/marda/TWOTB1/xBD/hurricanes/images/florence/hurricane-florence_00000283_post_disaster.png,29,50,1,39,68,367,417,630,38.459993093360566,21.89640390445409
7438,/media/marda/TWOTB1/xBD/hurricanes/images/florence/hurricane-florence_00000283_post_disaster.png,62,53,1,505,567,378,431,863,42.164552197785945,29.664044801950745
7439,/media/marda/TWOTB1/xBD/hurricanes/images/florence/hurricane-florence_00000283_post_disaster.png,34,35,1,365,399,379,414,398,23.318505650752986,22.85189628598812
7440,/media/marda/TWOTB1/xBD/hurricanes/images/florence/hurricane-florence_00000283_post_disaster.png,33,24,1,484,517,384,408,136,15.766083912312366,11.445401131741301
7441,/media/marda/TWOTB1/xBD/hurricanes/images/florence/hurricane-florence_00000283_post_disaster.png,19,34,1,29,48,390,424,217,20.071415765467183,14.499295306210703
7442,/media/marda/TWOTB1/xBD/hurricanes/images/florence/hurricane-florence_00000283_post_disaster.png,23,26,1,382,405,403,429,100,12.753640574727157,10.452973361234266
7443,/media/marda/TWOTB1/xBD/hurricanes/images/florence/hurricane-florence_00000283_post_disaster.png,16,25,1,100,116,418,443,81,12.070342361974028,9.053711478539894
7444,/media/marda/TWOTB1/xBD/hurricanes/images/florence/hurricane-florence_00000283_post_disaster.png,12,28,1,34,46,421,449,94,12.978264842617365,9.845117764787865
7445,/media/marda/TWOTB1/xBD/hurricanes/images/florence/hurricane-florence_00000283_post_disaster.png,76,46,1,406,482,423,469,1254,66.71547788512882,25.203131163623453
7446,/media/marda/TWOTB1/xBD/hurricanes/images/florence/hurricane-florence_00000283_post_disaster.png,72,59,1,319,391,428,487,1658,63.701062196529485,35.28651155246768
7447,/media/marda/TWOTB1/xBD/hurricanes/images/florence/hurricane-florence_00000283_post_disaster.png,74,56,1,777,851,437,493,829,44.75281522128566,24.736155736045404
7448,/media/marda/TWOTB1/xBD/hurricanes/images/florence/hurricane-florence_00000283_post_disaster.png,21,31,1,276,297,445,476,126,13.948112696782514,12.151388786948212
7449,/media/marda/TWOTB1/xBD/hurricanes/images/florence/hurricane-florence_00000283_post_disaster.png,38,73,1,83,121,456,529,1188,61.50192397135849,25.690324365822956
7450,/media/marda/TWOTB1/xBD/hurricanes/images/florence/hurricane-florence_00000283_post_disaster.png,53,66,1,256,309,468,534,1142,51.81523033662847,29.61221888187215
7451,/media/marda/TWOTB1/xBD/hurricanes/images/florence/hurricane-florence_00000283_post_disaster.png,83,61,1,707,790,477,538,1199,52.35510410071626,32.90794402077285
7452,/media/marda/TWOTB1/xBD/hurricanes/images/florence/hurricane-florence_00000283_post_disaster.png,31,38,1,0,31,504,542,357,35.357769260588874,13.50044752405919
7453,/media/marda/TWOTB1/xBD/hurricanes/images/florence/hurricane-florence_00000283_post_disaster.png,73,58,1,644,717,552,610,980,51.93036641181591,24.830057488290652
7454,/media/marda/TWOTB1/xBD/hurricanes/images/florence/hurricane-florence_00000283_post_disaster.png,39,38,1,560,599,568,606,248,19.110412717532082,17.322309809282117
7455,/media/marda/TWOTB1/xBD/hurricanes/images/florence/hurricane-florence_00000283_post_disaster.png,79,65,1,566,645,605,670,1206,61.742331988832596,26.00800702885469
7456,/media/marda/TWOTB1/xBD/hurricanes/images/florence/hurricane-florence_00000283_post_disaster.png,68,60,1,484,552,619,679,1105,55.47169980677649,27.65829961368408
7457,/media/marda/TWOTB1/xBD/hurricanes/images/florence/hurricane-florence_00000283_post_disaster.png,65,48,1,214,279,645,693,674,63.94906015761769,14.037544560111952
7458,/media/marda/TWOTB1/xBD/hurricanes/images/florence/hurricane-florence_00000283_post_disaster.png,65,57,1,391,456,645,702,1135,54.94543844703514,28.34593206372171
7459,/media/marda/TWOTB1/xBD/hurricanes/images/florence/hurricane-florence_00000283_post_disaster.png,63,56,1,125,188,651,707,1257,64.59786871976937,25.77943616883985
7460,/media/marda/TWOTB1/xBD/hurricanes/images/florence/hurricane-florence_00000283_post_disaster.png,56,49,1,39,95,662,711,804,60.257418643835074,19.52170427121831
7461,/media/marda/TWOTB1/xBD/hurricanes/images/florence/hurricane-florence_00000283_post_disaster.png,32,59,1,108,140,686,745,703,32.35051047634345,28.85519301528017
7462,/media/marda/TWOTB1/xBD/hurricanes/images/florence/hurricane-florence_00000100_pre_disaster.png,32,42,1,337,369,5,47,428,36.78974224680432,17.73770887672443
7463,/media/marda/TWOTB1/xBD/hurricanes/images/florence/hurricane-florence_00000100_pre_disaster.png,87,35,1,852,939,36,71,1241,56.98414541677371,28.90911048413736
7464,/media/marda/TWOTB1/xBD/hurricanes/images/florence/hurricane-florence_00000100_pre_disaster.png,68,41,1,463,531,87,128,1000,54.17126961390739,24.472623652100577
7465,/media/marda/TWOTB1/xBD/hurricanes/images/florence/hurricane-florence_00000100_pre_disaster.png,33,16,1,493,526,152,168,80,11.902230565043496,8.985371866347235
7466,/media/marda/TWOTB1/xBD/hurricanes/images/florence/hurricane-florence_00000100_pre_disaster.png,26,15,1,479,505,188,203,55,9.121014408845921,8.207987761673005
7467,/media/marda/TWOTB1/xBD/hurricanes/images/florence/hurricane-florence_00000122_post_disaster.png,37,18,1,182,219,17,35,529,34.35461001981567,20.303872700433136
7468,/media/marda/TWOTB1/xBD/hurricanes/images/florence/hurricane-florence_00000122_post_disaster.png,302,714,1,400,702,175,889,183623,817.953419408785,305.49078052523583
7469,/media/marda/TWOTB1/xBD/hurricanes/images/florence/hurricane-florence_00000511_post_disaster.png,130,60,1,634,764,700,760,3144,117.16199274796722,35.60376006667689
7470,/media/marda/TWOTB1/xBD/hurricanes/images/florence/hurricane-florence_00000511_post_disaster.png,128,60,1,636,764,754,814,3214,116.00169956706362,36.78622641240122
7471,/media/marda/TWOTB1/xBD/hurricanes/images/florence/hurricane-florence_00000511_post_disaster.png,130,65,1,635,765,819,884,3157,117.62542247030504,35.647351816490094
7472,/media/marda/TWOTB1/xBD/hurricanes/images/florence/hurricane-florence_00000511_post_disaster.png,130,66,1,636,766,873,939,3273,118.12817380562446,36.84281979971882
7473,/media/marda/TWOTB1/xBD/hurricanes/images/florence/hurricane-florence_00000511_post_disaster.png,51,49,1,806,857,883,932,323,21.908902300206645,19.595917942265423
7474,/media/marda/TWOTB1/xBD/hurricanes/images/florence/hurricane-florence_00000235_post_disaster.png,93,123,1,0,93,753,876,2343,141.76526490884723,28.826409018053926
7475,/media/marda/TWOTB1/xBD/hurricanes/images/florence/hurricane-florence_00000235_post_disaster.png,17,45,1,19,36,780,825,139,17.18593849984292,10.836073841428135
7476,/media/marda/TWOTB1/xBD/hurricanes/images/florence/hurricane-florence_00000235_post_disaster.png,33,62,1,34,67,827,889,478,32.10531177426295,19.88261696713308
7477,/media/marda/TWOTB1/xBD/hurricanes/images/florence/hurricane-florence_00000235_post_disaster.png,58,77,1,91,149,831,908,817,63.821080597911916,21.81898025345388
7478,/media/marda/TWOTB1/xBD/hurricanes/images/florence/hurricane-florence_00000235_post_disaster.png,45,78,1,57,102,878,956,1165,47.35177555378277,32.06609520916615
7479,/media/marda/TWOTB1/xBD/hurricanes/images/florence/hurricane-florence_00000235_post_disaster.png,28,62,1,0,28,979,1041,473,26.72485955041219,23.645391049383026
7480,/media/marda/TWOTB1/xBD/hurricanes/images/florence/hurricane-florence_00000121_pre_disaster.png,63,52,1,349,412,57,109,1322,48.74855989485212,35.916900246616166
7481,/media/marda/TWOTB1/xBD/hurricanes/images/florence/hurricane-florence_00000533_post_disaster.png,31,22,1,467,498,276,298,158,15.746030174179223,13.27271944337257
7482,/media/marda/TWOTB1/xBD/hurricanes/images/florence/hurricane-florence_00000533_post_disaster.png,54,60,1,473,527,303,363,1140,45.32328726390659,33.28727567367142
7483,/media/marda/TWOTB1/xBD/hurricanes/images/florence/hurricane-florence_00000443_pre_disaster.png,50,84,1,295,345,794,878,1437,53.12550406248019,35.9592516384297
7484,/media/marda/TWOTB1/xBD/hurricanes/images/florence/hurricane-florence_00000443_pre_disaster.png,57,74,1,0,57,835,909,2048,63.75115659442408,42.88311928156942
7485,/media/marda/TWOTB1/xBD/hurricanes/images/florence/hurricane-florence_00000443_pre_disaster.png,57,69,1,307,364,858,927,1092,44.42899811870693,32.94241230798036
7486,/media/marda/TWOTB1/xBD/hurricanes/images/florence/hurricane-florence_00000443_pre_disaster.png,64,68,1,436,500,858,926,1393,52.227513224124955,35.455574096984364
7487,/media/marda/TWOTB1/xBD/hurricanes/images/florence/hurricane-florence_00000443_pre_disaster.png,29,47,1,408,437,876,923,195,17.281975195754296,14.966629547095765
7488,/media/marda/TWOTB1/xBD/hurricanes/images/florence/hurricane-florence_00000443_pre_disaster.png,59,73,1,0,59,884,957,1729,66.27319011887442,34.81802451164029
7489,/media/marda/TWOTB1/xBD/hurricanes/images/florence/hurricane-florence_00000443_pre_disaster.png,28,52,1,445,473,894,946,176,18.591331294067054,12.584212359708612
7490,/media/marda/TWOTB1/xBD/hurricanes/images/florence/hurricane-florence_00000443_pre_disaster.png,133,108,1,118,251,934,1042,3816,127.48732410210617,40.666736237409324
7491,/media/marda/TWOTB1/xBD/hurricanes/images/florence/hurricane-florence_00000443_pre_disaster.png,67,81,1,0,67,951,1032,2395,75.68483387878167,42.22469993276511
7492,/media/marda/TWOTB1/xBD/hurricanes/images/florence/hurricane-florence_00000443_pre_disaster.png,14,51,1,109,123,981,1032,93,15.309419371564235,8.193956876016053
7493,/media/marda/TWOTB1/xBD/hurricanes/images/florence/hurricane-florence_00000443_pre_disaster.png,27,57,1,127,154,987,1044,224,19.62121483772428,15.166411758844191
7494,/media/marda/TWOTB1/xBD/hurricanes/images/florence/hurricane-florence_00000265_pre_disaster.png,78,29,1,773,851,0,29,784,50.56466437430754,21.362600439903147
7495,/media/marda/TWOTB1/xBD/hurricanes/images/florence/hurricane-florence_00000265_pre_disaster.png,69,22,1,940,1009,0,22,525,31.988928554780653,21.66135591708358
7496,/media/marda/TWOTB1/xBD/hurricanes/images/florence/hurricane-florence_00000265_pre_disaster.png,69,65,1,749,818,2,67,1041,73.62600855833065,19.1315370872448
7497,/media/marda/TWOTB1/xBD/hurricanes/images/florence/hurricane-florence_00000265_pre_disaster.png,48,16,1,723,771,13,29,176,21.050963589550463,11.206965907148223
7498,/media/marda/TWOTB1/xBD/hurricanes/images/florence/hurricane-florence_00000265_pre_disaster.png,55,14,1,976,1031,18,32,129,16.181563423129973,10.540214961643528
7499,/media/marda/TWOTB1/xBD/hurricanes/images/florence/hurricane-florence_00000265_pre_disaster.png,58,23,1,730,788,24,47,447,29.745750354509127,19.75408395337139
7500,/media/marda/TWOTB1/xBD/hurricanes/images/florence/hurricane-florence_00000265_pre_disaster.png,45,44,1,262,307,27,71,904,45.229011270866295,26.728601230995796
7501,/media/marda/TWOTB1/xBD/hurricanes/images/florence/hurricane-florence_00000265_pre_disaster.png,57,27,1,488,545,32,59,755,41.0888911989066,24.452034194122735
7502,/media/marda/TWOTB1/xBD/hurricanes/images/florence/hurricane-florence_00000265_pre_disaster.png,84,42,1,938,1022,55,97,1136,40.913418779244964,36.708665939607485
7503,/media/marda/TWOTB1/xBD/hurricanes/images/florence/hurricane-florence_00000265_pre_disaster.png,35,13,1,496,531,62,75,143,15.58288918776134,12.270338702728136
7504,/media/marda/TWOTB1/xBD/hurricanes/images/florence/hurricane-florence_00000265_pre_disaster.png,48,23,1,522,570,87,110,354,29.054516476813863,16.092280903510783
7505,/media/marda/TWOTB1/xBD/hurricanes/images/florence/hurricane-florence_00000265_pre_disaster.png,58,27,1,862,920,103,130,295,20.01096582969684,19.538209526708425
7506,/media/marda/TWOTB1/xBD/hurricanes/images/florence/hurricane-florence_00000265_pre_disaster.png,63,37,1,461,524,125,162,1058,46.197064178125984,30.54190508057429
7507,/media/marda/TWOTB1/xBD/hurricanes/images/florence/hurricane-florence_00000265_pre_disaster.png,58,31,1,719,777,210,241,335,30.33810747292848,16.74529492566484
7508,/media/marda/TWOTB1/xBD/hurricanes/images/florence/hurricane-florence_00000265_pre_disaster.png,38,25,1,495,533,226,251,269,20.765757895656968,17.230906464612502
7509,/media/marda/TWOTB1/xBD/hurricanes/images/florence/hurricane-florence_00000265_pre_disaster.png,50,63,1,514,564,245,308,1584,62.10860503477553,33.887072658877685
7510,/media/marda/TWOTB1/xBD/hurricanes/images/florence/hurricane-florence_00000265_pre_disaster.png,29,29,1,286,315,260,289,278,19.803929329458942,18.718108998484585
7511,/media/marda/TWOTB1/xBD/hurricanes/images/florence/hurricane-florence_00000265_pre_disaster.png,46,62,1,300,346,268,330,1226,55.917330486530815,29.05851577183613
7512,/media/marda/TWOTB1/xBD/hurricanes/images/florence/hurricane-florence_00000265_pre_disaster.png,39,37,1,219,258,350,387,479,32.48242068942381,19.296867860995306
7513,/media/marda/TWOTB1/xBD/hurricanes/images/florence/hurricane-florence_00000265_pre_disaster.png,56,70,1,271,327,371,441,1643,55.58454695705548,40.76216614517348
7514,/media/marda/TWOTB1/xBD/hurricanes/images/florence/hurricane-florence_00000265_pre_disaster.png,70,66,1,556,626,392,458,1649,47.53638463205592,45.55950349554956
7515,/media/marda/TWOTB1/xBD/hurricanes/images/florence/hurricane-florence_00000265_pre_disaster.png,39,37,1,670,709,420,457,241,21.390857184217953,14.966342068103845
7516,/media/marda/TWOTB1/xBD/hurricanes/images/florence/hurricane-florence_00000265_pre_disaster.png,31,40,1,180,211,426,466,353,23.158164279127025,20.276573565745075
7517,/media/marda/TWOTB1/xBD/hurricanes/images/florence/hurricane-florence_00000265_pre_disaster.png,58,62,1,253,311,437,499,1319,47.227108495960316,37.183675299724214
7518,/media/marda/TWOTB1/xBD/hurricanes/images/florence/hurricane-florence_00000265_pre_disaster.png,64,91,1,214,278,497,588,2180,66.5661834471848,47.55625622637454
7519,/media/marda/TWOTB1/xBD/hurricanes/images/florence/hurricane-florence_00000265_pre_disaster.png,60,81,1,392,452,535,616,1344,64.42464861453468,27.77542788823351
7520,/media/marda/TWOTB1/xBD/hurricanes/images/florence/hurricane-florence_00000265_pre_disaster.png,37,39,1,470,507,561,600,213,19.677333008438293,14.337575897406916
7521,/media/marda/TWOTB1/xBD/hurricanes/images/florence/hurricane-florence_00000265_pre_disaster.png,50,73,1,179,229,584,657,1191,53.45831187694395,29.614208801393065
7522,/media/marda/TWOTB1/xBD/hurricanes/images/florence/hurricane-florence_00000265_pre_disaster.png,59,71,1,357,416,615,686,1158,46.38767718321946,33.46997867751409
7523,/media/marda/TWOTB1/xBD/hurricanes/images/florence/hurricane-florence_00000265_pre_disaster.png,41,45,1,439,480,635,680,254,26.915808901294117,12.533039625913519
7524,/media/marda/TWOTB1/xBD/hurricanes/images/florence/hurricane-florence_00000265_pre_disaster.png,29,52,1,113,142,664,716,392,26.40770551790553,19.73178172549526
7525,/media/marda/TWOTB1/xBD/hurricanes/images/florence/hurricane-florence_00000265_pre_disaster.png,54,85,1,136,190,675,760,1597,63.28325581853081,33.25613091178655
7526,/media/marda/TWOTB1/xBD/hurricanes/images/florence/hurricane-florence_00000265_pre_disaster.png,81,85,1,315,396,690,775,1968,66.70634473435344,44.55504978193251
7527,/media/marda/TWOTB1/xBD/hurricanes/images/florence/hurricane-florence_00000265_pre_disaster.png,36,50,1,386,422,737,787,279,20.2494176599735,18.211864483935734
7528,/media/marda/TWOTB1/xBD/hurricanes/images/florence/hurricane-florence_00000265_pre_disaster.png,54,81,1,278,332,765,846,1205,55.04161448483268,29.138651330212898
7529,/media/marda/TWOTB1/xBD/hurricanes/images/florence/hurricane-florence_00000265_pre_disaster.png,29,48,1,350,379,815,863,156,17.00783647401656,12.149562459894021
7530,/media/marda/TWOTB1/xBD/hurricanes/images/florence/hurricane-florence_00000265_pre_disaster.png,52,80,1,239,291,844,924,1160,44.118841046952724,34.80125522546923
7531,/media/marda/TWOTB1/xBD/hurricanes/images/florence/hurricane-florence_00000265_pre_disaster.png,38,61,1,304,342,866,927,399,28.437404329650406,18.9397130980473
7532,/media/marda/TWOTB1/xBD/hurricanes/images/florence/hurricane-florence_00000265_pre_disaster.png,34,67,1,32,66,869,936,632,31.44066381739381,26.77593639673041
7533,/media/marda/TWOTB1/xBD/hurricanes/images/florence/hurricane-florence_00000265_pre_disaster.png,50,101,1,26,76,900,1001,1785,64.55615635700127,37.78794832122698
7534,/media/marda/TWOTB1/xBD/hurricanes/images/florence/hurricane-florence_00000265_pre_disaster.png,52,89,1,198,250,915,1004,1171,55.02274778826092,28.24676305763912
7535,/media/marda/TWOTB1/xBD/hurricanes/images/florence/hurricane-florence_00000265_pre_disaster.png,13,66,1,0,13,962,1028,204,27.553724496391286,11.301241708195386
7536,/media/marda/TWOTB1/xBD/hurricanes/images/florence/hurricane-florence_00000265_pre_disaster.png,29,55,1,257,286,963,1018,217,18.420297467352118,15.695711675251886
7537,/media/marda/TWOTB1/xBD/hurricanes/images/florence/hurricane-florence_00000265_pre_disaster.png,48,53,1,520,568,991,1044,193,25.481219365277447,11.627227196317573
7538,/media/marda/TWOTB1/xBD/hurricanes/images/florence/hurricane-florence_00000265_pre_disaster.png,28,51,1,176,204,993,1044,131,20.288990962475193,9.833909519595615
7539,/media/marda/TWOTB1/xBD/hurricanes/images/florence/hurricane-florence_00000010_pre_disaster.png,51,51,1,0,51,0,51,1571,55.68471643231621,37.47584897042291
7540,/media/marda/TWOTB1/xBD/hurricanes/images/florence/hurricane-florence_00000010_pre_disaster.png,61,31,1,263,324,0,31,987,47.323667669536555,29.32154618968827
7541,/media/marda/TWOTB1/xBD/hurricanes/images/florence/hurricane-florence_00000010_pre_disaster.png,85,29,1,441,526,0,29,1100,62.6340775431939,26.148829844067585
7542,/media/marda/TWOTB1/xBD/hurricanes/images/florence/hurricane-florence_00000010_pre_disaster.png,88,53,1,942,1030,11,64,1612,49.9916991987093,45.9179985753295
7543,/media/marda/TWOTB1/xBD/hurricanes/images/florence/hurricane-florence_00000010_pre_disaster.png,73,56,1,803,876,13,69,1471,56.07270688455571,35.011843340247665
7544,/media/marda/TWOTB1/xBD/hurricanes/images/florence/hurricane-florence_00000010_pre_disaster.png,81,46,1,377,458,18,64,2407,74.76363429451085,43.1772616432671
7545,/media/marda/TWOTB1/xBD/hurricanes/images/florence/hurricane-florence_00000010_pre_disaster.png,78,38,1,628,706,31,69,1545,55.24926999790414,37.23402658262626
7546,/media/marda/TWOTB1/xBD/hurricanes/images/florence/hurricane-florence_00000010_pre_disaster.png,57,44,1,225,282,83,127,1621,48.28118395444827,44.260208503226465
7547,/media/marda/TWOTB1/xBD/hurricanes/images/florence/hurricane-florence_00000010_pre_disaster.png,89,56,1,640,729,83,139,1966,63.124195427020055,45.97624254768161
7548,/media/marda/TWOTB1/xBD/hurricanes/images/florence/hurricane-florence_00000010_pre_disaster.png,95,69,1,501,596,91,160,2382,69.45663101190225,56.388131558587254
7549,/media/marda/TWOTB1/xBD/hurricanes/images/florence/hurricane-florence_00000010_pre_disaster.png,97,70,1,829,926,97,167,2202,63.82307505293925,47.68585555246726
7550,/media/marda/TWOTB1/xBD/hurricanes/images/florence/hurricane-florence_00000010_pre_disaster.png,66,52,1,357,423,122,174,2034,55.98691419481864,50.08418665349497
7551,/media/marda/TWOTB1/xBD/hurricanes/images/florence/hurricane-florence_00000010_pre_disaster.png,80,58,1,216,296,148,206,2013,66.363863232743,44.05738496326887
7552,/media/marda/TWOTB1/xBD/hurricanes/images/florence/hurricane-florence_00000010_pre_disaster.png,82,50,1,660,742,152,202,1782,58.21110162172789,47.297399879675645
7553,/media/marda/TWOTB1/xBD/hurricanes/images/florence/hurricane-florence_00000010_pre_disaster.png,81,83,1,413,494,160,243,2539,71.09612885962686,53.252763566267895
7554,/media/marda/TWOTB1/xBD/hurricanes/images/florence/hurricane-florence_00000010_pre_disaster.png,83,59,1,245,328,205,264,1743,70.19017483505388,37.84963571293558
7555,/media/marda/TWOTB1/xBD/hurricanes/images/florence/hurricane-florence_00000010_pre_disaster.png,72,58,1,453,525,215,273,1451,48.20231400304757,40.4503534493317
7556,/media/marda/TWOTB1/xBD/hurricanes/images/florence/hurricane-florence_00000010_pre_disaster.png,90,71,1,619,709,217,288,2074,59.11163734037515,50.69058978313501
7557,/media/marda/TWOTB1/xBD/hurricanes/images/florence/hurricane-florence_00000010_pre_disaster.png,65,66,1,298,363,234,300,1652,50.377172184073096,43.7173387848752
7558,/media/marda/TWOTB1/xBD/hurricanes/images/florence/hurricane-florence_00000010_pre_disaster.png,85,55,1,515,600,242,297,1584,61.34795600412511,36.834356627245036
7559,/media/marda/TWOTB1/xBD/hurricanes/images/florence/hurricane-florence_00000010_pre_disaster.png,19,18,1,263,282,256,274,54,10.062461072716959,7.216662004929232
7560,/media/marda/TWOTB1/xBD/hurricanes/images/florence/hurricane-florence_00000010_pre_disaster.png,75,66,1,343,418,278,344,1994,56.202502803972635,48.13204744980702
7561,/media/marda/TWOTB1/xBD/hurricanes/images/florence/hurricane-florence_00000010_pre_disaster.png,89,74,1,545,634,300,374,2464,75.66508419869783,44.21982315601935
7562,/media/marda/TWOTB1/xBD/hurricanes/images/florence/hurricane-florence_00000010_pre_disaster.png,77,76,1,391,468,323,399,2031,58.21747810886674,51.447841232691154
7563,/media/marda/TWOTB1/xBD/hurricanes/images/florence/hurricane-florence_00000010_pre_disaster.png,103,103,1,6,109,372,475,5495,113.98886034525374,72.36581147728671
7564,/media/marda/TWOTB1/xBD/hurricanes/images/florence/hurricane-florence_00000010_pre_disaster.png,75,82,1,436,511,374,456,2408,62.87501742153275,52.67857332077988
7565,/media/marda/TWOTB1/xBD/hurricanes/images/florence/hurricane-florence_00000010_pre_disaster.png,94,66,1,942,1036,374,440,1699,47.85295570199535,46.374495986130114
7566,/media/marda/TWOTB1/xBD/hurricanes/images/florence/hurricane-florence_00000010_pre_disaster.png,87,70,1,510,597,379,449,2258,68.2200183097748,45.67636269364156
7567,/media/marda/TWOTB1/xBD/hurricanes/images/florence/hurricane-florence_00000010_pre_disaster.png,86,69,1,903,989,430,499,2207,57.37290461818926,50.74139168047685
7568,/media/marda/TWOTB1/xBD/hurricanes/images/florence/hurricane-florence_00000010_pre_disaster.png,99,75,1,945,1044,482,557,2128,56.50138997521478,49.61319218634192
7569,/media/marda/TWOTB1/xBD/hurricanes/images/florence/hurricane-florence_00000010_pre_disaster.png,107,112,1,118,225,486,598,5190,122.25180953997503,62.52895832600648
7570,/media/marda/TWOTB1/xBD/hurricanes/images/florence/hurricane-florence_00000010_pre_disaster.png,111,77,1,51,162,494,571,1995,127.52150781654824,30.91042242697125
7571,/media/marda/TWOTB1/xBD/hurricanes/images/florence/hurricane-florence_00000010_pre_disaster.png,105,145,1,0,105,522,667,6050,134.06493966814256,85.91965433009463
7572,/media/marda/TWOTB1/xBD/hurricanes/images/florence/hurricane-florence_00000010_pre_disaster.png,52,46,1,159,211,589,635,909,54.41121823897246,23.58834273232493
7573,/media/marda/TWOTB1/xBD/hurricanes/images/florence/hurricane-florence_00000010_pre_disaster.png,101,142,1,229,330,601,743,6269,132.65128737430288,88.23745470855337
7574,/media/marda/TWOTB1/xBD/hurricanes/images/florence/hurricane-florence_00000010_pre_disaster.png,117,106,1,841,958,615,721,3318,77.9928588599681,56.744960360619736
7575,/media/marda/TWOTB1/xBD/hurricanes/images/florence/hurricane-florence_00000010_pre_disaster.png,22,49,1,118,140,627,676,375,26.241752343248113,19.064122772022408
7576,/media/marda/TWOTB1/xBD/hurricanes/images/florence/hurricane-florence_00000010_pre_disaster.png,23,58,1,175,198,631,689,611,38.169254526827885,21.36958509781394
7577,/media/marda/TWOTB1/xBD/hurricanes/images/florence/hurricane-florence_00000010_pre_disaster.png,109,133,1,0,109,664,797,5689,130.8042435804043,81.52990933905234
7578,/media/marda/TWOTB1/xBD/hurricanes/images/florence/hurricane-florence_00000010_pre_disaster.png,30,58,1,115,145,689,747,464,29.93453457940221,20.485406142948804
7579,/media/marda/TWOTB1/xBD/hurricanes/images/florence/hurricane-florence_00000010_pre_disaster.png,36,42,1,175,211,689,731,420,34.62176579359676,16.1245154965971
7580,/media/marda/TWOTB1/xBD/hurricanes/images/florence/hurricane-florence_00000010_pre_disaster.png,40,64,1,91,131,713,777,637,37.9971885555627,22.389217604513316
7581,/media/marda/TWOTB1/xBD/hurricanes/images/florence/hurricane-florence_00000010_pre_disaster.png,133,114,1,95,228,714,828,5257,142.32365853031544,68.48046197924509
7582,/media/marda/TWOTB1/xBD/hurricanes/images/florence/hurricane-florence_00000010_pre_disaster.png,115,106,1,929,1044,722,828,3086,67.71113097649453,60.68864625623666
7583,/media/marda/TWOTB1/xBD/hurricanes/images/florence/hurricane-florence_00000010_pre_disaster.png,35,63,1,35,70,768,831,563,36.85410590704125,20.401158783250477
7584,/media/marda/TWOTB1/xBD/hurricanes/images/florence/hurricane-florence_00000010_pre_disaster.png,129,112,1,653,782,774,886,1704,129.46767440671204,25.16707217747079
7585,/media/marda/TWOTB1/xBD/hurricanes/images/florence/hurricane-florence_00000010_pre_disaster.png,102,151,1,17,119,782,933,5685,135.45583030105217,80.43918182118173
7586,/media/marda/TWOTB1/xBD/hurricanes/images/florence/hurricane-florence_00000010_pre_disaster.png,33,50,1,2,35,785,835,532,35.622194589763886,19.966581440900715
7587,/media/marda/TWOTB1/xBD/hurricanes/images/florence/hurricane-florence_00000010_pre_disaster.png,85,97,1,599,684,863,960,607,94.29895669980716,8.598359077779962
7588,/media/marda/TWOTB1/xBD/hurricanes/images/florence/hurricane-florence_00000010_pre_disaster.png,101,95,1,839,940,883,978,2151,59.97532371319572,47.59723180621021
7589,/media/marda/TWOTB1/xBD/hurricanes/images/florence/hurricane-florence_00000010_pre_disaster.png,217,148,1,677,894,894,1042,11418,168.4197641754286,94.76921295873365
7590,/media/marda/TWOTB1/xBD/hurricanes/images/florence/hurricane-florence_00000010_pre_disaster.png,68,113,1,556,624,929,1042,635,96.77615559475454,8.761396479590537
7591,/media/marda/TWOTB1/xBD/hurricanes/images/florence/hurricane-florence_00000010_pre_disaster.png,75,75,1,898,973,936,1011,663,43.30716299010292,20.43568363157885
7592,/media/marda/TWOTB1/xBD/hurricanes/images/florence/hurricane-florence_00000010_pre_disaster.png,93,90,1,595,688,952,1042,1287,80.6824068155064,21.42638014060228
7593,/media/marda/TWOTB1/xBD/hurricanes/images/florence/hurricane-florence_00000010_pre_disaster.png,66,67,1,585,651,975,1042,646,43.56213037593573,20.288816725838846
7594,/media/marda/TWOTB1/xBD/hurricanes/images/florence/hurricane-florence_00000237_post_disaster.png,52,30,1,294,346,0,30,477,44.2595624113894,14.539773135614178
7595,/media/marda/TWOTB1/xBD/hurricanes/images/florence/hurricane-florence_00000237_post_disaster.png,43,21,1,317,360,0,21,299,31.11879883475488,12.90289895001306
7596,/media/marda/TWOTB1/xBD/hurricanes/images/florence/hurricane-florence_00000237_post_disaster.png,108,64,1,728,836,79,143,1662,94.78993319358324,23.404689079901104
7597,/media/marda/TWOTB1/xBD/hurricanes/images/florence/hurricane-florence_00000237_post_disaster.png,116,81,1,928,1044,188,269,3363,88.46831074688968,51.06486937238375
7598,/media/marda/TWOTB1/xBD/hurricanes/images/florence/hurricane-florence_00000237_post_disaster.png,67,38,1,882,949,235,273,457,28.776671125819373,21.221018206112337
7599,/media/marda/TWOTB1/xBD/hurricanes/images/florence/hurricane-florence_00000237_post_disaster.png,111,68,1,861,972,260,328,3128,86.94019539926795,56.36235305383688
7600,/media/marda/TWOTB1/xBD/hurricanes/images/florence/hurricane-florence_00000237_post_disaster.png,88,80,1,690,778,289,369,2214,65.09219010636318,50.91369488651924
7601,/media/marda/TWOTB1/xBD/hurricanes/images/florence/hurricane-florence_00000237_post_disaster.png,88,62,1,604,692,332,394,1260,69.94431222104838,28.462007593616715
7602,/media/marda/TWOTB1/xBD/hurricanes/images/florence/hurricane-florence_00000237_post_disaster.png,59,50,1,672,731,345,395,588,39.503894765514126,19.8716444696772
7603,/media/marda/TWOTB1/xBD/hurricanes/images/florence/hurricane-florence_00000237_post_disaster.png,66,48,1,631,697,379,427,665,45.00588749579401,19.728059964758252
7604,/media/marda/TWOTB1/xBD/hurricanes/images/florence/hurricane-florence_00000237_post_disaster.png,48,33,1,702,750,379,412,204,20.272609009172445,13.474804027111611
7605,/media/marda/TWOTB1/xBD/hurricanes/images/florence/hurricane-florence_00000237_post_disaster.png,87,75,1,639,726,398,473,1237,76.90296624488883,24.464726482315104
7606,/media/marda/TWOTB1/xBD/hurricanes/images/florence/hurricane-florence_00000237_post_disaster.png,69,67,1,507,576,497,564,1021,53.57196190204251,25.42657288616278
7607,/media/marda/TWOTB1/xBD/hurricanes/images/florence/hurricane-florence_00000237_post_disaster.png,85,77,1,446,531,535,612,1439,75.32568894200833,28.168485832799767
7608,/media/marda/TWOTB1/xBD/hurricanes/images/florence/hurricane-florence_00000237_post_disaster.png,45,67,1,71,116,624,691,865,43.32136304952267,28.051271893258676
7609,/media/marda/TWOTB1/xBD/hurricanes/images/florence/hurricane-florence_00000237_post_disaster.png,25,69,1,0,25,685,754,672,38.71138819048828,24.697320084913315
7610,/media/marda/TWOTB1/xBD/hurricanes/images/florence/hurricane-florence_00000237_post_disaster.png,49,83,1,0,49,785,868,763,68.11138662574679,15.017729487107058
7611,/media/marda/TWOTB1/xBD/hurricanes/images/florence/hurricane-florence_00000237_post_disaster.png,60,82,1,0,60,800,882,852,75.96151993601887,14.958136036769568
7612,/media/marda/TWOTB1/xBD/hurricanes/images/florence/hurricane-florence_00000237_post_disaster.png,55,114,1,0,55,864,978,2557,75.66645496251893,49.25368669945585
7613,/media/marda/TWOTB1/xBD/hurricanes/images/florence/hurricane-florence_00000237_post_disaster.png,124,123,1,146,270,918,1041,5608,105.1985271900267,74.75061975691544
7614,/media/marda/TWOTB1/xBD/hurricanes/images/florence/hurricane-florence_00000237_post_disaster.png,89,112,1,28,117,929,1041,2821,85.40924356338512,47.16031221334982
7615,/media/marda/TWOTB1/xBD/hurricanes/images/florence/hurricane-florence_00000237_post_disaster.png,77,60,1,930,1007,981,1041,479,41.91651528002249,15.240416610148062
7616,/media/marda/TWOTB1/xBD/hurricanes/images/florence/hurricane-florence_00000237_post_disaster.png,54,60,1,101,155,983,1043,471,44.9010052138593,17.524723798082853
7617,/media/marda/TWOTB1/xBD/hurricanes/images/florence/hurricane-florence_00000273_post_disaster.png,90,36,1,288,378,0,36,1603,75.91210430147818,30.957585792028652
7618,/media/marda/TWOTB1/xBD/hurricanes/images/florence/hurricane-florence_00000273_post_disaster.png,49,30,1,712,761,43,73,344,32.667498184711086,14.11646786948298
7619,/media/marda/TWOTB1/xBD/hurricanes/images/florence/hurricane-florence_00000273_post_disaster.png,78,43,1,474,552,46,89,1434,61.071390039875624,31.89064653638549
7620,/media/marda/TWOTB1/xBD/hurricanes/images/florence/hurricane-florence_00000273_post_disaster.png,84,57,1,624,708,82,139,1888,50.94631889296132,48.90402012225518
7621,/media/marda/TWOTB1/xBD/hurricanes/images/florence/hurricane-florence_00000273_post_disaster.png,78,72,1,729,807,196,268,1729,58.705808970035186,41.069507674758995
7622,/media/marda/TWOTB1/xBD/hurricanes/images/florence/hurricane-florence_00000273_post_disaster.png,54,40,1,294,348,198,238,852,45.51989123717976,24.99489125660256
7623,/media/marda/TWOTB1/xBD/hurricanes/images/florence/hurricane-florence_00000273_post_disaster.png,38,26,1,354,392,208,234,270,27.79792755352648,12.913070020874578
7624,/media/marda/TWOTB1/xBD/hurricanes/images/florence/hurricane-florence_00000273_post_disaster.png,51,58,1,286,337,228,286,1240,49.43505548925741,34.90444757434489
7625,/media/marda/TWOTB1/xBD/hurricanes/images/florence/hurricane-florence_00000273_post_disaster.png,33,32,1,188,221,489,521,228,30.38966912335241,9.958602622369979
7626,/media/marda/TWOTB1/xBD/hurricanes/images/florence/hurricane-florence_00000273_post_disaster.png,49,63,1,170,219,497,560,1094,39.73780532795611,37.72668407743046
7627,/media/marda/TWOTB1/xBD/hurricanes/images/florence/hurricane-florence_00000273_post_disaster.png,60,62,1,300,360,507,569,1220,51.26237408823156,33.83689357371451
7628,/media/marda/TWOTB1/xBD/hurricanes/images/florence/hurricane-florence_00000273_post_disaster.png,25,41,1,261,286,562,603,209,21.285494870268984,13.146922975580214
7629,/media/marda/TWOTB1/xBD/hurricanes/images/florence/hurricane-florence_00000273_post_disaster.png,28,65,1,296,324,715,780,460,40.74517067360233,15.099833768041778
7630,/media/marda/TWOTB1/xBD/hurricanes/images/florence/hurricane-florence_00000273_post_disaster.png,64,70,1,335,399,821,891,1489,55.07590795352697,36.11390137304011
7631,/media/marda/TWOTB1/xBD/hurricanes/images/florence/hurricane-florence_00000273_post_disaster.png,48,92,1,41,89,879,971,1315,63.283894917184305,27.705882103679713
7632,/media/marda/TWOTB1/xBD/hurricanes/images/florence/hurricane-florence_00000273_post_disaster.png,28,58,1,142,170,885,943,264,20.67591982625066,17.085075931805846
7633,/media/marda/TWOTB1/xBD/hurricanes/images/florence/hurricane-florence_00000273_post_disaster.png,73,111,1,141,214,925,1036,1835,89.6091389347032,29.44733717806463
7634,/media/marda/TWOTB1/xBD/hurricanes/images/florence/hurricane-florence_00000273_post_disaster.png,24,45,1,393,417,934,979,85,11.147372866272212,10.118968209588605
7635,/media/marda/TWOTB1/xBD/hurricanes/images/florence/hurricane-florence_00000273_post_disaster.png,32,27,1,277,309,336,363,209,23.190388335443895,12.09345967545535
7636,/media/marda/TWOTB1/xBD/hurricanes/images/florence/hurricane-florence_00000273_post_disaster.png,41,48,1,231,272,367,415,710,33.14921387874958,28.721102484575805
7637,/media/marda/TWOTB1/xBD/hurricanes/images/florence/hurricane-florence_00000273_post_disaster.png,23,28,1,270,293,374,402,151,14.656531733981598,13.84467102316414
7638,/media/marda/TWOTB1/xBD/hurricanes/images/florence/hurricane-florence_00000273_post_disaster.png,23,27,1,302,325,442,469,121,12.649110640673518,12.649110640673518
7639,/media/marda/TWOTB1/xBD/hurricanes/images/florence/hurricane-florence_00000180_pre_disaster.png,63,61,1,981,1044,354,415,664,44.771220631445395,22.466254838759003
7640,/media/marda/TWOTB1/xBD/hurricanes/images/florence/hurricane-florence_00000181_post_disaster.png,48,58,1,33,81,297,355,1293,49.06798342244543,36.1506611802765
7641,/media/marda/TWOTB1/xBD/hurricanes/images/florence/hurricane-florence_00000181_post_disaster.png,55,59,1,198,253,367,426,1647,48.491162111734475,45.375187093649394
7642,/media/marda/TWOTB1/xBD/hurricanes/images/florence/hurricane-florence_00000181_post_disaster.png,49,61,1,20,69,420,481,1285,48.98943228065171,36.34347349678801
7643,/media/marda/TWOTB1/xBD/hurricanes/images/florence/hurricane-florence_00000181_post_disaster.png,21,36,1,132,153,440,476,221,19.879166648262128,14.653263158083424
7644,/media/marda/TWOTB1/xBD/hurricanes/images/florence/hurricane-florence_00000181_post_disaster.png,23,33,1,137,160,462,495,201,19.249482935972793,14.026516565104517
7645,/media/marda/TWOTB1/xBD/hurricanes/images/florence/hurricane-florence_00000181_post_disaster.png,39,61,1,46,85,497,558,1179,42.64474407436934,36.915141816951575
7646,/media/marda/TWOTB1/xBD/hurricanes/images/florence/hurricane-florence_00000181_post_disaster.png,18,60,1,0,18,691,751,308,27.654227622006577,16.480012198668568
7647,/media/marda/TWOTB1/xBD/hurricanes/images/florence/hurricane-florence_00000181_post_disaster.png,29,57,1,16,45,714,771,421,23.834060858627733,23.588738906141323
7648,/media/marda/TWOTB1/xBD/hurricanes/images/florence/hurricane-florence_00000181_post_disaster.png,35,53,1,177,212,739,792,392,25.408740065290566,21.034039307606996
7649,/media/marda/TWOTB1/xBD/hurricanes/images/florence/hurricane-florence_00000181_post_disaster.png,58,98,1,195,253,758,856,1732,66.6794162318936,40.503824004159824
7650,/media/marda/TWOTB1/xBD/hurricanes/images/florence/hurricane-florence_00000181_post_disaster.png,92,92,1,553,645,781,873,1843,77.9720566946921,33.77314068503703
7651,/media/marda/TWOTB1/xBD/hurricanes/images/florence/hurricane-florence_00000181_post_disaster.png,44,45,1,603,647,825,870,202,21.281172468812837,12.732698038622512
7652,/media/marda/TWOTB1/xBD/hurricanes/images/florence/hurricane-florence_00000181_post_disaster.png,28,61,1,100,128,836,897,423,28.334971269778013,19.951593608633015
7653,/media/marda/TWOTB1/xBD/hurricanes/images/florence/hurricane-florence_00000181_post_disaster.png,38,65,1,154,192,839,904,582,28.919220547178067,27.238094658411825
7654,/media/marda/TWOTB1/xBD/hurricanes/images/florence/hurricane-florence_00000181_post_disaster.png,48,64,1,156,204,872,936,499,47.96937492193082,13.890276615525018
7655,/media/marda/TWOTB1/xBD/hurricanes/images/florence/hurricane-florence_00000181_post_disaster.png,52,60,1,582,634,872,932,424,27.59786650748471,20.518266829072477
7656,/media/marda/TWOTB1/xBD/hurricanes/images/florence/hurricane-florence_00000181_post_disaster.png,53,88,1,77,130,900,988,1253,58.10057422009786,29.023869592995712
7657,/media/marda/TWOTB1/xBD/hurricanes/images/florence/hurricane-florence_00000181_post_disaster.png,20,67,1,0,20,948,1015,379,27.753030478893912,18.835060868171947
7658,/media/marda/TWOTB1/xBD/hurricanes/images/florence/hurricane-florence_00000181_post_disaster.png,57,85,1,251,308,954,1039,1267,43.734139817602006,41.432935942285866
7659,/media/marda/TWOTB1/xBD/hurricanes/images/florence/hurricane-florence_00000181_post_disaster.png,29,54,1,314,343,989,1043,160,16.20664411314986,13.34209734598369
7660,/media/marda/TWOTB1/xBD/hurricanes/images/florence/hurricane-florence_00000181_post_disaster.png,95,34,1,884,979,88,122,1267,64.35138828971668,29.231357354295785
7661,/media/marda/TWOTB1/xBD/hurricanes/images/florence/hurricane-florence_00000181_post_disaster.png,83,62,1,677,760,282,344,1321,60.32104702980914,30.789690314285455
7662,/media/marda/TWOTB1/xBD/hurricanes/images/florence/hurricane-florence_00000181_post_disaster.png,80,63,1,963,1043,453,516,966,50.67680469433056,26.582501395614646
7663,/media/marda/TWOTB1/xBD/hurricanes/images/florence/hurricane-florence_00000181_post_disaster.png,102,70,1,825,927,588,658,1581,65.95788132210497,37.4672024533267
7664,/media/marda/TWOTB1/xBD/hurricanes/images/florence/hurricane-florence_00000181_post_disaster.png,65,55,1,832,897,634,689,555,30.513911718750297,24.300190199388844
7665,/media/marda/TWOTB1/xBD/hurricanes/images/florence/hurricane-florence_00000181_post_disaster.png,79,68,1,950,1029,634,702,672,52.16957143150488,17.36984528629685
7666,/media/marda/TWOTB1/xBD/hurricanes/images/florence/hurricane-florence_00000181_post_disaster.png,74,67,1,724,798,662,729,1099,44.73246850180502,32.76502786742514
7667,/media/marda/TWOTB1/xBD/hurricanes/images/florence/hurricane-florence_00000181_post_disaster.png,46,33,1,967,1013,684,717,45,9.014163291733533,6.790637774504804
7668,/media/marda/TWOTB1/xBD/hurricanes/images/florence/hurricane-florence_00000181_post_disaster.png,49,45,1,797,846,699,744,142,16.172751399681214,11.825775910342026
7669,/media/marda/TWOTB1/xBD/hurricanes/images/florence/hurricane-florence_00000181_post_disaster.png,73,71,1,744,817,707,778,981,36.478635552411646,35.56263871530959
7670,/media/marda/TWOTB1/xBD/hurricanes/images/florence/hurricane-florence_00000384_post_disaster.png,11,19,1,93,104,0,19,151,22.063933964485155,9.12409136168645
7671,/media/marda/TWOTB1/xBD/hurricanes/images/florence/hurricane-florence_00000384_post_disaster.png,31,7,1,255,286,0,7,113,25.15541952196354,6.136253883566825
7672,/media/marda/TWOTB1/xBD/hurricanes/images/florence/hurricane-florence_00000384_post_disaster.png,25,55,1,125,150,5,60,777,60.02885926116723,17.15488331561563
7673,/media/marda/TWOTB1/xBD/hurricanes/images/florence/hurricane-florence_00000384_post_disaster.png,24,10,1,339,363,20,30,109,13.910682624411768,10.446726795592918
7674,/media/marda/TWOTB1/xBD/hurricanes/images/florence/hurricane-florence_00000384_post_disaster.png,24,17,1,290,314,47,64,157,17.876017378460162,12.245164235291773
7675,/media/marda/TWOTB1/xBD/hurricanes/images/florence/hurricane-florence_00000384_post_disaster.png,84,47,1,248,332,62,109,1933,83.19905621528122,42.011911382564584
7676,/media/marda/TWOTB1/xBD/hurricanes/images/florence/hurricane-florence_00000384_post_disaster.png,48,38,1,267,315,214,252,881,41.25999697483329,28.81788198683688
7677,/media/marda/TWOTB1/xBD/hurricanes/images/florence/hurricane-florence_00000384_post_disaster.png,28,29,1,328,356,225,254,269,21.870344626101872,16.27305458692195
7678,/media/marda/TWOTB1/xBD/hurricanes/images/florence/hurricane-florence_00000384_post_disaster.png,27,37,1,112,139,261,298,540,30.319469607254337,23.822132308013217
7679,/media/marda/TWOTB1/xBD/hurricanes/images/florence/hurricane-florence_00000384_post_disaster.png,36,63,1,156,192,265,328,1232,58.75629031813355,28.15884478845812
7680,/media/marda/TWOTB1/xBD/hurricanes/images/florence/hurricane-florence_00000384_post_disaster.png,28,51,1,40,68,314,365,914,41.011781595040375,29.00228583092591
7681,/media/marda/TWOTB1/xBD/hurricanes/images/florence/hurricane-florence_00000384_post_disaster.png,54,25,1,919,973,334,359,202,20.321002878949777,13.322196442955207
7682,/media/marda/TWOTB1/xBD/hurricanes/images/florence/hurricane-florence_00000384_post_disaster.png,53,28,1,905,958,349,377,233,19.200104609941352,16.277320098088804
7683,/media/marda/TWOTB1/xBD/hurricanes/images/florence/hurricane-florence_00000384_post_disaster.png,81,46,1,962,1043,354,400,1060,46.20604391014378,31.59953016199234
7684,/media/marda/TWOTB1/xBD/hurricanes/images/florence/hurricane-florence_00000384_post_disaster.png,53,45,1,537,590,368,413,807,33.88964592750846,31.37782270581877
7685,/media/marda/TWOTB1/xBD/hurricanes/images/florence/hurricane-florence_00000384_post_disaster.png,45,37,1,174,219,402,439,522,43.14382320932502,15.949283231584019
7686,/media/marda/TWOTB1/xBD/hurricanes/images/florence/hurricane-florence_00000384_post_disaster.png,30,37,1,67,97,403,440,451,32.39429668621083,18.44209831024038
7687,/media/marda/TWOTB1/xBD/hurricanes/images/florence/hurricane-florence_00000384_post_disaster.png,70,74,1,445,515,414,488,1933,56.43782071665012,49.443014577955765
7688,/media/marda/TWOTB1/xBD/hurricanes/images/florence/hurricane-florence_00000384_post_disaster.png,10,30,1,58,68,425,455,101,14.538931179975421,9.2967044985158
7689,/media/marda/TWOTB1/xBD/hurricanes/images/florence/hurricane-florence_00000384_post_disaster.png,29,66,1,178,207,441,507,746,55.14385363191527,18.07415410657422
7690,/media/marda/TWOTB1/xBD/hurricanes/images/florence/hurricane-florence_00000384_post_disaster.png,18,35,1,123,141,514,549,190,16.366293326054794,15.50897370815412
7691,/media/marda/TWOTB1/xBD/hurricanes/images/florence/hurricane-florence_00000384_post_disaster.png,154,83,1,60,214,542,625,5218,156.93758645811693,47.971968043869474
7692,/media/marda/TWOTB1/xBD/hurricanes/images/florence/hurricane-florence_00000384_post_disaster.png,50,71,1,472,522,550,621,1118,54.689403606350375,27.004612556444002
7693,/media/marda/TWOTB1/xBD/hurricanes/images/florence/hurricane-florence_00000384_post_disaster.png,44,38,1,507,551,576,614,294,23.335796103998778,16.82467975192302
7694,/media/marda/TWOTB1/xBD/hurricanes/images/florence/hurricane-florence_00000384_post_disaster.png,42,50,1,512,554,701,751,351,23.07435449459169,20.441724819670572
7695,/media/marda/TWOTB1/xBD/hurricanes/images/florence/hurricane-florence_00000384_post_disaster.png,55,53,1,469,524,706,759,663,40.752642307254,21.48123775564739
7696,/media/marda/TWOTB1/xBD/hurricanes/images/florence/hurricane-florence_00000384_post_disaster.png,44,42,1,688,732,713,755,128,14.833982364793671,11.61692589289397
7697,/media/marda/TWOTB1/xBD/hurricanes/images/florence/hurricane-florence_00000384_post_disaster.png,38,60,1,399,437,728,788,455,33.46552731462639,17.934834494374766
7698,/media/marda/TWOTB1/xBD/hurricanes/images/florence/hurricane-florence_00000384_post_disaster.png,60,56,1,666,726,741,797,709,37.23680944445573,25.255632344694074
7699,/media/marda/TWOTB1/xBD/hurricanes/images/florence/hurricane-florence_00000384_post_disaster.png,88,62,1,499,587,756,818,1629,74.37433075711276,29.491841486481487
7700,/media/marda/TWOTB1/xBD/hurricanes/images/florence/hurricane-florence_00000384_post_disaster.png,36,44,1,632,668,793,837,112,13.45447365043063,11.25561519792434
7701,/media/marda/TWOTB1/xBD/hurricanes/images/florence/hurricane-florence_00000384_post_disaster.png,56,60,1,628,684,803,863,641,33.886086245537484,25.044000652132674
7702,/media/marda/TWOTB1/xBD/hurricanes/images/florence/hurricane-florence_00000384_post_disaster.png,66,99,1,257,323,846,945,2050,67.29007240227442,49.2940386219631
7703,/media/marda/TWOTB1/xBD/hurricanes/images/florence/hurricane-florence_00000384_post_disaster.png,71,60,1,883,954,870,930,704,35.65927971470796,25.946543217526333
7704,/media/marda/TWOTB1/xBD/hurricanes/images/florence/hurricane-florence_00000384_post_disaster.png,65,73,1,784,849,922,995,845,34.76275312716895,32.04366578959271
7705,/media/marda/TWOTB1/xBD/hurricanes/images/florence/hurricane-florence_00000384_post_disaster.png,37,53,1,576,613,925,978,202,17.753490486413046,15.340552280716546
7706,/media/marda/TWOTB1/xBD/hurricanes/images/florence/hurricane-florence_00000384_post_disaster.png,51,58,1,839,890,930,988,307,21.884425430610932,18.799340001938496
7707,/media/marda/TWOTB1/xBD/hurricanes/images/florence/hurricane-florence_00000384_post_disaster.png,58,77,1,637,695,944,1021,1041,42.25567527083216,32.99421727283722
7708,/media/marda/TWOTB1/xBD/hurricanes/images/florence/hurricane-florence_00000384_post_disaster.png,50,87,1,505,555,953,1040,988,51.34777579864817,27.386085322479758
7709,/media/marda/TWOTB1/xBD/hurricanes/images/florence/hurricane-florence_00000384_post_disaster.png,64,60,1,823,887,957,1017,513,33.86481275983355,20.216547529001655
7710,/media/marda/TWOTB1/xBD/hurricanes/images/florence/hurricane-florence_00000384_post_disaster.png,55,55,1,792,847,988,1043,283,25.00786821267507,15.188013380521499
7711,/media/marda/TWOTB1/xBD/hurricanes/images/florence/hurricane-florence_00000062_pre_disaster.png,37,29,1,229,266,0,29,502,29.814004699197472,24.210207669470822
7712,/media/marda/TWOTB1/xBD/hurricanes/images/florence/hurricane-florence_00000062_pre_disaster.png,33,42,1,51,84,156,198,691,38.01560651262479,24.07935008005791
7713,/media/marda/TWOTB1/xBD/hurricanes/images/florence/hurricane-florence_00000062_pre_disaster.png,27,19,1,236,263,171,190,183,20.26453052804543,12.094986283096697
7714,/media/marda/TWOTB1/xBD/hurricanes/images/florence/hurricane-florence_00000062_pre_disaster.png,63,41,1,811,874,198,239,875,36.091600843996446,31.919303298290323
7715,/media/marda/TWOTB1/xBD/hurricanes/images/florence/hurricane-florence_00000062_pre_disaster.png,67,72,1,282,349,820,892,1392,58.651861502658676,31.377900104860583
7716,/media/marda/TWOTB1/xBD/hurricanes/images/florence/hurricane-florence_00000062_pre_disaster.png,57,50,1,830,887,845,895,240,27.51742685201993,11.676904912373889
7717,/media/marda/TWOTB1/xBD/hurricanes/images/florence/hurricane-florence_00000062_pre_disaster.png,54,52,1,870,924,939,991,203,23.486865323212815,11.58002476644707
7718,/media/marda/TWOTB1/xBD/hurricanes/images/florence/hurricane-florence_00000317_pre_disaster.png,62,18,1,939,1001,12,30,309,25.472672775871573,16.187405686142085
7719,/media/marda/TWOTB1/xBD/hurricanes/images/florence/hurricane-florence_00000317_pre_disaster.png,64,50,1,980,1044,19,69,797,47.75168336520018,23.196044964106637
7720,/media/marda/TWOTB1/xBD/hurricanes/images/florence/hurricane-florence_00000317_pre_disaster.png,50,62,1,376,426,106,168,1232,62.617827320692136,26.113497420150047
7721,/media/marda/TWOTB1/xBD/hurricanes/images/florence/hurricane-florence_00000317_pre_disaster.png,64,49,1,696,760,117,166,1032,43.325100144676355,31.756459649701032
7722,/media/marda/TWOTB1/xBD/hurricanes/images/florence/hurricane-florence_00000317_pre_disaster.png,68,47,1,965,1033,131,178,614,46.1276874071451,18.396596396072884
7723,/media/marda/TWOTB1/xBD/hurricanes/images/florence/hurricane-florence_00000317_pre_disaster.png,21,12,1,375,396,167,179,64,10.10566749386685,8.359155729103442
7724,/media/marda/TWOTB1/xBD/hurricanes/images/florence/hurricane-florence_00000317_pre_disaster.png,47,45,1,31,78,190,235,1039,47.063893770160554,29.456882069664385
7725,/media/marda/TWOTB1/xBD/hurricanes/images/florence/hurricane-florence_00000317_pre_disaster.png,59,62,1,400,459,190,252,1520,63.574285871055,31.711271383722245
7726,/media/marda/TWOTB1/xBD/hurricanes/images/florence/hurricane-florence_00000317_pre_disaster.png,44,26,1,497,541,247,273,287,23.618078162465356,16.086719072583794
7727,/media/marda/TWOTB1/xBD/hurricanes/images/florence/hurricane-florence_00000317_pre_disaster.png,55,60,1,426,481,275,335,1204,53.69343959233946,29.926675506478155
7728,/media/marda/TWOTB1/xBD/hurricanes/images/florence/hurricane-florence_00000317_pre_disaster.png,67,42,1,28,95,277,319,1126,74.2504704972641,21.989223587671024
7729,/media/marda/TWOTB1/xBD/hurricanes/images/florence/hurricane-florence_00000317_pre_disaster.png,70,52,1,229,299,305,357,1433,62.479310499826454,30.389115643188934
7730,/media/marda/TWOTB1/xBD/hurricanes/images/florence/hurricane-florence_00000317_pre_disaster.png,60,50,1,179,239,336,386,1228,57.28620375501307,28.413065605919115
7731,/media/marda/TWOTB1/xBD/hurricanes/images/florence/hurricane-florence_00000317_pre_disaster.png,57,66,1,449,506,357,423,1343,56.484244122437296,33.733105889122186
7732,/media/marda/TWOTB1/xBD/hurricanes/images/florence/hurricane-florence_00000317_pre_disaster.png,19,27,1,120,139,389,416,147,14.572480421289082,13.46486142552785
7733,/media/marda/TWOTB1/xBD/hurricanes/images/florence/hurricane-florence_00000317_pre_disaster.png,35,39,1,205,240,406,445,383,28.598031799695207,17.83396076074732
7734,/media/marda/TWOTB1/xBD/hurricanes/images/florence/hurricane-florence_00000317_pre_disaster.png,57,54,1,483,540,444,498,992,38.158844407601244,34.14803158438773
7735,/media/marda/TWOTB1/xBD/hurricanes/images/florence/hurricane-florence_00000317_pre_disaster.png,35,26,1,523,558,470,496,94,14.410515958977538,8.926349690416624
7736,/media/marda/TWOTB1/xBD/hurricanes/images/florence/hurricane-florence_00000317_pre_disaster.png,50,49,1,487,537,573,622,576,32.27082676504993,23.615762195665752
7737,/media/marda/TWOTB1/xBD/hurricanes/images/florence/hurricane-florence_00000317_pre_disaster.png,37,40,1,500,537,619,659,131,15.98740162890645,10.997294529603726
7738,/media/marda/TWOTB1/xBD/hurricanes/images/florence/hurricane-florence_00000317_pre_disaster.png,50,46,1,716,766,621,667,272,20.63179548288854,17.562101662564174
7739,/media/marda/TWOTB1/xBD/hurricanes/images/florence/hurricane-florence_00000317_pre_disaster.png,24,34,1,272,296,663,697,126,18.120841557420636,9.367227583378329
7740,/media/marda/TWOTB1/xBD/hurricanes/images/florence/hurricane-florence_00000317_pre_disaster.png,35,39,1,564,599,663,702,118,13.618703672795137,11.596962656206237
7741,/media/marda/TWOTB1/xBD/hurricanes/images/florence/hurricane-florence_00000317_pre_disaster.png,37,48,1,522,559,679,727,191,25.37915257133634,10.100291148433858
7742,/media/marda/TWOTB1/xBD/hurricanes/images/florence/hurricane-florence_00000317_pre_disaster.png,39,68,1,168,207,885,953,665,31.072708997531144,28.384972661913505
7743,/media/marda/TWOTB1/xBD/hurricanes/images/florence/hurricane-florence_00000396_pre_disaster.png,65,36,1,900,965,407,443,506,30.91851764308536,21.563342983458508
7744,/media/marda/TWOTB1/xBD/hurricanes/images/florence/hurricane-florence_00000396_pre_disaster.png,57,56,1,987,1044,409,465,576,42.3365165602704,17.95265303398405
7745,/media/marda/TWOTB1/xBD/hurricanes/images/florence/hurricane-florence_00000396_pre_disaster.png,89,41,1,847,936,444,485,806,57.74720225243982,20.981582931541336
7746,/media/marda/TWOTB1/xBD/hurricanes/images/florence/hurricane-florence_00000396_pre_disaster.png,55,29,1,822,877,566,595,197,25.335378305971016,10.194603401615229
7747,/media/marda/TWOTB1/xBD/hurricanes/images/florence/hurricane-florence_00000396_pre_disaster.png,53,54,1,844,897,584,638,513,37.685006613874066,21.31656960804985
7748,/media/marda/TWOTB1/xBD/hurricanes/images/florence/hurricane-florence_00000396_pre_disaster.png,52,54,1,810,862,606,660,557,33.021941240776734,22.383997414639698
7749,/media/marda/TWOTB1/xBD/hurricanes/images/florence/hurricane-florence_00000396_pre_disaster.png,72,55,1,830,902,739,794,751,42.2379373570083,24.061059532111674
7750,/media/marda/TWOTB1/xBD/hurricanes/images/florence/hurricane-florence_00000396_pre_disaster.png,40,67,1,474,514,798,865,712,38.47894003133222,24.70886041644074
7751,/media/marda/TWOTB1/xBD/hurricanes/images/florence/hurricane-florence_00000396_pre_disaster.png,78,71,1,873,951,918,989,810,46.24659545772024,23.29207487130181
7752,/media/marda/TWOTB1/xBD/hurricanes/images/florence/hurricane-florence_00000396_pre_disaster.png,70,68,1,853,923,950,1018,608,32.93474278259581,24.762662365240338
7753,/media/marda/TWOTB1/xBD/hurricanes/images/florence/hurricane-florence_00000005_pre_disaster.png,67,65,1,0,67,0,65,3012,65.77331538924561,61.307816511674496
7754,/media/marda/TWOTB1/xBD/hurricanes/images/florence/hurricane-florence_00000005_pre_disaster.png,92,109,1,364,456,0,109,4457,124.02639808696759,48.22296445280601
7755,/media/marda/TWOTB1/xBD/hurricanes/images/florence/hurricane-florence_00000005_pre_disaster.png,114,31,1,492,606,0,31,1393,85.75428540813512,26.474519990935896
7756,/media/marda/TWOTB1/xBD/hurricanes/images/florence/hurricane-florence_00000005_pre_disaster.png,106,32,1,623,729,0,32,1293,67.66997850932108,29.3677904921748
7757,/media/marda/TWOTB1/xBD/hurricanes/images/florence/hurricane-florence_00000005_pre_disaster.png,91,8,1,939,1030,0,8,372,61.34279072883111,8.031743152618704
7758,/media/marda/TWOTB1/xBD/hurricanes/images/florence/hurricane-florence_00000005_pre_disaster.png,79,80,1,452,531,35,115,2995,84.04331129875439,46.983249429864635
7759,/media/marda/TWOTB1/xBD/hurricanes/images/florence/hurricane-florence_00000005_pre_disaster.png,102,88,1,935,1037,36,124,4602,95.43882060838042,63.842942135554054
7760,/media/marda/TWOTB1/xBD/hurricanes/images/florence/hurricane-florence_00000005_pre_disaster.png,82,106,1,656,738,40,146,4208,119.64724374477044,47.78678870118986
7761,/media/marda/TWOTB1/xBD/hurricanes/images/florence/hurricane-florence_00000005_pre_disaster.png,79,94,1,738,817,76,170,3652,103.82969039760532,46.89569441914271
7762,/media/marda/TWOTB1/xBD/hurricanes/images/florence/hurricane-florence_00000005_pre_disaster.png,114,88,1,446,560,117,205,3648,104.38173517953369,46.49633857908144
7763,/media/marda/TWOTB1/xBD/hurricanes/images/florence/hurricane-florence_00000005_pre_disaster.png,132,70,1,556,688,139,209,3768,122.33416270082125,41.361005455468565
7764,/media/marda/TWOTB1/xBD/hurricanes/images/florence/hurricane-florence_00000005_pre_disaster.png,84,82,1,960,1044,143,225,2175,71.51183383157728,43.50514886309935
7765,/media/marda/TWOTB1/xBD/hurricanes/images/florence/hurricane-florence_00000005_pre_disaster.png,124,78,1,676,800,177,255,3513,107.9693556409003,43.652862429517725
7766,/media/marda/TWOTB1/xBD/hurricanes/images/florence/hurricane-florence_00000005_pre_disaster.png,84,74,1,125,209,179,253,2520,85.65796485914922,39.125843539230964
7767,/media/marda/TWOTB1/xBD/hurricanes/images/florence/hurricane-florence_00000005_pre_disaster.png,92,42,1,565,657,272,314,2051,76.64766799046699,35.089586068359125
7768,/media/marda/TWOTB1/xBD/hurricanes/images/florence/hurricane-florence_00000005_pre_disaster.png,101,77,1,475,576,274,351,2506,94.01792426107168,36.20537208003462
7769,/media/marda/TWOTB1/xBD/hurricanes/images/florence/hurricane-florence_00000005_pre_disaster.png,100,58,1,634,734,283,341,2170,80.36449670245842,35.72097948906066
7770,/media/marda/TWOTB1/xBD/hurricanes/images/florence/hurricane-florence_00000005_pre_disaster.png,122,57,1,706,828,309,366,2838,103.69475777638733,36.434201905718936
7771,/media/marda/TWOTB1/xBD/hurricanes/images/florence/hurricane-florence_00000005_pre_disaster.png,92,87,1,404,496,323,410,2329,92.08636270093854,34.582076696817765
7772,/media/marda/TWOTB1/xBD/hurricanes/images/florence/hurricane-florence_00000005_pre_disaster.png,83,31,1,942,1025,363,394,620,49.05290416588084,17.51658710771809
7773,/media/marda/TWOTB1/xBD/hurricanes/images/florence/hurricane-florence_00000005_pre_disaster.png,122,62,1,530,652,365,427,2836,110.18825105043065,34.02820088103903
7774,/media/marda/TWOTB1/xBD/hurricanes/images/florence/hurricane-florence_00000005_pre_disaster.png,128,66,1,695,823,392,458,3030,110.02248989164782,36.522665865964655
7775,/media/marda/TWOTB1/xBD/hurricanes/images/florence/hurricane-florence_00000005_pre_disaster.png,70,82,1,370,440,395,477,2118,72.91771761213744,38.443170086660665
7776,/media/marda/TWOTB1/xBD/hurricanes/images/florence/hurricane-florence_00000005_pre_disaster.png,72,119,1,972,1044,406,525,2822,116.8608425814215,32.739719343625076
7777,/media/marda/TWOTB1/xBD/hurricanes/images/florence/hurricane-florence_00000005_pre_disaster.png,93,97,1,463,556,407,504,2778,97.51243349789517,38.196994733555286
7778,/media/marda/TWOTB1/xBD/hurricanes/images/florence/hurricane-florence_00000005_pre_disaster.png,69,87,1,598,667,407,494,2359,75.11708447254534,41.340367293914625
7779,/media/marda/TWOTB1/xBD/hurricanes/images/florence/hurricane-florence_00000005_pre_disaster.png,90,122,1,888,978,407,529,4117,118.49630822582813,46.73180855050922
7780,/media/marda/TWOTB1/xBD/hurricanes/images/florence/hurricane-florence_00000005_pre_disaster.png,69,88,1,687,756,437,525,2169,78.28007075778577,36.917340572067076
7781,/media/marda/TWOTB1/xBD/hurricanes/images/florence/hurricane-florence_00000005_pre_disaster.png,65,96,1,365,430,474,570,2677,86.61054385275706,42.0547541462001
7782,/media/marda/TWOTB1/xBD/hurricanes/images/florence/hurricane-florence_00000005_pre_disaster.png,5,40,1,0,5,475,515,87,25.47451140525017,4.6756031658470905
7783,/media/marda/TWOTB1/xBD/hurricanes/images/florence/hurricane-florence_00000005_pre_disaster.png,51,74,1,13,64,477,551,1675,52.238495571734816,42.85005737845133
7784,/media/marda/TWOTB1/xBD/hurricanes/images/florence/hurricane-florence_00000005_pre_disaster.png,73,101,1,581,654,480,581,2761,89.27958491439733,40.63761453656595
7785,/media/marda/TWOTB1/xBD/hurricanes/images/florence/hurricane-florence_00000005_pre_disaster.png,76,88,1,461,537,496,584,1991,69.2280685428731,38.2219026148654
7786,/media/marda/TWOTB1/xBD/hurricanes/images/florence/hurricane-florence_00000005_pre_disaster.png,57,78,1,58,115,510,588,1769,51.2323207039341,46.77126507111352
7787,/media/marda/TWOTB1/xBD/hurricanes/images/florence/hurricane-florence_00000005_pre_disaster.png,72,102,1,668,740,510,612,2557,88.77634507015178,38.07012033253306
7788,/media/marda/TWOTB1/xBD/hurricanes/images/florence/hurricane-florence_00000005_pre_disaster.png,88,97,1,877,965,518,615,3089,85.66812135501702,48.388784954241935
7789,/media/marda/TWOTB1/xBD/hurricanes/images/florence/hurricane-florence_00000005_pre_disaster.png,93,132,1,951,1044,528,660,4126,121.88186218309674,44.89133198589421
7790,/media/marda/TWOTB1/xBD/hurricanes/images/florence/hurricane-florence_00000005_pre_disaster.png,109,75,1,519,628,547,622,2420,93.40213719596322,34.43033378035524
7791,/media/marda/TWOTB1/xBD/hurricanes/images/florence/hurricane-florence_00000005_pre_disaster.png,49,70,1,95,144,560,630,1491,45.00054362134519,43.59314372996413
7792,/media/marda/TWOTB1/xBD/hurricanes/images/florence/hurricane-florence_00000005_pre_disaster.png,95,90,1,385,480,561,651,2737,90.34157807172588,40.13272678957984
7793,/media/marda/TWOTB1/xBD/hurricanes/images/florence/hurricane-florence_00000005_pre_disaster.png,38,74,1,0,38,594,668,1125,44.13446531580811,36.75827949370201
7794,/media/marda/TWOTB1/xBD/hurricanes/images/florence/hurricane-florence_00000005_pre_disaster.png,127,83,1,655,782,594,677,3271,107.95861513625856,40.13830001960991
7795,/media/marda/TWOTB1/xBD/hurricanes/images/florence/hurricane-florence_00000005_pre_disaster.png,104,136,1,843,947,596,732,4516,124.04930754623271,49.46336384005237
7796,/media/marda/TWOTB1/xBD/hurricanes/images/florence/hurricane-florence_00000005_pre_disaster.png,55,73,1,113,168,611,684,1830,53.680474115899095,46.094459959190125
7797,/media/marda/TWOTB1/xBD/hurricanes/images/florence/hurricane-florence_00000005_pre_disaster.png,91,78,1,498,589,627,705,2172,75.52193134134853,37.98567763348186
7798,/media/marda/TWOTB1/xBD/hurricanes/images/florence/hurricane-florence_00000005_pre_disaster.png,94,104,1,923,1017,645,749,3002,88.22666068602626,45.59227699562012
7799,/media/marda/TWOTB1/xBD/hurricanes/images/florence/hurricane-florence_00000005_pre_disaster.png,49,71,1,8,57,653,724,1815,55.33537501571619,43.27003328932474
7800,/media/marda/TWOTB1/xBD/hurricanes/images/florence/hurricane-florence_00000005_pre_disaster.png,92,72,1,568,660,653,725,1904,74.86080341313989,33.856058775238004
7801,/media/marda/TWOTB1/xBD/hurricanes/images/florence/hurricane-florence_00000005_pre_disaster.png,55,69,1,121,176,671,740,1787,53.14338095633266,45.778813271295
7802,/media/marda/TWOTB1/xBD/hurricanes/images/florence/hurricane-florence_00000005_pre_disaster.png,138,88,1,635,773,675,763,3618,121.45451576765802,39.63755188246742
7803,/media/marda/TWOTB1/xBD/hurricanes/images/florence/hurricane-florence_00000005_pre_disaster.png,62,67,1,982,1044,699,766,629,40.83174999239178,20.80038363826603
7804,/media/marda/TWOTB1/xBD/hurricanes/images/florence/hurricane-florence_00000005_pre_disaster.png,53,74,1,11,64,710,784,1778,52.1546540633222,46.1628494201206
7805,/media/marda/TWOTB1/xBD/hurricanes/images/florence/hurricane-florence_00000005_pre_disaster.png,58,76,1,124,182,720,796,1927,55.26138921283326,47.008733266514625
7806,/media/marda/TWOTB1/xBD/hurricanes/images/florence/hurricane-florence_00000005_pre_disaster.png,147,98,1,809,956,723,821,4042,121.84294580784882,44.177939026961255
7807,/media/marda/TWOTB1/xBD/hurricanes/images/florence/hurricane-florence_00000005_pre_disaster.png,122,95,1,921,1043,756,851,3174,86.67920427338849,49.47969939537741
7808,/media/marda/TWOTB1/xBD/hurricanes/images/florence/hurricane-florence_00000005_pre_disaster.png,53,69,1,125,178,784,853,1596,50.4208706094248,42.818710450132436
7809,/media/marda/TWOTB1/xBD/hurricanes/images/florence/hurricane-florence_00000005_pre_disaster.png,62,75,1,421,483,788,863,1651,52.43623651279449,42.72669387122481
7810,/media/marda/TWOTB1/xBD/hurricanes/images/florence/hurricane-florence_00000005_pre_disaster.png,73,89,1,477,550,802,891,1744,51.47959641983494,45.27824464297142
7811,/media/marda/TWOTB1/xBD/hurricanes/images/florence/hurricane-florence_00000005_pre_disaster.png,53,87,1,17,70,804,891,2032,56.31402563486525,48.88537665825853
7812,/media/marda/TWOTB1/xBD/hurricanes/images/florence/hurricane-florence_00000005_pre_disaster.png,75,84,1,360,435,812,896,1921,54.584470068924176,45.95130563029092
7813,/media/marda/TWOTB1/xBD/hurricanes/images/florence/hurricane-florence_00000005_pre_disaster.png,15,74,1,0,15,825,899,502,43.50061672970576,15.599618447088458
7814,/media/marda/TWOTB1/xBD/hurricanes/images/florence/hurricane-florence_00000005_pre_disaster.png,58,81,1,120,178,837,918,1932,55.23089403861998,47.46541304781172
7815,/media/marda/TWOTB1/xBD/hurricanes/images/florence/hurricane-florence_00000005_pre_disaster.png,68,86,1,181,249,859,945,1913,54.22132389954206,47.04671126716249
7816,/media/marda/TWOTB1/xBD/hurricanes/images/florence/hurricane-florence_00000005_pre_disaster.png,74,81,1,499,573,864,945,1926,54.87035404999835,47.687051532184505
7817,/media/marda/TWOTB1/xBD/hurricanes/images/florence/hurricane-florence_00000005_pre_disaster.png,66,82,1,359,425,880,962,1466,46.90805609340664,41.8778948438947
7818,/media/marda/TWOTB1/xBD/hurricanes/images/florence/hurricane-florence_00000005_pre_disaster.png,76,91,1,475,551,911,1002,1871,53.200132891285925,47.52995272614478
7819,/media/marda/TWOTB1/xBD/hurricanes/images/florence/hurricane-florence_00000005_pre_disaster.png,71,91,1,301,372,917,1008,2003,55.628094020698356,48.64485617389782
7820,/media/marda/TWOTB1/xBD/hurricanes/images/florence/hurricane-florence_00000005_pre_disaster.png,45,74,1,37,82,924,998,1464,49.84466584303491,39.39440263322609
7821,/media/marda/TWOTB1/xBD/hurricanes/images/florence/hurricane-florence_00000005_pre_disaster.png,25,85,1,0,25,929,1014,841,47.84324285645312,25.080002989330012
7822,/media/marda/TWOTB1/xBD/hurricanes/images/florence/hurricane-florence_00000005_pre_disaster.png,62,85,1,87,149,937,1022,1902,57.10440698583347,44.42331285453953
7823,/media/marda/TWOTB1/xBD/hurricanes/images/florence/hurricane-florence_00000005_pre_disaster.png,69,88,1,434,503,954,1042,1604,48.68509148212354,43.59218121887886
7824,/media/marda/TWOTB1/xBD/hurricanes/images/florence/hurricane-florence_00000005_pre_disaster.png,152,83,1,800,952,959,1042,3155,136.70381332626238,42.772047689556565
7825,/media/marda/TWOTB1/xBD/hurricanes/images/florence/hurricane-florence_00000005_pre_disaster.png,68,77,1,139,207,965,1042,1703,57.0861928118726,39.28312076909612
7826,/media/marda/TWOTB1/xBD/hurricanes/images/florence/hurricane-florence_00000005_pre_disaster.png,90,62,1,937,1027,980,1042,1045,53.544636676402234,26.133700235338
7827,/media/marda/TWOTB1/xBD/hurricanes/images/florence/hurricane-florence_00000356_pre_disaster.png,86,80,1,930,1016,583,663,1334,63.21748259572874,28.16253987313993
7828,/media/marda/TWOTB1/xBD/hurricanes/images/florence/hurricane-florence_00000356_pre_disaster.png,95,93,1,851,946,629,722,1922,67.012305226903,51.346297101291945
7829,/media/marda/TWOTB1/xBD/hurricanes/images/florence/hurricane-florence_00000356_pre_disaster.png,55,43,1,911,966,645,688,186,16.22783695990348,15.413508937631303
7830,/media/marda/TWOTB1/xBD/hurricanes/images/florence/hurricane-florence_00000356_pre_disaster.png,71,59,1,973,1044,682,741,722,32.05821475870837,30.239484721026173
7831,/media/marda/TWOTB1/xBD/hurricanes/images/florence/hurricane-florence_00000356_pre_disaster.png,61,72,1,605,666,807,879,836,35.799980422594366,31.386990669614697
7832,/media/marda/TWOTB1/xBD/hurricanes/images/florence/hurricane-florence_00000360_post_disaster.png,22,31,1,4,26,0,31,437,33.939149285597054,17.384811759829752
7833,/media/marda/TWOTB1/xBD/hurricanes/images/florence/hurricane-florence_00000360_post_disaster.png,36,28,1,85,121,0,28,672,33.41515321838508,26.842520952463815
7834,/media/marda/TWOTB1/xBD/hurricanes/images/florence/hurricane-florence_00000360_post_disaster.png,44,28,1,369,413,0,28,570,29.356989791102805,25.665263549242084
7835,/media/marda/TWOTB1/xBD/hurricanes/images/florence/hurricane-florence_00000360_post_disaster.png,49,44,1,422,471,0,44,922,50.95328172565939,27.06971615131507
7836,/media/marda/TWOTB1/xBD/hurricanes/images/florence/hurricane-florence_00000360_post_disaster.png,54,21,1,521,575,0,21,548,33.903365653371914,21.2310577239774
7837,/media/marda/TWOTB1/xBD/hurricanes/images/florence/hurricane-florence_00000360_post_disaster.png,57,36,1,325,382,12,48,1076,48.542802675292435,29.281393190981593
7838,/media/marda/TWOTB1/xBD/hurricanes/images/florence/hurricane-florence_00000360_post_disaster.png,58,43,1,712,770,13,56,797,41.52859005995075,25.460644151729717
7839,/media/marda/TWOTB1/xBD/hurricanes/images/florence/hurricane-florence_00000360_post_disaster.png,74,66,1,662,736,15,81,1794,65.34607000361021,38.65760389393968
7840,/media/marda/TWOTB1/xBD/hurricanes/images/florence/hurricane-florence_00000360_post_disaster.png,85,33,1,567,652,16,49,984,69.82381121457057,18.79902039718337
7841,/media/marda/TWOTB1/xBD/hurricanes/images/florence/hurricane-florence_00000360_post_disaster.png,38,28,1,294,332,27,55,550,31.951654256974074,22.868289390863463
7842,/media/marda/TWOTB1/xBD/hurricanes/images/florence/hurricane-florence_00000360_post_disaster.png,51,34,1,242,293,39,73,933,44.423540350803556,27.84237462014409
7843,/media/marda/TWOTB1/xBD/hurricanes/images/florence/hurricane-florence_00000360_post_disaster.png,62,53,1,585,647,52,105,1362,52.311661967532224,34.65526730776097
7844,/media/marda/TWOTB1/xBD/hurricanes/images/florence/hurricane-florence_00000360_post_disaster.png,40,28,1,210,250,54,82,615,32.70906526637754,24.798196146396812
7845,/media/marda/TWOTB1/xBD/hurricanes/images/florence/hurricane-florence_00000360_post_disaster.png,30,26,1,288,318,57,83,332,24.763305333449544,17.93186215556088
7846,/media/marda/TWOTB1/xBD/hurricanes/images/florence/hurricane-florence_00000360_post_disaster.png,81,58,1,942,1023,69,127,1437,55.54552706676101,39.32469320829102
7847,/media/marda/TWOTB1/xBD/hurricanes/images/florence/hurricane-florence_00000360_post_disaster.png,47,27,1,402,449,81,108,553,32.02927744873976,22.692582235064485
7848,/media/marda/TWOTB1/xBD/hurricanes/images/florence/hurricane-florence_00000360_post_disaster.png,44,30,1,358,402,82,112,590,30.343054057226908,25.954407600059692
7849,/media/marda/TWOTB1/xBD/hurricanes/images/florence/hurricane-florence_00000360_post_disaster.png,48,39,1,452,500,93,132,779,40.35477581673387,25.97231175887251
7850,/media/marda/TWOTB1/xBD/hurricanes/images/florence/hurricane-florence_00000360_post_disaster.png,63,35,1,408,471,125,160,833,46.87674801983414,25.89446800293369
7851,/media/marda/TWOTB1/xBD/hurricanes/images/florence/hurricane-florence_00000360_post_disaster.png,50,50,1,352,402,131,181,1082,44.85932263566855,32.84857367736829
7852,/media/marda/TWOTB1/xBD/hurricanes/images/florence/hurricane-florence_00000360_post_disaster.png,64,34,1,650,714,146,180,618,42.62119262751067,19.28544973415428
7853,/media/marda/TWOTB1/xBD/hurricanes/images/florence/hurricane-florence_00000360_post_disaster.png,50,61,1,117,167,153,214,1361,60.37768401601837,32.53881218463748
7854,/media/marda/TWOTB1/xBD/hurricanes/images/florence/hurricane-florence_00000360_post_disaster.png,50,64,1,243,293,156,220,1514,63.96500448867369,31.21644853268113
7855,/media/marda/TWOTB1/xBD/hurricanes/images/florence/hurricane-florence_00000360_post_disaster.png,43,65,1,280,323,159,224,1244,63.99683583690433,26.859646121246282
7856,/media/marda/TWOTB1/xBD/hurricanes/images/florence/hurricane-florence_00000360_post_disaster.png,63,54,1,572,635,175,229,1344,46.511289544643304,38.438084630759505
7857,/media/marda/TWOTB1/xBD/hurricanes/images/florence/hurricane-florence_00000360_post_disaster.png,63,43,1,981,1044,200,243,655,33.10890993267276,26.27812650721649
7858,/media/marda/TWOTB1/xBD/hurricanes/images/florence/hurricane-florence_00000360_post_disaster.png,54,49,1,478,532,214,263,885,41.03375784869969,29.054882257475587
7859,/media/marda/TWOTB1/xBD/hurricanes/images/florence/hurricane-florence_00000360_post_disaster.png,47,30,1,633,680,216,246,316,22.220761494904398,19.025568487254947
7860,/media/marda/TWOTB1/xBD/hurricanes/images/florence/hurricane-florence_00000360_post_disaster.png,63,41,1,685,748,220,261,748,35.91236090118897,28.044780587222363
7861,/media/marda/TWOTB1/xBD/hurricanes/images/florence/hurricane-florence_00000360_post_disaster.png,40,23,1,615,655,235,258,158,15.629900029700282,13.508022805609068
7862,/media/marda/TWOTB1/xBD/hurricanes/images/florence/hurricane-florence_00000360_post_disaster.png,75,59,1,616,691,246,305,1822,50.75336298555747,47.16409146861341
7863,/media/marda/TWOTB1/xBD/hurricanes/images/florence/hurricane-florence_00000360_post_disaster.png,88,52,1,812,900,246,298,1580,61.34578776954967,36.60264815358333
7864,/media/marda/TWOTB1/xBD/hurricanes/images/florence/hurricane-florence_00000360_post_disaster.png,44,41,1,316,360,258,299,688,30.735984092561758,29.758361257256553
7865,/media/marda/TWOTB1/xBD/hurricanes/images/florence/hurricane-florence_00000360_post_disaster.png,56,43,1,361,417,263,306,1004,43.09533014765306,30.41834065670224
7866,/media/marda/TWOTB1/xBD/hurricanes/images/florence/hurricane-florence_00000360_post_disaster.png,45,56,1,279,324,271,327,1015,44.9672721852869,30.911500271201295
7867,/media/marda/TWOTB1/xBD/hurricanes/images/florence/hurricane-florence_00000360_post_disaster.png,39,28,1,456,495,273,301,310,23.086503196655737,17.980204420530992
7868,/media/marda/TWOTB1/xBD/hurricanes/images/florence/hurricane-florence_00000360_post_disaster.png,41,57,1,192,233,297,354,917,44.38378895737527,27.589367061267676
7869,/media/marda/TWOTB1/xBD/hurricanes/images/florence/hurricane-florence_00000360_post_disaster.png,64,48,1,623,687,302,350,847,42.22774672428122,27.528787839901042
7870,/media/marda/TWOTB1/xBD/hurricanes/images/florence/hurricane-florence_00000360_post_disaster.png,37,26,1,667,704,303,329,127,13.245827922861839,12.569078466829433
7871,/media/marda/TWOTB1/xBD/hurricanes/images/florence/hurricane-florence_00000360_post_disaster.png,28,27,1,333,361,314,341,169,16.972955958133298,13.190865980241757
7872,/media/marda/TWOTB1/xBD/hurricanes/images/florence/hurricane-florence_00000360_post_disaster.png,55,44,1,748,803,315,359,522,32.743741067524205,21.315107790118013
7873,/media/marda/TWOTB1/xBD/hurricanes/images/florence/hurricane-florence_00000360_post_disaster.png,30,26,1,380,410,318,344,153,17.154828269851425,11.983729367272632
7874,/media/marda/TWOTB1/xBD/hurricanes/images/florence/hurricane-florence_00000360_post_disaster.png,66,59,1,516,582,318,377,1388,50.099808868582485,36.95872050577876
7875,/media/marda/TWOTB1/xBD/hurricanes/images/florence/hurricane-florence_00000360_post_disaster.png,63,39,1,690,753,321,360,536,35.9317452483823,19.939285035502923
7876,/media/marda/TWOTB1/xBD/hurricanes/images/florence/hurricane-florence_00000360_post_disaster.png,35,55,1,124,159,322,377,893,41.26086777443334,28.576408381760768
7877,/media/marda/TWOTB1/xBD/hurricanes/images/florence/hurricane-florence_00000360_post_disaster.png,86,47,1,853,939,335,382,1213,53.30786698706887,30.01919586086754
7878,/media/marda/TWOTB1/xBD/hurricanes/images/florence/hurricane-florence_00000360_post_disaster.png,36,50,1,69,105,341,391,877,34.65935426206911,33.50060058666037
7879,/media/marda/TWOTB1/xBD/hurricanes/images/florence/hurricane-florence_00000360_post_disaster.png,69,55,1,325,394,347,402,1188,65.34154631850555,27.78455450038498
7880,/media/marda/TWOTB1/xBD/hurricanes/images/florence/hurricane-florence_00000360_post_disaster.png,59,45,1,637,696,348,393,732,32.194154481714364,30.289277408906052
7881,/media/marda/TWOTB1/xBD/hurricanes/images/florence/hurricane-florence_00000360_post_disaster.png,45,60,1,209,254,350,410,1068,46.244355772965505,30.898761437028938
7882,/media/marda/TWOTB1/xBD/hurricanes/images/florence/hurricane-florence_00000360_post_disaster.png,30,41,1,26,56,359,400,611,31.357618094905778,25.316922965171507
7883,/media/marda/TWOTB1/xBD/hurricanes/images/florence/hurricane-florence_00000360_post_disaster.png,43,33,1,367,410,363,396,374,31.995499812245946,15.511246929922619
7884,/media/marda/TWOTB1/xBD/hurricanes/images/florence/hurricane-florence_00000360_post_disaster.png,34,24,1,525,559,364,388,92,13.678622630530047,9.080776416301395
7885,/media/marda/TWOTB1/xBD/hurricanes/images/florence/hurricane-florence_00000360_post_disaster.png,44,29,1,686,730,375,404,172,17.554922271005104,13.192809836082288
7886,/media/marda/TWOTB1/xBD/hurricanes/images/florence/hurricane-florence_00000360_post_disaster.png,46,27,1,742,788,375,402,174,19.437096956757212,11.971771821829236
7887,/media/marda/TWOTB1/xBD/hurricanes/images/florence/hurricane-florence_00000360_post_disaster.png,15,40,1,0,15,376,416,304,28.5179886194503,14.54878662077749
7888,/media/marda/TWOTB1/xBD/hurricanes/images/florence/hurricane-florence_00000360_post_disaster.png,72,43,1,878,950,381,424,728,37.18618892187642,26.006720319136452
7889,/media/marda/TWOTB1/xBD/hurricanes/images/florence/hurricane-florence_00000360_post_disaster.png,54,45,1,653,707,383,428,619,31.16555796115238,26.52240135711621
7890,/media/marda/TWOTB1/xBD/hurricanes/images/florence/hurricane-florence_00000360_post_disaster.png,41,35,1,520,561,385,420,286,22.697391293251716,16.72223848691094
7891,/media/marda/TWOTB1/xBD/hurricanes/images/florence/hurricane-florence_00000360_post_disaster.png,47,39,1,491,538,393,432,349,29.62144939773363,16.647560614066734
7892,/media/marda/TWOTB1/xBD/hurricanes/images/florence/hurricane-florence_00000360_post_disaster.png,56,48,1,339,395,396,444,922,43.82767001737933,27.951785919854093
7893,/media/marda/TWOTB1/xBD/hurricanes/images/florence/hurricane-florence_00000360_post_disaster.png,43,42,1,537,580,407,449,350,23.210656128821874,20.077038698122546
7894,/media/marda/TWOTB1/xBD/hurricanes/images/florence/hurricane-florence_00000360_post_disaster.png,52,57,1,476,528,422,479,936,37.59885939287286,32.788902042326775
7895,/media/marda/TWOTB1/xBD/hurricanes/images/florence/hurricane-florence_00000360_post_disaster.png,37,36,1,410,447,425,461,255,22.33350870626281,16.06368029030007
7896,/media/marda/TWOTB1/xBD/hurricanes/images/florence/hurricane-florence_00000360_post_disaster.png,40,74,1,16,56,438,512,1255,61.5816952111125,27.198092375596
7897,/media/marda/TWOTB1/xBD/hurricanes/images/florence/hurricane-florence_00000360_post_disaster.png,47,54,1,219,266,438,492,879,41.183634980940205,29.937871550163706
7898,/media/marda/TWOTB1/xBD/hurricanes/images/florence/hurricane-florence_00000360_post_disaster.png,61,53,1,421,482,441,494,1011,44.85834998808477,29.856791297717137
7899,/media/marda/TWOTB1/xBD/hurricanes/images/florence/hurricane-florence_00000360_post_disaster.png,60,49,1,353,413,456,505,926,44.02800493777575,27.888983104092304
7900,/media/marda/TWOTB1/xBD/hurricanes/images/florence/hurricane-florence_00000360_post_disaster.png,54,46,1,679,733,463,509,594,28.759628907886217,27.228448544445733
7901,/media/marda/TWOTB1/xBD/hurricanes/images/florence/hurricane-florence_00000360_post_disaster.png,58,53,1,687,745,492,545,627,31.76999010857983,26.386606827001604
7902,/media/marda/TWOTB1/xBD/hurricanes/images/florence/hurricane-florence_00000360_post_disaster.png,48,54,1,243,291,513,567,814,40.17070936438109,27.051949405842876
7903,/media/marda/TWOTB1/xBD/hurricanes/images/florence/hurricane-florence_00000360_post_disaster.png,75,53,1,552,627,516,569,1126,51.82680209799471,29.08762149283137
7904,/media/marda/TWOTB1/xBD/hurricanes/images/florence/hurricane-florence_00000360_post_disaster.png,27,51,1,40,67,517,568,569,30.22137643232642,24.895394086808565
7905,/media/marda/TWOTB1/xBD/hurricanes/images/florence/hurricane-florence_00000360_post_disaster.png,63,80,1,502,565,529,609,1371,58.36400893926917,35.67230754814551
7906,/media/marda/TWOTB1/xBD/hurricanes/images/florence/hurricane-florence_00000360_post_disaster.png,64,56,1,603,667,532,588,873,38.005628945620444,30.494594277005902
7907,/media/marda/TWOTB1/xBD/hurricanes/images/florence/hurricane-florence_00000360_post_disaster.png,102,60,1,722,824,560,620,1504,79.65757815068747,25.519147863214958
7908,/media/marda/TWOTB1/xBD/hurricanes/images/florence/hurricane-florence_00000360_post_disaster.png,44,51,1,531,575,588,639,365,26.567754955677067,18.530805194190215
7909,/media/marda/TWOTB1/xBD/hurricanes/images/florence/hurricane-florence_00000360_post_disaster.png,74,105,1,787,861,590,695,1548,90.13608754118972,23.098473807562137
7910,/media/marda/TWOTB1/xBD/hurricanes/images/florence/hurricane-florence_00000360_post_disaster.png,30,36,1,522,552,591,627,73,12.037089568314498,8.23670576065536
7911,/media/marda/TWOTB1/xBD/hurricanes/images/florence/hurricane-florence_00000360_post_disaster.png,53,47,1,479,532,598,645,480,36.297053082397746,17.600607037518788
7912,/media/marda/TWOTB1/xBD/hurricanes/images/florence/hurricane-florence_00000360_post_disaster.png,74,114,1,723,797,612,726,2035,99.319189648704,27.83155709304171
7913,/media/marda/TWOTB1/xBD/hurricanes/images/florence/hurricane-florence_00000360_post_disaster.png,52,54,1,297,349,613,667,765,42.761566510312306,23.66542602078279
7914,/media/marda/TWOTB1/xBD/hurricanes/images/florence/hurricane-florence_00000360_post_disaster.png,107,125,1,614,721,623,748,2877,130.00256852007715,40.503380601756604
7915,/media/marda/TWOTB1/xBD/hurricanes/images/florence/hurricane-florence_00000360_post_disaster.png,49,66,1,410,459,625,691,841,41.30825806239446,27.1153663933135
7916,/media/marda/TWOTB1/xBD/hurricanes/images/florence/hurricane-florence_00000360_post_disaster.png,38,53,1,152,190,639,692,650,35.25604982556443,24.49516598462802
7917,/media/marda/TWOTB1/xBD/hurricanes/images/florence/hurricane-florence_00000360_post_disaster.png,44,50,1,558,602,643,693,407,26.302904845836135,20.68360699801033
7918,/media/marda/TWOTB1/xBD/hurricanes/images/florence/hurricane-florence_00000360_post_disaster.png,73,67,1,288,361,653,720,1517,65.20563735580274,31.20922120582499
7919,/media/marda/TWOTB1/xBD/hurricanes/images/florence/hurricane-florence_00000360_post_disaster.png,46,55,1,98,144,655,710,818,42.166185216824005,26.16388663882397
7920,/media/marda/TWOTB1/xBD/hurricanes/images/florence/hurricane-florence_00000360_post_disaster.png,30,48,1,182,212,661,709,385,23.144085833223773,22.258451841090558
7921,/media/marda/TWOTB1/xBD/hurricanes/images/florence/hurricane-florence_00000360_post_disaster.png,50,51,1,448,498,681,732,615,38.018772504612734,21.261518350563342
7922,/media/marda/TWOTB1/xBD/hurricanes/images/florence/hurricane-florence_00000360_post_disaster.png,20,48,1,0,20,685,733,361,23.399862637846365,20.63454203404822
7923,/media/marda/TWOTB1/xBD/hurricanes/images/florence/hurricane-florence_00000360_post_disaster.png,102,69,1,767,869,690,759,1487,80.90207955110556,24.55634776952656
7924,/media/marda/TWOTB1/xBD/hurricanes/images/florence/hurricane-florence_00000360_post_disaster.png,37,69,1,9,46,711,780,1054,38.99541217576447,35.171799353287476
7925,/media/marda/TWOTB1/xBD/hurricanes/images/florence/hurricane-florence_00000360_post_disaster.png,50,60,1,343,393,736,796,778,39.62794955370545,25.717289634403922
7926,/media/marda/TWOTB1/xBD/hurricanes/images/florence/hurricane-florence_00000360_post_disaster.png,116,76,1,601,717,736,812,2092,100.62649470592919,28.019715242042764
7927,/media/marda/TWOTB1/xBD/hurricanes/images/florence/hurricane-florence_00000360_post_disaster.png,49,74,1,439,488,737,811,894,46.965705663405004,25.401912716486716
7928,/media/marda/TWOTB1/xBD/hurricanes/images/florence/hurricane-florence_00000360_post_disaster.png,37,66,1,135,172,750,816,814,35.15456881664075,31.91737713204685
7929,/media/marda/TWOTB1/xBD/hurricanes/images/florence/hurricane-florence_00000360_post_disaster.png,38,57,1,7,45,760,817,756,39.5507564363862,25.03583006306737
7930,/media/marda/TWOTB1/xBD/hurricanes/images/florence/hurricane-florence_00000360_post_disaster.png,82,104,1,808,890,772,876,1866,83.08517403624215,37.702612680595834
7931,/media/marda/TWOTB1/xBD/hurricanes/images/florence/hurricane-florence_00000360_post_disaster.png,23,45,1,358,381,788,833,98,12.99371458796472,9.858289498458516
7932,/media/marda/TWOTB1/xBD/hurricanes/images/florence/hurricane-florence_00000360_post_disaster.png,63,103,1,576,639,790,893,1536,79.73276275427563,26.035026102387484
7933,/media/marda/TWOTB1/xBD/hurricanes/images/florence/hurricane-florence_00000360_post_disaster.png,43,60,1,373,416,799,859,569,28.185932374309232,26.506765866504267
7934,/media/marda/TWOTB1/xBD/hurricanes/images/florence/hurricane-florence_00000360_post_disaster.png,116,81,1,630,746,822,903,2111,100.47444251043223,28.02885153521591
7935,/media/marda/TWOTB1/xBD/hurricanes/images/florence/hurricane-florence_00000360_post_disaster.png,49,74,1,383,432,830,904,986,41.99519794570613,30.852277823982906
7936,/media/marda/TWOTB1/xBD/hurricanes/images/florence/hurricane-florence_00000360_post_disaster.png,147,82,1,717,864,853,935,2965,129.1779009483725,40.10297587507205
7937,/media/marda/TWOTB1/xBD/hurricanes/images/florence/hurricane-florence_00000360_post_disaster.png,51,69,1,54,105,881,950,1034,62.72058573822791,25.43103070929502
7938,/media/marda/TWOTB1/xBD/hurricanes/images/florence/hurricane-florence_00000360_post_disaster.png,53,61,1,374,427,882,943,496,42.624844786694375,15.3783708517116
7939,/media/marda/TWOTB1/xBD/hurricanes/images/florence/hurricane-florence_00000360_post_disaster.png,34,53,1,421,455,990,1043,179,17.340442572642946,13.710650577098752
7940,/media/marda/TWOTB1/xBD/hurricanes/images/florence/hurricane-florence_00000368_pre_disaster.png,43,60,1,0,43,555,615,1055,42.43531324736422,34.61902766615924
7941,/media/marda/TWOTB1/xBD/hurricanes/images/florence/hurricane-florence_00000368_pre_disaster.png,41,60,1,88,129,556,616,1002,36.95956086182129,35.9433700313166
7942,/media/marda/TWOTB1/xBD/hurricanes/images/florence/hurricane-florence_00000368_pre_disaster.png,54,49,1,956,1010,764,813,336,24.558666786031612,18.217662406608273
7943,/media/marda/TWOTB1/xBD/hurricanes/images/florence/hurricane-florence_00000368_pre_disaster.png,55,59,1,989,1044,764,823,364,34.58655017411293,14.301630610016973
7944,/media/marda/TWOTB1/xBD/hurricanes/images/florence/hurricane-florence_00000368_pre_disaster.png,70,80,1,907,977,807,887,1197,49.56187873822784,34.13631876320718
7945,/media/marda/TWOTB1/xBD/hurricanes/images/florence/hurricane-florence_00000368_pre_disaster.png,56,95,1,53,109,831,926,1736,70.66406641586018,37.525158927388176
7946,/media/marda/TWOTB1/xBD/hurricanes/images/florence/hurricane-florence_00000368_pre_disaster.png,25,57,1,100,125,882,939,358,25.982784390415585,20.219193028662357
7947,/media/marda/TWOTB1/xBD/hurricanes/images/florence/hurricane-florence_00000368_pre_disaster.png,73,60,1,910,983,883,943,857,39.48156080796864,29.019223199936725
7948,/media/marda/TWOTB1/xBD/hurricanes/images/florence/hurricane-florence_00000368_pre_disaster.png,73,56,1,910,983,988,1044,307,33.24281965174467,14.200862975053626
7949,/media/marda/TWOTB1/xBD/hurricanes/images/florence/hurricane-florence_00000362_post_disaster.png,143,101,1,159,302,309,410,4183,160.5296326097041,35.685987614035135
7950,/media/marda/TWOTB1/xBD/hurricanes/images/florence/hurricane-florence_00000362_post_disaster.png,16,38,1,92,108,352,390,314,29.860999239409058,13.897752797262022
7951,/media/marda/TWOTB1/xBD/hurricanes/images/florence/hurricane-florence_00000362_post_disaster.png,18,32,1,44,62,360,392,264,19.29092035865742,18.32980097647404
7952,/media/marda/TWOTB1/xBD/hurricanes/images/florence/hurricane-florence_00000362_post_disaster.png,17,40,1,54,71,399,439,305,23.771957967495762,17.155925508290384
7953,/media/marda/TWOTB1/xBD/hurricanes/images/florence/hurricane-florence_00000362_post_disaster.png,26,45,1,13,39,406,451,626,29.822405667681632,28.162334279039218
7954,/media/marda/TWOTB1/xBD/hurricanes/images/florence/hurricane-florence_00000229_post_disaster.png,60,19,1,601,661,0,19,562,37.712554947268465,19.759267238004135
7955,/media/marda/TWOTB1/xBD/hurricanes/images/florence/hurricane-florence_00000229_post_disaster.png,29,45,1,99,128,408,453,505,26.66610574839674,24.970025834145165
7956,/media/marda/TWOTB1/xBD/hurricanes/images/florence/hurricane-florence_00000229_post_disaster.png,45,47,1,14,59,409,456,832,45.562364760239966,26.41188773487493
7957,/media/marda/TWOTB1/xBD/hurricanes/images/florence/hurricane-florence_00000229_post_disaster.png,29,30,1,394,423,523,553,66,11.297883274904404,8.219535995559673
7958,/media/marda/TWOTB1/xBD/hurricanes/images/florence/hurricane-florence_00000229_post_disaster.png,60,75,1,218,278,619,694,1861,53.76409172017678,45.547651154960526
7959,/media/marda/TWOTB1/xBD/hurricanes/images/florence/hurricane-florence_00000229_post_disaster.png,68,75,1,975,1043,653,728,893,46.35187430187738,27.537125008561382
7960,/media/marda/TWOTB1/xBD/hurricanes/images/florence/hurricane-florence_00000229_post_disaster.png,22,38,1,266,288,678,716,148,15.10214931569516,12.985704417140443
7961,/media/marda/TWOTB1/xBD/hurricanes/images/florence/hurricane-florence_00000229_post_disaster.png,112,81,1,871,983,700,781,2323,75.85075679874248,41.84917959213189
7962,/media/marda/TWOTB1/xBD/hurricanes/images/florence/hurricane-florence_00000229_post_disaster.png,58,90,1,95,153,715,805,2404,59.41839648810436,52.57749388541702
7963,/media/marda/TWOTB1/xBD/hurricanes/images/florence/hurricane-florence_00000229_post_disaster.png,56,48,1,961,1017,746,794,212,17.03541088696946,16.667176602895957
7964,/media/marda/TWOTB1/xBD/hurricanes/images/florence/hurricane-florence_00000229_post_disaster.png,97,93,1,389,486,855,948,2665,82.25552907067531,48.40781631013359
7965,/media/marda/TWOTB1/xBD/hurricanes/images/florence/hurricane-florence_00000229_post_disaster.png,75,85,1,641,716,887,972,1336,47.48920518137173,36.87903338270572
7966,/media/marda/TWOTB1/xBD/hurricanes/images/florence/hurricane-florence_00000229_post_disaster.png,59,60,1,933,992,891,951,296,20.71506892835014,19.098105557231296
7967,/media/marda/TWOTB1/xBD/hurricanes/images/florence/hurricane-florence_00000229_post_disaster.png,56,56,1,890,946,897,953,168,23.778837544514868,10.700519865613163
7968,/media/marda/TWOTB1/xBD/hurricanes/images/florence/hurricane-florence_00000229_post_disaster.png,49,51,1,915,964,902,953,99,15.034113025043558,8.802874363829527
7969,/media/marda/TWOTB1/xBD/hurricanes/images/florence/hurricane-florence_00000229_post_disaster.png,50,56,1,831,881,915,971,192,18.907915332747585,13.495138975353061
7970,/media/marda/TWOTB1/xBD/hurricanes/images/florence/hurricane-florence_00000229_post_disaster.png,85,77,1,921,1006,929,1006,988,49.8208320871631,26.51002069436059
7971,/media/marda/TWOTB1/xBD/hurricanes/images/florence/hurricane-florence_00000229_post_disaster.png,88,62,1,854,942,979,1041,805,51.761444952150924,22.3321754722828
7972,/media/marda/TWOTB1/xBD/hurricanes/images/florence/hurricane-florence_00000475_pre_disaster.png,65,42,1,335,400,0,42,1373,51.060772041125496,35.25064854694571
7973,/media/marda/TWOTB1/xBD/hurricanes/images/florence/hurricane-florence_00000475_pre_disaster.png,45,17,1,777,822,7,24,133,17.517495082561936,9.988593380673297
7974,/media/marda/TWOTB1/xBD/hurricanes/images/florence/hurricane-florence_00000475_pre_disaster.png,61,36,1,543,604,54,90,751,35.346943541968045,28.963012488582354
7975,/media/marda/TWOTB1/xBD/hurricanes/images/florence/hurricane-florence_00000475_pre_disaster.png,48,60,1,195,243,310,370,1024,42.833828934555896,32.97114004853524
7976,/media/marda/TWOTB1/xBD/hurricanes/images/florence/hurricane-florence_00000475_pre_disaster.png,60,48,1,798,858,347,395,471,36.39078218294114,17.379361073419318
7977,/media/marda/TWOTB1/xBD/hurricanes/images/florence/hurricane-florence_00000475_pre_disaster.png,53,59,1,229,282,357,416,1155,39.456621117825684,38.7439802997396
7978,/media/marda/TWOTB1/xBD/hurricanes/images/florence/hurricane-florence_00000475_pre_disaster.png,51,29,1,837,888,365,394,157,18.937084771242642,11.143110923817918
7979,/media/marda/TWOTB1/xBD/hurricanes/images/florence/hurricane-florence_00000475_pre_disaster.png,54,62,1,87,141,369,431,1264,53.491049767464,32.410584197637974
7980,/media/marda/TWOTB1/xBD/hurricanes/images/florence/hurricane-florence_00000475_pre_disaster.png,17,28,1,151,168,404,432,79,10.991048460195522,9.62867356528939
7981,/media/marda/TWOTB1/xBD/hurricanes/images/florence/hurricane-florence_00000475_pre_disaster.png,40,52,1,104,144,421,473,691,32.1517938991518,28.44294563652764
7982,/media/marda/TWOTB1/xBD/hurricanes/images/florence/hurricane-florence_00000475_pre_disaster.png,70,60,1,775,845,435,495,658,52.50871499993517,16.73078178956835
7983,/media/marda/TWOTB1/xBD/hurricanes/images/florence/hurricane-florence_00000475_pre_disaster.png,68,71,1,857,925,437,508,801,61.88181378530877,17.37813773169279
7984,/media/marda/TWOTB1/xBD/hurricanes/images/florence/hurricane-florence_00000475_pre_disaster.png,15,31,1,74,89,453,484,121,13.741137447745782,11.687104969392237
7985,/media/marda/TWOTB1/xBD/hurricanes/images/florence/hurricane-florence_00000475_pre_disaster.png,56,34,1,907,963,453,487,211,21.98668362433782,12.79812682931504
7986,/media/marda/TWOTB1/xBD/hurricanes/images/florence/hurricane-florence_00000475_pre_disaster.png,72,74,1,33,105,466,540,1785,80.11374840106977,29.48908237002675
7987,/media/marda/TWOTB1/xBD/hurricanes/images/florence/hurricane-florence_00000475_pre_disaster.png,49,35,1,785,834,480,515,185,16.5027680070469,15.004296663817987
7988,/media/marda/TWOTB1/xBD/hurricanes/images/florence/hurricane-florence_00000475_pre_disaster.png,31,47,1,66,97,536,583,444,26.687320536871333,22.040526589534085
7989,/media/marda/TWOTB1/xBD/hurricanes/images/florence/hurricane-florence_00000475_pre_disaster.png,72,73,1,153,225,540,613,1297,79.42420256890149,21.63227688952576
7990,/media/marda/TWOTB1/xBD/hurricanes/images/florence/hurricane-florence_00000475_pre_disaster.png,19,41,1,64,83,560,601,231,19.536026712283146,15.586842077274861
7991,/media/marda/TWOTB1/xBD/hurricanes/images/florence/hurricane-florence_00000475_pre_disaster.png,23,35,1,150,173,562,597,150,19.315132014004085,10.257666387928536
7992,/media/marda/TWOTB1/xBD/hurricanes/images/florence/hurricane-florence_00000475_pre_disaster.png,67,64,1,139,206,568,632,674,76.87737502833133,11.651883169567041
7993,/media/marda/TWOTB1/xBD/hurricanes/images/florence/hurricane-florence_00000475_pre_disaster.png,40,48,1,411,451,622,670,312,20.86254536117485,19.975249968631985
7994,/media/marda/TWOTB1/xBD/hurricanes/images/florence/hurricane-florence_00000475_pre_disaster.png,48,51,1,512,560,632,683,423,27.766146040258544,19.840894935147833
7995,/media/marda/TWOTB1/xBD/hurricanes/images/florence/hurricane-florence_00000475_pre_disaster.png,88,89,1,366,454,665,754,2746,68.83273897482835,53.33648885844337
7996,/media/marda/TWOTB1/xBD/hurricanes/images/florence/hurricane-florence_00000475_pre_disaster.png,31,42,1,464,495,711,753,104,15.820562704303347,8.747765725410208
7997,/media/marda/TWOTB1/xBD/hurricanes/images/florence/hurricane-florence_00000475_pre_disaster.png,49,53,1,425,474,770,823,396,35.4398468992876,14.910764340576627
7998,/media/marda/TWOTB1/xBD/hurricanes/images/florence/hurricane-florence_00000475_pre_disaster.png,65,74,1,2,67,798,872,2028,72.20018283314266,40.561112247029925
7999,/media/marda/TWOTB1/xBD/hurricanes/images/florence/hurricane-florence_00000475_pre_disaster.png,56,72,1,302,358,836,908,1019,41.451021207472714,32.81364949463413
8000,/media/marda/TWOTB1/xBD/hurricanes/images/florence/hurricane-florence_00000475_pre_disaster.png,69,85,1,223,292,854,939,1516,62.3002282242145,32.784370427819496
8001,/media/marda/TWOTB1/xBD/hurricanes/images/florence/hurricane-florence_00000475_pre_disaster.png,6,49,1,0,6,915,964,43,11.581104904631081,5.588001854998525
8002,/media/marda/TWOTB1/xBD/hurricanes/images/florence/hurricane-florence_00000475_pre_disaster.png,19,67,1,0,19,934,1001,316,27.49818772242952,16.394852477675833
8003,/media/marda/TWOTB1/xBD/hurricanes/images/florence/hurricane-florence_00000475_pre_disaster.png,49,83,1,129,178,941,1024,1265,48.883836589097605,37.08732011500209
8004,/media/marda/TWOTB1/xBD/hurricanes/images/florence/hurricane-florence_00000475_pre_disaster.png,53,73,1,0,53,969,1042,1107,51.82273708429042,28.37192893828647
8005,/media/marda/TWOTB1/xBD/hurricanes/images/florence/hurricane-florence_00000449_post_disaster.png,51,32,1,649,700,102,134,427,25.954634413820354,21.85245497335304
8006,/media/marda/TWOTB1/xBD/hurricanes/images/florence/hurricane-florence_00000449_post_disaster.png,55,32,1,78,133,137,169,941,57.334118675753345,21.55072264647552
8007,/media/marda/TWOTB1/xBD/hurricanes/images/florence/hurricane-florence_00000449_post_disaster.png,48,30,1,54,102,238,268,552,49.3954024569488,15.372688002653137
8008,/media/marda/TWOTB1/xBD/hurricanes/images/florence/hurricane-florence_00000449_post_disaster.png,18,41,1,0,18,240,281,422,32.872424839962974,16.904938544611557
8009,/media/marda/TWOTB1/xBD/hurricanes/images/florence/hurricane-florence_00000449_post_disaster.png,80,70,1,628,708,304,374,1774,64.63498815330927,40.22957881913981
8010,/media/marda/TWOTB1/xBD/hurricanes/images/florence/hurricane-florence_00000449_post_disaster.png,64,46,1,822,886,355,401,716,31.515092536320157,30.33786057529512
8011,/media/marda/TWOTB1/xBD/hurricanes/images/florence/hurricane-florence_00000449_post_disaster.png,85,54,1,767,852,357,411,1531,56.77043938662913,37.44994820422031
8012,/media/marda/TWOTB1/xBD/hurricanes/images/florence/hurricane-florence_00000449_post_disaster.png,87,91,1,693,780,938,1029,1922,58.90108338809412,44.17540534680691
8013,/media/marda/TWOTB1/xBD/hurricanes/images/florence/hurricane-florence_00000449_post_disaster.png,51,18,1,965,1016,180,198,145,14.89644988052075,13.09848144455411
8014,/media/marda/TWOTB1/xBD/hurricanes/images/florence/hurricane-florence_00000449_post_disaster.png,53,51,1,990,1043,202,253,415,46.96195913913116,12.144046406097814
8015,/media/marda/TWOTB1/xBD/hurricanes/images/florence/hurricane-florence_00000449_post_disaster.png,57,31,1,149,206,249,280,689,57.19636544618264,16.079437913679193
8016,/media/marda/TWOTB1/xBD/hurricanes/images/florence/hurricane-florence_00000449_post_disaster.png,72,82,1,190,262,451,533,2519,76.78688537053573,47.15480057489957
8017,/media/marda/TWOTB1/xBD/hurricanes/images/florence/hurricane-florence_00000449_post_disaster.png,81,59,1,881,962,463,522,1018,53.78733205264257,27.04868515531527
8018,/media/marda/TWOTB1/xBD/hurricanes/images/florence/hurricane-florence_00000449_post_disaster.png,78,47,1,544,622,552,599,689,66.08323211033017,13.809335359217044
8019,/media/marda/TWOTB1/xBD/hurricanes/images/florence/hurricane-florence_00000449_post_disaster.png,44,59,1,266,310,573,632,868,38.74785445269397,29.70622302582105
8020,/media/marda/TWOTB1/xBD/hurricanes/images/florence/hurricane-florence_00000449_post_disaster.png,66,53,1,608,674,574,627,781,43.10648363539486,24.027694414098594
8021,/media/marda/TWOTB1/xBD/hurricanes/images/florence/hurricane-florence_00000449_post_disaster.png,30,55,1,25,55,589,644,871,34.65517982224182,33.553691321706886
8022,/media/marda/TWOTB1/xBD/hurricanes/images/florence/hurricane-florence_00000449_post_disaster.png,45,51,1,514,559,627,678,396,25.183415707589845,21.112629624717904
8023,/media/marda/TWOTB1/xBD/hurricanes/images/florence/hurricane-florence_00000449_post_disaster.png,61,59,1,564,625,628,687,726,41.729925295430796,24.608592696301503
8024,/media/marda/TWOTB1/xBD/hurricanes/images/florence/hurricane-florence_00000449_post_disaster.png,16,40,1,64,80,636,676,147,16.16888255284597,11.988014870689351
8025,/media/marda/TWOTB1/xBD/hurricanes/images/florence/hurricane-florence_00000449_post_disaster.png,36,51,1,50,86,661,712,506,34.0661423198654,19.97560109237455
8026,/media/marda/TWOTB1/xBD/hurricanes/images/florence/hurricane-florence_00000449_post_disaster.png,16,43,1,96,112,686,729,145,14.253913128482177,13.70056165916475
8027,/media/marda/TWOTB1/xBD/hurricanes/images/florence/hurricane-florence_00000449_post_disaster.png,37,44,1,81,118,704,748,393,40.11818388365804,14.414112158741021
8028,/media/marda/TWOTB1/xBD/hurricanes/images/florence/hurricane-florence_00000449_post_disaster.png,20,77,1,104,124,739,816,695,55.55923323958392,16.69925906430665
8029,/media/marda/TWOTB1/xBD/hurricanes/images/florence/hurricane-florence_00000368_post_disaster.png,43,60,1,0,43,555,615,1055,42.43531324736422,34.61902766615924
8030,/media/marda/TWOTB1/xBD/hurricanes/images/florence/hurricane-florence_00000368_post_disaster.png,41,60,1,88,129,556,616,1002,36.95956086182129,35.9433700313166
8031,/media/marda/TWOTB1/xBD/hurricanes/images/florence/hurricane-florence_00000368_post_disaster.png,55,60,1,989,1044,763,823,365,34.65483168382514,14.363605684826625
8032,/media/marda/TWOTB1/xBD/hurricanes/images/florence/hurricane-florence_00000368_post_disaster.png,54,49,1,956,1010,764,813,336,24.558666786031612,18.217662406608273
8033,/media/marda/TWOTB1/xBD/hurricanes/images/florence/hurricane-florence_00000368_post_disaster.png,70,80,1,907,977,807,887,1197,49.56187873822784,34.13631876320718
8034,/media/marda/TWOTB1/xBD/hurricanes/images/florence/hurricane-florence_00000368_post_disaster.png,56,95,1,53,109,831,926,1736,70.66406641586018,37.525158927388176
8035,/media/marda/TWOTB1/xBD/hurricanes/images/florence/hurricane-florence_00000368_post_disaster.png,25,57,1,100,125,882,939,358,25.982784390415585,20.219193028662357
8036,/media/marda/TWOTB1/xBD/hurricanes/images/florence/hurricane-florence_00000368_post_disaster.png,73,60,1,910,983,883,943,857,39.48156080796864,29.019223199936725
8037,/media/marda/TWOTB1/xBD/hurricanes/images/florence/hurricane-florence_00000368_post_disaster.png,73,55,1,910,983,988,1043,285,33.08354534095246,13.227978045540318
8038,/media/marda/TWOTB1/xBD/hurricanes/images/florence/hurricane-florence_00000188_post_disaster.png,46,20,1,634,680,22,42,399,24.480216169414234,21.50958145910203
8039,/media/marda/TWOTB1/xBD/hurricanes/images/florence/hurricane-florence_00000188_post_disaster.png,58,36,1,636,694,46,82,732,31.788014347981694,30.51812624598766
8040,/media/marda/TWOTB1/xBD/hurricanes/images/florence/hurricane-florence_00000188_post_disaster.png,72,69,1,971,1043,192,261,1333,62.521380757404415,30.72672332287866
8041,/media/marda/TWOTB1/xBD/hurricanes/images/florence/hurricane-florence_00000188_post_disaster.png,53,31,1,862,915,323,354,210,19.40181599315768,14.474405078648406
8042,/media/marda/TWOTB1/xBD/hurricanes/images/florence/hurricane-florence_00000188_post_disaster.png,57,36,1,986,1043,357,393,255,21.185050902234583,16.570890216987593
8043,/media/marda/TWOTB1/xBD/hurricanes/images/florence/hurricane-florence_00000188_post_disaster.png,76,53,1,887,963,563,616,660,41.32244439395419,21.289560307944953
8044,/media/marda/TWOTB1/xBD/hurricanes/images/florence/hurricane-florence_00000188_post_disaster.png,75,67,1,823,898,574,641,966,46.00459588244425,29.833815046025226
8045,/media/marda/TWOTB1/xBD/hurricanes/images/florence/hurricane-florence_00000188_post_disaster.png,49,44,1,809,858,657,701,182,19.60230648590372,12.462344080996017
8046,/media/marda/TWOTB1/xBD/hurricanes/images/florence/hurricane-florence_00000188_post_disaster.png,78,69,1,714,792,696,765,1281,45.9450082586667,37.27227092405241
8047,/media/marda/TWOTB1/xBD/hurricanes/images/florence/hurricane-florence_00000188_post_disaster.png,51,51,1,722,773,780,831,392,24.647018062855306,20.884151468880223
8048,/media/marda/TWOTB1/xBD/hurricanes/images/florence/hurricane-florence_00000539_post_disaster.png,36,35,1,117,153,197,232,666,33.29378923966583,26.612645866190366
8049,/media/marda/TWOTB1/xBD/hurricanes/images/florence/hurricane-florence_00000539_post_disaster.png,41,85,1,67,108,327,412,2055,81.1717839442037,33.63695657044747
8050,/media/marda/TWOTB1/xBD/hurricanes/images/florence/hurricane-florence_00000539_post_disaster.png,52,45,1,977,1029,752,797,92,20.778605738655344,5.855701589054222
8051,/media/marda/TWOTB1/xBD/hurricanes/images/florence/hurricane-florence_00000539_post_disaster.png,59,49,1,981,1040,828,877,159,18.59977583579088,11.490681452463015
8052,/media/marda/TWOTB1/xBD/hurricanes/images/florence/hurricane-florence_00000539_post_disaster.png,95,112,1,865,960,838,950,1752,96.06731640569895,24.28513323743735
8053,/media/marda/TWOTB1/xBD/hurricanes/images/florence/hurricane-florence_00000539_post_disaster.png,95,113,1,900,995,859,972,1720,96.57623071327761,23.689703130061897
8054,/media/marda/TWOTB1/xBD/hurricanes/images/florence/hurricane-florence_00000539_post_disaster.png,98,112,1,937,1035,882,994,1722,95.6196460520707,23.93069917084656
8055,/media/marda/TWOTB1/xBD/hurricanes/images/florence/hurricane-florence_00000539_post_disaster.png,71,100,1,972,1043,918,1018,974,61.03338289638795,22.290898779988755
8056,/media/marda/TWOTB1/xBD/hurricanes/images/florence/hurricane-florence_00000514_post_disaster.png,78,35,1,810,888,156,191,1114,48.90823342858419,30.310067195109603
8057,/media/marda/TWOTB1/xBD/hurricanes/images/florence/hurricane-florence_00000514_post_disaster.png,44,29,1,706,750,199,228,272,22.706294418067976,16.27445904874957
8058,/media/marda/TWOTB1/xBD/hurricanes/images/florence/hurricane-florence_00000514_post_disaster.png,46,54,1,459,505,546,600,480,34.767399894148184,18.439951016455375
8059,/media/marda/TWOTB1/xBD/hurricanes/images/florence/hurricane-florence_00000187_pre_disaster.png,45,37,1,504,549,451,488,331,25.12499563981039,17.646942010908912
8060,/media/marda/TWOTB1/xBD/hurricanes/images/florence/hurricane-florence_00000187_pre_disaster.png,83,31,1,961,1044,461,492,516,51.56842095784525,13.355220792511103
8061,/media/marda/TWOTB1/xBD/hurricanes/images/florence/hurricane-florence_00000187_pre_disaster.png,96,56,1,553,649,472,528,1907,81.73123595003213,30.89679612355479
8062,/media/marda/TWOTB1/xBD/hurricanes/images/florence/hurricane-florence_00000187_pre_disaster.png,35,36,1,373,408,487,523,260,19.870479086764416,17.518457938835986
8063,/media/marda/TWOTB1/xBD/hurricanes/images/florence/hurricane-florence_00000187_pre_disaster.png,64,90,1,676,740,506,596,1438,75.62811554991298,25.334489302042087
8064,/media/marda/TWOTB1/xBD/hurricanes/images/florence/hurricane-florence_00000187_pre_disaster.png,53,37,1,576,629,513,550,311,35.278391330278595,11.716833027192356
8065,/media/marda/TWOTB1/xBD/hurricanes/images/florence/hurricane-florence_00000187_pre_disaster.png,95,126,1,378,473,519,645,5341,111.03398177710518,64.03684017942035
8066,/media/marda/TWOTB1/xBD/hurricanes/images/florence/hurricane-florence_00000187_pre_disaster.png,54,54,1,579,633,525,579,580,38.78918205234977,24.96778276422456
8067,/media/marda/TWOTB1/xBD/hurricanes/images/florence/hurricane-florence_00000187_pre_disaster.png,102,55,1,942,1044,529,584,1175,75.35768161462929,20.772724190328216
8068,/media/marda/TWOTB1/xBD/hurricanes/images/florence/hurricane-florence_00000187_pre_disaster.png,125,144,1,243,368,539,683,8291,110.60211996649214,103.60439735720281
8069,/media/marda/TWOTB1/xBD/hurricanes/images/florence/hurricane-florence_00000187_pre_disaster.png,75,81,1,465,540,542,623,2332,56.93714916778721,54.14446898900222
8070,/media/marda/TWOTB1/xBD/hurricanes/images/florence/hurricane-florence_00000187_pre_disaster.png,39,32,1,588,627,556,588,106,18.359440675109518,7.745162481879835
8071,/media/marda/TWOTB1/xBD/hurricanes/images/florence/hurricane-florence_00000187_pre_disaster.png,121,143,1,121,242,577,720,8279,110.39136493306852,102.90503932849046
8072,/media/marda/TWOTB1/xBD/hurricanes/images/florence/hurricane-florence_00000187_pre_disaster.png,76,77,1,927,1003,597,674,1424,55.38366808356991,34.02379670363239
8073,/media/marda/TWOTB1/xBD/hurricanes/images/florence/hurricane-florence_00000187_pre_disaster.png,94,61,1,649,743,610,671,1254,76.342528995454,21.793990765211348
8074,/media/marda/TWOTB1/xBD/hurricanes/images/florence/hurricane-florence_00000187_pre_disaster.png,116,147,1,3,119,614,761,8119,109.52938265918418,102.02355991541582
8075,/media/marda/TWOTB1/xBD/hurricanes/images/florence/hurricane-florence_00000187_pre_disaster.png,49,77,1,545,594,635,712,849,55.99442358699569,20.0201773563338
8076,/media/marda/TWOTB1/xBD/hurricanes/images/florence/hurricane-florence_00000187_pre_disaster.png,66,108,1,642,708,660,768,1751,94.71330282000584,24.560394819840802
8077,/media/marda/TWOTB1/xBD/hurricanes/images/florence/hurricane-florence_00000187_pre_disaster.png,95,75,1,429,524,667,742,2221,83.15667120579545,35.62681517871454
8078,/media/marda/TWOTB1/xBD/hurricanes/images/florence/hurricane-florence_00000187_pre_disaster.png,40,43,1,515,555,670,713,200,18.413821611980012,14.521156071132143
8079,/media/marda/TWOTB1/xBD/hurricanes/images/florence/hurricane-florence_00000187_pre_disaster.png,58,91,1,696,754,672,763,1042,74.13759627930631,18.58599500348787
8080,/media/marda/TWOTB1/xBD/hurricanes/images/florence/hurricane-florence_00000187_pre_disaster.png,65,101,1,389,454,674,775,2176,81.06991055483746,35.809236588507666
8081,/media/marda/TWOTB1/xBD/hurricanes/images/florence/hurricane-florence_00000187_pre_disaster.png,65,89,1,328,393,697,786,2069,56.61631835863609,48.40091955223413
8082,/media/marda/TWOTB1/xBD/hurricanes/images/florence/hurricane-florence_00000187_pre_disaster.png,50,52,1,728,778,699,751,317,22.549721639215544,18.803349717817273
8083,/media/marda/TWOTB1/xBD/hurricanes/images/florence/hurricane-florence_00000187_pre_disaster.png,81,123,1,538,619,700,823,3234,103.04406424364873,41.767246218301295
8084,/media/marda/TWOTB1/xBD/hurricanes/images/florence/hurricane-florence_00000187_pre_disaster.png,47,49,1,683,730,702,751,293,20.78386266835585,18.770599375498414
8085,/media/marda/TWOTB1/xBD/hurricanes/images/florence/hurricane-florence_00000187_pre_disaster.png,48,42,1,624,672,712,754,172,27.04694054973663,8.528357550399093
8086,/media/marda/TWOTB1/xBD/hurricanes/images/florence/hurricane-florence_00000187_pre_disaster.png,127,111,1,204,331,714,825,5746,125.40031825313189,60.79090691673488
8087,/media/marda/TWOTB1/xBD/hurricanes/images/florence/hurricane-florence_00000187_pre_disaster.png,43,60,1,638,681,723,783,374,34.637780099873,14.33743961889064
8088,/media/marda/TWOTB1/xBD/hurricanes/images/florence/hurricane-florence_00000187_pre_disaster.png,50,61,1,618,668,727,788,556,36.07426337486431,22.32773164994152
8089,/media/marda/TWOTB1/xBD/hurricanes/images/florence/hurricane-florence_00000187_pre_disaster.png,49,55,1,488,537,742,797,360,38.88018923054886,15.887331593121589
8090,/media/marda/TWOTB1/xBD/hurricanes/images/florence/hurricane-florence_00000187_pre_disaster.png,154,126,1,43,197,751,877,7590,166.4004336123511,61.51665982884613
8091,/media/marda/TWOTB1/xBD/hurricanes/images/florence/hurricane-florence_00000187_pre_disaster.png,48,57,1,465,513,756,813,547,28.36075590863028,25.757633283647653
8092,/media/marda/TWOTB1/xBD/hurricanes/images/florence/hurricane-florence_00000187_pre_disaster.png,66,62,1,764,830,756,818,802,33.40238854007715,31.583247958795
8093,/media/marda/TWOTB1/xBD/hurricanes/images/florence/hurricane-florence_00000187_pre_disaster.png,42,55,1,523,565,765,820,386,27.218366218587462,18.80221070262595
8094,/media/marda/TWOTB1/xBD/hurricanes/images/florence/hurricane-florence_00000187_pre_disaster.png,184,126,1,575,759,765,891,5135,189.005409980731,44.89043996585298
8095,/media/marda/TWOTB1/xBD/hurricanes/images/florence/hurricane-florence_00000187_pre_disaster.png,27,88,1,0,27,790,878,911,58.51915979752755,20.58030215691439
8096,/media/marda/TWOTB1/xBD/hurricanes/images/florence/hurricane-florence_00000187_pre_disaster.png,78,110,1,506,584,790,900,2359,81.21935676750266,39.86689200652382
8097,/media/marda/TWOTB1/xBD/hurricanes/images/florence/hurricane-florence_00000187_pre_disaster.png,126,157,1,319,445,791,948,8264,111.61160105063021,101.33237100474481
8098,/media/marda/TWOTB1/xBD/hurricanes/images/florence/hurricane-florence_00000187_pre_disaster.png,53,49,1,584,637,795,844,294,33.880866819464536,11.52225337601431
8099,/media/marda/TWOTB1/xBD/hurricanes/images/florence/hurricane-florence_00000187_pre_disaster.png,71,105,1,457,528,811,916,2295,74.16658652684505,41.27111874568311
8100,/media/marda/TWOTB1/xBD/hurricanes/images/florence/hurricane-florence_00000187_pre_disaster.png,46,50,1,761,807,820,870,170,16.162663920701203,14.036634871502335
8101,/media/marda/TWOTB1/xBD/hurricanes/images/florence/hurricane-florence_00000187_pre_disaster.png,124,155,1,198,322,830,985,8287,110.57134706493936,102.58339840442677
8102,/media/marda/TWOTB1/xBD/hurricanes/images/florence/hurricane-florence_00000187_pre_disaster.png,47,52,1,651,698,830,882,281,22.364530954309053,16.811133039406943
8103,/media/marda/TWOTB1/xBD/hurricanes/images/florence/hurricane-florence_00000187_pre_disaster.png,116,157,1,79,195,867,1024,8339,113.00756283211068,101.67278964233779
8104,/media/marda/TWOTB1/xBD/hurricanes/images/florence/hurricane-florence_00000187_pre_disaster.png,58,59,1,545,603,868,927,580,37.17008680241874,22.59810395305478
8105,/media/marda/TWOTB1/xBD/hurricanes/images/florence/hurricane-florence_00000187_pre_disaster.png,78,60,1,966,1044,981,1041,612,45.06747340699945,18.127139354480054
8106,/media/marda/TWOTB1/xBD/hurricanes/images/florence/hurricane-florence_00000139_post_disaster.png,64,54,1,499,563,332,386,965,36.963385876943555,34.68204755781576
8107,/media/marda/TWOTB1/xBD/hurricanes/images/florence/hurricane-florence_00000139_post_disaster.png,70,76,1,451,521,409,485,1601,61.77357805697686,37.95366854281974
8108,/media/marda/TWOTB1/xBD/hurricanes/images/florence/hurricane-florence_00000139_post_disaster.png,30,36,1,230,260,513,549,193,21.209747525755013,13.93672884341332
8109,/media/marda/TWOTB1/xBD/hurricanes/images/florence/hurricane-florence_00000139_post_disaster.png,45,61,1,248,293,543,604,790,41.63305722124704,26.397444494016995
8110,/media/marda/TWOTB1/xBD/hurricanes/images/florence/hurricane-florence_00000139_post_disaster.png,11,48,1,0,11,560,608,160,28.100095622807746,8.943901608865165
8111,/media/marda/TWOTB1/xBD/hurricanes/images/florence/hurricane-florence_00000139_post_disaster.png,29,45,1,297,326,712,757,152,15.70246614042177,13.002652948598822
8112,/media/marda/TWOTB1/xBD/hurricanes/images/florence/hurricane-florence_00000139_post_disaster.png,28,45,1,281,309,743,788,155,16.55791451086211,12.632378489491302
8113,/media/marda/TWOTB1/xBD/hurricanes/images/florence/hurricane-florence_00000268_pre_disaster.png,74,60,1,687,761,578,638,910,50.432855003034966,24.074819011255588
8114,/media/marda/TWOTB1/xBD/hurricanes/images/florence/hurricane-florence_00000268_pre_disaster.png,82,75,1,712,794,640,715,1520,50.30918088728711,40.08633812218065
8115,/media/marda/TWOTB1/xBD/hurricanes/images/florence/hurricane-florence_00000268_pre_disaster.png,62,67,1,734,796,687,754,694,39.71573597196206,23.145877202485334
8116,/media/marda/TWOTB1/xBD/hurricanes/images/florence/hurricane-florence_00000268_pre_disaster.png,48,57,1,662,710,696,753,360,26.819781018597993,19.64956790756369
8117,/media/marda/TWOTB1/xBD/hurricanes/images/florence/hurricane-florence_00000268_pre_disaster.png,52,54,1,718,770,712,766,325,25.134283659252468,17.289772818282838
8118,/media/marda/TWOTB1/xBD/hurricanes/images/florence/hurricane-florence_00000268_pre_disaster.png,60,68,1,749,809,734,802,621,44.70776941747337,18.34137116503024
8119,/media/marda/TWOTB1/xBD/hurricanes/images/florence/hurricane-florence_00000268_pre_disaster.png,92,73,1,947,1039,780,853,1624,53.870813528366554,40.7995074368864
8120,/media/marda/TWOTB1/xBD/hurricanes/images/florence/hurricane-florence_00000268_pre_disaster.png,49,44,1,904,953,821,865,128,13.226415373186827,12.328013024243898
8121,/media/marda/TWOTB1/xBD/hurricanes/images/florence/hurricane-florence_00000268_pre_disaster.png,95,86,1,737,832,874,960,1770,73.25264318295683,32.675742868950095
8122,/media/marda/TWOTB1/xBD/hurricanes/images/florence/hurricane-florence_00000268_pre_disaster.png,69,99,1,624,693,909,1008,1631,60.95468375742688,37.806483725928466
8123,/media/marda/TWOTB1/xBD/hurricanes/images/florence/hurricane-florence_00000268_pre_disaster.png,46,81,1,19,65,933,1014,822,59.83444758257235,18.171821423662454
8124,/media/marda/TWOTB1/xBD/hurricanes/images/florence/hurricane-florence_00000268_pre_disaster.png,59,88,1,223,282,944,1032,1305,58.93958748357612,31.664508515829194
8125,/media/marda/TWOTB1/xBD/hurricanes/images/florence/hurricane-florence_00000268_pre_disaster.png,28,56,1,290,318,959,1015,196,18.44960228921482,14.061340496883629
8126,/media/marda/TWOTB1/xBD/hurricanes/images/florence/hurricane-florence_00000268_pre_disaster.png,54,80,1,349,403,962,1042,1128,41.847766134644786,36.394067524040686
8127,/media/marda/TWOTB1/xBD/hurricanes/images/florence/hurricane-florence_00000268_pre_disaster.png,53,68,1,626,679,965,1033,492,31.444540016999202,20.78622295645812
8128,/media/marda/TWOTB1/xBD/hurricanes/images/florence/hurricane-florence_00000268_pre_disaster.png,28,49,1,391,419,970,1019,97,12.239002848542608,10.551564615303135
8129,/media/marda/TWOTB1/xBD/hurricanes/images/florence/hurricane-florence_00000268_pre_disaster.png,36,49,1,616,652,970,1019,86,12.692462701138727,9.117248144470434
8130,/media/marda/TWOTB1/xBD/hurricanes/images/florence/hurricane-florence_00000268_pre_disaster.png,39,59,1,408,447,976,1035,300,20.531158180062555,19.47565743881678
8131,/media/marda/TWOTB1/xBD/hurricanes/images/florence/hurricane-florence_00000268_pre_disaster.png,44,57,1,654,698,987,1044,175,21.06729446102669,11.384828878037213
8132,/media/marda/TWOTB1/xBD/hurricanes/images/florence/hurricane-florence_00000268_pre_disaster.png,34,52,1,520,554,992,1044,104,13.402296671130623,10.629159687152006
8133,/media/marda/TWOTB1/xBD/hurricanes/images/florence/hurricane-florence_00000268_pre_disaster.png,29,47,1,491,520,997,1044,53,10.744542233055759,6.65100274229233
8134,/media/marda/TWOTB1/xBD/hurricanes/images/florence/hurricane-florence_00000033_post_disaster.png,50,36,1,75,125,0,36,1066,47.63775068023513,30.109047683432998
8135,/media/marda/TWOTB1/xBD/hurricanes/images/florence/hurricane-florence_00000033_post_disaster.png,50,42,1,139,189,0,42,1102,43.06804024098423,34.73960794361617
8136,/media/marda/TWOTB1/xBD/hurricanes/images/florence/hurricane-florence_00000033_post_disaster.png,54,27,1,306,360,0,27,767,38.04365028576217,27.387472343329
8137,/media/marda/TWOTB1/xBD/hurricanes/images/florence/hurricane-florence_00000033_post_disaster.png,81,43,1,711,792,0,43,1345,46.12784986045718,39.45252345675066
8138,/media/marda/TWOTB1/xBD/hurricanes/images/florence/hurricane-florence_00000033_post_disaster.png,46,8,1,759,805,0,8,76,15.778604416068307,7.3488211141041075
8139,/media/marda/TWOTB1/xBD/hurricanes/images/florence/hurricane-florence_00000033_post_disaster.png,96,48,1,928,1024,0,48,1565,50.86047321186248,40.698181927926846
8140,/media/marda/TWOTB1/xBD/hurricanes/images/florence/hurricane-florence_00000033_post_disaster.png,46,30,1,425,471,3,33,452,24.6219241798742,24.523662042329132
8141,/media/marda/TWOTB1/xBD/hurricanes/images/florence/hurricane-florence_00000033_post_disaster.png,57,36,1,368,425,6,42,1076,47.955988999028335,29.65554314533839
8142,/media/marda/TWOTB1/xBD/hurricanes/images/florence/hurricane-florence_00000033_post_disaster.png,71,47,1,548,619,6,53,1160,45.77664054297887,34.26365860053517
8143,/media/marda/TWOTB1/xBD/hurricanes/images/florence/hurricane-florence_00000033_post_disaster.png,38,23,1,466,504,13,36,228,24.612627046355136,12.409998531878967
8144,/media/marda/TWOTB1/xBD/hurricanes/images/florence/hurricane-florence_00000033_post_disaster.png,105,67,1,902,1007,31,98,2294,62.822899900587366,48.71362131343429
8145,/media/marda/TWOTB1/xBD/hurricanes/images/florence/hurricane-florence_00000033_post_disaster.png,37,32,1,329,366,39,71,742,35.09827026041375,27.915178711790325
8146,/media/marda/TWOTB1/xBD/hurricanes/images/florence/hurricane-florence_00000033_post_disaster.png,37,48,1,29,66,40,88,1191,52.18725612629872,32.69962562485046
8147,/media/marda/TWOTB1/xBD/hurricanes/images/florence/hurricane-florence_00000033_post_disaster.png,74,51,1,495,569,43,94,1423,46.4321565313693,43.455845914788945
8148,/media/marda/TWOTB1/xBD/hurricanes/images/florence/hurricane-florence_00000033_post_disaster.png,78,48,1,674,752,51,99,1188,50.65805875738658,32.300471497496126
8149,/media/marda/TWOTB1/xBD/hurricanes/images/florence/hurricane-florence_00000033_post_disaster.png,52,33,1,196,248,54,87,685,44.76794899071788,22.779482729414426
8150,/media/marda/TWOTB1/xBD/hurricanes/images/florence/hurricane-florence_00000033_post_disaster.png,151,116,1,800,951,66,182,6737,112.8237828605102,79.46788425450029
8151,/media/marda/TWOTB1/xBD/hurricanes/images/florence/hurricane-florence_00000033_post_disaster.png,74,60,1,462,536,78,138,1718,53.639697548152654,45.11767382772798
8152,/media/marda/TWOTB1/xBD/hurricanes/images/florence/hurricane-florence_00000033_post_disaster.png,74,53,1,633,707,92,145,1314,46.198138643253564,38.91361154012739
8153,/media/marda/TWOTB1/xBD/hurricanes/images/florence/hurricane-florence_00000033_post_disaster.png,45,63,1,51,96,99,162,1477,55.504518537093496,35.96426645637144
8154,/media/marda/TWOTB1/xBD/hurricanes/images/florence/hurricane-florence_00000033_post_disaster.png,61,54,1,269,330,113,167,1370,47.406146550225486,38.885993116946686
8155,/media/marda/TWOTB1/xBD/hurricanes/images/florence/hurricane-florence_00000033_post_disaster.png,29,22,1,334,363,126,148,143,20.983037921478154,9.053892181645628
8156,/media/marda/TWOTB1/xBD/hurricanes/images/florence/hurricane-florence_00000033_post_disaster.png,74,52,1,595,669,135,187,1255,47.56426685144005,35.57946340772813
8157,/media/marda/TWOTB1/xBD/hurricanes/images/florence/hurricane-florence_00000033_post_disaster.png,48,48,1,112,160,144,192,980,36.31062230932893,36.01592523835214
8158,/media/marda/TWOTB1/xBD/hurricanes/images/florence/hurricane-florence_00000033_post_disaster.png,59,49,1,422,481,147,196,955,43.92138431562818,29.412106981285287
8159,/media/marda/TWOTB1/xBD/hurricanes/images/florence/hurricane-florence_00000033_post_disaster.png,63,58,1,314,377,148,206,1552,49.91272244072078,40.67537070295307
8160,/media/marda/TWOTB1/xBD/hurricanes/images/florence/hurricane-florence_00000033_post_disaster.png,61,62,1,145,206,168,230,1569,52.681936605324005,41.117870132844295
8161,/media/marda/TWOTB1/xBD/hurricanes/images/florence/hurricane-florence_00000033_post_disaster.png,32,15,1,383,415,182,197,198,20.752509888364507,12.649110640673518
8162,/media/marda/TWOTB1/xBD/hurricanes/images/florence/hurricane-florence_00000033_post_disaster.png,80,58,1,544,624,189,247,1588,58.99863523601714,35.7516371765456
8163,/media/marda/TWOTB1/xBD/hurricanes/images/florence/hurricane-florence_00000033_post_disaster.png,26,55,1,0,26,196,251,789,49.02296905093102,22.88219331398655
8164,/media/marda/TWOTB1/xBD/hurricanes/images/florence/hurricane-florence_00000033_post_disaster.png,34,34,1,120,154,201,235,385,25.95576816096901,19.85604725474576
8165,/media/marda/TWOTB1/xBD/hurricanes/images/florence/hurricane-florence_00000033_post_disaster.png,54,39,1,377,431,202,241,952,42.96910871792904,29.98492672767896
8166,/media/marda/TWOTB1/xBD/hurricanes/images/florence/hurricane-florence_00000033_post_disaster.png,54,53,1,196,250,205,258,954,51.193802441957274,24.869046969079385
8167,/media/marda/TWOTB1/xBD/hurricanes/images/florence/hurricane-florence_00000033_post_disaster.png,98,74,1,729,827,205,279,1951,75.81649234570173,34.293197004311025
8168,/media/marda/TWOTB1/xBD/hurricanes/images/florence/hurricane-florence_00000033_post_disaster.png,46,28,1,623,669,219,247,215,19.82757529333425,14.530041240184453
8169,/media/marda/TWOTB1/xBD/hurricanes/images/florence/hurricane-florence_00000033_post_disaster.png,57,61,1,13,70,231,292,1480,58.463907692169705,34.2981233249605
8170,/media/marda/TWOTB1/xBD/hurricanes/images/florence/hurricane-florence_00000033_post_disaster.png,146,117,1,898,1044,233,350,4531,140.39732246092598,43.38170354249175
8171,/media/marda/TWOTB1/xBD/hurricanes/images/florence/hurricane-florence_00000033_post_disaster.png,55,50,1,243,298,242,292,996,42.25419151765313,31.48906711750348
8172,/media/marda/TWOTB1/xBD/hurricanes/images/florence/hurricane-florence_00000033_post_disaster.png,29,33,1,115,144,244,277,299,25.671777951709593,15.574617253877014
8173,/media/marda/TWOTB1/xBD/hurricanes/images/florence/hurricane-florence_00000033_post_disaster.png,78,57,1,709,787,269,326,1225,48.58677842212319,33.49771661177798
8174,/media/marda/TWOTB1/xBD/hurricanes/images/florence/hurricane-florence_00000033_post_disaster.png,54,55,1,62,116,272,327,1333,47.61987819085458,37.294050194654425
8175,/media/marda/TWOTB1/xBD/hurricanes/images/florence/hurricane-florence_00000033_post_disaster.png,80,50,1,475,555,284,334,1202,63.28956142017613,31.469093422660272
8176,/media/marda/TWOTB1/xBD/hurricanes/images/florence/hurricane-florence_00000033_post_disaster.png,36,29,1,294,330,287,316,313,23.575711899883007,17.12672232591148
8177,/media/marda/TWOTB1/xBD/hurricanes/images/florence/hurricane-florence_00000033_post_disaster.png,63,63,1,312,375,290,353,1188,61.05811930948703,25.967899297438727
8178,/media/marda/TWOTB1/xBD/hurricanes/images/florence/hurricane-florence_00000033_post_disaster.png,104,80,1,660,764,294,374,2724,75.02532526067009,48.31798576737692
8179,/media/marda/TWOTB1/xBD/hurricanes/images/florence/hurricane-florence_00000033_post_disaster.png,50,55,1,105,155,313,368,976,41.11166268057581,31.695710701677783
8180,/media/marda/TWOTB1/xBD/hurricanes/images/florence/hurricane-florence_00000033_post_disaster.png,69,62,1,415,484,329,391,1428,54.75128498242574,34.562385813881924
8181,/media/marda/TWOTB1/xBD/hurricanes/images/florence/hurricane-florence_00000033_post_disaster.png,127,98,1,822,949,331,429,2915,111.85778127364674,34.76027433943236
8182,/media/marda/TWOTB1/xBD/hurricanes/images/florence/hurricane-florence_00000033_post_disaster.png,37,37,1,242,279,334,371,335,29.995538682632894,14.955723781926434
8183,/media/marda/TWOTB1/xBD/hurricanes/images/florence/hurricane-florence_00000033_post_disaster.png,53,67,1,159,212,341,408,1397,53.2117986895839,38.813360656950096
8184,/media/marda/TWOTB1/xBD/hurricanes/images/florence/hurricane-florence_00000033_post_disaster.png,44,59,1,0,44,352,411,1225,40.98150821289755,39.38044371929197
8185,/media/marda/TWOTB1/xBD/hurricanes/images/florence/hurricane-florence_00000033_post_disaster.png,48,50,1,268,316,353,403,770,35.910354325733344,28.324965953288118
8186,/media/marda/TWOTB1/xBD/hurricanes/images/florence/hurricane-florence_00000033_post_disaster.png,63,56,1,385,448,381,437,1140,51.26013210728854,29.529390153083252
8187,/media/marda/TWOTB1/xBD/hurricanes/images/florence/hurricane-florence_00000033_post_disaster.png,55,55,1,214,269,386,441,1473,49.77643367940169,40.96958296838157
8188,/media/marda/TWOTB1/xBD/hurricanes/images/florence/hurricane-florence_00000033_post_disaster.png,92,74,1,602,694,386,460,1858,75.0145722311279,34.784250959530766
8189,/media/marda/TWOTB1/xBD/hurricanes/images/florence/hurricane-florence_00000033_post_disaster.png,57,45,1,987,1044,390,435,283,27.94969256677905,15.71483624232708
8190,/media/marda/TWOTB1/xBD/hurricanes/images/florence/hurricane-florence_00000033_post_disaster.png,50,47,1,463,513,393,440,498,26.78238688515971,24.851812993067416
8191,/media/marda/TWOTB1/xBD/hurricanes/images/florence/hurricane-florence_00000033_post_disaster.png,60,66,1,32,92,396,462,1428,55.89461868392764,36.000272210908534
8192,/media/marda/TWOTB1/xBD/hurricanes/images/florence/hurricane-florence_00000033_post_disaster.png,47,46,1,433,480,404,450,461,28.049468334142954,21.986260231117377
8193,/media/marda/TWOTB1/xBD/hurricanes/images/florence/hurricane-florence_00000033_post_disaster.png,97,81,1,842,939,408,489,1969,63.4282361917119,41.40957373396119
8194,/media/marda/TWOTB1/xBD/hurricanes/images/florence/hurricane-florence_00000033_post_disaster.png,83,69,1,566,649,410,479,860,78.71243397593877,14.595343867961585
8195,/media/marda/TWOTB1/xBD/hurricanes/images/florence/hurricane-florence_00000033_post_disaster.png,63,70,1,340,403,421,491,1326,52.94867845124565,34.404424032700874
8196,/media/marda/TWOTB1/xBD/hurricanes/images/florence/hurricane-florence_00000033_post_disaster.png,56,65,1,89,145,424,489,1234,55.80378594173511,29.298782658196174
8197,/media/marda/TWOTB1/xBD/hurricanes/images/florence/hurricane-florence_00000033_post_disaster.png,64,54,1,550,614,430,484,662,49.01641953020093,17.961733365600878
8198,/media/marda/TWOTB1/xBD/hurricanes/images/florence/hurricane-florence_00000033_post_disaster.png,145,151,1,899,1044,436,587,6291,130.9053167145754,92.96959331552662
8199,/media/marda/TWOTB1/xBD/hurricanes/images/florence/hurricane-florence_00000033_post_disaster.png,86,72,1,530,616,450,522,1132,79.1271235703808,19.090173028104292
8200,/media/marda/TWOTB1/xBD/hurricanes/images/florence/hurricane-florence_00000033_post_disaster.png,52,43,1,584,636,457,500,412,24.17735960728711,22.748523968514093
8201,/media/marda/TWOTB1/xBD/hurricanes/images/florence/hurricane-florence_00000033_post_disaster.png,84,72,1,513,597,471,543,1136,79.16306999959231,19.150176934610094
8202,/media/marda/TWOTB1/xBD/hurricanes/images/florence/hurricane-florence_00000033_post_disaster.png,62,68,1,313,375,474,542,1401,55.83777075853578,33.12100531882109
8203,/media/marda/TWOTB1/xBD/hurricanes/images/florence/hurricane-florence_00000033_post_disaster.png,42,66,1,139,181,485,551,1309,56.730166873839586,32.151040730507745
8204,/media/marda/TWOTB1/xBD/hurricanes/images/florence/hurricane-florence_00000033_post_disaster.png,23,34,1,84,107,491,525,276,22.357692646865758,16.305107692688924
8205,/media/marda/TWOTB1/xBD/hurricanes/images/florence/hurricane-florence_00000033_post_disaster.png,105,101,1,475,580,491,592,3499,77.9452917456209,59.856847774764084
8206,/media/marda/TWOTB1/xBD/hurricanes/images/florence/hurricane-florence_00000033_post_disaster.png,18,38,1,65,83,505,543,184,16.145228001776967,15.060710358862496
8207,/media/marda/TWOTB1/xBD/hurricanes/images/florence/hurricane-florence_00000033_post_disaster.png,60,65,1,277,337,520,585,1149,46.46998498379753,33.86122744414148
8208,/media/marda/TWOTB1/xBD/hurricanes/images/florence/hurricane-florence_00000033_post_disaster.png,79,74,1,762,841,522,596,1585,48.15929199230892,43.155670064303976
8209,/media/marda/TWOTB1/xBD/hurricanes/images/florence/hurricane-florence_00000033_post_disaster.png,39,45,1,350,389,527,572,325,26.039921226895775,16.680637771427087
8210,/media/marda/TWOTB1/xBD/hurricanes/images/florence/hurricane-florence_00000033_post_disaster.png,57,67,1,98,155,529,596,1282,59.320701157891854,30.389735410148784
8211,/media/marda/TWOTB1/xBD/hurricanes/images/florence/hurricane-florence_00000033_post_disaster.png,42,63,1,0,42,534,597,971,44.84880035393109,28.987270624336485
8212,/media/marda/TWOTB1/xBD/hurricanes/images/florence/hurricane-florence_00000033_post_disaster.png,102,100,1,439,541,536,636,3297,78.01515557007106,56.36001823227572
8213,/media/marda/TWOTB1/xBD/hurricanes/images/florence/hurricane-florence_00000033_post_disaster.png,103,96,1,632,735,538,634,2738,82.59697312059079,44.09307647615632
8214,/media/marda/TWOTB1/xBD/hurricanes/images/florence/hurricane-florence_00000033_post_disaster.png,68,60,1,716,784,542,602,804,33.63155031224727,31.911285621972297
8215,/media/marda/TWOTB1/xBD/hurricanes/images/florence/hurricane-florence_00000033_post_disaster.png,24,47,1,44,68,549,596,417,29.185392932538203,19.6444794890057
8216,/media/marda/TWOTB1/xBD/hurricanes/images/florence/hurricane-florence_00000033_post_disaster.png,51,54,1,305,356,563,617,671,35.18012647736235,25.433341716452357
8217,/media/marda/TWOTB1/xBD/hurricanes/images/florence/hurricane-florence_00000033_post_disaster.png,58,70,1,39,97,564,634,1690,63.27315869480547,37.77188223258084
8218,/media/marda/TWOTB1/xBD/hurricanes/images/florence/hurricane-florence_00000033_post_disaster.png,52,69,1,247,299,565,634,1117,42.09315473294222,35.48136053287718
8219,/media/marda/TWOTB1/xBD/hurricanes/images/florence/hurricane-florence_00000033_post_disaster.png,98,89,1,597,695,598,687,2066,79.36372269269728,34.762990470006905
8220,/media/marda/TWOTB1/xBD/hurricanes/images/florence/hurricane-florence_00000033_post_disaster.png,103,96,1,826,929,598,694,2296,74.38513257090521,44.90701521722746
8221,/media/marda/TWOTB1/xBD/hurricanes/images/florence/hurricane-florence_00000033_post_disaster.png,59,71,1,195,254,605,676,1114,50.27706474026378,32.087634813412876
8222,/media/marda/TWOTB1/xBD/hurricanes/images/florence/hurricane-florence_00000033_post_disaster.png,112,148,1,577,689,632,780,4514,136.5266282342188,53.99247864175074
8223,/media/marda/TWOTB1/xBD/hurricanes/images/florence/hurricane-florence_00000033_post_disaster.png,72,64,1,670,742,643,707,797,48.63515968939809,21.87057863202839
8224,/media/marda/TWOTB1/xBD/hurricanes/images/florence/hurricane-florence_00000033_post_disaster.png,83,76,1,800,883,646,722,1402,47.588061165801186,40.49895919901003
8225,/media/marda/TWOTB1/xBD/hurricanes/images/florence/hurricane-florence_00000033_post_disaster.png,49,67,1,160,209,652,719,1088,41.37890545224761,34.33838880916044
8226,/media/marda/TWOTB1/xBD/hurricanes/images/florence/hurricane-florence_00000033_post_disaster.png,148,149,1,672,820,669,818,6689,138.09308715013202,64.52006093148789
8227,/media/marda/TWOTB1/xBD/hurricanes/images/florence/hurricane-florence_00000033_post_disaster.png,95,94,1,328,423,679,773,2531,81.85968585319327,42.338373494407286
8228,/media/marda/TWOTB1/xBD/hurricanes/images/florence/hurricane-florence_00000033_post_disaster.png,53,75,1,122,175,686,761,1140,50.13464046080554,30.12157747257088
8229,/media/marda/TWOTB1/xBD/hurricanes/images/florence/hurricane-florence_00000033_post_disaster.png,20,54,1,0,20,688,742,360,24.005380626157823,20.04747999324868
8230,/media/marda/TWOTB1/xBD/hurricanes/images/florence/hurricane-florence_00000033_post_disaster.png,29,46,1,207,236,706,752,189,17.52593435691973,14.472379990288374
8231,/media/marda/TWOTB1/xBD/hurricanes/images/florence/hurricane-florence_00000033_post_disaster.png,102,108,1,290,392,724,832,3311,96.67936160512835,45.566291686830056
8232,/media/marda/TWOTB1/xBD/hurricanes/images/florence/hurricane-florence_00000033_post_disaster.png,87,88,1,521,608,735,823,1699,72.33900974944926,31.377509554482174
8233,/media/marda/TWOTB1/xBD/hurricanes/images/florence/hurricane-florence_00000033_post_disaster.png,62,94,1,87,149,741,835,2128,58.20282177971813,50.80024965593134
8234,/media/marda/TWOTB1/xBD/hurricanes/images/florence/hurricane-florence_00000033_post_disaster.png,76,82,1,485,561,756,838,1430,60.077646937565895,31.75213405059348
8235,/media/marda/TWOTB1/xBD/hurricanes/images/florence/hurricane-florence_00000033_post_disaster.png,101,111,1,252,353,769,880,3283,96.84120394474044,45.27163415246813
8236,/media/marda/TWOTB1/xBD/hurricanes/images/florence/hurricane-florence_00000033_post_disaster.png,91,90,1,472,563,779,869,1192,93.57571556955494,16.99155591534446
8237,/media/marda/TWOTB1/xBD/hurricanes/images/florence/hurricane-florence_00000033_post_disaster.png,193,169,1,566,759,783,952,9712,187.46385542928144,75.12167000959961
8238,/media/marda/TWOTB1/xBD/hurricanes/images/florence/hurricane-florence_00000033_post_disaster.png,64,80,1,53,117,786,866,1495,56.50987514400486,41.724171301550804
8239,/media/marda/TWOTB1/xBD/hurricanes/images/florence/hurricane-florence_00000033_post_disaster.png,89,96,1,437,526,806,902,1959,78.76380749816086,33.138981465435315
8240,/media/marda/TWOTB1/xBD/hurricanes/images/florence/hurricane-florence_00000033_post_disaster.png,99,110,1,214,313,816,926,2929,97.85559135322733,39.81941840486712
8241,/media/marda/TWOTB1/xBD/hurricanes/images/florence/hurricane-florence_00000033_post_disaster.png,52,80,1,8,60,836,916,1169,55.36771641277166,28.390482831588873
8242,/media/marda/TWOTB1/xBD/hurricanes/images/florence/hurricane-florence_00000033_post_disaster.png,61,71,1,491,552,849,920,808,33.809884163738054,31.897702761964354
8243,/media/marda/TWOTB1/xBD/hurricanes/images/florence/hurricane-florence_00000033_post_disaster.png,98,101,1,428,526,853,954,1702,99.44223032516808,22.835546021309796
8244,/media/marda/TWOTB1/xBD/hurricanes/images/florence/hurricane-florence_00000033_post_disaster.png,13,62,1,0,13,869,931,213,26.479189393599494,11.995613302205538
8245,/media/marda/TWOTB1/xBD/hurricanes/images/florence/hurricane-florence_00000033_post_disaster.png,86,104,1,342,428,895,999,2441,70.61074660654549,47.23550747141207
8246,/media/marda/TWOTB1/xBD/hurricanes/images/florence/hurricane-florence_00000033_post_disaster.png,35,70,1,34,69,908,978,572,34.55583556446924,22.11461490398552
8247,/media/marda/TWOTB1/xBD/hurricanes/images/florence/hurricane-florence_00000033_post_disaster.png,83,75,1,530,613,966,1041,1289,52.94342761414447,34.169555804360265
8248,/media/marda/TWOTB1/xBD/hurricanes/images/florence/hurricane-florence_00000033_post_disaster.png,102,69,1,858,960,972,1041,1137,56.47052598503574,31.00580361708789
8249,/media/marda/TWOTB1/xBD/hurricanes/images/florence/hurricane-florence_00000287_post_disaster.png,48,38,1,56,104,87,125,869,43.57008019904576,26.731650559285395
8250,/media/marda/TWOTB1/xBD/hurricanes/images/florence/hurricane-florence_00000287_post_disaster.png,30,36,1,0,30,96,132,651,33.8967041632372,26.036653651870676
8251,/media/marda/TWOTB1/xBD/hurricanes/images/florence/hurricane-florence_00000287_post_disaster.png,23,29,1,63,86,126,155,325,23.590244748593072,18.159435059922973
8252,/media/marda/TWOTB1/xBD/hurricanes/images/florence/hurricane-florence_00000287_post_disaster.png,38,46,1,594,632,800,846,110,12.894642952807475,11.52589257491749
8253,/media/marda/TWOTB1/xBD/hurricanes/images/florence/hurricane-florence_00000287_post_disaster.png,55,67,1,514,569,852,919,535,38.84183776910991,18.37797101074646
8254,/media/marda/TWOTB1/xBD/hurricanes/images/florence/hurricane-florence_00000287_post_disaster.png,37,44,1,665,702,858,902,80,11.11051966537664,9.852098901517333
8255,/media/marda/TWOTB1/xBD/hurricanes/images/florence/hurricane-florence_00000293_pre_disaster.png,27,9,1,466,493,56,65,68,11.83152639650332,7.858244546353753
8256,/media/marda/TWOTB1/xBD/hurricanes/images/florence/hurricane-florence_00000293_pre_disaster.png,52,54,1,533,585,177,231,1470,55.27643986650642,35.32635278446719
8257,/media/marda/TWOTB1/xBD/hurricanes/images/florence/hurricane-florence_00000293_pre_disaster.png,75,50,1,526,601,252,302,1531,62.705017296102035,36.17397342091343
8258,/media/marda/TWOTB1/xBD/hurricanes/images/florence/hurricane-florence_00000293_pre_disaster.png,53,37,1,386,439,273,310,867,42.988902127321296,26.79413316199711
8259,/media/marda/TWOTB1/xBD/hurricanes/images/florence/hurricane-florence_00000293_pre_disaster.png,62,38,1,209,271,284,322,1103,59.533529827219105,24.54812707407689
8260,/media/marda/TWOTB1/xBD/hurricanes/images/florence/hurricane-florence_00000293_pre_disaster.png,54,25,1,759,813,289,314,332,28.007839639440007,15.877900758364788
8261,/media/marda/TWOTB1/xBD/hurricanes/images/florence/hurricane-florence_00000293_pre_disaster.png,54,51,1,637,691,313,364,1013,41.12596641355317,32.59901122545871
8262,/media/marda/TWOTB1/xBD/hurricanes/images/florence/hurricane-florence_00000293_pre_disaster.png,55,71,1,762,817,342,413,1228,64.80593802274905,25.687931420143048
8263,/media/marda/TWOTB1/xBD/hurricanes/images/florence/hurricane-florence_00000293_pre_disaster.png,62,38,1,180,242,346,384,1094,58.9577954942606,24.21141028804997
8264,/media/marda/TWOTB1/xBD/hurricanes/images/florence/hurricane-florence_00000293_pre_disaster.png,35,26,1,504,539,359,385,207,17.21485575155633,15.869768101795211
8265,/media/marda/TWOTB1/xBD/hurricanes/images/florence/hurricane-florence_00000293_pre_disaster.png,50,41,1,652,702,365,406,556,31.477742780735433,25.16471094153663
8266,/media/marda/TWOTB1/xBD/hurricanes/images/florence/hurricane-florence_00000293_pre_disaster.png,31,21,1,562,593,385,406,81,11.843711478326757,9.169653303382603
8267,/media/marda/TWOTB1/xBD/hurricanes/images/florence/hurricane-florence_00000293_pre_disaster.png,74,58,1,651,725,392,450,1363,54.60841409505428,37.33261851606338
8268,/media/marda/TWOTB1/xBD/hurricanes/images/florence/hurricane-florence_00000293_pre_disaster.png,50,62,1,491,541,398,460,896,48.071757823435796,24.839776211925926
8269,/media/marda/TWOTB1/xBD/hurricanes/images/florence/hurricane-florence_00000293_pre_disaster.png,52,50,1,402,454,407,457,871,37.04000134120981,31.664590399750203
8270,/media/marda/TWOTB1/xBD/hurricanes/images/florence/hurricane-florence_00000293_pre_disaster.png,56,49,1,766,822,407,456,701,34.849451518176416,26.578316258933985
8271,/media/marda/TWOTB1/xBD/hurricanes/images/florence/hurricane-florence_00000293_pre_disaster.png,50,35,1,571,621,410,445,351,28.40498450555013,17.000402188873537
8272,/media/marda/TWOTB1/xBD/hurricanes/images/florence/hurricane-florence_00000293_pre_disaster.png,20,48,1,0,20,421,469,487,31.514913589204355,20.310346056973586
8273,/media/marda/TWOTB1/xBD/hurricanes/images/florence/hurricane-florence_00000293_pre_disaster.png,62,49,1,581,643,436,485,800,41.156029300950564,26.23367353573073
8274,/media/marda/TWOTB1/xBD/hurricanes/images/florence/hurricane-florence_00000293_pre_disaster.png,50,50,1,552,602,441,491,694,33.76968338324279,27.29886075217065
8275,/media/marda/TWOTB1/xBD/hurricanes/images/florence/hurricane-florence_00000293_pre_disaster.png,80,45,1,787,867,458,503,996,52.982837244646255,24.829912586029817
8276,/media/marda/TWOTB1/xBD/hurricanes/images/florence/hurricane-florence_00000293_pre_disaster.png,60,68,1,885,945,484,552,814,55.860323987113404,19.46140104252079
8277,/media/marda/TWOTB1/xBD/hurricanes/images/florence/hurricane-florence_00000293_pre_disaster.png,61,48,1,941,1002,497,545,472,26.31609888530838,23.7196682876437
8278,/media/marda/TWOTB1/xBD/hurricanes/images/florence/hurricane-florence_00000293_pre_disaster.png,59,56,1,82,141,514,570,1319,61.422723708168554,28.371443847393113
8279,/media/marda/TWOTB1/xBD/hurricanes/images/florence/hurricane-florence_00000293_pre_disaster.png,41,55,1,362,403,516,571,702,36.00419906774995,25.596467475121447
8280,/media/marda/TWOTB1/xBD/hurricanes/images/florence/hurricane-florence_00000293_pre_disaster.png,56,82,1,386,442,516,598,1756,65.01183660424154,36.95423430749526
8281,/media/marda/TWOTB1/xBD/hurricanes/images/florence/hurricane-florence_00000293_pre_disaster.png,67,54,1,448,515,532,586,1005,51.08857058084403,27.346209054271835
8282,/media/marda/TWOTB1/xBD/hurricanes/images/florence/hurricane-florence_00000293_pre_disaster.png,26,40,1,94,120,549,589,318,22.789044475709147,18.561562672360512
8283,/media/marda/TWOTB1/xBD/hurricanes/images/florence/hurricane-florence_00000293_pre_disaster.png,77,68,1,505,582,556,624,1629,56.102314738398604,40.31463600404445
8284,/media/marda/TWOTB1/xBD/hurricanes/images/florence/hurricane-florence_00000293_pre_disaster.png,60,59,1,583,643,568,627,996,38.34991730818611,34.346600486122526
8285,/media/marda/TWOTB1/xBD/hurricanes/images/florence/hurricane-florence_00000293_pre_disaster.png,54,61,1,657,711,568,629,786,42.04667351655049,24.948718791710085
8286,/media/marda/TWOTB1/xBD/hurricanes/images/florence/hurricane-florence_00000293_pre_disaster.png,38,36,1,467,505,573,609,238,21.92249279971985,14.45370438241117
8287,/media/marda/TWOTB1/xBD/hurricanes/images/florence/hurricane-florence_00000293_pre_disaster.png,14,33,1,117,131,575,608,80,13.090442049652077,8.281927731192825
8288,/media/marda/TWOTB1/xBD/hurricanes/images/florence/hurricane-florence_00000293_pre_disaster.png,54,61,1,465,519,597,658,893,35.99167246803882,33.45795838881264
8289,/media/marda/TWOTB1/xBD/hurricanes/images/florence/hurricane-florence_00000293_pre_disaster.png,29,54,1,340,369,600,654,299,32.3369112243373,12.381218207405823
8290,/media/marda/TWOTB1/xBD/hurricanes/images/florence/hurricane-florence_00000293_pre_disaster.png,30,39,1,449,479,611,650,165,14.892252362414844,14.446021008283283
8291,/media/marda/TWOTB1/xBD/hurricanes/images/florence/hurricane-florence_00000293_pre_disaster.png,56,50,1,563,619,616,666,643,35.09433471473801,24.060972107059627
8292,/media/marda/TWOTB1/xBD/hurricanes/images/florence/hurricane-florence_00000293_pre_disaster.png,48,48,1,638,686,617,665,397,23.260248799083676,22.939704225960263
8293,/media/marda/TWOTB1/xBD/hurricanes/images/florence/hurricane-florence_00000293_pre_disaster.png,82,54,1,873,955,632,686,925,50.58528603076982,23.93893310321479
8294,/media/marda/TWOTB1/xBD/hurricanes/images/florence/hurricane-florence_00000293_pre_disaster.png,34,44,1,328,362,634,678,260,20.16521397241297,16.92608724633278
8295,/media/marda/TWOTB1/xBD/hurricanes/images/florence/hurricane-florence_00000293_pre_disaster.png,51,41,1,872,923,668,709,209,17.076743217204097,16.177608921618837
8296,/media/marda/TWOTB1/xBD/hurricanes/images/florence/hurricane-florence_00000293_pre_disaster.png,70,63,1,417,487,673,736,783,62.0344847069736,16.85081006304942
8297,/media/marda/TWOTB1/xBD/hurricanes/images/florence/hurricane-florence_00000293_pre_disaster.png,59,66,1,985,1044,690,756,529,39.408647014111274,18.3176108646498
8298,/media/marda/TWOTB1/xBD/hurricanes/images/florence/hurricane-florence_00000293_pre_disaster.png,42,63,1,504,546,693,756,459,36.733021856123514,16.704993122369082
8299,/media/marda/TWOTB1/xBD/hurricanes/images/florence/hurricane-florence_00000293_pre_disaster.png,81,64,1,959,1040,749,813,1185,45.4336074538623,34.10459667146915
8300,/media/marda/TWOTB1/xBD/hurricanes/images/florence/hurricane-florence_00000293_pre_disaster.png,73,50,1,971,1044,786,836,487,39.050696450880466,16.691378660280797
8301,/media/marda/TWOTB1/xBD/hurricanes/images/florence/hurricane-florence_00000081_pre_disaster.png,163,134,1,806,969,705,839,4759,153.45592134855704,41.369448998475306
8302,/media/marda/TWOTB1/xBD/hurricanes/images/florence/hurricane-florence_00000081_pre_disaster.png,70,81,1,718,788,813,894,1258,46.7258498399926,36.42830477837814
8303,/media/marda/TWOTB1/xBD/hurricanes/images/florence/hurricane-florence_00000081_pre_disaster.png,46,49,1,766,812,823,872,162,18.17437532028713,11.926243817475866
8304,/media/marda/TWOTB1/xBD/hurricanes/images/florence/hurricane-florence_00000081_pre_disaster.png,63,76,1,981,1044,883,959,617,38.239059275404344,22.644712083184352
8305,/media/marda/TWOTB1/xBD/hurricanes/images/florence/hurricane-florence_00000081_pre_disaster.png,68,73,1,619,687,923,996,808,45.637026435367424,23.404108811614588
8306,/media/marda/TWOTB1/xBD/hurricanes/images/florence/hurricane-florence_00000468_pre_disaster.png,37,15,1,418,455,89,104,216,23.032323378170815,12.464383066781323
8307,/media/marda/TWOTB1/xBD/hurricanes/images/florence/hurricane-florence_00000468_pre_disaster.png,53,40,1,423,476,133,173,968,38.221623042456315,32.8863631831006
8308,/media/marda/TWOTB1/xBD/hurricanes/images/florence/hurricane-florence_00000468_pre_disaster.png,61,41,1,880,941,418,459,484,27.754721970800443,23.075818192161947
8309,/media/marda/TWOTB1/xBD/hurricanes/images/florence/hurricane-florence_00000468_pre_disaster.png,50,29,1,958,1008,435,464,112,14.446943981437135,10.4547173907125
8310,/media/marda/TWOTB1/xBD/hurricanes/images/florence/hurricane-florence_00000468_pre_disaster.png,78,46,1,727,805,447,493,943,54.14615358633374,23.258279569578917
8311,/media/marda/TWOTB1/xBD/hurricanes/images/florence/hurricane-florence_00000468_pre_disaster.png,78,54,1,884,962,490,544,943,44.38129614709858,28.168986535697695
8312,/media/marda/TWOTB1/xBD/hurricanes/images/florence/hurricane-florence_00000468_pre_disaster.png,147,139,1,70,217,655,794,6562,172.6935172035115,78.23066379920728
8313,/media/marda/TWOTB1/xBD/hurricanes/images/florence/hurricane-florence_00000468_pre_disaster.png,27,50,1,120,147,689,739,344,22.8694196534191,19.965964185101118
8314,/media/marda/TWOTB1/xBD/hurricanes/images/florence/hurricane-florence_00000468_pre_disaster.png,48,74,1,381,429,912,986,844,37.05581382007946,31.031230366038876
8315,/media/marda/TWOTB1/xBD/hurricanes/images/florence/hurricane-florence_00000468_pre_disaster.png,38,56,1,414,452,958,1014,310,22.232540062330322,18.557672571857317
8316,/media/marda/TWOTB1/xBD/hurricanes/images/florence/hurricane-florence_00000428_pre_disaster.png,19,12,1,41,60,0,12,147,17.628159134612872,11.39736619140201
8317,/media/marda/TWOTB1/xBD/hurricanes/images/florence/hurricane-florence_00000428_pre_disaster.png,46,22,1,529,575,2,24,318,24.332390403710935,17.414515258740796
8318,/media/marda/TWOTB1/xBD/hurricanes/images/florence/hurricane-florence_00000428_pre_disaster.png,67,42,1,195,262,11,53,1479,60.92872830784014,31.9253549812292
8319,/media/marda/TWOTB1/xBD/hurricanes/images/florence/hurricane-florence_00000428_pre_disaster.png,65,51,1,813,878,14,65,679,56.602202479260846,16.02583372942904
8320,/media/marda/TWOTB1/xBD/hurricanes/images/florence/hurricane-florence_00000428_pre_disaster.png,76,31,1,501,577,26,57,564,66.17526836280163,11.374340889204223
8321,/media/marda/TWOTB1/xBD/hurricanes/images/florence/hurricane-florence_00000428_pre_disaster.png,54,24,1,782,836,28,52,332,22.632044067274528,19.83843624736161
8322,/media/marda/TWOTB1/xBD/hurricanes/images/florence/hurricane-florence_00000428_pre_disaster.png,42,38,1,3,45,35,73,932,38.54256733959399,33.42603346510219
8323,/media/marda/TWOTB1/xBD/hurricanes/images/florence/hurricane-florence_00000428_pre_disaster.png,26,17,1,197,223,68,85,179,21.52359165143867,11.257711293266201
8324,/media/marda/TWOTB1/xBD/hurricanes/images/florence/hurricane-florence_00000428_pre_disaster.png,86,74,1,909,995,118,192,1532,78.06004648174819,36.45944947543096
8325,/media/marda/TWOTB1/xBD/hurricanes/images/florence/hurricane-florence_00000428_pre_disaster.png,58,28,1,885,943,140,168,284,19.982564679370004,19.134501978528622
8326,/media/marda/TWOTB1/xBD/hurricanes/images/florence/hurricane-florence_00000428_pre_disaster.png,84,53,1,960,1044,242,295,1150,55.20667514901527,27.55463901557112
8327,/media/marda/TWOTB1/xBD/hurricanes/images/florence/hurricane-florence_00000428_pre_disaster.png,65,48,1,661,726,304,352,796,37.747916196209616,27.721552255767946
8328,/media/marda/TWOTB1/xBD/hurricanes/images/florence/hurricane-florence_00000428_pre_disaster.png,55,38,1,637,692,342,380,479,30.919732283165214,20.390296139543658
8329,/media/marda/TWOTB1/xBD/hurricanes/images/florence/hurricane-florence_00000428_pre_disaster.png,70,48,1,908,978,362,410,698,33.223934289504264,27.810655823533178
8330,/media/marda/TWOTB1/xBD/hurricanes/images/florence/hurricane-florence_00000428_pre_disaster.png,110,72,1,721,831,366,438,1983,86.24268369005388,35.211767614149856
8331,/media/marda/TWOTB1/xBD/hurricanes/images/florence/hurricane-florence_00000428_pre_disaster.png,69,51,1,952,1021,388,439,632,35.74143605397313,25.042613040880457
8332,/media/marda/TWOTB1/xBD/hurricanes/images/florence/hurricane-florence_00000428_pre_disaster.png,78,49,1,966,1044,470,519,620,42.02378922904496,20.586558317740856
8333,/media/marda/TWOTB1/xBD/hurricanes/images/florence/hurricane-florence_00000428_pre_disaster.png,37,33,1,617,654,601,634,105,15.080377237919537,9.281092874606541
8334,/media/marda/TWOTB1/xBD/hurricanes/images/florence/hurricane-florence_00000428_pre_disaster.png,41,42,1,651,692,631,673,126,20.280343014742378,8.346260729019372
8335,/media/marda/TWOTB1/xBD/hurricanes/images/florence/hurricane-florence_00000428_pre_disaster.png,39,42,1,584,623,632,674,143,17.96112210117265,10.702530709102014
8336,/media/marda/TWOTB1/xBD/hurricanes/images/florence/hurricane-florence_00000428_pre_disaster.png,53,44,1,829,882,658,702,232,20.62853509154263,14.914284908002317
8337,/media/marda/TWOTB1/xBD/hurricanes/images/florence/hurricane-florence_00000428_pre_disaster.png,66,89,1,349,415,694,783,972,77.6074423040146,16.634570122026286
8338,/media/marda/TWOTB1/xBD/hurricanes/images/florence/hurricane-florence_00000428_pre_disaster.png,63,59,1,765,828,696,755,530,31.4269110724312,22.27630842188345
8339,/media/marda/TWOTB1/xBD/hurricanes/images/florence/hurricane-florence_00000428_pre_disaster.png,63,80,1,308,371,715,795,1368,50.608225126279514,35.82821239694346
8340,/media/marda/TWOTB1/xBD/hurricanes/images/florence/hurricane-florence_00000428_pre_disaster.png,237,81,1,0,237,729,810,6812,266.1407644938047,34.231454220808146
8341,/media/marda/TWOTB1/xBD/hurricanes/images/florence/hurricane-florence_00000428_pre_disaster.png,35,48,1,395,430,751,799,202,17.009898575334503,15.958727887451511
8342,/media/marda/TWOTB1/xBD/hurricanes/images/florence/hurricane-florence_00000428_pre_disaster.png,65,86,1,281,346,757,843,1321,65.89919739415905,26.747989694644787
8343,/media/marda/TWOTB1/xBD/hurricanes/images/florence/hurricane-florence_00000428_pre_disaster.png,15,37,1,47,62,777,814,82,15.23789440103046,7.586379481680197
8344,/media/marda/TWOTB1/xBD/hurricanes/images/florence/hurricane-florence_00000428_pre_disaster.png,201,82,1,0,201,797,879,6047,228.2001376270373,35.38210405281207
8345,/media/marda/TWOTB1/xBD/hurricanes/images/florence/hurricane-florence_00000428_pre_disaster.png,15,41,1,9,24,805,846,95,16.476213588548955,7.916285200779631
8346,/media/marda/TWOTB1/xBD/hurricanes/images/florence/hurricane-florence_00000428_pre_disaster.png,79,75,1,916,995,828,903,995,40.859084777026474,33.868172752295905
8347,/media/marda/TWOTB1/xBD/hurricanes/images/florence/hurricane-florence_00000428_pre_disaster.png,54,79,1,309,363,830,909,940,46.278657417772074,28.638395257233437
8348,/media/marda/TWOTB1/xBD/hurricanes/images/florence/hurricane-florence_00000428_pre_disaster.png,34,56,1,223,257,856,912,296,26.89953344013017,14.469313966089228
8349,/media/marda/TWOTB1/xBD/hurricanes/images/florence/hurricane-florence_00000428_pre_disaster.png,66,62,1,957,1023,865,927,472,27.27695299946349,22.839024142986666
8350,/media/marda/TWOTB1/xBD/hurricanes/images/florence/hurricane-florence_00000428_pre_disaster.png,74,70,1,970,1044,876,946,814,39.21724545157454,27.782180508366064
8351,/media/marda/TWOTB1/xBD/hurricanes/images/florence/hurricane-florence_00000428_pre_disaster.png,79,93,1,344,423,882,975,1678,67.19685488147269,33.40611522177796
8352,/media/marda/TWOTB1/xBD/hurricanes/images/florence/hurricane-florence_00000428_pre_disaster.png,83,84,1,759,842,915,999,1172,57.33038176942223,27.163738846735566
8353,/media/marda/TWOTB1/xBD/hurricanes/images/florence/hurricane-florence_00000428_pre_disaster.png,47,72,1,311,358,959,1031,652,30.852563652339544,28.3046057390681
8354,/media/marda/TWOTB1/xBD/hurricanes/images/florence/hurricane-florence_00000290_post_disaster.png,59,42,1,829,888,170,212,766,38.481402314683265,26.878463087537774
8355,/media/marda/TWOTB1/xBD/hurricanes/images/florence/hurricane-florence_00000290_post_disaster.png,44,27,1,345,389,173,200,437,35.69785165422855,16.122404380352897
8356,/media/marda/TWOTB1/xBD/hurricanes/images/florence/hurricane-florence_00000290_post_disaster.png,23,12,1,477,500,184,196,56,9.16515138991168,8.0
8357,/media/marda/TWOTB1/xBD/hurricanes/images/florence/hurricane-florence_00000290_post_disaster.png,63,46,1,453,516,202,248,1052,54.917504712479605,27.353318324516767
8358,/media/marda/TWOTB1/xBD/hurricanes/images/florence/hurricane-florence_00000290_post_disaster.png,44,23,1,513,557,205,228,283,24.60672921656504,15.127296167911016
8359,/media/marda/TWOTB1/xBD/hurricanes/images/florence/hurricane-florence_00000290_post_disaster.png,67,40,1,751,818,209,249,387,43.93859405436242,13.626759838075927
8360,/media/marda/TWOTB1/xBD/hurricanes/images/florence/hurricane-florence_00000290_post_disaster.png,30,28,1,484,514,237,265,180,24.061051417605427,11.175684683102771
8361,/media/marda/TWOTB1/xBD/hurricanes/images/florence/hurricane-florence_00000290_post_disaster.png,73,37,1,851,924,274,311,747,40.55990469928966,24.473142934896465
8362,/media/marda/TWOTB1/xBD/hurricanes/images/florence/hurricane-florence_00000290_post_disaster.png,75,55,1,712,787,307,362,754,55.752490718285465,18.05414954432622
8363,/media/marda/TWOTB1/xBD/hurricanes/images/florence/hurricane-florence_00000290_post_disaster.png,83,121,1,814,897,384,505,3002,113.68255269515397,40.913345332354616
8364,/media/marda/TWOTB1/xBD/hurricanes/images/florence/hurricane-florence_00000290_post_disaster.png,49,31,1,615,664,392,423,256,23.401153728839358,14.410224108136825
8365,/media/marda/TWOTB1/xBD/hurricanes/images/florence/hurricane-florence_00000290_post_disaster.png,50,68,1,351,401,402,470,1093,56.75126722248613,25.544746619261048
8366,/media/marda/TWOTB1/xBD/hurricanes/images/florence/hurricane-florence_00000290_post_disaster.png,53,56,1,907,960,419,475,518,44.259903521171985,15.660003642320767
8367,/media/marda/TWOTB1/xBD/hurricanes/images/florence/hurricane-florence_00000290_post_disaster.png,48,36,1,757,805,421,457,209,17.74125677087857,15.75600738517834
8368,/media/marda/TWOTB1/xBD/hurricanes/images/florence/hurricane-florence_00000290_post_disaster.png,45,39,1,999,1044,423,462,69,24.346267631565336,4.134508561465841
8369,/media/marda/TWOTB1/xBD/hurricanes/images/florence/hurricane-florence_00000290_post_disaster.png,52,76,1,526,578,429,505,1279,65.2832207346209,25.68796253207211
8370,/media/marda/TWOTB1/xBD/hurricanes/images/florence/hurricane-florence_00000290_post_disaster.png,32,28,1,570,602,432,460,104,12.557465586724494,11.20542445997343
8371,/media/marda/TWOTB1/xBD/hurricanes/images/florence/hurricane-florence_00000290_post_disaster.png,47,38,1,573,620,454,492,355,24.533733245494858,19.50772052743152
8372,/media/marda/TWOTB1/xBD/hurricanes/images/florence/hurricane-florence_00000290_post_disaster.png,74,50,1,774,848,463,513,910,44.608331639217084,26.829906454449556
8373,/media/marda/TWOTB1/xBD/hurricanes/images/florence/hurricane-florence_00000290_post_disaster.png,60,50,1,648,708,464,514,643,35.5276787328426,27.932732951995796
8374,/media/marda/TWOTB1/xBD/hurricanes/images/florence/hurricane-florence_00000290_post_disaster.png,36,28,1,638,674,466,494,80,10.770942727627036,10.042748267191516
8375,/media/marda/TWOTB1/xBD/hurricanes/images/florence/hurricane-florence_00000290_post_disaster.png,74,50,1,709,783,484,534,953,47.29603166012778,26.6364846228256
8376,/media/marda/TWOTB1/xBD/hurricanes/images/florence/hurricane-florence_00000290_post_disaster.png,56,80,1,290,346,493,573,1307,61.25089437805017,28.79174927483723
8377,/media/marda/TWOTB1/xBD/hurricanes/images/florence/hurricane-florence_00000290_post_disaster.png,67,74,1,657,724,501,575,1472,52.563161600785136,36.93757017827285
8378,/media/marda/TWOTB1/xBD/hurricanes/images/florence/hurricane-florence_00000290_post_disaster.png,67,54,1,595,662,523,577,886,44.45428335155039,26.524423017860105
8379,/media/marda/TWOTB1/xBD/hurricanes/images/florence/hurricane-florence_00000290_post_disaster.png,45,55,1,348,393,530,585,646,33.41398166308445,25.682634814201474
8380,/media/marda/TWOTB1/xBD/hurricanes/images/florence/hurricane-florence_00000290_post_disaster.png,71,53,1,946,1017,535,588,641,34.94759410405922,25.701425385758885
8381,/media/marda/TWOTB1/xBD/hurricanes/images/florence/hurricane-florence_00000290_post_disaster.png,56,52,1,537,593,541,593,790,36.9389862830228,28.0484532117071
8382,/media/marda/TWOTB1/xBD/hurricanes/images/florence/hurricane-florence_00000290_post_disaster.png,59,56,1,300,359,550,606,498,57.59632691418996,11.539197798509003
8383,/media/marda/TWOTB1/xBD/hurricanes/images/florence/hurricane-florence_00000290_post_disaster.png,48,38,1,907,955,557,595,104,18.679593494181027,7.356135379433423
8384,/media/marda/TWOTB1/xBD/hurricanes/images/florence/hurricane-florence_00000290_post_disaster.png,34,43,1,351,385,600,643,256,19.857210184341387,16.83929360643251
8385,/media/marda/TWOTB1/xBD/hurricanes/images/florence/hurricane-florence_00000290_post_disaster.png,60,69,1,397,457,610,679,1125,43.28562436206676,36.04640162422857
8386,/media/marda/TWOTB1/xBD/hurricanes/images/florence/hurricane-florence_00000290_post_disaster.png,38,50,1,364,402,621,671,366,22.867691136113276,21.361615225832868
8387,/media/marda/TWOTB1/xBD/hurricanes/images/florence/hurricane-florence_00000290_post_disaster.png,42,62,1,99,141,632,694,718,40.926714460880405,23.3279353176262
8388,/media/marda/TWOTB1/xBD/hurricanes/images/florence/hurricane-florence_00000290_post_disaster.png,52,63,1,333,385,661,724,504,51.45325157516933,13.05389490472495
8389,/media/marda/TWOTB1/xBD/hurricanes/images/florence/hurricane-florence_00000290_post_disaster.png,32,44,1,210,242,702,746,174,24.892137858346608,9.862332659537905
8390,/media/marda/TWOTB1/xBD/hurricanes/images/florence/hurricane-florence_00000290_post_disaster.png,18,44,1,190,208,708,752,168,17.4649906139092,12.847534271978763
8391,/media/marda/TWOTB1/xBD/hurricanes/images/florence/hurricane-florence_00000290_post_disaster.png,39,57,1,206,245,730,787,504,26.9875389665153,24.490212292921953
8392,/media/marda/TWOTB1/xBD/hurricanes/images/florence/hurricane-florence_00000290_post_disaster.png,47,71,1,221,268,751,822,883,43.470014310633175,26.607103711296215
8393,/media/marda/TWOTB1/xBD/hurricanes/images/florence/hurricane-florence_00000290_post_disaster.png,43,65,1,105,148,760,825,647,44.456517093659066,19.60918319670055
8394,/media/marda/TWOTB1/xBD/hurricanes/images/florence/hurricane-florence_00000290_post_disaster.png,61,78,1,105,166,798,876,1597,56.963603310580055,36.30173497902343
8395,/media/marda/TWOTB1/xBD/hurricanes/images/florence/hurricane-florence_00000290_post_disaster.png,30,92,1,0,30,918,1010,870,47.824628864685046,27.745951491104144
8396,/media/marda/TWOTB1/xBD/hurricanes/images/florence/hurricane-florence_00000264_post_disaster.png,65,28,1,563,628,151,179,785,45.9989719224572,22.612201148521603
8397,/media/marda/TWOTB1/xBD/hurricanes/images/florence/hurricane-florence_00000264_post_disaster.png,54,27,1,504,558,160,187,579,35.657436893446906,22.030235199930473
8398,/media/marda/TWOTB1/xBD/hurricanes/images/florence/hurricane-florence_00000264_post_disaster.png,70,47,1,644,714,179,226,1412,47.795879423935006,40.37492129350542
8399,/media/marda/TWOTB1/xBD/hurricanes/images/florence/hurricane-florence_00000264_post_disaster.png,40,23,1,507,547,207,230,256,22.708121306123306,14.861089089763535
8400,/media/marda/TWOTB1/xBD/hurricanes/images/florence/hurricane-florence_00000264_post_disaster.png,97,29,1,947,1044,127,156,805,65.48338095339685,16.232312198217652
8401,/media/marda/TWOTB1/xBD/hurricanes/images/florence/hurricane-florence_00000411_post_disaster.png,58,47,1,571,629,22,69,709,54.11319893442448,17.4207270309483
8402,/media/marda/TWOTB1/xBD/hurricanes/images/florence/hurricane-florence_00000411_post_disaster.png,58,46,1,604,662,42,88,630,52.5098370264002,15.99360285918414
8403,/media/marda/TWOTB1/xBD/hurricanes/images/florence/hurricane-florence_00000411_post_disaster.png,35,10,1,602,637,46,56,57,9.949592029552775,7.8005148224735255
8404,/media/marda/TWOTB1/xBD/hurricanes/images/florence/hurricane-florence_00000411_post_disaster.png,70,42,1,544,614,119,161,917,48.728099859840675,25.024444151770627
8405,/media/marda/TWOTB1/xBD/hurricanes/images/florence/hurricane-florence_00000411_post_disaster.png,71,39,1,515,586,164,203,619,58.852375380971786,14.058357738419357
8406,/media/marda/TWOTB1/xBD/hurricanes/images/florence/hurricane-florence_00000411_post_disaster.png,70,41,1,492,562,196,237,543,58.15356089159198,12.421599826138031
8407,/media/marda/TWOTB1/xBD/hurricanes/images/florence/hurricane-florence_00000411_post_disaster.png,55,46,1,299,354,226,272,821,43.197223488471735,25.3704564568461
8408,/media/marda/TWOTB1/xBD/hurricanes/images/florence/hurricane-florence_00000411_post_disaster.png,73,45,1,465,538,231,276,683,65.2842466278472,13.906076719812914
8409,/media/marda/TWOTB1/xBD/hurricanes/images/florence/hurricane-florence_00000411_post_disaster.png,69,44,1,438,507,261,305,608,63.109364258231125,12.834238001633143
8410,/media/marda/TWOTB1/xBD/hurricanes/images/florence/hurricane-florence_00000411_post_disaster.png,58,52,1,374,432,268,320,680,55.541137404949865,16.34570450499087
8411,/media/marda/TWOTB1/xBD/hurricanes/images/florence/hurricane-florence_00000411_post_disaster.png,53,61,1,407,460,289,350,725,62.59037349387646,15.387422868047603
8412,/media/marda/TWOTB1/xBD/hurricanes/images/florence/hurricane-florence_00000411_post_disaster.png,55,43,1,445,500,319,362,664,37.16426310625138,23.720933689584296
8413,/media/marda/TWOTB1/xBD/hurricanes/images/florence/hurricane-florence_00000411_post_disaster.png,45,44,1,666,711,610,654,221,18.32815397082976,16.140894527986024
8414,/media/marda/TWOTB1/xBD/hurricanes/images/florence/hurricane-florence_00000411_post_disaster.png,54,47,1,512,566,22,69,578,54.41117572150411,14.184955683769319
8415,/media/marda/TWOTB1/xBD/hurricanes/images/florence/hurricane-florence_00000411_post_disaster.png,68,47,1,479,547,41,88,722,64.04948041558107,15.058941643216292
8416,/media/marda/TWOTB1/xBD/hurricanes/images/florence/hurricane-florence_00000411_post_disaster.png,72,40,1,446,518,76,116,664,64.36625904634285,13.759434791323315
8417,/media/marda/TWOTB1/xBD/hurricanes/images/florence/hurricane-florence_00000411_post_disaster.png,67,46,1,428,495,109,155,590,64.2733105073555,12.25350301285642
8418,/media/marda/TWOTB1/xBD/hurricanes/images/florence/hurricane-florence_00000411_post_disaster.png,29,16,1,413,442,110,126,79,10.852068911217874,9.739349901828907
8419,/media/marda/TWOTB1/xBD/hurricanes/images/florence/hurricane-florence_00000411_post_disaster.png,65,48,1,406,471,142,190,599,63.48565830433727,12.603264602989855
8420,/media/marda/TWOTB1/xBD/hurricanes/images/florence/hurricane-florence_00000411_post_disaster.png,23,19,1,279,302,145,164,157,15.282101307533525,13.806166950617405
8421,/media/marda/TWOTB1/xBD/hurricanes/images/florence/hurricane-florence_00000411_post_disaster.png,54,53,1,379,433,165,218,678,58.8162029751958,15.387789350354799
8422,/media/marda/TWOTB1/xBD/hurricanes/images/florence/hurricane-florence_00000411_post_disaster.png,47,60,1,351,398,174,234,691,64.8200136850001,14.23987569894184
8423,/media/marda/TWOTB1/xBD/hurricanes/images/florence/hurricane-florence_00000411_post_disaster.png,65,34,1,283,348,191,225,715,62.95852566108589,15.171773094771174
8424,/media/marda/TWOTB1/xBD/hurricanes/images/florence/hurricane-florence_00000411_post_disaster.png,62,42,1,193,255,256,298,747,63.47215325662108,16.207943532095506
8425,/media/marda/TWOTB1/xBD/hurricanes/images/florence/hurricane-florence_00000411_post_disaster.png,48,59,1,262,310,313,372,633,55.569385134567426,15.214921703400899
8426,/media/marda/TWOTB1/xBD/hurricanes/images/florence/hurricane-florence_00000411_post_disaster.png,50,64,1,294,344,331,395,758,62.66464267869415,16.10049435737826
8427,/media/marda/TWOTB1/xBD/hurricanes/images/florence/hurricane-florence_00000411_post_disaster.png,52,66,1,327,379,352,418,794,62.25132227138771,17.02796866257549
8428,/media/marda/TWOTB1/xBD/hurricanes/images/florence/hurricane-florence_00000411_post_disaster.png,50,60,1,364,414,374,434,691,53.85331764294492,17.447128476143376
8429,/media/marda/TWOTB1/xBD/hurricanes/images/florence/hurricane-florence_00000411_post_disaster.png,52,64,1,396,448,392,456,699,54.05490075484824,17.27029136726407
8430,/media/marda/TWOTB1/xBD/hurricanes/images/florence/hurricane-florence_00000411_post_disaster.png,12,50,1,0,12,586,636,189,26.918032525884694,10.737040113941303
8431,/media/marda/TWOTB1/xBD/hurricanes/images/florence/hurricane-florence_00000411_post_disaster.png,30,62,1,24,54,616,678,520,41.92480929985621,18.315447890861968
8432,/media/marda/TWOTB1/xBD/hurricanes/images/florence/hurricane-florence_00000411_post_disaster.png,29,57,1,10,39,633,690,504,28.97680518367044,24.13125540611383
8433,/media/marda/TWOTB1/xBD/hurricanes/images/florence/hurricane-florence_00000201_pre_disaster.png,394,32,1,585,979,0,32,5903,348.35955417648836,25.921212692052038
8434,/media/marda/TWOTB1/xBD/hurricanes/images/florence/hurricane-florence_00000201_pre_disaster.png,64,69,1,296,360,436,505,1304,55.320839080705156,31.27834358960059
8435,/media/marda/TWOTB1/xBD/hurricanes/images/florence/hurricane-florence_00000201_pre_disaster.png,42,35,1,729,771,597,632,86,13.522931050866847,8.600312887581262
8436,/media/marda/TWOTB1/xBD/hurricanes/images/florence/hurricane-florence_00000201_pre_disaster.png,62,85,1,733,795,611,696,671,70.01183085074297,12.812480350916756
8437,/media/marda/TWOTB1/xBD/hurricanes/images/florence/hurricane-florence_00000201_pre_disaster.png,65,83,1,795,860,696,779,1051,58.87299168611858,23.818281349097898
8438,/media/marda/TWOTB1/xBD/hurricanes/images/florence/hurricane-florence_00000201_pre_disaster.png,58,86,1,619,677,700,786,986,62.581511592235145,20.975657858687352
8439,/media/marda/TWOTB1/xBD/hurricanes/images/florence/hurricane-florence_00000201_pre_disaster.png,66,78,1,786,852,808,886,918,47.8574427986904,25.441017996487602
8440,/media/marda/TWOTB1/xBD/hurricanes/images/florence/hurricane-florence_00000201_pre_disaster.png,59,78,1,660,719,834,912,851,49.01393954515328,23.011648394385922
8441,/media/marda/TWOTB1/xBD/hurricanes/images/florence/hurricane-florence_00000201_pre_disaster.png,61,82,1,853,914,931,1013,931,49.231889378190125,25.157872755162657
8442,/media/marda/TWOTB1/xBD/hurricanes/images/florence/hurricane-florence_00000260_pre_disaster.png,40,7,1,386,426,0,7,132,29.779205093191244,6.028372618933926
8443,/media/marda/TWOTB1/xBD/hurricanes/images/florence/hurricane-florence_00000260_pre_disaster.png,63,37,1,665,728,1,38,655,36.87353110917392,23.70455783851302
8444,/media/marda/TWOTB1/xBD/hurricanes/images/florence/hurricane-florence_00000260_pre_disaster.png,32,26,1,348,380,8,34,329,27.23024364217497,16.818996603194684
8445,/media/marda/TWOTB1/xBD/hurricanes/images/florence/hurricane-florence_00000260_pre_disaster.png,57,29,1,964,1021,21,50,379,29.8125970611214,17.70488029487596
8446,/media/marda/TWOTB1/xBD/hurricanes/images/florence/hurricane-florence_00000260_pre_disaster.png,65,32,1,703,768,47,79,445,43.735185651022526,13.49812594461022
8447,/media/marda/TWOTB1/xBD/hurricanes/images/florence/hurricane-florence_00000260_pre_disaster.png,82,46,1,561,643,57,103,1877,61.089502497987716,41.17402051964416
8448,/media/marda/TWOTB1/xBD/hurricanes/images/florence/hurricane-florence_00000260_pre_disaster.png,70,37,1,957,1027,66,103,699,35.49082374775256,26.30877867663679
8449,/media/marda/TWOTB1/xBD/hurricanes/images/florence/hurricane-florence_00000260_pre_disaster.png,49,41,1,535,584,91,132,888,43.93713324587793,27.80917823679873
8450,/media/marda/TWOTB1/xBD/hurricanes/images/florence/hurricane-florence_00000260_pre_disaster.png,67,41,1,637,704,99,140,654,53.768887255542126,16.148413901243774
8451,/media/marda/TWOTB1/xBD/hurricanes/images/florence/hurricane-florence_00000260_pre_disaster.png,59,31,1,841,900,172,203,298,31.445552169465714,12.673618550543845
8452,/media/marda/TWOTB1/xBD/hurricanes/images/florence/hurricane-florence_00000260_pre_disaster.png,113,71,1,800,913,188,259,1765,93.34790832258058,26.793850991388915
8453,/media/marda/TWOTB1/xBD/hurricanes/images/florence/hurricane-florence_00000260_pre_disaster.png,57,36,1,555,612,189,225,614,38.5090625462575,20.810868573308632
8454,/media/marda/TWOTB1/xBD/hurricanes/images/florence/hurricane-florence_00000260_pre_disaster.png,51,43,1,574,625,259,302,611,33.30718886830291,24.503255101778166
8455,/media/marda/TWOTB1/xBD/hurricanes/images/florence/hurricane-florence_00000260_pre_disaster.png,70,70,1,387,457,264,334,1724,60.885736433184526,41.041218858875354
8456,/media/marda/TWOTB1/xBD/hurricanes/images/florence/hurricane-florence_00000260_pre_disaster.png,50,29,1,714,764,277,306,230,18.829477415006686,16.384202288350178
8457,/media/marda/TWOTB1/xBD/hurricanes/images/florence/hurricane-florence_00000260_pre_disaster.png,52,58,1,220,272,292,350,632,63.92671430236482,13.211173633504862
8458,/media/marda/TWOTB1/xBD/hurricanes/images/florence/hurricane-florence_00000260_pre_disaster.png,37,35,1,376,413,299,334,273,22.46317536097971,16.251432226273803
8459,/media/marda/TWOTB1/xBD/hurricanes/images/florence/hurricane-florence_00000260_pre_disaster.png,65,60,1,685,750,321,381,909,47.386141301404614,26.264805820963186
8460,/media/marda/TWOTB1/xBD/hurricanes/images/florence/hurricane-florence_00000260_pre_disaster.png,60,72,1,385,445,368,440,1334,62.5227588721063,28.647644574346515
8461,/media/marda/TWOTB1/xBD/hurricanes/images/florence/hurricane-florence_00000260_pre_disaster.png,55,65,1,236,291,377,442,1148,54.98171471766688,27.869847794772284
8462,/media/marda/TWOTB1/xBD/hurricanes/images/florence/hurricane-florence_00000260_pre_disaster.png,26,27,1,329,355,386,413,104,12.379898549942624,11.353059413522624
8463,/media/marda/TWOTB1/xBD/hurricanes/images/florence/hurricane-florence_00000260_pre_disaster.png,103,105,1,436,539,626,731,3705,73.84845633648195,66.68631013828744
8464,/media/marda/TWOTB1/xBD/hurricanes/images/florence/hurricane-florence_00000260_pre_disaster.png,68,78,1,532,600,687,765,1307,46.10477092306877,37.50179233078333
8465,/media/marda/TWOTB1/xBD/hurricanes/images/florence/hurricane-florence_00000260_pre_disaster.png,62,79,1,585,647,738,817,674,61.05736418356882,14.741377611487788
8466,/media/marda/TWOTB1/xBD/hurricanes/images/florence/hurricane-florence_00000260_pre_disaster.png,74,77,1,919,993,853,930,834,46.43838327700718,24.411033877358395
8467,/media/marda/TWOTB1/xBD/hurricanes/images/florence/hurricane-florence_00000260_pre_disaster.png,53,84,1,410,463,930,1014,555,55.058907654897965,13.61842862319804
8468,/media/marda/TWOTB1/xBD/hurricanes/images/florence/hurricane-florence_00000436_pre_disaster.png,348,120,1,341,689,269,389,9982,382.74037487065686,34.8657665376954
8469,/media/marda/TWOTB1/xBD/hurricanes/images/florence/hurricane-florence_00000436_pre_disaster.png,72,70,1,740,812,303,373,1449,60.55964990736354,31.919546568836516
8470,/media/marda/TWOTB1/xBD/hurricanes/images/florence/hurricane-florence_00000436_pre_disaster.png,54,45,1,676,730,314,359,455,30.30008667419066,21.777721367747905
8471,/media/marda/TWOTB1/xBD/hurricanes/images/florence/hurricane-florence_00000436_pre_disaster.png,347,125,1,277,624,353,478,10081,387.00578939401066,34.7178940734078
8472,/media/marda/TWOTB1/xBD/hurricanes/images/florence/hurricane-florence_00000436_pre_disaster.png,33,22,1,408,441,387,409,126,17.821805651793902,9.166513331997946
8473,/media/marda/TWOTB1/xBD/hurricanes/images/florence/hurricane-florence_00000436_pre_disaster.png,61,37,1,709,770,392,429,532,33.22589779351196,22.394811667772185
8474,/media/marda/TWOTB1/xBD/hurricanes/images/florence/hurricane-florence_00000436_pre_disaster.png,347,128,1,294,641,420,548,10245,384.01415357384747,35.63046329080529
8475,/media/marda/TWOTB1/xBD/hurricanes/images/florence/hurricane-florence_00000436_pre_disaster.png,75,55,1,681,756,473,528,1662,54.730637587648175,40.3303668080488
8476,/media/marda/TWOTB1/xBD/hurricanes/images/florence/hurricane-florence_00000436_pre_disaster.png,349,127,1,309,658,490,617,9815,386.0853799036772,33.86883442992637
8477,/media/marda/TWOTB1/xBD/hurricanes/images/florence/hurricane-florence_00000436_pre_disaster.png,30,31,1,445,475,522,553,102,14.587208211063531,9.14368915372104
8478,/media/marda/TWOTB1/xBD/hurricanes/images/florence/hurricane-florence_00000436_pre_disaster.png,14,44,1,53,67,840,884,137,15.766208736747712,11.703184055757083
8479,/media/marda/TWOTB1/xBD/hurricanes/images/florence/hurricane-florence_00000436_pre_disaster.png,58,82,1,82,140,927,1009,1481,54.43600484395939,37.32089407952749
8480,/media/marda/TWOTB1/xBD/hurricanes/images/florence/hurricane-florence_00000071_post_disaster.png,58,34,1,49,107,160,194,1217,58.99150492660706,27.49034456204977
8481,/media/marda/TWOTB1/xBD/hurricanes/images/florence/hurricane-florence_00000071_post_disaster.png,16,17,1,19,35,171,188,162,17.052634602615726,12.452374825011841
8482,/media/marda/TWOTB1/xBD/hurricanes/images/florence/hurricane-florence_00000071_post_disaster.png,31,89,1,0,31,255,344,1043,83.69034722989582,22.59603252276563
8483,/media/marda/TWOTB1/xBD/hurricanes/images/florence/hurricane-florence_00000408_pre_disaster.png,19,7,1,39,58,0,7,67,17.706908584689273,5.832425022741497
8484,/media/marda/TWOTB1/xBD/hurricanes/images/florence/hurricane-florence_00000408_pre_disaster.png,73,40,1,575,648,3,43,907,57.02635954653032,23.311226933628316
8485,/media/marda/TWOTB1/xBD/hurricanes/images/florence/hurricane-florence_00000408_pre_disaster.png,48,36,1,0,48,21,57,919,50.13514512806967,24.365199315502007
8486,/media/marda/TWOTB1/xBD/hurricanes/images/florence/hurricane-florence_00000408_pre_disaster.png,77,39,1,592,669,40,79,686,62.9373401893537,14.5490806219741
8487,/media/marda/TWOTB1/xBD/hurricanes/images/florence/hurricane-florence_00000408_pre_disaster.png,67,37,1,504,571,52,89,693,54.52951503613812,17.118411790092214
8488,/media/marda/TWOTB1/xBD/hurricanes/images/florence/hurricane-florence_00000408_pre_disaster.png,11,15,1,0,11,57,72,103,13.425694180565035,10.46596337946035
8489,/media/marda/TWOTB1/xBD/hurricanes/images/florence/hurricane-florence_00000408_pre_disaster.png,73,35,1,614,687,70,105,728,55.17132306175679,18.641829787072076
8490,/media/marda/TWOTB1/xBD/hurricanes/images/florence/hurricane-florence_00000408_pre_disaster.png,70,40,1,441,511,91,131,827,59.52880751164192,19.809818870799546
8491,/media/marda/TWOTB1/xBD/hurricanes/images/florence/hurricane-florence_00000408_pre_disaster.png,45,22,1,682,727,112,134,185,16.156208762144516,15.374315744568861
8492,/media/marda/TWOTB1/xBD/hurricanes/images/florence/hurricane-florence_00000408_pre_disaster.png,70,40,1,630,700,114,154,758,49.81182413587743,21.848437642351666
8493,/media/marda/TWOTB1/xBD/hurricanes/images/florence/hurricane-florence_00000408_pre_disaster.png,66,45,1,386,452,127,172,673,62.95387018981622,14.273766469780556
8494,/media/marda/TWOTB1/xBD/hurricanes/images/florence/hurricane-florence_00000408_pre_disaster.png,82,42,1,520,602,131,173,926,67.40407344358913,25.167977108738096
8495,/media/marda/TWOTB1/xBD/hurricanes/images/florence/hurricane-florence_00000408_pre_disaster.png,76,50,1,546,622,159,209,995,56.667338772139075,34.97798850626123
8496,/media/marda/TWOTB1/xBD/hurricanes/images/florence/hurricane-florence_00000408_pre_disaster.png,59,38,1,337,396,163,201,718,55.01297070233282,19.401348531453184
8497,/media/marda/TWOTB1/xBD/hurricanes/images/florence/hurricane-florence_00000408_pre_disaster.png,66,39,1,476,542,170,209,571,56.19185447993129,13.571964872404171
8498,/media/marda/TWOTB1/xBD/hurricanes/images/florence/hurricane-florence_00000408_pre_disaster.png,59,44,1,286,345,191,235,854,54.17688417555406,23.745404429040267
8499,/media/marda/TWOTB1/xBD/hurricanes/images/florence/hurricane-florence_00000408_pre_disaster.png,74,49,1,489,563,193,242,1355,58.4689287343935,32.95909471494429
8500,/media/marda/TWOTB1/xBD/hurricanes/images/florence/hurricane-florence_00000408_pre_disaster.png,72,45,1,607,679,208,253,768,54.11165064482149,20.288995085204277
8501,/media/marda/TWOTB1/xBD/hurricanes/images/florence/hurricane-florence_00000408_pre_disaster.png,55,36,1,421,476,209,245,509,41.37136352263062,17.086005627011527
8502,/media/marda/TWOTB1/xBD/hurricanes/images/florence/hurricane-florence_00000408_pre_disaster.png,61,49,1,233,294,226,275,899,60.44860406689822,21.328616878737634
8503,/media/marda/TWOTB1/xBD/hurricanes/images/florence/hurricane-florence_00000408_pre_disaster.png,64,48,1,437,501,234,282,853,50.51596480251852,24.817587552830105
8504,/media/marda/TWOTB1/xBD/hurricanes/images/florence/hurricane-florence_00000408_pre_disaster.png,62,48,1,359,421,241,289,775,54.05508016284254,21.1675476722636
8505,/media/marda/TWOTB1/xBD/hurricanes/images/florence/hurricane-florence_00000408_pre_disaster.png,53,41,1,554,607,249,290,575,33.577670459284086,23.469622944544742
8506,/media/marda/TWOTB1/xBD/hurricanes/images/florence/hurricane-florence_00000408_pre_disaster.png,43,56,1,218,261,269,325,909,50.93340122045457,25.666648238222486
8507,/media/marda/TWOTB1/xBD/hurricanes/images/florence/hurricane-florence_00000408_pre_disaster.png,68,49,1,377,445,269,318,858,61.33237932643553,19.33848159456321
8508,/media/marda/TWOTB1/xBD/hurricanes/images/florence/hurricane-florence_00000408_pre_disaster.png,65,57,1,306,371,273,330,1021,62.109613133833406,26.284615830969877
8509,/media/marda/TWOTB1/xBD/hurricanes/images/florence/hurricane-florence_00000408_pre_disaster.png,70,47,1,495,565,277,324,682,59.64460837642761,15.27908671969339
8510,/media/marda/TWOTB1/xBD/hurricanes/images/florence/hurricane-florence_00000408_pre_disaster.png,57,83,1,19,76,286,369,2022,82.04498153603872,32.95429987631662
8511,/media/marda/TWOTB1/xBD/hurricanes/images/florence/hurricane-florence_00000408_pre_disaster.png,63,46,1,442,505,314,360,586,54.74387755800961,14.28913500501589
8512,/media/marda/TWOTB1/xBD/hurricanes/images/florence/hurricane-florence_00000408_pre_disaster.png,62,51,1,385,447,347,398,654,58.44283779008114,14.947196137148648
8513,/media/marda/TWOTB1/xBD/hurricanes/images/florence/hurricane-florence_00000408_pre_disaster.png,56,47,1,337,393,382,429,616,49.81296282701826,16.47587730626397
8514,/media/marda/TWOTB1/xBD/hurricanes/images/florence/hurricane-florence_00000408_pre_disaster.png,73,45,1,956,1029,416,461,418,39.99366836297249,13.974503160310395
8515,/media/marda/TWOTB1/xBD/hurricanes/images/florence/hurricane-florence_00000408_pre_disaster.png,77,47,1,865,942,460,507,478,48.35920542577672,13.209218367630925
8516,/media/marda/TWOTB1/xBD/hurricanes/images/florence/hurricane-florence_00000408_pre_disaster.png,82,52,1,830,912,477,529,690,54.475610429818786,18.403045902848735
8517,/media/marda/TWOTB1/xBD/hurricanes/images/florence/hurricane-florence_00000408_pre_disaster.png,82,53,1,796,878,494,547,533,56.056775781916066,12.73576952964375
8518,/media/marda/TWOTB1/xBD/hurricanes/images/florence/hurricane-florence_00000408_pre_disaster.png,75,54,1,766,841,511,565,546,50.71682058931091,15.912066183179139
8519,/media/marda/TWOTB1/xBD/hurricanes/images/florence/hurricane-florence_00000408_pre_disaster.png,56,67,1,912,968,516,583,690,52.08766745795036,17.93962308059177
8520,/media/marda/TWOTB1/xBD/hurricanes/images/florence/hurricane-florence_00000408_pre_disaster.png,81,65,1,730,811,523,588,1050,52.57036382533763,30.080916184076678
8521,/media/marda/TWOTB1/xBD/hurricanes/images/florence/hurricane-florence_00000408_pre_disaster.png,57,68,1,881,938,539,607,802,55.08137666607077,21.292599874505765
8522,/media/marda/TWOTB1/xBD/hurricanes/images/florence/hurricane-florence_00000408_pre_disaster.png,52,36,1,932,984,545,581,207,17.220392919402606,15.516657597600144
8523,/media/marda/TWOTB1/xBD/hurricanes/images/florence/hurricane-florence_00000408_pre_disaster.png,48,66,1,846,894,557,623,690,53.13527838673803,17.300545003858034
8524,/media/marda/TWOTB1/xBD/hurricanes/images/florence/hurricane-florence_00000408_pre_disaster.png,76,60,1,662,738,564,624,805,52.12906042244408,23.219199440577672
8525,/media/marda/TWOTB1/xBD/hurricanes/images/florence/hurricane-florence_00000408_pre_disaster.png,47,34,1,829,876,564,598,189,16.831463562631072,15.025339239120672
8526,/media/marda/TWOTB1/xBD/hurricanes/images/florence/hurricane-florence_00000408_pre_disaster.png,65,68,1,801,866,566,634,941,46.77573030446922,29.52535679344398
8527,/media/marda/TWOTB1/xBD/hurricanes/images/florence/hurricane-florence_00000408_pre_disaster.png,81,78,1,963,1044,573,651,1535,51.58321011779809,39.86482974666441
8528,/media/marda/TWOTB1/xBD/hurricanes/images/florence/hurricane-florence_00000408_pre_disaster.png,39,64,1,159,198,579,643,754,45.029639160194435,22.272692206065674
8529,/media/marda/TWOTB1/xBD/hurricanes/images/florence/hurricane-florence_00000408_pre_disaster.png,73,59,1,629,702,580,639,656,57.29705836479417,16.38708352240151
8530,/media/marda/TWOTB1/xBD/hurricanes/images/florence/hurricane-florence_00000408_pre_disaster.png,44,63,1,779,823,592,655,458,44.03690473131297,13.881524161043604
8531,/media/marda/TWOTB1/xBD/hurricanes/images/florence/hurricane-florence_00000408_pre_disaster.png,82,56,1,585,667,598,654,1305,60.201182940915615,30.844009037208266
8532,/media/marda/TWOTB1/xBD/hurricanes/images/florence/hurricane-florence_00000408_pre_disaster.png,44,79,1,712,756,622,701,698,62.037344193391114,15.019194918604981
8533,/media/marda/TWOTB1/xBD/hurricanes/images/florence/hurricane-florence_00000408_pre_disaster.png,41,40,1,605,646,629,669,249,19.203960320761375,17.293913913787307
8534,/media/marda/TWOTB1/xBD/hurricanes/images/florence/hurricane-florence_00000408_pre_disaster.png,75,72,1,884,959,638,710,854,51.300526931357965,22.20625504813696
8535,/media/marda/TWOTB1/xBD/hurricanes/images/florence/hurricane-florence_00000408_pre_disaster.png,32,105,1,0,32,648,753,1321,72.24729467467591,28.13782944956865
8536,/media/marda/TWOTB1/xBD/hurricanes/images/florence/hurricane-florence_00000408_pre_disaster.png,57,65,1,645,702,662,727,563,49.123594562440296,18.449815313127853
8537,/media/marda/TWOTB1/xBD/hurricanes/images/florence/hurricane-florence_00000408_pre_disaster.png,81,89,1,77,158,798,887,2417,85.48606128882807,37.329698481602996
8538,/media/marda/TWOTB1/xBD/hurricanes/images/florence/hurricane-florence_00000408_pre_disaster.png,58,131,1,0,58,831,962,2910,107.82280396891971,46.334539184437496
8539,/media/marda/TWOTB1/xBD/hurricanes/images/florence/hurricane-florence_00000408_pre_disaster.png,77,64,1,603,680,872,936,597,61.50209851750768,13.097413539690628
8540,/media/marda/TWOTB1/xBD/hurricanes/images/florence/hurricane-florence_00000408_pre_disaster.png,36,64,1,36,72,875,939,673,39.88847928823287,22.321217247194145
8541,/media/marda/TWOTB1/xBD/hurricanes/images/florence/hurricane-florence_00000408_pre_disaster.png,72,97,1,159,231,887,984,1433,83.42918388597549,22.76905202671115
8542,/media/marda/TWOTB1/xBD/hurricanes/images/florence/hurricane-florence_00000408_pre_disaster.png,71,74,1,72,143,903,977,722,81.81768276442021,11.786378268598376
8543,/media/marda/TWOTB1/xBD/hurricanes/images/florence/hurricane-florence_00000408_pre_disaster.png,51,77,1,646,697,906,983,522,46.99948084899983,14.739442835800466
8544,/media/marda/TWOTB1/xBD/hurricanes/images/florence/hurricane-florence_00000408_pre_disaster.png,115,124,1,143,258,918,1042,2391,143.17828378872952,22.148855881167957
8545,/media/marda/TWOTB1/xBD/hurricanes/images/florence/hurricane-florence_00000408_pre_disaster.png,6,48,1,0,6,939,987,50,12.069417645052921,5.586229292580571
8546,/media/marda/TWOTB1/xBD/hurricanes/images/florence/hurricane-florence_00000408_pre_disaster.png,30,70,1,67,97,944,1014,335,41.7487339238432,10.751429477290573
8547,/media/marda/TWOTB1/xBD/hurricanes/images/florence/hurricane-florence_00000408_pre_disaster.png,85,69,1,532,617,973,1042,984,52.33976540633007,27.269448811773337
8548,/media/marda/TWOTB1/xBD/hurricanes/images/florence/hurricane-florence_00000408_pre_disaster.png,37,54,1,232,269,990,1044,208,24.407123573446135,13.131397148052411
8549,/media/marda/TWOTB1/xBD/hurricanes/images/florence/hurricane-florence_00000381_pre_disaster.png,52,37,1,941,993,335,372,353,27.152071662774418,17.281786145529697
8550,/media/marda/TWOTB1/xBD/hurricanes/images/florence/hurricane-florence_00000381_pre_disaster.png,37,27,1,648,685,371,398,147,15.694209446802125,12.584596217151764
8551,/media/marda/TWOTB1/xBD/hurricanes/images/florence/hurricane-florence_00000381_pre_disaster.png,56,58,1,510,566,855,913,579,39.1912600860826,19.97341356110092
8552,/media/marda/TWOTB1/xBD/hurricanes/images/florence/hurricane-florence_00000381_pre_disaster.png,46,87,1,104,150,895,982,1081,51.64049784211236,27.781975665801244
8553,/media/marda/TWOTB1/xBD/hurricanes/images/florence/hurricane-florence_00000381_pre_disaster.png,21,56,1,70,91,941,997,267,20.303598594064855,17.19843806503203
8554,/media/marda/TWOTB1/xBD/hurricanes/images/florence/hurricane-florence_00000381_pre_disaster.png,87,71,1,709,796,956,1027,1263,63.93203480771189,26.543446016456404
8555,/media/marda/TWOTB1/xBD/hurricanes/images/florence/hurricane-florence_00000381_pre_disaster.png,71,77,1,534,605,965,1042,1253,46.150684770216635,35.80011660409137
8556,/media/marda/TWOTB1/xBD/hurricanes/images/florence/hurricane-florence_00000317_post_disaster.png,62,18,1,939,1001,12,30,309,25.472672775871573,16.187405686142085
8557,/media/marda/TWOTB1/xBD/hurricanes/images/florence/hurricane-florence_00000317_post_disaster.png,64,50,1,980,1044,19,69,799,47.98922449139982,23.170822755792738
8558,/media/marda/TWOTB1/xBD/hurricanes/images/florence/hurricane-florence_00000317_post_disaster.png,50,62,1,376,426,106,168,1232,62.617827320692136,26.113497420150047
8559,/media/marda/TWOTB1/xBD/hurricanes/images/florence/hurricane-florence_00000317_post_disaster.png,64,49,1,696,760,117,166,1032,43.325100144676355,31.756459649701032
8560,/media/marda/TWOTB1/xBD/hurricanes/images/florence/hurricane-florence_00000317_post_disaster.png,68,47,1,965,1033,131,178,614,46.1276874071451,18.396596396072884
8561,/media/marda/TWOTB1/xBD/hurricanes/images/florence/hurricane-florence_00000317_post_disaster.png,21,12,1,375,396,167,179,64,10.10566749386685,8.359155729103442
8562,/media/marda/TWOTB1/xBD/hurricanes/images/florence/hurricane-florence_00000317_post_disaster.png,47,45,1,31,78,190,235,1039,47.063893770160554,29.456882069664385
8563,/media/marda/TWOTB1/xBD/hurricanes/images/florence/hurricane-florence_00000317_post_disaster.png,59,62,1,400,459,190,252,1520,63.574285871055,31.711271383722245
8564,/media/marda/TWOTB1/xBD/hurricanes/images/florence/hurricane-florence_00000317_post_disaster.png,44,26,1,497,541,247,273,287,23.618078162465356,16.086719072583794
8565,/media/marda/TWOTB1/xBD/hurricanes/images/florence/hurricane-florence_00000317_post_disaster.png,55,60,1,426,481,275,335,1204,53.69343959233946,29.926675506478155
8566,/media/marda/TWOTB1/xBD/hurricanes/images/florence/hurricane-florence_00000317_post_disaster.png,67,42,1,28,95,277,319,1126,74.2504704972641,21.989223587671024
8567,/media/marda/TWOTB1/xBD/hurricanes/images/florence/hurricane-florence_00000317_post_disaster.png,70,52,1,229,299,305,357,1433,62.479310499826454,30.389115643188934
8568,/media/marda/TWOTB1/xBD/hurricanes/images/florence/hurricane-florence_00000317_post_disaster.png,60,50,1,179,239,336,386,1228,57.28620375501307,28.413065605919115
8569,/media/marda/TWOTB1/xBD/hurricanes/images/florence/hurricane-florence_00000317_post_disaster.png,57,66,1,449,506,357,423,1343,56.484244122437296,33.733105889122186
8570,/media/marda/TWOTB1/xBD/hurricanes/images/florence/hurricane-florence_00000317_post_disaster.png,19,27,1,120,139,389,416,147,14.572480421289082,13.46486142552785
8571,/media/marda/TWOTB1/xBD/hurricanes/images/florence/hurricane-florence_00000317_post_disaster.png,35,39,1,205,240,406,445,383,28.598031799695207,17.83396076074732
8572,/media/marda/TWOTB1/xBD/hurricanes/images/florence/hurricane-florence_00000317_post_disaster.png,57,54,1,483,540,444,498,992,38.158844407601244,34.14803158438773
8573,/media/marda/TWOTB1/xBD/hurricanes/images/florence/hurricane-florence_00000317_post_disaster.png,35,26,1,523,558,470,496,94,14.410515958977538,8.926349690416624
8574,/media/marda/TWOTB1/xBD/hurricanes/images/florence/hurricane-florence_00000317_post_disaster.png,50,49,1,487,537,573,622,576,32.27082676504993,23.615762195665752
8575,/media/marda/TWOTB1/xBD/hurricanes/images/florence/hurricane-florence_00000317_post_disaster.png,37,40,1,500,537,619,659,131,15.98740162890645,10.997294529603726
8576,/media/marda/TWOTB1/xBD/hurricanes/images/florence/hurricane-florence_00000317_post_disaster.png,50,46,1,716,766,621,667,272,20.63179548288854,17.562101662564174
8577,/media/marda/TWOTB1/xBD/hurricanes/images/florence/hurricane-florence_00000317_post_disaster.png,24,34,1,272,296,663,697,126,18.120841557420636,9.367227583378329
8578,/media/marda/TWOTB1/xBD/hurricanes/images/florence/hurricane-florence_00000317_post_disaster.png,35,39,1,564,599,663,702,118,13.618703672795137,11.596962656206237
8579,/media/marda/TWOTB1/xBD/hurricanes/images/florence/hurricane-florence_00000317_post_disaster.png,37,48,1,522,559,679,727,191,25.37915257133634,10.100291148433858
8580,/media/marda/TWOTB1/xBD/hurricanes/images/florence/hurricane-florence_00000317_post_disaster.png,39,68,1,168,207,885,953,665,31.072708997531144,28.384972661913505
8581,/media/marda/TWOTB1/xBD/hurricanes/images/florence/hurricane-florence_00000011_post_disaster.png,73,46,1,563,636,0,46,1257,44.753879221252085,37.38711643441745
8582,/media/marda/TWOTB1/xBD/hurricanes/images/florence/hurricane-florence_00000011_post_disaster.png,57,14,1,597,654,0,14,238,27.94392644442717,13.075054266525854
8583,/media/marda/TWOTB1/xBD/hurricanes/images/florence/hurricane-florence_00000011_post_disaster.png,21,17,1,116,137,13,30,173,15.954059341804108,14.527923444124749
8584,/media/marda/TWOTB1/xBD/hurricanes/images/florence/hurricane-florence_00000011_post_disaster.png,125,97,1,628,753,13,110,4307,102.74957587442309,56.11637393825669
8585,/media/marda/TWOTB1/xBD/hurricanes/images/florence/hurricane-florence_00000011_post_disaster.png,63,82,1,70,133,55,137,2745,84.99087563864411,53.17976931089666
8586,/media/marda/TWOTB1/xBD/hurricanes/images/florence/hurricane-florence_00000011_post_disaster.png,62,27,1,967,1029,190,217,244,25.723569200990763,12.686563280000572
8587,/media/marda/TWOTB1/xBD/hurricanes/images/florence/hurricane-florence_00000011_post_disaster.png,152,125,1,786,938,215,340,6463,117.64897094548334,74.00072649505273
8588,/media/marda/TWOTB1/xBD/hurricanes/images/florence/hurricane-florence_00000011_post_disaster.png,62,63,1,105,167,226,289,1797,49.509125454175695,47.511465946832935
8589,/media/marda/TWOTB1/xBD/hurricanes/images/florence/hurricane-florence_00000011_post_disaster.png,52,60,1,15,67,230,290,1453,56.84896348609323,34.16436787520257
8590,/media/marda/TWOTB1/xBD/hurricanes/images/florence/hurricane-florence_00000011_post_disaster.png,48,55,1,67,115,260,315,1837,50.18996360510317,48.191681686677484
8591,/media/marda/TWOTB1/xBD/hurricanes/images/florence/hurricane-florence_00000011_post_disaster.png,106,120,1,78,184,294,414,4715,128.52431985295652,50.616666253808695
8592,/media/marda/TWOTB1/xBD/hurricanes/images/florence/hurricane-florence_00000011_post_disaster.png,76,62,1,968,1044,335,397,1099,43.280931400347,35.5477614997262
8593,/media/marda/TWOTB1/xBD/hurricanes/images/florence/hurricane-florence_00000011_post_disaster.png,48,61,1,0,48,359,420,1788,49.076504034619994,47.925413608799026
8594,/media/marda/TWOTB1/xBD/hurricanes/images/florence/hurricane-florence_00000011_post_disaster.png,93,53,1,938,1031,378,431,1211,50.095499066450685,32.83033232935504
8595,/media/marda/TWOTB1/xBD/hurricanes/images/florence/hurricane-florence_00000011_post_disaster.png,64,73,1,39,103,383,456,2268,58.282047652708236,51.02326451075685
8596,/media/marda/TWOTB1/xBD/hurricanes/images/florence/hurricane-florence_00000011_post_disaster.png,87,64,1,898,985,400,464,1395,45.71250798781686,40.900932972117786
8597,/media/marda/TWOTB1/xBD/hurricanes/images/florence/hurricane-florence_00000011_post_disaster.png,69,81,1,139,208,424,505,2205,60.07931042921706,48.17484327832292
8598,/media/marda/TWOTB1/xBD/hurricanes/images/florence/hurricane-florence_00000011_post_disaster.png,102,67,1,937,1039,445,512,1594,59.25610264758346,38.03636302647473
8599,/media/marda/TWOTB1/xBD/hurricanes/images/florence/hurricane-florence_00000011_post_disaster.png,63,79,1,101,164,467,546,2030,56.30682902779249,47.22090434731295
8600,/media/marda/TWOTB1/xBD/hurricanes/images/florence/hurricane-florence_00000011_post_disaster.png,56,68,1,3,59,501,569,2192,59.18266649090649,48.48974969279637
8601,/media/marda/TWOTB1/xBD/hurricanes/images/florence/hurricane-florence_00000011_post_disaster.png,45,66,1,65,110,507,573,1435,46.4978229482111,39.93138074147207
8602,/media/marda/TWOTB1/xBD/hurricanes/images/florence/hurricane-florence_00000011_post_disaster.png,49,44,1,995,1044,603,647,96,17.492869163917792,8.389780527698143
8603,/media/marda/TWOTB1/xBD/hurricanes/images/florence/hurricane-florence_00000011_post_disaster.png,77,96,1,69,146,652,748,2654,67.9014993191704,52.12831743264113
8604,/media/marda/TWOTB1/xBD/hurricanes/images/florence/hurricane-florence_00000011_post_disaster.png,51,42,1,896,947,694,736,106,12.56771056648782,11.287654392433716
8605,/media/marda/TWOTB1/xBD/hurricanes/images/florence/hurricane-florence_00000011_post_disaster.png,68,63,1,872,940,705,768,574,36.12686705968268,21.0677939274959
8606,/media/marda/TWOTB1/xBD/hurricanes/images/florence/hurricane-florence_00000011_post_disaster.png,86,76,1,891,977,718,794,935,58.80173643173184,21.220871962360246
8607,/media/marda/TWOTB1/xBD/hurricanes/images/florence/hurricane-florence_00000011_post_disaster.png,80,72,1,762,842,728,800,874,56.08956471785312,21.20174614179799
8608,/media/marda/TWOTB1/xBD/hurricanes/images/florence/hurricane-florence_00000011_post_disaster.png,73,66,1,921,994,744,810,648,39.17425463106327,22.079858026009486
8609,/media/marda/TWOTB1/xBD/hurricanes/images/florence/hurricane-florence_00000011_post_disaster.png,79,76,1,783,862,748,824,1036,53.66931499314964,25.661393554996273
8610,/media/marda/TWOTB1/xBD/hurricanes/images/florence/hurricane-florence_00000011_post_disaster.png,81,83,1,807,888,767,850,1141,60.04961252405151,25.529649926869737
8611,/media/marda/TWOTB1/xBD/hurricanes/images/florence/hurricane-florence_00000011_post_disaster.png,87,81,1,955,1042,777,858,1378,48.563496378881744,38.1878708211584
8612,/media/marda/TWOTB1/xBD/hurricanes/images/florence/hurricane-florence_00000011_post_disaster.png,81,83,1,832,913,790,873,945,59.44157842269044,22.557389158622676
8613,/media/marda/TWOTB1/xBD/hurricanes/images/florence/hurricane-florence_00000011_post_disaster.png,71,75,1,745,816,798,873,726,50.65614124002948,19.67940790417714
8614,/media/marda/TWOTB1/xBD/hurricanes/images/florence/hurricane-florence_00000011_post_disaster.png,85,81,1,855,940,815,896,1091,55.748206717262214,26.42978224670074
8615,/media/marda/TWOTB1/xBD/hurricanes/images/florence/hurricane-florence_00000011_post_disaster.png,77,84,1,765,842,819,903,1015,58.855478192228716,23.09397675171547
8616,/media/marda/TWOTB1/xBD/hurricanes/images/florence/hurricane-florence_00000011_post_disaster.png,71,79,1,663,734,841,920,874,53.49319257481899,21.80269926094103
8617,/media/marda/TWOTB1/xBD/hurricanes/images/florence/hurricane-florence_00000011_post_disaster.png,72,77,1,787,859,847,924,776,49.730115082070874,21.00607521294562
8618,/media/marda/TWOTB1/xBD/hurricanes/images/florence/hurricane-florence_00000011_post_disaster.png,115,124,1,391,506,859,983,3049,125.84925148338843,32.31257014378149
8619,/media/marda/TWOTB1/xBD/hurricanes/images/florence/hurricane-florence_00000011_post_disaster.png,78,79,1,811,889,866,945,897,53.87694059162777,22.218332158527694
8620,/media/marda/TWOTB1/xBD/hurricanes/images/florence/hurricane-florence_00000011_post_disaster.png,71,73,1,684,755,868,941,882,46.68130379526153,25.349574567659822
8621,/media/marda/TWOTB1/xBD/hurricanes/images/florence/hurricane-florence_00000011_post_disaster.png,81,78,1,909,990,882,960,788,51.11995081500533,20.562875454214748
8622,/media/marda/TWOTB1/xBD/hurricanes/images/florence/hurricane-florence_00000011_post_disaster.png,68,75,1,707,775,889,964,659,44.927286794979516,19.61133769275327
8623,/media/marda/TWOTB1/xBD/hurricanes/images/florence/hurricane-florence_00000011_post_disaster.png,83,79,1,889,972,905,984,817,53.40652375004533,20.40790315102272
8624,/media/marda/TWOTB1/xBD/hurricanes/images/florence/hurricane-florence_00000011_post_disaster.png,65,74,1,979,1044,914,988,554,36.75681698180644,19.989662724694224
8625,/media/marda/TWOTB1/xBD/hurricanes/images/florence/hurricane-florence_00000011_post_disaster.png,82,80,1,867,949,926,1006,974,49.534565076943835,26.239955138867217
8626,/media/marda/TWOTB1/xBD/hurricanes/images/florence/hurricane-florence_00000011_post_disaster.png,74,80,1,755,829,931,1011,884,49.81221459977258,24.383211183225686
8627,/media/marda/TWOTB1/xBD/hurricanes/images/florence/hurricane-florence_00000011_post_disaster.png,76,82,1,660,736,947,1029,1109,49.609380402029736,30.59415070648573
8628,/media/marda/TWOTB1/xBD/hurricanes/images/florence/hurricane-florence_00000011_post_disaster.png,70,64,1,958,1028,948,1012,467,28.321255225682595,21.830216572088126
8629,/media/marda/TWOTB1/xBD/hurricanes/images/florence/hurricane-florence_00000011_post_disaster.png,86,86,1,849,935,953,1039,1094,58.51423923295579,24.950399264819083
8630,/media/marda/TWOTB1/xBD/hurricanes/images/florence/hurricane-florence_00000011_post_disaster.png,107,82,1,224,331,959,1041,2456,82.36321459217527,43.24565785456958
8631,/media/marda/TWOTB1/xBD/hurricanes/images/florence/hurricane-florence_00000011_post_disaster.png,71,65,1,934,1005,976,1041,541,31.88261752804195,22.56488326853705
8632,/media/marda/TWOTB1/xBD/hurricanes/images/florence/hurricane-florence_00000011_post_disaster.png,52,63,1,562,614,980,1043,392,25.35218056477458,20.37900901661918
8633,/media/marda/TWOTB1/xBD/hurricanes/images/florence/hurricane-florence_00000013_pre_disaster.png,16,14,1,0,16,0,14,185,17.077110804817693,14.517274169296007
8634,/media/marda/TWOTB1/xBD/hurricanes/images/florence/hurricane-florence_00000013_pre_disaster.png,51,13,1,371,422,0,13,266,32.033963244208344,12.54178147605265
8635,/media/marda/TWOTB1/xBD/hurricanes/images/florence/hurricane-florence_00000013_pre_disaster.png,63,29,1,410,473,0,29,924,44.88977870437211,28.128908579299107
8636,/media/marda/TWOTB1/xBD/hurricanes/images/florence/hurricane-florence_00000013_pre_disaster.png,72,48,1,455,527,0,48,1709,52.29558886230524,45.084521146770705
8637,/media/marda/TWOTB1/xBD/hurricanes/images/florence/hurricane-florence_00000013_pre_disaster.png,59,7,1,674,733,0,7,123,34.64187856464789,6.022717007959857
8638,/media/marda/TWOTB1/xBD/hurricanes/images/florence/hurricane-florence_00000013_pre_disaster.png,74,25,1,721,795,0,25,771,44.7447136945753,23.81724422234453
8639,/media/marda/TWOTB1/xBD/hurricanes/images/florence/hurricane-florence_00000013_pre_disaster.png,67,48,1,552,619,21,69,1422,46.48703153385954,40.19756906322327
8640,/media/marda/TWOTB1/xBD/hurricanes/images/florence/hurricane-florence_00000013_pre_disaster.png,5,17,1,0,5,24,41,49,17.279787250750907,4.210758276545564
8641,/media/marda/TWOTB1/xBD/hurricanes/images/florence/hurricane-florence_00000013_pre_disaster.png,69,60,1,392,461,40,100,1721,52.00556030732382,45.37352536337878
8642,/media/marda/TWOTB1/xBD/hurricanes/images/florence/hurricane-florence_00000013_pre_disaster.png,72,49,1,588,660,60,109,1219,54.73801629599267,30.064065104924595
8643,/media/marda/TWOTB1/xBD/hurricanes/images/florence/hurricane-florence_00000013_pre_disaster.png,7,19,1,0,7,75,94,82,16.92658396296955,7.033951814492281
8644,/media/marda/TWOTB1/xBD/hurricanes/images/florence/hurricane-florence_00000013_pre_disaster.png,67,55,1,345,412,78,133,1608,52.04096243655935,42.28009256131652
8645,/media/marda/TWOTB1/xBD/hurricanes/images/florence/hurricane-florence_00000013_pre_disaster.png,69,52,1,527,596,82,134,1307,44.33131151473635,39.52768763548238
8646,/media/marda/TWOTB1/xBD/hurricanes/images/florence/hurricane-florence_00000013_pre_disaster.png,66,57,1,490,556,101,158,1298,48.801301899446784,36.92991173455309
8647,/media/marda/TWOTB1/xBD/hurricanes/images/florence/hurricane-florence_00000013_pre_disaster.png,65,50,1,307,372,106,156,1438,45.211917003050786,41.922516050053424
8648,/media/marda/TWOTB1/xBD/hurricanes/images/florence/hurricane-florence_00000013_pre_disaster.png,49,53,1,0,49,116,169,1467,52.33277958663463,38.04884292712148
8649,/media/marda/TWOTB1/xBD/hurricanes/images/florence/hurricane-florence_00000013_pre_disaster.png,64,58,1,451,515,127,185,1304,48.91269478917799,37.196845681056146
8650,/media/marda/TWOTB1/xBD/hurricanes/images/florence/hurricane-florence_00000013_pre_disaster.png,57,57,1,272,329,129,186,1441,49.48674418093397,38.77697916816451
8651,/media/marda/TWOTB1/xBD/hurricanes/images/florence/hurricane-florence_00000013_pre_disaster.png,52,54,1,47,99,132,186,1528,54.41592248181194,38.437966467379056
8652,/media/marda/TWOTB1/xBD/hurricanes/images/florence/hurricane-florence_00000013_pre_disaster.png,48,55,1,93,141,148,203,1423,51.11374287563645,36.831700564635504
8653,/media/marda/TWOTB1/xBD/hurricanes/images/florence/hurricane-florence_00000013_pre_disaster.png,53,63,1,235,288,151,214,1329,55.26101557034371,33.825844296918056
8654,/media/marda/TWOTB1/xBD/hurricanes/images/florence/hurricane-florence_00000013_pre_disaster.png,98,91,1,380,478,152,243,3304,103.42070715454503,45.25593456196224
8655,/media/marda/TWOTB1/xBD/hurricanes/images/florence/hurricane-florence_00000013_pre_disaster.png,50,52,1,133,183,167,219,1373,43.69161749099447,41.66037748437155
8656,/media/marda/TWOTB1/xBD/hurricanes/images/florence/hurricane-florence_00000013_pre_disaster.png,54,53,1,185,239,178,231,1834,53.79020367361265,45.669448061363
8657,/media/marda/TWOTB1/xBD/hurricanes/images/florence/hurricane-florence_00000013_pre_disaster.png,59,61,1,338,397,205,266,1304,47.00323735723969,38.64792716755111
8658,/media/marda/TWOTB1/xBD/hurricanes/images/florence/hurricane-florence_00000013_pre_disaster.png,23,66,1,0,23,218,284,750,51.39131837330515,22.55701606222257
8659,/media/marda/TWOTB1/xBD/hurricanes/images/florence/hurricane-florence_00000013_pre_disaster.png,45,50,1,25,70,235,285,1267,47.879578331790796,36.14994403446546
8660,/media/marda/TWOTB1/xBD/hurricanes/images/florence/hurricane-florence_00000013_pre_disaster.png,61,59,1,304,365,241,300,1356,44.38004340882921,40.77730450149882
8661,/media/marda/TWOTB1/xBD/hurricanes/images/florence/hurricane-florence_00000013_pre_disaster.png,53,54,1,65,118,250,304,1466,51.8951249563585,38.645937680776825
8662,/media/marda/TWOTB1/xBD/hurricanes/images/florence/hurricane-florence_00000013_pre_disaster.png,54,52,1,108,162,264,316,1318,49.54771071571139,37.229464139267314
8663,/media/marda/TWOTB1/xBD/hurricanes/images/florence/hurricane-florence_00000013_pre_disaster.png,66,62,1,255,321,265,327,1774,52.5729895819833,46.27850600950227
8664,/media/marda/TWOTB1/xBD/hurricanes/images/florence/hurricane-florence_00000013_pre_disaster.png,51,59,1,153,204,277,336,1388,51.016181449187805,37.5102661801023
8665,/media/marda/TWOTB1/xBD/hurricanes/images/florence/hurricane-florence_00000013_pre_disaster.png,50,51,1,206,256,279,330,1245,44.41199601096092,37.97516406163738
8666,/media/marda/TWOTB1/xBD/hurricanes/images/florence/hurricane-florence_00000013_pre_disaster.png,35,57,1,0,35,310,367,1162,45.06276665682294,33.60055072384798
8667,/media/marda/TWOTB1/xBD/hurricanes/images/florence/hurricane-florence_00000013_pre_disaster.png,40,60,1,38,78,328,388,1238,47.688038556130955,35.00380967332012
8668,/media/marda/TWOTB1/xBD/hurricanes/images/florence/hurricane-florence_00000013_pre_disaster.png,43,61,1,77,120,336,397,1101,45.34445793241867,35.07014628369201
8669,/media/marda/TWOTB1/xBD/hurricanes/images/florence/hurricane-florence_00000013_pre_disaster.png,50,59,1,108,158,367,426,1137,49.777065679433456,32.28479619838384
8670,/media/marda/TWOTB1/xBD/hurricanes/images/florence/hurricane-florence_00000013_pre_disaster.png,21,53,1,0,21,412,465,566,36.88460115514317,20.310080378406504
8671,/media/marda/TWOTB1/xBD/hurricanes/images/florence/hurricane-florence_00000013_pre_disaster.png,51,47,1,134,185,426,473,1088,48.63525352707573,30.558231862397225
8672,/media/marda/TWOTB1/xBD/hurricanes/images/florence/hurricane-florence_00000013_pre_disaster.png,39,64,1,42,81,427,491,1262,49.79806242126446,35.31919387884736
8673,/media/marda/TWOTB1/xBD/hurricanes/images/florence/hurricane-florence_00000013_pre_disaster.png,50,59,1,123,173,466,525,1234,43.72557537364736,39.025965050288484
8674,/media/marda/TWOTB1/xBD/hurricanes/images/florence/hurricane-florence_00000013_pre_disaster.png,42,57,1,28,70,475,532,1122,43.08265645813625,35.2985137706683
8675,/media/marda/TWOTB1/xBD/hurricanes/images/florence/hurricane-florence_00000013_pre_disaster.png,58,63,1,107,165,513,576,1392,53.568381736697695,35.40113242746584
8676,/media/marda/TWOTB1/xBD/hurricanes/images/florence/hurricane-florence_00000013_pre_disaster.png,47,58,1,0,47,518,576,1171,47.94805302415342,32.946087324652694
8677,/media/marda/TWOTB1/xBD/hurricanes/images/florence/hurricane-florence_00000013_pre_disaster.png,44,60,1,97,141,554,614,1108,42.6474706389253,35.74359183588841
8678,/media/marda/TWOTB1/xBD/hurricanes/images/florence/hurricane-florence_00000013_pre_disaster.png,51,91,1,69,120,591,682,1610,57.09450323143646,39.65989424079501
8679,/media/marda/TWOTB1/xBD/hurricanes/images/florence/hurricane-florence_00000013_pre_disaster.png,15,79,1,0,15,593,672,464,50.83370463907724,13.325994864757646
8680,/media/marda/TWOTB1/xBD/hurricanes/images/florence/hurricane-florence_00000013_pre_disaster.png,36,72,1,25,61,605,677,1315,48.401897015921456,35.86615739188317
8681,/media/marda/TWOTB1/xBD/hurricanes/images/florence/hurricane-florence_00000447_pre_disaster.png,37,45,1,564,601,596,641,306,21.90131928177078,18.570582600529224
8682,/media/marda/TWOTB1/xBD/hurricanes/images/florence/hurricane-florence_00000447_pre_disaster.png,28,38,1,517,545,628,666,112,16.1245154965971,9.16515138991168
8683,/media/marda/TWOTB1/xBD/hurricanes/images/florence/hurricane-florence_00000447_pre_disaster.png,82,59,1,549,631,686,745,1345,67.11269818206549,28.590871584585827
8684,/media/marda/TWOTB1/xBD/hurricanes/images/florence/hurricane-florence_00000447_pre_disaster.png,42,79,1,371,413,951,1030,994,47.54912881030529,27.20871639274765
8685,/media/marda/TWOTB1/xBD/hurricanes/images/florence/hurricane-florence_00000447_pre_disaster.png,40,59,1,338,378,985,1044,454,29.694029647934805,20.19682725187845
8686,/media/marda/TWOTB1/xBD/hurricanes/images/florence/hurricane-florence_00000390_post_disaster.png,62,56,1,158,220,871,927,768,59.85425585652838,18.59685023995596
8687,/media/marda/TWOTB1/xBD/hurricanes/images/florence/hurricane-florence_00000390_post_disaster.png,21,61,1,113,134,790,851,463,32.80288588948991,18.6993801525004
8688,/media/marda/TWOTB1/xBD/hurricanes/images/florence/hurricane-florence_00000390_post_disaster.png,17,44,1,145,162,813,857,76,11.726500469245787,8.75182551829463
8689,/media/marda/TWOTB1/xBD/hurricanes/images/florence/hurricane-florence_00000390_post_disaster.png,26,43,1,167,193,819,862,163,23.181728439737803,9.714881858747814
8690,/media/marda/TWOTB1/xBD/hurricanes/images/florence/hurricane-florence_00000390_post_disaster.png,16,68,1,113,129,851,919,328,37.47950074138649,11.582110907083235
8691,/media/marda/TWOTB1/xBD/hurricanes/images/florence/hurricane-florence_00000390_post_disaster.png,23,50,1,263,286,915,965,106,13.264001554728637,10.851175052924324
8692,/media/marda/TWOTB1/xBD/hurricanes/images/florence/hurricane-florence_00000229_pre_disaster.png,60,19,1,601,661,0,19,562,37.712554947268465,19.759267238004135
8693,/media/marda/TWOTB1/xBD/hurricanes/images/florence/hurricane-florence_00000229_pre_disaster.png,29,45,1,99,128,408,453,505,26.66610574839674,24.970025834145165
8694,/media/marda/TWOTB1/xBD/hurricanes/images/florence/hurricane-florence_00000229_pre_disaster.png,45,47,1,14,59,409,456,832,45.562364760239966,26.41188773487493
8695,/media/marda/TWOTB1/xBD/hurricanes/images/florence/hurricane-florence_00000229_pre_disaster.png,29,30,1,394,423,523,553,66,11.297883274904404,8.219535995559673
8696,/media/marda/TWOTB1/xBD/hurricanes/images/florence/hurricane-florence_00000229_pre_disaster.png,60,75,1,218,278,619,694,1861,53.76409172017678,45.547651154960526
8697,/media/marda/TWOTB1/xBD/hurricanes/images/florence/hurricane-florence_00000229_pre_disaster.png,69,75,1,975,1044,653,728,932,46.73091992375686,28.23245632290692
8698,/media/marda/TWOTB1/xBD/hurricanes/images/florence/hurricane-florence_00000229_pre_disaster.png,22,38,1,266,288,678,716,148,15.10214931569516,12.985704417140443
8699,/media/marda/TWOTB1/xBD/hurricanes/images/florence/hurricane-florence_00000229_pre_disaster.png,112,81,1,871,983,700,781,2323,75.85075679874248,41.84917959213189
8700,/media/marda/TWOTB1/xBD/hurricanes/images/florence/hurricane-florence_00000229_pre_disaster.png,58,90,1,95,153,715,805,2404,59.41839648810436,52.57749388541702
8701,/media/marda/TWOTB1/xBD/hurricanes/images/florence/hurricane-florence_00000229_pre_disaster.png,56,48,1,961,1017,746,794,212,17.03541088696946,16.667176602895957
8702,/media/marda/TWOTB1/xBD/hurricanes/images/florence/hurricane-florence_00000229_pre_disaster.png,97,93,1,389,486,855,948,2665,82.25552907067531,48.40781631013359
8703,/media/marda/TWOTB1/xBD/hurricanes/images/florence/hurricane-florence_00000229_pre_disaster.png,75,85,1,641,716,887,972,1336,47.48920518137173,36.87903338270572
8704,/media/marda/TWOTB1/xBD/hurricanes/images/florence/hurricane-florence_00000229_pre_disaster.png,47,47,1,920,967,889,936,65,9.876146537156265,8.816080083469908
8705,/media/marda/TWOTB1/xBD/hurricanes/images/florence/hurricane-florence_00000229_pre_disaster.png,59,60,1,933,992,891,951,296,20.71506892835014,19.098105557231296
8706,/media/marda/TWOTB1/xBD/hurricanes/images/florence/hurricane-florence_00000229_pre_disaster.png,56,56,1,890,946,897,953,168,23.778837544514868,10.700519865613163
8707,/media/marda/TWOTB1/xBD/hurricanes/images/florence/hurricane-florence_00000229_pre_disaster.png,49,51,1,915,964,902,953,99,15.034113025043558,8.802874363829527
8708,/media/marda/TWOTB1/xBD/hurricanes/images/florence/hurricane-florence_00000229_pre_disaster.png,50,56,1,831,881,915,971,192,18.907915332747585,13.495138975353061
8709,/media/marda/TWOTB1/xBD/hurricanes/images/florence/hurricane-florence_00000229_pre_disaster.png,85,77,1,921,1006,929,1006,988,49.8208320871631,26.51002069436059
8710,/media/marda/TWOTB1/xBD/hurricanes/images/florence/hurricane-florence_00000229_pre_disaster.png,88,63,1,854,942,979,1042,855,52.444071714462254,23.17090176073261
8711,/media/marda/TWOTB1/xBD/hurricanes/images/florence/hurricane-florence_00000170_pre_disaster.png,40,14,1,601,641,72,86,119,13.865182905883758,11.3604826353438
8712,/media/marda/TWOTB1/xBD/hurricanes/images/florence/hurricane-florence_00000170_pre_disaster.png,100,43,1,603,703,123,166,1845,82.65321076437601,29.588916991540515
8713,/media/marda/TWOTB1/xBD/hurricanes/images/florence/hurricane-florence_00000170_pre_disaster.png,45,18,1,722,767,134,152,150,16.296238204546054,12.18847170907476
8714,/media/marda/TWOTB1/xBD/hurricanes/images/florence/hurricane-florence_00000170_pre_disaster.png,41,18,1,686,727,144,162,124,13.378591465300746,12.458663058356963
8715,/media/marda/TWOTB1/xBD/hurricanes/images/florence/hurricane-florence_00000170_pre_disaster.png,59,30,1,744,803,165,195,520,30.970162438271654,22.449336453136443
8716,/media/marda/TWOTB1/xBD/hurricanes/images/florence/hurricane-florence_00000170_pre_disaster.png,89,65,1,716,805,368,433,1927,60.31415041643165,43.0175130751713
8717,/media/marda/TWOTB1/xBD/hurricanes/images/florence/hurricane-florence_00000170_pre_disaster.png,101,66,1,657,758,477,543,2040,78.69309071166676,43.31435131455791
8718,/media/marda/TWOTB1/xBD/hurricanes/images/florence/hurricane-florence_00000170_pre_disaster.png,36,32,1,670,706,542,574,79,11.585674519696942,9.238355590780552
8719,/media/marda/TWOTB1/xBD/hurricanes/images/florence/hurricane-florence_00000170_pre_disaster.png,106,56,1,724,830,545,601,1449,74.77106914694865,27.584965890804458
8720,/media/marda/TWOTB1/xBD/hurricanes/images/florence/hurricane-florence_00000170_pre_disaster.png,37,42,1,609,646,690,732,136,13.937857034140224,13.149591127947668
8721,/media/marda/TWOTB1/xBD/hurricanes/images/florence/hurricane-florence_00000170_pre_disaster.png,39,47,1,712,751,895,942,73,10.928249181084364,8.804623223204693
8722,/media/marda/TWOTB1/xBD/hurricanes/images/florence/hurricane-florence_00000170_pre_disaster.png,40,52,1,716,756,905,957,92,16.98447330147785,7.310315324912255
8723,/media/marda/TWOTB1/xBD/hurricanes/images/florence/hurricane-florence_00000170_pre_disaster.png,71,76,1,607,678,928,1004,1096,47.10362463361392,31.822520062826623
8724,/media/marda/TWOTB1/xBD/hurricanes/images/florence/hurricane-florence_00000447_post_disaster.png,42,79,1,371,413,951,1030,994,47.54912881030529,27.20871639274765
8725,/media/marda/TWOTB1/xBD/hurricanes/images/florence/hurricane-florence_00000447_post_disaster.png,40,58,1,338,378,985,1043,426,29.46567759942009,19.113014246778434
8726,/media/marda/TWOTB1/xBD/hurricanes/images/florence/hurricane-florence_00000447_post_disaster.png,37,45,1,564,601,596,641,306,21.90131928177078,18.570582600529224
8727,/media/marda/TWOTB1/xBD/hurricanes/images/florence/hurricane-florence_00000447_post_disaster.png,28,38,1,517,545,628,666,112,16.1245154965971,9.16515138991168
8728,/media/marda/TWOTB1/xBD/hurricanes/images/florence/hurricane-florence_00000447_post_disaster.png,82,59,1,549,631,686,745,1345,67.11269818206549,28.590871584585827
8729,/media/marda/TWOTB1/xBD/hurricanes/images/florence/hurricane-florence_00000429_pre_disaster.png,32,26,1,414,446,471,497,140,17.937708775997002,10.306023193822229
8730,/media/marda/TWOTB1/xBD/hurricanes/images/florence/hurricane-florence_00000429_pre_disaster.png,22,55,1,106,128,565,620,500,38.41844437663983,17.421475358850387
8731,/media/marda/TWOTB1/xBD/hurricanes/images/florence/hurricane-florence_00000429_pre_disaster.png,17,34,1,100,117,608,642,94,13.62814087367327,9.34957560609314
8732,/media/marda/TWOTB1/xBD/hurricanes/images/florence/hurricane-florence_00000429_pre_disaster.png,17,63,1,3,20,819,882,296,33.648859174843416,11.80376913472875
8733,/media/marda/TWOTB1/xBD/hurricanes/images/florence/hurricane-florence_00000429_pre_disaster.png,17,67,1,0,17,851,918,419,35.91966029459801,16.02912721069403
8734,/media/marda/TWOTB1/xBD/hurricanes/images/florence/hurricane-florence_00000233_pre_disaster.png,37,72,1,182,219,753,825,856,45.54225341600404,25.023366157525842
8735,/media/marda/TWOTB1/xBD/hurricanes/images/florence/hurricane-florence_00000233_pre_disaster.png,18,49,1,176,194,812,861,141,16.343112647175435,11.57095179001576
8736,/media/marda/TWOTB1/xBD/hurricanes/images/florence/hurricane-florence_00000233_pre_disaster.png,33,55,1,194,227,816,871,393,26.27741541811462,20.1087130038511
8737,/media/marda/TWOTB1/xBD/hurricanes/images/florence/hurricane-florence_00000233_pre_disaster.png,29,47,1,314,343,851,898,163,15.705887872834834,13.79920065433091
8738,/media/marda/TWOTB1/xBD/hurricanes/images/florence/hurricane-florence_00000233_pre_disaster.png,40,55,1,347,387,866,921,353,25.265860850758628,18.52827888896789
8739,/media/marda/TWOTB1/xBD/hurricanes/images/florence/hurricane-florence_00000233_pre_disaster.png,21,45,1,371,392,956,1001,50,8.32344765176273,8.037923810808701
8740,/media/marda/TWOTB1/xBD/hurricanes/images/florence/hurricane-florence_00000233_pre_disaster.png,38,52,1,295,333,962,1014,163,31.217367782523116,7.016856198517402
8741,/media/marda/TWOTB1/xBD/hurricanes/images/florence/hurricane-florence_00000233_pre_disaster.png,51,56,1,291,342,988,1044,334,37.22525842111667,13.804865143846314
8742,/media/marda/TWOTB1/xBD/hurricanes/images/florence/hurricane-florence_00000200_post_disaster.png,47,30,1,469,516,175,205,392,24.292622238626844,21.313618100089876
8743,/media/marda/TWOTB1/xBD/hurricanes/images/florence/hurricane-florence_00000200_post_disaster.png,63,59,1,426,489,230,289,1181,49.28417307968176,31.68776080071416
8744,/media/marda/TWOTB1/xBD/hurricanes/images/florence/hurricane-florence_00000200_post_disaster.png,49,44,1,603,652,291,335,418,38.556491214092965,14.495180140880999
8745,/media/marda/TWOTB1/xBD/hurricanes/images/florence/hurricane-florence_00000200_post_disaster.png,61,58,1,555,616,363,421,924,45.47938740381054,27.128754103084606
8746,/media/marda/TWOTB1/xBD/hurricanes/images/florence/hurricane-florence_00000200_post_disaster.png,61,58,1,298,359,366,424,1016,53.43049173168972,25.70206943297514
8747,/media/marda/TWOTB1/xBD/hurricanes/images/florence/hurricane-florence_00000200_post_disaster.png,28,37,1,258,286,435,472,215,18.545646260225727,15.36177572807318
8748,/media/marda/TWOTB1/xBD/hurricanes/images/florence/hurricane-florence_00000200_post_disaster.png,24,30,1,286,310,442,472,95,13.523931473797543,9.43033990548726
8749,/media/marda/TWOTB1/xBD/hurricanes/images/florence/hurricane-florence_00000200_post_disaster.png,67,87,1,372,439,656,743,1592,63.932064342629005,34.95755034224982
8750,/media/marda/TWOTB1/xBD/hurricanes/images/florence/hurricane-florence_00000200_post_disaster.png,33,48,1,324,357,668,716,259,20.606851258855695,16.787044763898628
8751,/media/marda/TWOTB1/xBD/hurricanes/images/florence/hurricane-florence_00000200_post_disaster.png,30,45,1,317,347,688,733,164,15.762587340458781,13.772761758260977
8752,/media/marda/TWOTB1/xBD/hurricanes/images/florence/hurricane-florence_00000200_post_disaster.png,34,53,1,293,327,725,778,320,24.058558083330475,17.79583435669747
8753,/media/marda/TWOTB1/xBD/hurricanes/images/florence/hurricane-florence_00000200_post_disaster.png,60,79,1,572,632,736,815,979,48.13408959861522,28.44894885733786
8754,/media/marda/TWOTB1/xBD/hurricanes/images/florence/hurricane-florence_00000200_post_disaster.png,30,50,1,268,298,745,795,257,18.708483320529417,18.364451522156443
8755,/media/marda/TWOTB1/xBD/hurricanes/images/florence/hurricane-florence_00000200_post_disaster.png,62,101,1,118,180,748,849,1911,76.2034013579423,35.927291742527615
8756,/media/marda/TWOTB1/xBD/hurricanes/images/florence/hurricane-florence_00000200_post_disaster.png,67,67,1,614,681,768,835,952,37.67463902523831,33.530005274666486
8757,/media/marda/TWOTB1/xBD/hurricanes/images/florence/hurricane-florence_00000200_post_disaster.png,50,78,1,342,392,770,848,1021,49.656755857121595,27.29830315270338
8758,/media/marda/TWOTB1/xBD/hurricanes/images/florence/hurricane-florence_00000200_post_disaster.png,40,62,1,70,110,778,840,665,36.7676659632394,24.068798545683745
8759,/media/marda/TWOTB1/xBD/hurricanes/images/florence/hurricane-florence_00000200_post_disaster.png,42,51,1,660,702,793,844,181,17.022508111881802,14.295190377871023
8760,/media/marda/TWOTB1/xBD/hurricanes/images/florence/hurricane-florence_00000200_post_disaster.png,49,71,1,205,254,909,980,796,39.56260702373064,28.072515992007183
8761,/media/marda/TWOTB1/xBD/hurricanes/images/florence/hurricane-florence_00000200_post_disaster.png,44,75,1,256,300,950,1025,810,35.49524636251168,30.28786804960047
8762,/media/marda/TWOTB1/xBD/hurricanes/images/florence/hurricane-florence_00000210_post_disaster.png,81,36,1,772,853,0,36,1177,47.353063987220125,32.64705238233509
8763,/media/marda/TWOTB1/xBD/hurricanes/images/florence/hurricane-florence_00000210_post_disaster.png,29,23,1,352,381,127,150,181,16.418195067752173,14.787336824090996
8764,/media/marda/TWOTB1/xBD/hurricanes/images/florence/hurricane-florence_00000210_post_disaster.png,49,31,1,809,858,488,519,127,15.194929923763347,11.181705077704782
8765,/media/marda/TWOTB1/xBD/hurricanes/images/florence/hurricane-florence_00000428_post_disaster.png,19,12,1,41,60,0,12,147,17.628159134612872,11.39736619140201
8766,/media/marda/TWOTB1/xBD/hurricanes/images/florence/hurricane-florence_00000428_post_disaster.png,46,22,1,529,575,2,24,318,24.332390403710935,17.414515258740796
8767,/media/marda/TWOTB1/xBD/hurricanes/images/florence/hurricane-florence_00000428_post_disaster.png,67,42,1,195,262,11,53,1479,60.92872830784014,31.9253549812292
8768,/media/marda/TWOTB1/xBD/hurricanes/images/florence/hurricane-florence_00000428_post_disaster.png,65,51,1,813,878,14,65,679,56.602202479260846,16.02583372942904
8769,/media/marda/TWOTB1/xBD/hurricanes/images/florence/hurricane-florence_00000428_post_disaster.png,76,31,1,501,577,26,57,564,66.17526836280163,11.374340889204223
8770,/media/marda/TWOTB1/xBD/hurricanes/images/florence/hurricane-florence_00000428_post_disaster.png,54,24,1,782,836,28,52,332,22.632044067274528,19.83843624736161
8771,/media/marda/TWOTB1/xBD/hurricanes/images/florence/hurricane-florence_00000428_post_disaster.png,42,38,1,3,45,35,73,932,38.54256733959399,33.42603346510219
8772,/media/marda/TWOTB1/xBD/hurricanes/images/florence/hurricane-florence_00000428_post_disaster.png,26,17,1,197,223,68,85,179,21.52359165143867,11.257711293266201
8773,/media/marda/TWOTB1/xBD/hurricanes/images/florence/hurricane-florence_00000428_post_disaster.png,86,74,1,909,995,118,192,1532,78.06004648174819,36.45944947543096
8774,/media/marda/TWOTB1/xBD/hurricanes/images/florence/hurricane-florence_00000428_post_disaster.png,58,28,1,885,943,140,168,284,19.982564679370004,19.134501978528622
8775,/media/marda/TWOTB1/xBD/hurricanes/images/florence/hurricane-florence_00000428_post_disaster.png,83,53,1,960,1043,242,295,1126,54.35811577451919,27.486286193121874
8776,/media/marda/TWOTB1/xBD/hurricanes/images/florence/hurricane-florence_00000428_post_disaster.png,65,48,1,661,726,304,352,796,37.747916196209616,27.721552255767946
8777,/media/marda/TWOTB1/xBD/hurricanes/images/florence/hurricane-florence_00000428_post_disaster.png,55,38,1,637,692,342,380,479,30.919732283165214,20.390296139543658
8778,/media/marda/TWOTB1/xBD/hurricanes/images/florence/hurricane-florence_00000428_post_disaster.png,70,48,1,908,978,362,410,698,33.223934289504264,27.810655823533178
8779,/media/marda/TWOTB1/xBD/hurricanes/images/florence/hurricane-florence_00000428_post_disaster.png,110,72,1,721,831,366,438,1983,86.24268369005388,35.211767614149856
8780,/media/marda/TWOTB1/xBD/hurricanes/images/florence/hurricane-florence_00000428_post_disaster.png,69,51,1,952,1021,388,439,632,35.74143605397313,25.042613040880457
8781,/media/marda/TWOTB1/xBD/hurricanes/images/florence/hurricane-florence_00000428_post_disaster.png,77,49,1,966,1043,470,519,620,42.03126082870445,20.536010901403106
8782,/media/marda/TWOTB1/xBD/hurricanes/images/florence/hurricane-florence_00000428_post_disaster.png,37,33,1,617,654,601,634,105,15.080377237919537,9.281092874606541
8783,/media/marda/TWOTB1/xBD/hurricanes/images/florence/hurricane-florence_00000428_post_disaster.png,41,42,1,651,692,631,673,126,20.280343014742378,8.346260729019372
8784,/media/marda/TWOTB1/xBD/hurricanes/images/florence/hurricane-florence_00000428_post_disaster.png,39,42,1,584,623,632,674,143,17.96112210117265,10.702530709102014
8785,/media/marda/TWOTB1/xBD/hurricanes/images/florence/hurricane-florence_00000428_post_disaster.png,53,44,1,829,882,658,702,232,20.62853509154263,14.914284908002317
8786,/media/marda/TWOTB1/xBD/hurricanes/images/florence/hurricane-florence_00000428_post_disaster.png,66,89,1,349,415,694,783,972,77.6074423040146,16.634570122026286
8787,/media/marda/TWOTB1/xBD/hurricanes/images/florence/hurricane-florence_00000428_post_disaster.png,63,59,1,765,828,696,755,530,31.4269110724312,22.27630842188345
8788,/media/marda/TWOTB1/xBD/hurricanes/images/florence/hurricane-florence_00000428_post_disaster.png,63,80,1,308,371,715,795,1368,50.608225126279514,35.82821239694346
8789,/media/marda/TWOTB1/xBD/hurricanes/images/florence/hurricane-florence_00000428_post_disaster.png,237,81,1,0,237,729,810,6812,266.1407644938047,34.231454220808146
8790,/media/marda/TWOTB1/xBD/hurricanes/images/florence/hurricane-florence_00000428_post_disaster.png,35,48,1,395,430,751,799,202,17.009898575334503,15.958727887451511
8791,/media/marda/TWOTB1/xBD/hurricanes/images/florence/hurricane-florence_00000428_post_disaster.png,65,86,1,281,346,757,843,1321,65.89919739415905,26.747989694644787
8792,/media/marda/TWOTB1/xBD/hurricanes/images/florence/hurricane-florence_00000428_post_disaster.png,15,37,1,47,62,777,814,82,15.23789440103046,7.586379481680197
8793,/media/marda/TWOTB1/xBD/hurricanes/images/florence/hurricane-florence_00000428_post_disaster.png,201,82,1,0,201,797,879,6047,228.2001376270373,35.38210405281207
8794,/media/marda/TWOTB1/xBD/hurricanes/images/florence/hurricane-florence_00000428_post_disaster.png,15,41,1,9,24,805,846,95,16.476213588548955,7.916285200779631
8795,/media/marda/TWOTB1/xBD/hurricanes/images/florence/hurricane-florence_00000428_post_disaster.png,79,75,1,916,995,828,903,995,40.859084777026474,33.868172752295905
8796,/media/marda/TWOTB1/xBD/hurricanes/images/florence/hurricane-florence_00000428_post_disaster.png,54,79,1,309,363,830,909,940,46.278657417772074,28.638395257233437
8797,/media/marda/TWOTB1/xBD/hurricanes/images/florence/hurricane-florence_00000428_post_disaster.png,34,56,1,223,257,856,912,296,26.89953344013017,14.469313966089228
8798,/media/marda/TWOTB1/xBD/hurricanes/images/florence/hurricane-florence_00000428_post_disaster.png,66,62,1,957,1023,865,927,472,27.27695299946349,22.839024142986666
8799,/media/marda/TWOTB1/xBD/hurricanes/images/florence/hurricane-florence_00000428_post_disaster.png,73,70,1,970,1043,876,946,795,38.87408644718151,27.306349757897166
8800,/media/marda/TWOTB1/xBD/hurricanes/images/florence/hurricane-florence_00000428_post_disaster.png,79,93,1,344,423,882,975,1678,67.19685488147269,33.40611522177796
8801,/media/marda/TWOTB1/xBD/hurricanes/images/florence/hurricane-florence_00000428_post_disaster.png,83,84,1,759,842,915,999,1172,57.33038176942223,27.163738846735566
8802,/media/marda/TWOTB1/xBD/hurricanes/images/florence/hurricane-florence_00000428_post_disaster.png,47,72,1,311,358,959,1031,652,30.852563652339544,28.3046057390681
8803,/media/marda/TWOTB1/xBD/hurricanes/images/florence/hurricane-florence_00000077_pre_disaster.png,80,47,1,418,498,0,47,1836,55.04267373425225,47.62866587947134
8804,/media/marda/TWOTB1/xBD/hurricanes/images/florence/hurricane-florence_00000077_pre_disaster.png,30,34,1,26,56,2,36,585,30.28465940036271,25.65589514022037
8805,/media/marda/TWOTB1/xBD/hurricanes/images/florence/hurricane-florence_00000077_pre_disaster.png,92,64,1,532,624,19,83,2593,61.81457889160724,55.700720713163385
8806,/media/marda/TWOTB1/xBD/hurricanes/images/florence/hurricane-florence_00000077_pre_disaster.png,35,28,1,262,297,27,55,449,25.886420915404194,23.165089108828887
8807,/media/marda/TWOTB1/xBD/hurricanes/images/florence/hurricane-florence_00000077_pre_disaster.png,28,20,1,222,250,29,49,228,17.854279138008803,17.105318072653596
8808,/media/marda/TWOTB1/xBD/hurricanes/images/florence/hurricane-florence_00000077_pre_disaster.png,77,69,1,589,666,47,116,1890,69.06745600745896,43.06473671709239
8809,/media/marda/TWOTB1/xBD/hurricanes/images/florence/hurricane-florence_00000077_pre_disaster.png,67,33,1,395,462,50,83,793,53.26848862424747,22.30958722128174
8810,/media/marda/TWOTB1/xBD/hurricanes/images/florence/hurricane-florence_00000077_pre_disaster.png,102,80,1,638,740,54,134,3127,79.12649370060373,57.28832812205066
8811,/media/marda/TWOTB1/xBD/hurricanes/images/florence/hurricane-florence_00000077_pre_disaster.png,65,35,1,142,207,66,101,1331,59.217600737615584,30.68521620419435
8812,/media/marda/TWOTB1/xBD/hurricanes/images/florence/hurricane-florence_00000077_pre_disaster.png,101,87,1,456,557,75,162,4105,85.8453444258806,65.64849577215081
8813,/media/marda/TWOTB1/xBD/hurricanes/images/florence/hurricane-florence_00000077_pre_disaster.png,107,148,1,498,605,98,246,3263,172.95210375170538,26.10734645746731
8814,/media/marda/TWOTB1/xBD/hurricanes/images/florence/hurricane-florence_00000077_pre_disaster.png,38,25,1,392,430,100,125,266,22.35410282858421,15.956499497156877
8815,/media/marda/TWOTB1/xBD/hurricanes/images/florence/hurricane-florence_00000077_pre_disaster.png,61,52,1,577,638,116,168,863,51.937112506719416,22.181926480463563
8816,/media/marda/TWOTB1/xBD/hurricanes/images/florence/hurricane-florence_00000077_pre_disaster.png,84,70,1,825,909,125,195,1682,68.9655926232586,32.54104364394037
8817,/media/marda/TWOTB1/xBD/hurricanes/images/florence/hurricane-florence_00000077_pre_disaster.png,83,55,1,337,420,144,199,2005,70.314571678944,38.047010126219426
8818,/media/marda/TWOTB1/xBD/hurricanes/images/florence/hurricane-florence_00000077_pre_disaster.png,42,36,1,303,345,150,186,595,29.396346352716648,26.89095268015821
8819,/media/marda/TWOTB1/xBD/hurricanes/images/florence/hurricane-florence_00000077_pre_disaster.png,69,49,1,945,1014,185,234,686,48.58767404441778,18.717390837330804
8820,/media/marda/TWOTB1/xBD/hurricanes/images/florence/hurricane-florence_00000077_pre_disaster.png,62,51,1,408,470,200,251,1083,42.355359789801035,34.12203979175294
8821,/media/marda/TWOTB1/xBD/hurricanes/images/florence/hurricane-florence_00000077_pre_disaster.png,72,41,1,853,925,229,270,877,35.90383461334086,31.946276846379067
8822,/media/marda/TWOTB1/xBD/hurricanes/images/florence/hurricane-florence_00000077_pre_disaster.png,54,34,1,559,613,233,267,456,32.228155870377165,18.90545277514586
8823,/media/marda/TWOTB1/xBD/hurricanes/images/florence/hurricane-florence_00000077_pre_disaster.png,67,55,1,977,1044,238,293,865,43.878694855389554,27.24513312542011
8824,/media/marda/TWOTB1/xBD/hurricanes/images/florence/hurricane-florence_00000077_pre_disaster.png,68,58,1,608,676,254,312,1172,47.31296866085143,33.05643230716866
8825,/media/marda/TWOTB1/xBD/hurricanes/images/florence/hurricane-florence_00000077_pre_disaster.png,80,46,1,918,998,265,311,925,45.50991201183838,27.030495169045405
8826,/media/marda/TWOTB1/xBD/hurricanes/images/florence/hurricane-florence_00000077_pre_disaster.png,105,61,1,839,944,303,364,2084,77.010387217441,35.842538012116904
8827,/media/marda/TWOTB1/xBD/hurricanes/images/florence/hurricane-florence_00000077_pre_disaster.png,70,55,1,974,1044,447,502,822,37.0171618549837,29.396391024940975
8828,/media/marda/TWOTB1/xBD/hurricanes/images/florence/hurricane-florence_00000077_pre_disaster.png,72,54,1,795,867,481,535,881,38.860882822729124,30.39201098631767
8829,/media/marda/TWOTB1/xBD/hurricanes/images/florence/hurricane-florence_00000077_pre_disaster.png,89,77,1,942,1031,555,632,1652,53.24840775206878,41.38209124998291
8830,/media/marda/TWOTB1/xBD/hurricanes/images/florence/hurricane-florence_00000077_pre_disaster.png,54,45,1,983,1037,630,675,173,21.490741168973038,10.801550238643605
8831,/media/marda/TWOTB1/xBD/hurricanes/images/florence/hurricane-florence_00000077_pre_disaster.png,80,69,1,753,833,641,710,1206,51.97540262709329,34.63536959326771
8832,/media/marda/TWOTB1/xBD/hurricanes/images/florence/hurricane-florence_00000077_pre_disaster.png,54,52,1,830,884,667,719,358,28.47652646033619,16.8261986291273
8833,/media/marda/TWOTB1/xBD/hurricanes/images/florence/hurricane-florence_00000167_pre_disaster.png,50,40,1,500,550,566,606,360,29.96862490014229,15.709301030870916
8834,/media/marda/TWOTB1/xBD/hurricanes/images/florence/hurricane-florence_00000167_pre_disaster.png,50,59,1,479,529,593,652,606,37.03604337025236,21.89579576544291
8835,/media/marda/TWOTB1/xBD/hurricanes/images/florence/hurricane-florence_00000167_pre_disaster.png,59,73,1,437,496,637,710,991,50.84597848813588,26.1115433945049
8836,/media/marda/TWOTB1/xBD/hurricanes/images/florence/hurricane-florence_00000167_pre_disaster.png,52,67,1,495,547,833,900,655,33.599208277428254,26.021489842504355
8837,/media/marda/TWOTB1/xBD/hurricanes/images/florence/hurricane-florence_00000325_pre_disaster.png,33,17,1,491,524,0,17,136,18.558006773748826,9.842797437827414
8838,/media/marda/TWOTB1/xBD/hurricanes/images/florence/hurricane-florence_00000325_pre_disaster.png,48,25,1,516,564,0,25,407,25.828706683296033,20.884364371511523
8839,/media/marda/TWOTB1/xBD/hurricanes/images/florence/hurricane-florence_00000325_pre_disaster.png,64,35,1,583,647,0,35,810,40.06708889212892,26.916461199771515
8840,/media/marda/TWOTB1/xBD/hurricanes/images/florence/hurricane-florence_00000325_pre_disaster.png,41,9,1,661,702,0,9,88,14.778333646721599,8.390004585232708
8841,/media/marda/TWOTB1/xBD/hurricanes/images/florence/hurricane-florence_00000325_pre_disaster.png,52,41,1,454,506,59,100,449,46.06327821796306,16.40043556494318
8842,/media/marda/TWOTB1/xBD/hurricanes/images/florence/hurricane-florence_00000325_pre_disaster.png,64,48,1,404,468,77,125,1374,43.214089124188256,41.88242223594565
8843,/media/marda/TWOTB1/xBD/hurricanes/images/florence/hurricane-florence_00000325_pre_disaster.png,45,24,1,559,604,97,121,300,22.236140509766795,18.040160436183527
8844,/media/marda/TWOTB1/xBD/hurricanes/images/florence/hurricane-florence_00000325_pre_disaster.png,32,10,1,582,614,97,107,50,8.916820244024562,7.627576072105328
8845,/media/marda/TWOTB1/xBD/hurricanes/images/florence/hurricane-florence_00000325_pre_disaster.png,63,45,1,585,648,106,151,682,50.310400618861074,18.14975582312128
8846,/media/marda/TWOTB1/xBD/hurricanes/images/florence/hurricane-florence_00000325_pre_disaster.png,48,32,1,533,581,117,149,317,31.797504947977977,15.994668037521139
8847,/media/marda/TWOTB1/xBD/hurricanes/images/florence/hurricane-florence_00000325_pre_disaster.png,51,68,1,111,162,133,201,1152,68.63640853691375,36.15868288956603
8848,/media/marda/TWOTB1/xBD/hurricanes/images/florence/hurricane-florence_00000325_pre_disaster.png,36,20,1,519,555,141,161,135,14.57834618718229,12.494331146038174
8849,/media/marda/TWOTB1/xBD/hurricanes/images/florence/hurricane-florence_00000325_pre_disaster.png,64,49,1,486,550,148,197,1207,42.06791333698649,37.4707048851536
8850,/media/marda/TWOTB1/xBD/hurricanes/images/florence/hurricane-florence_00000325_pre_disaster.png,54,33,1,563,617,151,184,418,33.379761395680106,16.86130361418412
8851,/media/marda/TWOTB1/xBD/hurricanes/images/florence/hurricane-florence_00000325_pre_disaster.png,52,35,1,634,686,155,190,499,28.968817672892182,22.40310434281474
8852,/media/marda/TWOTB1/xBD/hurricanes/images/florence/hurricane-florence_00000325_pre_disaster.png,21,20,1,104,125,157,177,137,14.067118420371223,13.043545576517978
8853,/media/marda/TWOTB1/xBD/hurricanes/images/florence/hurricane-florence_00000325_pre_disaster.png,57,33,1,732,789,178,211,407,28.165867920416193,19.3108831028341
8854,/media/marda/TWOTB1/xBD/hurricanes/images/florence/hurricane-florence_00000325_pre_disaster.png,52,47,1,232,284,184,231,898,39.37537872979023,30.802197121722926
8855,/media/marda/TWOTB1/xBD/hurricanes/images/florence/hurricane-florence_00000325_pre_disaster.png,48,57,1,189,237,219,276,1135,41.800679875510774,35.76947392725605
8856,/media/marda/TWOTB1/xBD/hurricanes/images/florence/hurricane-florence_00000325_pre_disaster.png,83,60,1,615,698,226,286,1624,52.97839773934957,42.420730073214386
8857,/media/marda/TWOTB1/xBD/hurricanes/images/florence/hurricane-florence_00000325_pre_disaster.png,83,48,1,678,761,231,279,1014,60.70539689497944,26.568782129352666
8858,/media/marda/TWOTB1/xBD/hurricanes/images/florence/hurricane-florence_00000325_pre_disaster.png,33,32,1,219,252,251,283,297,22.68217739507382,17.514917970163456
8859,/media/marda/TWOTB1/xBD/hurricanes/images/florence/hurricane-florence_00000325_pre_disaster.png,50,23,1,961,1011,269,292,110,12.943198719564473,11.37537809220315
8860,/media/marda/TWOTB1/xBD/hurricanes/images/florence/hurricane-florence_00000325_pre_disaster.png,93,65,1,870,963,322,387,1524,62.88000655724633,31.819321256127203
8861,/media/marda/TWOTB1/xBD/hurricanes/images/florence/hurricane-florence_00000325_pre_disaster.png,70,46,1,929,999,341,387,590,28.30311650187316,27.84931675533571
8862,/media/marda/TWOTB1/xBD/hurricanes/images/florence/hurricane-florence_00000325_pre_disaster.png,32,44,1,129,161,508,552,385,25.477820451613805,20.221261924000526
8863,/media/marda/TWOTB1/xBD/hurricanes/images/florence/hurricane-florence_00000325_pre_disaster.png,19,36,1,169,188,616,652,157,16.546689567283703,12.503426329886166
8864,/media/marda/TWOTB1/xBD/hurricanes/images/florence/hurricane-florence_00000325_pre_disaster.png,87,84,1,866,953,692,776,1397,55.22505941893659,34.10504377445734
8865,/media/marda/TWOTB1/xBD/hurricanes/images/florence/hurricane-florence_00000325_pre_disaster.png,94,122,1,688,782,779,901,3635,94.87934823399173,50.78675511186662
8866,/media/marda/TWOTB1/xBD/hurricanes/images/florence/hurricane-florence_00000325_pre_disaster.png,67,64,1,828,895,783,847,751,31.918981858136856,31.25481855337944
8867,/media/marda/TWOTB1/xBD/hurricanes/images/florence/hurricane-florence_00000325_pre_disaster.png,78,78,1,939,1017,793,871,1004,50.13479174438946,26.518474137981542
8868,/media/marda/TWOTB1/xBD/hurricanes/images/florence/hurricane-florence_00000325_pre_disaster.png,47,51,1,624,671,875,926,263,23.059755397674444,15.122181072150777
8869,/media/marda/TWOTB1/xBD/hurricanes/images/florence/hurricane-florence_00000325_pre_disaster.png,193,132,1,540,733,895,1027,5760,196.1066677652002,39.06531111249033
8870,/media/marda/TWOTB1/xBD/hurricanes/images/florence/hurricane-florence_00000325_pre_disaster.png,63,70,1,981,1044,922,992,501,36.27879376785847,18.065764687228974
8871,/media/marda/TWOTB1/xBD/hurricanes/images/florence/hurricane-florence_00000031_post_disaster.png,54,44,1,407,461,0,44,1296,47.40870369008179,36.40278331357407
8872,/media/marda/TWOTB1/xBD/hurricanes/images/florence/hurricane-florence_00000031_post_disaster.png,62,65,1,555,617,145,210,1925,65.52570964307569,39.91486484480519
8873,/media/marda/TWOTB1/xBD/hurricanes/images/florence/hurricane-florence_00000031_post_disaster.png,31,32,1,371,402,337,369,261,19.454362513901962,17.890282573429165
8874,/media/marda/TWOTB1/xBD/hurricanes/images/florence/hurricane-florence_00000031_post_disaster.png,45,59,1,251,296,359,418,1158,47.55067216854152,32.8160759385976
8875,/media/marda/TWOTB1/xBD/hurricanes/images/florence/hurricane-florence_00000031_post_disaster.png,27,25,1,330,357,366,391,109,12.571131342685746,11.4349687057993
8876,/media/marda/TWOTB1/xBD/hurricanes/images/florence/hurricane-florence_00000031_post_disaster.png,47,36,1,332,379,397,433,395,38.8105390430015,13.533462308418237
8877,/media/marda/TWOTB1/xBD/hurricanes/images/florence/hurricane-florence_00000031_post_disaster.png,23,39,1,122,145,570,609,246,19.709861993292165,16.702856516827985
8878,/media/marda/TWOTB1/xBD/hurricanes/images/florence/hurricane-florence_00000031_post_disaster.png,39,39,1,66,105,571,610,415,40.97158378144253,13.480936590994466
8879,/media/marda/TWOTB1/xBD/hurricanes/images/florence/hurricane-florence_00000031_post_disaster.png,48,51,1,9,57,580,631,995,53.18850785686782,24.51264053354367
8880,/media/marda/TWOTB1/xBD/hurricanes/images/florence/hurricane-florence_00000031_post_disaster.png,34,57,1,0,34,932,989,523,38.113557204692654,18.261967247314967
8881,/media/marda/TWOTB1/xBD/hurricanes/images/florence/hurricane-florence_00000176_post_disaster.png,61,29,1,645,706,15,44,773,38.96807518668243,25.987417267836815
8882,/media/marda/TWOTB1/xBD/hurricanes/images/florence/hurricane-florence_00000176_post_disaster.png,56,32,1,780,836,31,63,518,34.46292741119022,20.491518901656345
8883,/media/marda/TWOTB1/xBD/hurricanes/images/florence/hurricane-florence_00000176_post_disaster.png,43,32,1,547,590,57,89,601,34.40040260869919,23.19678929953419
8884,/media/marda/TWOTB1/xBD/hurricanes/images/florence/hurricane-florence_00000176_post_disaster.png,54,15,1,838,892,109,124,196,25.10317394031513,10.45683717135934
8885,/media/marda/TWOTB1/xBD/hurricanes/images/florence/hurricane-florence_00000176_post_disaster.png,68,29,1,769,837,133,162,726,40.860530675788276,23.328375756390482
8886,/media/marda/TWOTB1/xBD/hurricanes/images/florence/hurricane-florence_00000176_post_disaster.png,61,24,1,582,643,141,165,626,42.93066147479184,19.28404869159349
8887,/media/marda/TWOTB1/xBD/hurricanes/images/florence/hurricane-florence_00000176_post_disaster.png,45,50,1,381,426,146,196,1208,50.53035518661537,31.716538910042274
8888,/media/marda/TWOTB1/xBD/hurricanes/images/florence/hurricane-florence_00000176_post_disaster.png,51,22,1,799,850,156,178,206,17.398923453025706,15.892716367869228
8889,/media/marda/TWOTB1/xBD/hurricanes/images/florence/hurricane-florence_00000176_post_disaster.png,72,23,1,596,668,202,225,578,55.62737076569181,13.88947158837281
8890,/media/marda/TWOTB1/xBD/hurricanes/images/florence/hurricane-florence_00000176_post_disaster.png,45,49,1,393,438,227,276,783,42.68659120834122,24.445832503191262
8891,/media/marda/TWOTB1/xBD/hurricanes/images/florence/hurricane-florence_00000176_post_disaster.png,39,51,1,452,491,291,342,725,45.71817271239724,21.087424452652176
8892,/media/marda/TWOTB1/xBD/hurricanes/images/florence/hurricane-florence_00000403_post_disaster.png,30,25,1,58,88,0,25,536,28.68859776559805,24.947063599017543
8893,/media/marda/TWOTB1/xBD/hurricanes/images/florence/hurricane-florence_00000403_post_disaster.png,35,19,1,350,385,0,19,347,23.76616156335933,19.267201201131456
8894,/media/marda/TWOTB1/xBD/hurricanes/images/florence/hurricane-florence_00000403_post_disaster.png,69,33,1,364,433,26,59,964,61.630342662673456,22.22827883322435
8895,/media/marda/TWOTB1/xBD/hurricanes/images/florence/hurricane-florence_00000012_pre_disaster.png,52,74,1,0,52,10,84,1573,86.76835059278123,30.891522580468685
8896,/media/marda/TWOTB1/xBD/hurricanes/images/florence/hurricane-florence_00000012_pre_disaster.png,24,28,1,40,64,44,72,483,28.49509099492331,22.669148571863772
8897,/media/marda/TWOTB1/xBD/hurricanes/images/florence/hurricane-florence_00000012_pre_disaster.png,51,42,1,186,237,55,97,785,52.0006577919591,20.362838111659357
8898,/media/marda/TWOTB1/xBD/hurricanes/images/florence/hurricane-florence_00000012_pre_disaster.png,63,36,1,633,696,75,111,762,33.128523037411234,30.27542957223373
8899,/media/marda/TWOTB1/xBD/hurricanes/images/florence/hurricane-florence_00000012_pre_disaster.png,56,39,1,641,697,106,145,550,38.927329404523334,18.5848285404524
8900,/media/marda/TWOTB1/xBD/hurricanes/images/florence/hurricane-florence_00000012_pre_disaster.png,7,74,1,0,7,121,195,348,75.55616095767925,6.968138532053996
8901,/media/marda/TWOTB1/xBD/hurricanes/images/florence/hurricane-florence_00000012_pre_disaster.png,47,23,1,676,723,134,157,153,24.20728667584559,8.495083362957752
8902,/media/marda/TWOTB1/xBD/hurricanes/images/florence/hurricane-florence_00000012_pre_disaster.png,81,45,1,882,963,182,227,1173,44.632844155426554,35.06327878668219
8903,/media/marda/TWOTB1/xBD/hurricanes/images/florence/hurricane-florence_00000012_pre_disaster.png,57,64,1,20,77,313,377,1476,49.83082718492075,41.45116873874593
8904,/media/marda/TWOTB1/xBD/hurricanes/images/florence/hurricane-florence_00000012_pre_disaster.png,52,42,1,551,603,406,448,467,31.940584168183236,19.538875021802106
8905,/media/marda/TWOTB1/xBD/hurricanes/images/florence/hurricane-florence_00000012_pre_disaster.png,83,110,1,364,447,414,524,3322,96.0451504277606,47.05945882951384
8906,/media/marda/TWOTB1/xBD/hurricanes/images/florence/hurricane-florence_00000012_pre_disaster.png,87,95,1,516,603,456,551,3083,80.75896275839003,50.70574075654377
8907,/media/marda/TWOTB1/xBD/hurricanes/images/florence/hurricane-florence_00000012_pre_disaster.png,28,42,1,3,31,472,514,413,26.079859547738007,20.957454048757644
8908,/media/marda/TWOTB1/xBD/hurricanes/images/florence/hurricane-florence_00000012_pre_disaster.png,21,62,1,0,21,495,557,553,38.096619040022986,20.79113617962677
8909,/media/marda/TWOTB1/xBD/hurricanes/images/florence/hurricane-florence_00000012_pre_disaster.png,63,54,1,717,780,505,559,728,33.69546749874602,28.84068071030867
8910,/media/marda/TWOTB1/xBD/hurricanes/images/florence/hurricane-florence_00000012_pre_disaster.png,101,84,1,483,584,567,651,3140,81.48714611329395,51.15510411998074
8911,/media/marda/TWOTB1/xBD/hurricanes/images/florence/hurricane-florence_00000012_pre_disaster.png,197,219,1,361,558,700,919,21516,183.1416181165592,156.44696506948216
8912,/media/marda/TWOTB1/xBD/hurricanes/images/florence/hurricane-florence_00000012_pre_disaster.png,268,237,1,509,777,747,984,31761,250.05410167448687,169.83408302658984
8913,/media/marda/TWOTB1/xBD/hurricanes/images/florence/hurricane-florence_00000012_pre_disaster.png,75,70,1,896,971,871,941,846,33.93685808586193,32.79006044980433
8914,/media/marda/TWOTB1/xBD/hurricanes/images/florence/hurricane-florence_00000012_pre_disaster.png,7,59,1,0,7,886,945,93,21.248784471007617,6.478249064251303
8915,/media/marda/TWOTB1/xBD/hurricanes/images/florence/hurricane-florence_00000012_pre_disaster.png,15,48,1,128,143,886,934,86,11.320872939048385,10.060072635186788
8916,/media/marda/TWOTB1/xBD/hurricanes/images/florence/hurricane-florence_00000012_pre_disaster.png,33,74,1,134,167,901,975,737,39.9267299336865,24.483853201595895
8917,/media/marda/TWOTB1/xBD/hurricanes/images/florence/hurricane-florence_00000012_pre_disaster.png,56,57,1,941,997,912,969,169,23.418767877397222,10.213961516210635
8918,/media/marda/TWOTB1/xBD/hurricanes/images/florence/hurricane-florence_00000012_pre_disaster.png,41,74,1,87,128,917,991,686,39.937512707169,22.93215995274263
8919,/media/marda/TWOTB1/xBD/hurricanes/images/florence/hurricane-florence_00000012_pre_disaster.png,51,76,1,159,210,919,995,939,45.83672155479272,27.155811900370555
8920,/media/marda/TWOTB1/xBD/hurricanes/images/florence/hurricane-florence_00000012_pre_disaster.png,45,76,1,185,230,942,1018,925,41.16133408103818,30.522681971382198
8921,/media/marda/TWOTB1/xBD/hurricanes/images/florence/hurricane-florence_00000012_pre_disaster.png,44,83,1,219,263,945,1028,854,50.67934328159821,22.382753219096042
8922,/media/marda/TWOTB1/xBD/hurricanes/images/florence/hurricane-florence_00000012_pre_disaster.png,43,70,1,67,110,946,1016,707,41.92806138632811,22.41129575446325
8923,/media/marda/TWOTB1/xBD/hurricanes/images/florence/hurricane-florence_00000012_pre_disaster.png,50,80,1,243,293,960,1040,1035,48.70011081748489,28.064239616917295
8924,/media/marda/TWOTB1/xBD/hurricanes/images/florence/hurricane-florence_00000012_pre_disaster.png,43,65,1,52,95,977,1042,810,41.06830623369401,25.89822946745229
8925,/media/marda/TWOTB1/xBD/hurricanes/images/florence/hurricane-florence_00000012_pre_disaster.png,52,64,1,274,326,978,1042,816,40.352517437785274,27.056428471460087
8926,/media/marda/TWOTB1/xBD/hurricanes/images/florence/hurricane-florence_00000012_pre_disaster.png,42,62,1,310,352,982,1044,420,27.190467582317215,21.28027449616853
8927,/media/marda/TWOTB1/xBD/hurricanes/images/florence/hurricane-florence_00000012_pre_disaster.png,70,57,1,872,942,987,1044,321,31.535816988617352,15.614109499216324
8928,/media/marda/TWOTB1/xBD/hurricanes/images/florence/hurricane-florence_00000012_pre_disaster.png,26,52,1,34,60,992,1044,160,21.92939567736588,11.199122966800868
8929,/media/marda/TWOTB1/xBD/hurricanes/images/florence/hurricane-florence_00000534_pre_disaster.png,140,28,1,826,966,0,28,1825,111.649680125767,23.612252966061764
8930,/media/marda/TWOTB1/xBD/hurricanes/images/florence/hurricane-florence_00000534_pre_disaster.png,47,28,1,733,780,48,76,446,30.107985885095683,19.658692787940314
8931,/media/marda/TWOTB1/xBD/hurricanes/images/florence/hurricane-florence_00000534_pre_disaster.png,35,27,1,454,489,154,181,293,22.868009481068988,17.138132418961337
8932,/media/marda/TWOTB1/xBD/hurricanes/images/florence/hurricane-florence_00000534_pre_disaster.png,48,34,1,414,462,160,194,658,31.982234208101097,27.46946205359863
8933,/media/marda/TWOTB1/xBD/hurricanes/images/florence/hurricane-florence_00000534_pre_disaster.png,37,35,1,203,240,280,315,342,31.9164995696346,14.286669193656097
8934,/media/marda/TWOTB1/xBD/hurricanes/images/florence/hurricane-florence_00000534_pre_disaster.png,59,59,1,162,221,282,341,1087,63.94982375064683,22.282584009284623
8935,/media/marda/TWOTB1/xBD/hurricanes/images/florence/hurricane-florence_00000534_pre_disaster.png,37,33,1,408,445,387,420,225,17.530132063735508,17.1848141604507
8936,/media/marda/TWOTB1/xBD/hurricanes/images/florence/hurricane-florence_00000534_pre_disaster.png,45,42,1,424,469,398,440,368,26.43344884269695,18.597835073633725
8937,/media/marda/TWOTB1/xBD/hurricanes/images/florence/hurricane-florence_00000534_pre_disaster.png,28,28,1,449,477,420,448,89,11.488591779589067,10.114438630971998
8938,/media/marda/TWOTB1/xBD/hurricanes/images/florence/hurricane-florence_00000534_pre_disaster.png,65,65,1,321,386,430,495,1321,58.493238725809725,33.257609088146054
8939,/media/marda/TWOTB1/xBD/hurricanes/images/florence/hurricane-florence_00000534_pre_disaster.png,128,71,1,653,781,552,623,3006,111.54421975855246,35.95453039602231
8940,/media/marda/TWOTB1/xBD/hurricanes/images/florence/hurricane-florence_00000534_pre_disaster.png,53,62,1,234,287,558,620,1011,43.54650324272034,31.38875589815213
8941,/media/marda/TWOTB1/xBD/hurricanes/images/florence/hurricane-florence_00000534_pre_disaster.png,33,35,1,486,519,586,621,166,15.746988533652583,14.199922890547624
8942,/media/marda/TWOTB1/xBD/hurricanes/images/florence/hurricane-florence_00000534_pre_disaster.png,41,57,1,253,294,601,658,545,27.35927408443544,26.579255438445333
8943,/media/marda/TWOTB1/xBD/hurricanes/images/florence/hurricane-florence_00000534_pre_disaster.png,232,96,1,562,794,609,705,6312,238.9458137854212,35.18011617196028
8944,/media/marda/TWOTB1/xBD/hurricanes/images/florence/hurricane-florence_00000534_pre_disaster.png,61,77,1,411,472,799,876,962,49.90507797607824,25.435607911218657
8945,/media/marda/TWOTB1/xBD/hurricanes/images/florence/hurricane-florence_00000534_pre_disaster.png,32,51,1,381,413,831,882,187,19.161922648694134,12.840475050896275
8946,/media/marda/TWOTB1/xBD/hurricanes/images/florence/hurricane-florence_00000534_pre_disaster.png,28,44,1,392,420,846,890,73,10.426526937472167,9.446924153109965
8947,/media/marda/TWOTB1/xBD/hurricanes/images/florence/hurricane-florence_00000534_pre_disaster.png,101,93,1,843,944,947,1040,1283,80.06646691641366,25.028069494185786
8948,/media/marda/TWOTB1/xBD/hurricanes/images/florence/hurricane-florence_00000534_pre_disaster.png,62,54,1,969,1031,970,1024,309,24.412910901823608,17.068151978624076
8949,/media/marda/TWOTB1/xBD/hurricanes/images/florence/hurricane-florence_00000179_post_disaster.png,50,41,1,616,666,370,411,379,23.977990421454127,21.137093876088638
8950,/media/marda/TWOTB1/xBD/hurricanes/images/florence/hurricane-florence_00000179_post_disaster.png,55,25,1,275,330,373,398,409,52.204112763161675,10.472086513258644
8951,/media/marda/TWOTB1/xBD/hurricanes/images/florence/hurricane-florence_00000179_post_disaster.png,43,61,1,755,798,392,453,606,52.0253130999534,15.534379750855638
8952,/media/marda/TWOTB1/xBD/hurricanes/images/florence/hurricane-florence_00000179_post_disaster.png,42,66,1,687,729,393,459,725,57.76171352679515,16.72957873912315
8953,/media/marda/TWOTB1/xBD/hurricanes/images/florence/hurricane-florence_00000179_post_disaster.png,53,32,1,933,986,393,425,180,16.78608069892117,14.382270926092593
8954,/media/marda/TWOTB1/xBD/hurricanes/images/florence/hurricane-florence_00000179_post_disaster.png,63,43,1,826,889,400,443,510,29.65915879472293,22.9859866812565
8955,/media/marda/TWOTB1/xBD/hurricanes/images/florence/hurricane-florence_00000179_post_disaster.png,63,44,1,396,459,402,446,995,50.55365085561242,26.862420331135358
8956,/media/marda/TWOTB1/xBD/hurricanes/images/florence/hurricane-florence_00000179_post_disaster.png,66,30,1,296,362,424,454,643,61.873248606410904,13.868744219781142
8957,/media/marda/TWOTB1/xBD/hurricanes/images/florence/hurricane-florence_00000179_post_disaster.png,56,32,1,474,530,471,503,486,42.925733154748414,15.125767436224187
8958,/media/marda/TWOTB1/xBD/hurricanes/images/florence/hurricane-florence_00000179_post_disaster.png,35,29,1,669,704,499,528,85,12.26352014192022,9.285952352826248
8959,/media/marda/TWOTB1/xBD/hurricanes/images/florence/hurricane-florence_00000179_post_disaster.png,38,30,1,773,811,499,529,95,11.733838864251966,10.725541809830323
8960,/media/marda/TWOTB1/xBD/hurricanes/images/florence/hurricane-florence_00000179_post_disaster.png,23,66,1,98,121,508,574,696,50.902700235144664,19.56929619207755
8961,/media/marda/TWOTB1/xBD/hurricanes/images/florence/hurricane-florence_00000179_post_disaster.png,69,41,1,495,564,523,564,971,56.06382930160841,23.089173077207445
8962,/media/marda/TWOTB1/xBD/hurricanes/images/florence/hurricane-florence_00000179_post_disaster.png,40,38,1,474,514,526,564,302,22.809579308326597,18.01591601692777
8963,/media/marda/TWOTB1/xBD/hurricanes/images/florence/hurricane-florence_00000179_post_disaster.png,60,40,1,589,649,532,572,666,40.509663339920245,21.924589740386434
8964,/media/marda/TWOTB1/xBD/hurricanes/images/florence/hurricane-florence_00000179_post_disaster.png,80,35,1,780,860,533,568,549,57.26769026306821,12.857896571484593
8965,/media/marda/TWOTB1/xBD/hurricanes/images/florence/hurricane-florence_00000179_post_disaster.png,75,33,1,681,756,536,569,589,56.6585676267105,13.837730479887894
8966,/media/marda/TWOTB1/xBD/hurricanes/images/florence/hurricane-florence_00000179_post_disaster.png,59,36,1,293,352,657,693,478,55.19895525096785,11.546043451657802
8967,/media/marda/TWOTB1/xBD/hurricanes/images/florence/hurricane-florence_00000179_post_disaster.png,75,53,1,563,638,659,712,1069,58.44873391044038,25.76862024845397
8968,/media/marda/TWOTB1/xBD/hurricanes/images/florence/hurricane-florence_00000179_post_disaster.png,78,36,1,644,722,661,697,624,60.03332407921454,13.808210118138652
8969,/media/marda/TWOTB1/xBD/hurricanes/images/florence/hurricane-florence_00000179_post_disaster.png,44,35,1,882,926,664,699,57,9.567991265918021,8.02959978156389
8970,/media/marda/TWOTB1/xBD/hurricanes/images/florence/hurricane-florence_00000179_post_disaster.png,51,41,1,390,441,669,710,607,41.2952882499803,19.519201334398375
8971,/media/marda/TWOTB1/xBD/hurricanes/images/florence/hurricane-florence_00000179_post_disaster.png,32,36,1,302,334,673,709,197,22.708787119949818,11.640452942006572
8972,/media/marda/TWOTB1/xBD/hurricanes/images/florence/hurricane-florence_00000179_post_disaster.png,24,42,1,339,363,675,717,179,19.86978579291968,12.054028338509996
8973,/media/marda/TWOTB1/xBD/hurricanes/images/florence/hurricane-florence_00000179_post_disaster.png,71,70,1,815,886,683,753,925,45.5969600324434,27.248569403878392
8974,/media/marda/TWOTB1/xBD/hurricanes/images/florence/hurricane-florence_00000179_post_disaster.png,45,48,1,581,626,691,739,380,24.975337021684556,20.126837912726977
8975,/media/marda/TWOTB1/xBD/hurricanes/images/florence/hurricane-florence_00000179_post_disaster.png,52,48,1,390,442,754,802,703,42.75513674890584,21.95311849719729
8976,/media/marda/TWOTB1/xBD/hurricanes/images/florence/hurricane-florence_00000179_post_disaster.png,68,46,1,476,544,755,801,595,56.365221265637246,14.135800099652585
8977,/media/marda/TWOTB1/xBD/hurricanes/images/florence/hurricane-florence_00000179_post_disaster.png,55,50,1,198,253,849,899,427,52.3663149423389,10.905719163035474
8978,/media/marda/TWOTB1/xBD/hurricanes/images/florence/hurricane-florence_00000179_post_disaster.png,61,76,1,682,743,944,1020,490,48.13710215283054,13.620878615951355
8979,/media/marda/TWOTB1/xBD/hurricanes/images/florence/hurricane-florence_00000228_pre_disaster.png,53,57,1,142,195,201,258,1294,47.7767003829463,37.012081936143574
8980,/media/marda/TWOTB1/xBD/hurricanes/images/florence/hurricane-florence_00000228_pre_disaster.png,49,56,1,80,129,239,295,1103,51.497075189560505,29.973128767425074
8981,/media/marda/TWOTB1/xBD/hurricanes/images/florence/hurricane-florence_00000228_pre_disaster.png,48,53,1,225,273,246,299,913,40.89393336412437,31.454120610536247
8982,/media/marda/TWOTB1/xBD/hurricanes/images/florence/hurricane-florence_00000228_pre_disaster.png,68,90,1,555,623,762,852,1444,63.537070158717654,37.46893824897057
8983,/media/marda/TWOTB1/xBD/hurricanes/images/florence/hurricane-florence_00000228_pre_disaster.png,14,47,1,60,74,801,848,111,16.17751546664173,9.07445760603986
8984,/media/marda/TWOTB1/xBD/hurricanes/images/florence/hurricane-florence_00000228_pre_disaster.png,54,69,1,530,584,812,881,733,34.46870469271281,28.206005421122875
8985,/media/marda/TWOTB1/xBD/hurricanes/images/florence/hurricane-florence_00000228_pre_disaster.png,46,77,1,39,85,823,900,1221,45.32967785084249,35.68044746643466
8986,/media/marda/TWOTB1/xBD/hurricanes/images/florence/hurricane-florence_00000228_pre_disaster.png,74,79,1,358,432,833,912,1324,65.2997727797916,26.7715077520423
8987,/media/marda/TWOTB1/xBD/hurricanes/images/florence/hurricane-florence_00000228_pre_disaster.png,40,66,1,290,330,866,932,623,35.45113034839543,22.8700831746041
8988,/media/marda/TWOTB1/xBD/hurricanes/images/florence/hurricane-florence_00000228_pre_disaster.png,5,47,1,0,5,908,955,29,10.396269590153207,4.2578435155778305
8989,/media/marda/TWOTB1/xBD/hurricanes/images/florence/hurricane-florence_00000228_pre_disaster.png,44,69,1,217,261,913,982,636,32.47898723800619,26.004960020069692
8990,/media/marda/TWOTB1/xBD/hurricanes/images/florence/hurricane-florence_00000228_pre_disaster.png,52,75,1,146,198,933,1008,898,51.0607144716814,23.33654795431407
8991,/media/marda/TWOTB1/xBD/hurricanes/images/florence/hurricane-florence_00000228_pre_disaster.png,24,56,1,168,192,966,1022,208,19.016049227201414,14.6570788544665
8992,/media/marda/TWOTB1/xBD/hurricanes/images/florence/hurricane-florence_00000228_pre_disaster.png,40,68,1,90,130,969,1037,594,34.97589623184365,23.03937236542791
8993,/media/marda/TWOTB1/xBD/hurricanes/images/florence/hurricane-florence_00000228_pre_disaster.png,24,55,1,119,143,989,1044,204,19.516429742626233,14.280601361742397
8994,/media/marda/TWOTB1/xBD/hurricanes/images/florence/hurricane-florence_00000228_pre_disaster.png,17,51,1,21,38,993,1044,119,16.188654577098447,10.315956266741445
8995,/media/marda/TWOTB1/xBD/hurricanes/images/florence/hurricane-florence_00000251_pre_disaster.png,85,45,1,809,894,39,84,1139,54.18356528043794,27.88100811313158
8996,/media/marda/TWOTB1/xBD/hurricanes/images/florence/hurricane-florence_00000251_pre_disaster.png,84,28,1,664,748,80,108,623,65.13861828707458,12.77857394469345
8997,/media/marda/TWOTB1/xBD/hurricanes/images/florence/hurricane-florence_00000251_pre_disaster.png,85,50,1,943,1028,97,147,826,61.32749032812395,17.986944561342916
8998,/media/marda/TWOTB1/xBD/hurricanes/images/florence/hurricane-florence_00000251_pre_disaster.png,40,21,1,735,775,106,127,110,17.745985843135355,8.359425007453542
8999,/media/marda/TWOTB1/xBD/hurricanes/images/florence/hurricane-florence_00000251_pre_disaster.png,63,49,1,629,692,167,216,1042,45.37269760652668,31.21081249323372
9000,/media/marda/TWOTB1/xBD/hurricanes/images/florence/hurricane-florence_00000251_pre_disaster.png,57,49,1,588,645,262,311,814,41.03460156213437,26.48708592814542
9001,/media/marda/TWOTB1/xBD/hurricanes/images/florence/hurricane-florence_00000251_pre_disaster.png,48,40,1,415,463,275,315,680,33.12478914157476,27.955836495322423
9002,/media/marda/TWOTB1/xBD/hurricanes/images/florence/hurricane-florence_00000251_pre_disaster.png,71,62,1,742,813,275,337,1133,56.275697499013155,26.877254674649464
9003,/media/marda/TWOTB1/xBD/hurricanes/images/florence/hurricane-florence_00000251_pre_disaster.png,34,25,1,589,623,298,323,94,11.493260518926759,10.973404254922524
9004,/media/marda/TWOTB1/xBD/hurricanes/images/florence/hurricane-florence_00000251_pre_disaster.png,51,64,1,572,623,338,402,765,55.97857824838553,18.26916059793848
9005,/media/marda/TWOTB1/xBD/hurricanes/images/florence/hurricane-florence_00000251_pre_disaster.png,67,51,1,724,791,381,432,907,36.97167862415267,33.014940193802246
9006,/media/marda/TWOTB1/xBD/hurricanes/images/florence/hurricane-florence_00000251_pre_disaster.png,58,66,1,526,584,418,484,971,51.18762541592484,25.343003684763357
9007,/media/marda/TWOTB1/xBD/hurricanes/images/florence/hurricane-florence_00000251_pre_disaster.png,38,33,1,496,534,426,459,168,16.133671404573633,13.958088328122978
9008,/media/marda/TWOTB1/xBD/hurricanes/images/florence/hurricane-florence_00000251_pre_disaster.png,48,32,1,737,785,430,462,168,20.329373991584706,11.132371941222452
9009,/media/marda/TWOTB1/xBD/hurricanes/images/florence/hurricane-florence_00000251_pre_disaster.png,54,63,1,498,552,490,553,662,51.77653418577896,17.059347098257692
9010,/media/marda/TWOTB1/xBD/hurricanes/images/florence/hurricane-florence_00000251_pre_disaster.png,52,59,1,684,736,491,550,466,47.49090684986954,13.21122121526353
9011,/media/marda/TWOTB1/xBD/hurricanes/images/florence/hurricane-florence_00000251_pre_disaster.png,39,54,1,308,347,620,674,448,26.66367294352428,22.04040047433201
9012,/media/marda/TWOTB1/xBD/hurricanes/images/florence/hurricane-florence_00000251_pre_disaster.png,71,76,1,609,680,636,712,1062,56.27543443194267,25.18724381401791
9013,/media/marda/TWOTB1/xBD/hurricanes/images/florence/hurricane-florence_00000251_pre_disaster.png,69,78,1,311,380,661,739,1498,60.51374436752144,32.66736163384537
9014,/media/marda/TWOTB1/xBD/hurricanes/images/florence/hurricane-florence_00000251_pre_disaster.png,56,62,1,529,585,700,762,600,32.723093798710444,24.48671338176682
9015,/media/marda/TWOTB1/xBD/hurricanes/images/florence/hurricane-florence_00000251_pre_disaster.png,65,72,1,472,537,739,811,974,46.76781703426764,27.791524351563684
9016,/media/marda/TWOTB1/xBD/hurricanes/images/florence/hurricane-florence_00000251_pre_disaster.png,63,71,1,420,483,783,854,932,47.69711689846737,26.076430583386756
9017,/media/marda/TWOTB1/xBD/hurricanes/images/florence/hurricane-florence_00000251_pre_disaster.png,38,55,1,387,425,784,839,272,23.295955682532192,15.601991900383789
9018,/media/marda/TWOTB1/xBD/hurricanes/images/florence/hurricane-florence_00000269_pre_disaster.png,35,35,1,124,159,184,219,453,30.465493048504165,20.00252029097999
9019,/media/marda/TWOTB1/xBD/hurricanes/images/florence/hurricane-florence_00000269_pre_disaster.png,13,45,1,0,13,240,285,337,36.89347457599911,12.653058803463905
9020,/media/marda/TWOTB1/xBD/hurricanes/images/florence/hurricane-florence_00000269_pre_disaster.png,17,25,1,133,150,351,376,85,11.099797807792255,10.320055928631147
9021,/media/marda/TWOTB1/xBD/hurricanes/images/florence/hurricane-florence_00000269_pre_disaster.png,31,37,1,240,271,366,403,296,22.24566494444933,17.91129949953954
9022,/media/marda/TWOTB1/xBD/hurricanes/images/florence/hurricane-florence_00000098_pre_disaster.png,43,33,1,126,169,529,562,428,44.889448127299985,12.67197302035036
9023,/media/marda/TWOTB1/xBD/hurricanes/images/florence/hurricane-florence_00000098_pre_disaster.png,27,51,1,168,195,561,612,544,31.200212254737956,23.728477528704477
9024,/media/marda/TWOTB1/xBD/hurricanes/images/florence/hurricane-florence_00000098_pre_disaster.png,21,40,1,161,182,604,644,214,18.22211397513578,15.755101777836218
9025,/media/marda/TWOTB1/xBD/hurricanes/images/florence/hurricane-florence_00000449_pre_disaster.png,51,32,1,649,700,102,134,427,25.954634413820354,21.85245497335304
9026,/media/marda/TWOTB1/xBD/hurricanes/images/florence/hurricane-florence_00000449_pre_disaster.png,55,32,1,78,133,137,169,941,57.334118675753345,21.55072264647552
9027,/media/marda/TWOTB1/xBD/hurricanes/images/florence/hurricane-florence_00000449_pre_disaster.png,51,18,1,965,1016,180,198,145,14.89644988052075,13.09848144455411
9028,/media/marda/TWOTB1/xBD/hurricanes/images/florence/hurricane-florence_00000449_pre_disaster.png,54,50,1,990,1044,202,252,455,46.99044959827571,13.207718644612276
9029,/media/marda/TWOTB1/xBD/hurricanes/images/florence/hurricane-florence_00000449_pre_disaster.png,48,30,1,54,102,238,268,552,49.3954024569488,15.372688002653137
9030,/media/marda/TWOTB1/xBD/hurricanes/images/florence/hurricane-florence_00000449_pre_disaster.png,18,41,1,0,18,240,281,422,32.872424839962974,16.904938544611557
9031,/media/marda/TWOTB1/xBD/hurricanes/images/florence/hurricane-florence_00000449_pre_disaster.png,57,31,1,149,206,249,280,689,57.19636544618264,16.079437913679193
9032,/media/marda/TWOTB1/xBD/hurricanes/images/florence/hurricane-florence_00000449_pre_disaster.png,80,70,1,628,708,304,374,1774,64.63498815330927,40.22957881913981
9033,/media/marda/TWOTB1/xBD/hurricanes/images/florence/hurricane-florence_00000449_pre_disaster.png,64,46,1,822,886,355,401,716,31.515092536320157,30.33786057529512
9034,/media/marda/TWOTB1/xBD/hurricanes/images/florence/hurricane-florence_00000449_pre_disaster.png,85,54,1,767,852,357,411,1531,56.77043938662913,37.44994820422031
9035,/media/marda/TWOTB1/xBD/hurricanes/images/florence/hurricane-florence_00000449_pre_disaster.png,72,82,1,190,262,451,533,2519,76.78688537053573,47.15480057489957
9036,/media/marda/TWOTB1/xBD/hurricanes/images/florence/hurricane-florence_00000449_pre_disaster.png,81,59,1,881,962,463,522,1018,53.78733205264257,27.04868515531527
9037,/media/marda/TWOTB1/xBD/hurricanes/images/florence/hurricane-florence_00000449_pre_disaster.png,78,47,1,544,622,552,599,689,66.08323211033017,13.809335359217044
9038,/media/marda/TWOTB1/xBD/hurricanes/images/florence/hurricane-florence_00000449_pre_disaster.png,44,59,1,266,310,573,632,868,38.74785445269397,29.70622302582105
9039,/media/marda/TWOTB1/xBD/hurricanes/images/florence/hurricane-florence_00000449_pre_disaster.png,66,53,1,608,674,574,627,781,43.10648363539486,24.027694414098594
9040,/media/marda/TWOTB1/xBD/hurricanes/images/florence/hurricane-florence_00000449_pre_disaster.png,30,55,1,25,55,589,644,871,34.65517982224182,33.553691321706886
9041,/media/marda/TWOTB1/xBD/hurricanes/images/florence/hurricane-florence_00000449_pre_disaster.png,45,51,1,514,559,627,678,396,25.183415707589845,21.112629624717904
9042,/media/marda/TWOTB1/xBD/hurricanes/images/florence/hurricane-florence_00000449_pre_disaster.png,61,59,1,564,625,628,687,726,41.729925295430796,24.608592696301503
9043,/media/marda/TWOTB1/xBD/hurricanes/images/florence/hurricane-florence_00000449_pre_disaster.png,16,40,1,64,80,636,676,147,16.16888255284597,11.988014870689351
9044,/media/marda/TWOTB1/xBD/hurricanes/images/florence/hurricane-florence_00000449_pre_disaster.png,36,51,1,50,86,661,712,506,34.0661423198654,19.97560109237455
9045,/media/marda/TWOTB1/xBD/hurricanes/images/florence/hurricane-florence_00000449_pre_disaster.png,16,43,1,96,112,686,729,145,14.253913128482177,13.70056165916475
9046,/media/marda/TWOTB1/xBD/hurricanes/images/florence/hurricane-florence_00000449_pre_disaster.png,37,44,1,81,118,704,748,393,40.11818388365804,14.414112158741021
9047,/media/marda/TWOTB1/xBD/hurricanes/images/florence/hurricane-florence_00000449_pre_disaster.png,20,77,1,104,124,739,816,695,55.55923323958392,16.69925906430665
9048,/media/marda/TWOTB1/xBD/hurricanes/images/florence/hurricane-florence_00000449_pre_disaster.png,87,91,1,693,780,938,1029,1922,58.90108338809412,44.17540534680691
9049,/media/marda/TWOTB1/xBD/hurricanes/images/florence/hurricane-florence_00000346_post_disaster.png,62,72,1,0,62,0,72,2117,87.7633887779102,42.427952671240696
9050,/media/marda/TWOTB1/xBD/hurricanes/images/florence/hurricane-florence_00000346_post_disaster.png,43,54,1,156,199,0,54,1439,55.09721002375535,35.89044089605173
9051,/media/marda/TWOTB1/xBD/hurricanes/images/florence/hurricane-florence_00000346_post_disaster.png,36,46,1,262,298,0,46,1114,51.61571767528937,28.925095562640703
9052,/media/marda/TWOTB1/xBD/hurricanes/images/florence/hurricane-florence_00000346_post_disaster.png,55,28,1,303,358,0,28,1031,47.7976499678536,28.889660607078557
9053,/media/marda/TWOTB1/xBD/hurricanes/images/florence/hurricane-florence_00000346_post_disaster.png,34,10,1,368,402,0,10,185,24.916021432860873,9.921300184940536
9054,/media/marda/TWOTB1/xBD/hurricanes/images/florence/hurricane-florence_00000346_post_disaster.png,57,10,1,441,498,0,10,281,44.24251131451852,8.769048530978633
9055,/media/marda/TWOTB1/xBD/hurricanes/images/florence/hurricane-florence_00000346_post_disaster.png,55,22,1,849,904,0,22,391,26.349626912651527,19.53411628948181
9056,/media/marda/TWOTB1/xBD/hurricanes/images/florence/hurricane-florence_00000346_post_disaster.png,66,26,1,758,824,31,57,738,38.31830565173678,25.405342754894594
9057,/media/marda/TWOTB1/xBD/hurricanes/images/florence/hurricane-florence_00000346_post_disaster.png,76,30,1,708,784,37,67,1152,52.81447604269476,29.11680895826344
9058,/media/marda/TWOTB1/xBD/hurricanes/images/florence/hurricane-florence_00000346_post_disaster.png,69,27,1,652,721,52,79,877,47.7475082150827,24.517089140735283
9059,/media/marda/TWOTB1/xBD/hurricanes/images/florence/hurricane-florence_00000346_post_disaster.png,61,52,1,858,919,62,114,1030,58.069208596109426,25.171970388438844
9060,/media/marda/TWOTB1/xBD/hurricanes/images/florence/hurricane-florence_00000346_post_disaster.png,68,28,1,583,651,75,103,987,51.21756298904859,25.64353357388666
9061,/media/marda/TWOTB1/xBD/hurricanes/images/florence/hurricane-florence_00000346_post_disaster.png,79,29,1,465,544,82,111,1238,67.31284715970665,25.165118003748617
9062,/media/marda/TWOTB1/xBD/hurricanes/images/florence/hurricane-florence_00000346_post_disaster.png,100,37,1,728,828,96,133,1720,75.77270198822563,31.340773876424166
9063,/media/marda/TWOTB1/xBD/hurricanes/images/florence/hurricane-florence_00000346_post_disaster.png,40,65,1,180,220,106,171,1536,66.5374457278527,30.61869308264171
9064,/media/marda/TWOTB1/xBD/hurricanes/images/florence/hurricane-florence_00000346_post_disaster.png,90,62,1,617,707,106,168,2555,73.69283886071952,50.54629388538008
9065,/media/marda/TWOTB1/xBD/hurricanes/images/florence/hurricane-florence_00000346_post_disaster.png,52,46,1,78,130,124,170,1396,57.126120920671354,36.05702048748866
9066,/media/marda/TWOTB1/xBD/hurricanes/images/florence/hurricane-florence_00000346_post_disaster.png,59,45,1,868,927,140,185,824,42.67526539885576,25.35739524693694
9067,/media/marda/TWOTB1/xBD/hurricanes/images/florence/hurricane-florence_00000346_post_disaster.png,61,39,1,503,564,141,180,962,46.52622887535316,28.42712369185752
9068,/media/marda/TWOTB1/xBD/hurricanes/images/florence/hurricane-florence_00000346_post_disaster.png,9,30,1,0,9,145,175,126,25.090371552604395,7.678149580194629
9069,/media/marda/TWOTB1/xBD/hurricanes/images/florence/hurricane-florence_00000346_post_disaster.png,63,56,1,293,356,155,211,1812,62.11190913136831,43.53996730606684
9070,/media/marda/TWOTB1/xBD/hurricanes/images/florence/hurricane-florence_00000346_post_disaster.png,61,36,1,433,494,155,191,990,51.60955257205221,26.73751208793449
9071,/media/marda/TWOTB1/xBD/hurricanes/images/florence/hurricane-florence_00000346_post_disaster.png,50,30,1,374,424,168,198,732,39.99825426109829,24.225305297603068
9072,/media/marda/TWOTB1/xBD/hurricanes/images/florence/hurricane-florence_00000346_post_disaster.png,68,41,1,164,232,191,232,1747,68.08241187050895,33.959054501844186
9073,/media/marda/TWOTB1/xBD/hurricanes/images/florence/hurricane-florence_00000346_post_disaster.png,20,18,1,145,165,196,214,196,17.589463815433607,14.668237851538562
9074,/media/marda/TWOTB1/xBD/hurricanes/images/florence/hurricane-florence_00000346_post_disaster.png,19,22,1,6,25,206,228,162,19.806485958374786,10.855328386137687
9075,/media/marda/TWOTB1/xBD/hurricanes/images/florence/hurricane-florence_00000346_post_disaster.png,53,34,1,84,137,209,243,943,56.50612796845266,22.281003381080936
9076,/media/marda/TWOTB1/xBD/hurricanes/images/florence/hurricane-florence_00000346_post_disaster.png,95,48,1,746,841,211,259,1823,70.53986469169563,36.425895904158985
9077,/media/marda/TWOTB1/xBD/hurricanes/images/florence/hurricane-florence_00000346_post_disaster.png,60,49,1,881,941,212,261,813,43.248855273180766,25.100011536384777
9078,/media/marda/TWOTB1/xBD/hurricanes/images/florence/hurricane-florence_00000346_post_disaster.png,15,29,1,46,61,215,244,242,22.404767412594953,14.486847748286202
9079,/media/marda/TWOTB1/xBD/hurricanes/images/florence/hurricane-florence_00000346_post_disaster.png,19,35,1,0,19,225,260,369,26.085864398619226,19.108986673556235
9080,/media/marda/TWOTB1/xBD/hurricanes/images/florence/hurricane-florence_00000346_post_disaster.png,43,28,1,683,726,236,264,274,21.279440759428038,17.247109126713564
9081,/media/marda/TWOTB1/xBD/hurricanes/images/florence/hurricane-florence_00000346_post_disaster.png,69,53,1,613,682,238,291,1608,47.17540514132634,45.47711650183675
9082,/media/marda/TWOTB1/xBD/hurricanes/images/florence/hurricane-florence_00000346_post_disaster.png,73,30,1,499,572,240,270,867,58.48630505098446,19.89888542532438
9083,/media/marda/TWOTB1/xBD/hurricanes/images/florence/hurricane-florence_00000346_post_disaster.png,66,35,1,433,499,247,282,954,55.64168801192475,22.733972371991385
9084,/media/marda/TWOTB1/xBD/hurricanes/images/florence/hurricane-florence_00000346_post_disaster.png,66,34,1,370,436,262,296,936,56.160299770719284,21.984879014413632
9085,/media/marda/TWOTB1/xBD/hurricanes/images/florence/hurricane-florence_00000346_post_disaster.png,65,45,1,297,362,268,313,1295,52.70082842531652,34.35591107296578
9086,/media/marda/TWOTB1/xBD/hurricanes/images/florence/hurricane-florence_00000346_post_disaster.png,55,60,1,183,238,284,344,1726,61.040366821328675,40.06459243283338
9087,/media/marda/TWOTB1/xBD/hurricanes/images/florence/hurricane-florence_00000346_post_disaster.png,38,33,1,548,586,315,348,226,21.286666128190305,14.20494632211654
9088,/media/marda/TWOTB1/xBD/hurricanes/images/florence/hurricane-florence_00000346_post_disaster.png,25,40,1,0,25,316,356,469,27.988481912159752,22.501123429219444
9089,/media/marda/TWOTB1/xBD/hurricanes/images/florence/hurricane-florence_00000346_post_disaster.png,44,39,1,304,348,317,356,694,33.70202871021327,27.789630913165606
9090,/media/marda/TWOTB1/xBD/hurricanes/images/florence/hurricane-florence_00000346_post_disaster.png,103,52,1,793,896,327,379,1341,79.6382635658408,22.396608106110513
9091,/media/marda/TWOTB1/xBD/hurricanes/images/florence/hurricane-florence_00000346_post_disaster.png,71,61,1,514,585,330,391,1413,55.35730228099196,36.279707688960585
9092,/media/marda/TWOTB1/xBD/hurricanes/images/florence/hurricane-florence_00000346_post_disaster.png,59,39,1,765,824,352,391,536,30.118506595925048,23.369788226087486
9093,/media/marda/TWOTB1/xBD/hurricanes/images/florence/hurricane-florence_00000346_post_disaster.png,35,28,1,369,404,356,384,222,22.719605972139714,13.099880128963145
9094,/media/marda/TWOTB1/xBD/hurricanes/images/florence/hurricane-florence_00000346_post_disaster.png,26,40,1,0,26,362,402,528,27.28172310581546,25.705427324354307
9095,/media/marda/TWOTB1/xBD/hurricanes/images/florence/hurricane-florence_00000346_post_disaster.png,56,46,1,400,456,377,423,843,44.04158094870558,25.278234553089945
9096,/media/marda/TWOTB1/xBD/hurricanes/images/florence/hurricane-florence_00000346_post_disaster.png,73,68,1,316,389,390,458,1660,60.354596339881674,45.460993642024896
9097,/media/marda/TWOTB1/xBD/hurricanes/images/florence/hurricane-florence_00000346_post_disaster.png,40,46,1,6,46,398,444,743,42.5108391917508,23.33330219312386
9098,/media/marda/TWOTB1/xBD/hurricanes/images/florence/hurricane-florence_00000346_post_disaster.png,20,36,1,48,68,398,434,248,18.781588267371895,17.686162083722195
9099,/media/marda/TWOTB1/xBD/hurricanes/images/florence/hurricane-florence_00000346_post_disaster.png,79,75,1,182,261,398,473,1907,87.73820741137921,31.152759940042145
9100,/media/marda/TWOTB1/xBD/hurricanes/images/florence/hurricane-florence_00000346_post_disaster.png,51,40,1,907,958,416,456,217,25.931014128709762,13.61046987627234
9101,/media/marda/TWOTB1/xBD/hurricanes/images/florence/hurricane-florence_00000346_post_disaster.png,75,57,1,559,634,438,495,1353,55.01477978462667,35.49810305210323
9102,/media/marda/TWOTB1/xBD/hurricanes/images/florence/hurricane-florence_00000346_post_disaster.png,67,68,1,891,958,439,507,1234,55.40838976102805,29.737111634123927
9103,/media/marda/TWOTB1/xBD/hurricanes/images/florence/hurricane-florence_00000346_post_disaster.png,89,69,1,478,567,467,536,1851,78.71467123689004,32.05512096832086
9104,/media/marda/TWOTB1/xBD/hurricanes/images/florence/hurricane-florence_00000346_post_disaster.png,18,33,1,120,138,483,516,157,16.554174974602834,12.672007036336119
9105,/media/marda/TWOTB1/xBD/hurricanes/images/florence/hurricane-florence_00000346_post_disaster.png,35,58,1,60,95,497,555,847,36.92261626797356,30.523454947349773
9106,/media/marda/TWOTB1/xBD/hurricanes/images/florence/hurricane-florence_00000346_post_disaster.png,42,45,1,93,135,498,543,589,42.063435116139516,18.572464523692886
9107,/media/marda/TWOTB1/xBD/hurricanes/images/florence/hurricane-florence_00000346_post_disaster.png,63,85,1,594,657,504,589,1236,71.33535086792891,30.735542234598622
9108,/media/marda/TWOTB1/xBD/hurricanes/images/florence/hurricane-florence_00000346_post_disaster.png,86,67,1,387,473,505,572,2126,69.66823647420695,40.10597665563058
9109,/media/marda/TWOTB1/xBD/hurricanes/images/florence/hurricane-florence_00000346_post_disaster.png,58,62,1,252,310,535,597,1243,47.32459953452751,37.13161554311253
9110,/media/marda/TWOTB1/xBD/hurricanes/images/florence/hurricane-florence_00000346_post_disaster.png,51,53,1,412,463,580,633,694,33.07915709224044,28.003061955181895
9111,/media/marda/TWOTB1/xBD/hurricanes/images/florence/hurricane-florence_00000346_post_disaster.png,59,78,1,147,206,582,660,1569,57.44239670032168,43.45027004446793
9112,/media/marda/TWOTB1/xBD/hurricanes/images/florence/hurricane-florence_00000346_post_disaster.png,42,55,1,69,111,613,668,826,41.38389766566693,27.862632573070474
9113,/media/marda/TWOTB1/xBD/hurricanes/images/florence/hurricane-florence_00000346_post_disaster.png,52,93,1,292,344,621,714,1647,70.6430994533013,35.04719476212149
9114,/media/marda/TWOTB1/xBD/hurricanes/images/florence/hurricane-florence_00000346_post_disaster.png,67,75,1,436,503,627,702,1397,49.712753444070856,40.71214264135999
9115,/media/marda/TWOTB1/xBD/hurricanes/images/florence/hurricane-florence_00000346_post_disaster.png,60,50,1,739,799,639,689,527,33.09226855372111,21.08399324427915
9116,/media/marda/TWOTB1/xBD/hurricanes/images/florence/hurricane-florence_00000346_post_disaster.png,19,57,1,0,19,641,698,436,32.305123870666264,18.25528683000889
9117,/media/marda/TWOTB1/xBD/hurricanes/images/florence/hurricane-florence_00000346_post_disaster.png,94,72,1,950,1044,653,725,2267,63.81065162729544,47.11830010096503
9118,/media/marda/TWOTB1/xBD/hurricanes/images/florence/hurricane-florence_00000346_post_disaster.png,64,75,1,532,596,665,740,1303,52.122378893078846,34.15851893165466
9119,/media/marda/TWOTB1/xBD/hurricanes/images/florence/hurricane-florence_00000346_post_disaster.png,71,61,1,582,653,665,726,1105,53.12167975628496,27.4553509484562
9120,/media/marda/TWOTB1/xBD/hurricanes/images/florence/hurricane-florence_00000346_post_disaster.png,36,63,1,102,138,686,749,694,37.29270973084018,24.742279458395792
9121,/media/marda/TWOTB1/xBD/hurricanes/images/florence/hurricane-florence_00000346_post_disaster.png,70,81,1,456,526,693,774,1536,55.06880992015032,42.50816020820605
9122,/media/marda/TWOTB1/xBD/hurricanes/images/florence/hurricane-florence_00000346_post_disaster.png,65,92,1,314,379,709,801,1697,59.55507063179591,47.24267845247257
9123,/media/marda/TWOTB1/xBD/hurricanes/images/florence/hurricane-florence_00000346_post_disaster.png,64,57,1,767,831,712,769,621,34.81519110555229,24.000289979272235
9124,/media/marda/TWOTB1/xBD/hurricanes/images/florence/hurricane-florence_00000346_post_disaster.png,38,56,1,2,40,721,777,716,39.23010447833593,24.01883165064325
9125,/media/marda/TWOTB1/xBD/hurricanes/images/florence/hurricane-florence_00000346_post_disaster.png,42,74,1,120,162,724,798,1103,45.39177379923549,34.37503559025076
9126,/media/marda/TWOTB1/xBD/hurricanes/images/florence/hurricane-florence_00000346_post_disaster.png,56,62,1,682,738,747,809,591,34.44231141669929,23.558379259166202
9127,/media/marda/TWOTB1/xBD/hurricanes/images/florence/hurricane-florence_00000346_post_disaster.png,103,130,1,768,871,757,887,4163,100.44700834384325,55.52554503364052
9128,/media/marda/TWOTB1/xBD/hurricanes/images/florence/hurricane-florence_00000346_post_disaster.png,39,61,1,24,63,775,836,927,39.45444601839858,31.142182319480252
9129,/media/marda/TWOTB1/xBD/hurricanes/images/florence/hurricane-florence_00000346_post_disaster.png,32,61,1,257,289,781,842,482,32.87421179634819,19.53131987072338
9130,/media/marda/TWOTB1/xBD/hurricanes/images/florence/hurricane-florence_00000346_post_disaster.png,40,48,1,653,693,785,833,194,17.02720599440605,15.290883026270075
9131,/media/marda/TWOTB1/xBD/hurricanes/images/florence/hurricane-florence_00000346_post_disaster.png,41,90,1,142,183,787,877,1420,58.33509893954063,32.50010063332747
9132,/media/marda/TWOTB1/xBD/hurricanes/images/florence/hurricane-florence_00000346_post_disaster.png,43,63,1,220,263,795,858,677,34.40444625185717,26.284661085653138
9133,/media/marda/TWOTB1/xBD/hurricanes/images/florence/hurricane-florence_00000346_post_disaster.png,65,69,1,692,757,795,864,878,35.69669788089904,32.3196223918632
9134,/media/marda/TWOTB1/xBD/hurricanes/images/florence/hurricane-florence_00000346_post_disaster.png,40,67,1,184,224,806,873,764,34.527408204366296,29.33192453541495
9135,/media/marda/TWOTB1/xBD/hurricanes/images/florence/hurricane-florence_00000346_post_disaster.png,47,69,1,507,554,818,887,861,41.69819347913347,28.05466897643292
9136,/media/marda/TWOTB1/xBD/hurricanes/images/florence/hurricane-florence_00000346_post_disaster.png,81,84,1,963,1044,840,924,1223,51.26262247158591,31.329825737266294
9137,/media/marda/TWOTB1/xBD/hurricanes/images/florence/hurricane-florence_00000346_post_disaster.png,19,82,1,0,19,849,931,505,45.28103150601065,16.76752455502137
9138,/media/marda/TWOTB1/xBD/hurricanes/images/florence/hurricane-florence_00000346_post_disaster.png,54,67,1,36,90,850,917,1034,59.925121725438295,22.964608432705436
9139,/media/marda/TWOTB1/xBD/hurricanes/images/florence/hurricane-florence_00000346_post_disaster.png,82,104,1,351,433,850,954,2398,82.78390248101942,45.035276186617374
9140,/media/marda/TWOTB1/xBD/hurricanes/images/florence/hurricane-florence_00000346_post_disaster.png,86,79,1,717,803,872,951,1236,62.477572721904494,27.771106598914756
9141,/media/marda/TWOTB1/xBD/hurricanes/images/florence/hurricane-florence_00000346_post_disaster.png,48,53,1,684,732,881,934,238,20.239076123534527,15.686850437782956
9142,/media/marda/TWOTB1/xBD/hurricanes/images/florence/hurricane-florence_00000346_post_disaster.png,49,64,1,287,336,884,948,680,40.80078404504124,22.07454029574309
9143,/media/marda/TWOTB1/xBD/hurricanes/images/florence/hurricane-florence_00000346_post_disaster.png,64,85,1,697,761,900,985,968,44.88947031066585,29.74197343735894
9144,/media/marda/TWOTB1/xBD/hurricanes/images/florence/hurricane-florence_00000346_post_disaster.png,57,93,1,231,288,902,995,1498,56.93417908696904,42.22103158581276
9145,/media/marda/TWOTB1/xBD/hurricanes/images/florence/hurricane-florence_00000346_post_disaster.png,51,51,1,993,1044,905,956,96,14.773624624291868,8.604973620881854
9146,/media/marda/TWOTB1/xBD/hurricanes/images/florence/hurricane-florence_00000346_post_disaster.png,61,107,1,186,247,912,1019,1859,78.91100847736318,35.45466733763895
9147,/media/marda/TWOTB1/xBD/hurricanes/images/florence/hurricane-florence_00000346_post_disaster.png,53,96,1,581,634,928,1024,952,63.204043672297786,19.889982616590757
9148,/media/marda/TWOTB1/xBD/hurricanes/images/florence/hurricane-florence_00000346_post_disaster.png,60,51,1,974,1034,930,981,244,23.260379114754166,14.095831595047558
9149,/media/marda/TWOTB1/xBD/hurricanes/images/florence/hurricane-florence_00000346_post_disaster.png,126,110,1,5,131,931,1041,4999,130.38593507864437,53.659196885773284
9150,/media/marda/TWOTB1/xBD/hurricanes/images/florence/hurricane-florence_00000346_post_disaster.png,58,95,1,394,452,941,1036,1338,62.153273321477315,28.51747995025412
9151,/media/marda/TWOTB1/xBD/hurricanes/images/florence/hurricane-florence_00000346_post_disaster.png,39,60,1,567,606,946,1006,252,23.925266263944426,14.112240443830576
9152,/media/marda/TWOTB1/xBD/hurricanes/images/florence/hurricane-florence_00000346_post_disaster.png,75,85,1,649,724,946,1031,1494,48.87839342360845,40.81245596297666
9153,/media/marda/TWOTB1/xBD/hurricanes/images/florence/hurricane-florence_00000346_post_disaster.png,100,90,1,931,1031,947,1037,2162,67.4871108384085,45.53050543572576
9154,/media/marda/TWOTB1/xBD/hurricanes/images/florence/hurricane-florence_00000346_post_disaster.png,79,54,1,530,609,989,1043,524,63.31975812768383,12.30212260190684
9155,/media/marda/TWOTB1/xBD/hurricanes/images/florence/hurricane-florence_00000513_post_disaster.png,59,49,1,781,840,683,732,533,30.2340006025149,22.939943105064238
9156,/media/marda/TWOTB1/xBD/hurricanes/images/florence/hurricane-florence_00000513_post_disaster.png,99,73,1,810,909,697,770,1918,71.24441690040848,36.61172060345938
9157,/media/marda/TWOTB1/xBD/hurricanes/images/florence/hurricane-florence_00000513_post_disaster.png,69,91,1,974,1043,780,871,1320,71.57830135797155,30.37682465743372
9158,/media/marda/TWOTB1/xBD/hurricanes/images/florence/hurricane-florence_00000513_post_disaster.png,66,51,1,932,998,785,836,414,31.310104112292127,17.69640328860022
9159,/media/marda/TWOTB1/xBD/hurricanes/images/florence/hurricane-florence_00000380_post_disaster.png,50,20,1,924,974,147,167,173,16.74828249271996,13.636835228488502
9160,/media/marda/TWOTB1/xBD/hurricanes/images/florence/hurricane-florence_00000380_post_disaster.png,54,54,1,612,666,245,299,1197,51.95494550255286,30.777464358966814
9161,/media/marda/TWOTB1/xBD/hurricanes/images/florence/hurricane-florence_00000380_post_disaster.png,57,54,1,664,721,351,405,985,45.793519844074986,29.574223692769767
9162,/media/marda/TWOTB1/xBD/hurricanes/images/florence/hurricane-florence_00000380_post_disaster.png,31,28,1,365,396,431,459,138,20.03468111164143,9.274836971827426
9163,/media/marda/TWOTB1/xBD/hurricanes/images/florence/hurricane-florence_00000380_post_disaster.png,40,31,1,716,756,437,468,110,14.07598897563531,10.408043082350984
9164,/media/marda/TWOTB1/xBD/hurricanes/images/florence/hurricane-florence_00000380_post_disaster.png,38,36,1,438,476,443,479,295,21.229353061461048,18.614246823174856
9165,/media/marda/TWOTB1/xBD/hurricanes/images/florence/hurricane-florence_00000380_post_disaster.png,51,63,1,658,709,447,510,729,52.849970377762126,18.254412250132482
9166,/media/marda/TWOTB1/xBD/hurricanes/images/florence/hurricane-florence_00000380_post_disaster.png,37,28,1,361,398,453,481,209,27.96086694627007,10.054017105958778
9167,/media/marda/TWOTB1/xBD/hurricanes/images/florence/hurricane-florence_00000380_post_disaster.png,38,35,1,434,472,461,496,292,21.8192463804403,17.90456171830317
9168,/media/marda/TWOTB1/xBD/hurricanes/images/florence/hurricane-florence_00000380_post_disaster.png,41,43,1,323,364,474,517,450,30.7378820159662,21.511101739832633
9169,/media/marda/TWOTB1/xBD/hurricanes/images/florence/hurricane-florence_00000380_post_disaster.png,72,51,1,367,439,495,546,1135,64.02006971276333,23.66852650402384
9170,/media/marda/TWOTB1/xBD/hurricanes/images/florence/hurricane-florence_00000380_post_disaster.png,67,64,1,594,661,602,666,1134,44.40089432565902,33.62397193353251
9171,/media/marda/TWOTB1/xBD/hurricanes/images/florence/hurricane-florence_00000380_post_disaster.png,43,37,1,654,697,646,683,165,20.201435915350988,10.627247401151278
9172,/media/marda/TWOTB1/xBD/hurricanes/images/florence/hurricane-florence_00000380_post_disaster.png,79,64,1,879,958,652,716,1047,47.81959050347839,29.75444825025534
9173,/media/marda/TWOTB1/xBD/hurricanes/images/florence/hurricane-florence_00000380_post_disaster.png,42,52,1,588,630,661,713,446,28.813992531088296,20.744937668125953
9174,/media/marda/TWOTB1/xBD/hurricanes/images/florence/hurricane-florence_00000380_post_disaster.png,48,47,1,875,923,697,744,224,19.04824052200747,15.390329336872064
9175,/media/marda/TWOTB1/xBD/hurricanes/images/florence/hurricane-florence_00000380_post_disaster.png,77,82,1,963,1040,705,787,1209,53.02904027871851,31.76441829594295
9176,/media/marda/TWOTB1/xBD/hurricanes/images/florence/hurricane-florence_00000380_post_disaster.png,69,84,1,870,939,796,880,1482,57.2807024437954,36.49091183898176
9177,/media/marda/TWOTB1/xBD/hurricanes/images/florence/hurricane-florence_00000380_post_disaster.png,60,52,1,984,1044,951,1003,218,21.186650631351853,13.549530214635727
9178,/media/marda/TWOTB1/xBD/hurricanes/images/florence/hurricane-florence_00000380_post_disaster.png,71,70,1,924,995,971,1041,1016,37.55039188767265,36.14083485430236
9179,/media/marda/TWOTB1/xBD/hurricanes/images/florence/hurricane-florence_00000380_post_disaster.png,72,35,1,818,890,126,161,706,43.90289659665684,23.925584446763146
9180,/media/marda/TWOTB1/xBD/hurricanes/images/florence/hurricane-florence_00000380_post_disaster.png,55,22,1,721,776,133,155,256,27.97443883905233,12.260801605732008
9181,/media/marda/TWOTB1/xBD/hurricanes/images/florence/hurricane-florence_00000380_post_disaster.png,78,54,1,607,685,141,195,1806,59.82213872323104,43.05958418311077
9182,/media/marda/TWOTB1/xBD/hurricanes/images/florence/hurricane-florence_00000380_post_disaster.png,48,17,1,676,724,151,168,178,26.042564859389966,9.477110305143494
9183,/media/marda/TWOTB1/xBD/hurricanes/images/florence/hurricane-florence_00000380_post_disaster.png,95,51,1,667,762,196,247,1345,76.03607394092704,25.906212772173614
9184,/media/marda/TWOTB1/xBD/hurricanes/images/florence/hurricane-florence_00000231_post_disaster.png,69,44,1,741,810,307,351,695,43.57382738828363,26.617664135692873
9185,/media/marda/TWOTB1/xBD/hurricanes/images/florence/hurricane-florence_00000231_post_disaster.png,66,50,1,624,690,350,400,838,43.92531776321063,25.25621772874852
9186,/media/marda/TWOTB1/xBD/hurricanes/images/florence/hurricane-florence_00000231_post_disaster.png,62,60,1,488,550,454,514,1127,40.476335650916354,37.871523891682926
9187,/media/marda/TWOTB1/xBD/hurricanes/images/florence/hurricane-florence_00000231_post_disaster.png,77,41,1,762,839,491,532,872,54.356158978737646,21.42246030856606
9188,/media/marda/TWOTB1/xBD/hurricanes/images/florence/hurricane-florence_00000231_post_disaster.png,51,78,1,32,83,766,844,1309,52.16264329084071,33.05820940738078
9189,/media/marda/TWOTB1/xBD/hurricanes/images/florence/hurricane-florence_00000231_post_disaster.png,30,71,1,149,179,928,999,438,37.16068428024569,15.583421160353312
9190,/media/marda/TWOTB1/xBD/hurricanes/images/florence/hurricane-florence_00000231_post_disaster.png,45,55,1,303,348,956,1011,307,36.821126552162035,11.148319256524774
9191,/media/marda/TWOTB1/xBD/hurricanes/images/florence/hurricane-florence_00000231_post_disaster.png,22,46,1,98,120,997,1043,105,20.226179634222813,6.821885369103192
9192,/media/marda/TWOTB1/xBD/hurricanes/images/florence/hurricane-florence_00000310_post_disaster.png,63,36,1,981,1044,21,57,471,32.37021058465085,20.30137947191626
9193,/media/marda/TWOTB1/xBD/hurricanes/images/florence/hurricane-florence_00000310_post_disaster.png,64,52,1,738,802,486,538,647,30.99751567630733,27.871614514213086
9194,/media/marda/TWOTB1/xBD/hurricanes/images/florence/hurricane-florence_00000310_post_disaster.png,91,86,1,422,513,662,748,2342,69.91354706704092,47.69224661953601
9195,/media/marda/TWOTB1/xBD/hurricanes/images/florence/hurricane-florence_00000310_post_disaster.png,52,49,1,680,732,680,729,349,22.196824207438237,20.7832856773035
9196,/media/marda/TWOTB1/xBD/hurricanes/images/florence/hurricane-florence_00000310_post_disaster.png,56,60,1,654,710,726,786,515,26.55216218768893,25.90347549939044
9197,/media/marda/TWOTB1/xBD/hurricanes/images/florence/hurricane-florence_00000310_post_disaster.png,39,44,1,393,432,741,785,241,22.978786000151526,13.757000222508506
9198,/media/marda/TWOTB1/xBD/hurricanes/images/florence/hurricane-florence_00000310_post_disaster.png,25,42,1,316,341,752,794,170,15.18668147152784,14.922545122772338
9199,/media/marda/TWOTB1/xBD/hurricanes/images/florence/hurricane-florence_00000310_post_disaster.png,62,67,1,388,450,768,835,1040,47.56110188683371,29.15784407897626
9200,/media/marda/TWOTB1/xBD/hurricanes/images/florence/hurricane-florence_00000310_post_disaster.png,66,71,1,587,653,778,849,960,36.70933595937245,35.111578603546654
9201,/media/marda/TWOTB1/xBD/hurricanes/images/florence/hurricane-florence_00000310_post_disaster.png,52,57,1,301,353,790,847,881,45.1823964193989,26.052375614871064
9202,/media/marda/TWOTB1/xBD/hurricanes/images/florence/hurricane-florence_00000310_post_disaster.png,24,82,1,160,184,804,886,748,55.84768173715697,17.90674064853067
9203,/media/marda/TWOTB1/xBD/hurricanes/images/florence/hurricane-florence_00000310_post_disaster.png,28,76,1,218,246,810,886,648,50.13358617499247,17.257532843396632
9204,/media/marda/TWOTB1/xBD/hurricanes/images/florence/hurricane-florence_00000310_post_disaster.png,42,56,1,267,309,811,867,684,35.94583117400709,25.42210034835951
9205,/media/marda/TWOTB1/xBD/hurricanes/images/florence/hurricane-florence_00000310_post_disaster.png,38,56,1,67,105,827,883,722,40.42212426100043,23.733401117822197
9206,/media/marda/TWOTB1/xBD/hurricanes/images/florence/hurricane-florence_00000310_post_disaster.png,51,70,1,300,351,918,988,804,38.92828516054195,27.585450792722664
9207,/media/marda/TWOTB1/xBD/hurricanes/images/florence/hurricane-florence_00000310_post_disaster.png,30,66,1,166,196,975,1041,613,33.84656058249965,23.948103855020463
9208,/media/marda/TWOTB1/xBD/hurricanes/images/florence/hurricane-florence_00000310_post_disaster.png,24,61,1,0,24,977,1038,530,28.182888475664008,25.1342862309256
9209,/media/marda/TWOTB1/xBD/hurricanes/images/florence/hurricane-florence_00000366_pre_disaster.png,75,51,1,226,301,0,51,1906,68.46701234174948,36.81098625065471
9210,/media/marda/TWOTB1/xBD/hurricanes/images/florence/hurricane-florence_00000366_pre_disaster.png,79,24,1,547,626,0,24,749,54.04995098923058,20.1193364625418
9211,/media/marda/TWOTB1/xBD/hurricanes/images/florence/hurricane-florence_00000366_pre_disaster.png,19,27,1,0,19,210,237,325,21.449851951709633,20.25277990433138
9212,/media/marda/TWOTB1/xBD/hurricanes/images/florence/hurricane-florence_00000366_pre_disaster.png,37,29,1,596,633,214,243,231,23.224405687718388,13.201771450708348
9213,/media/marda/TWOTB1/xBD/hurricanes/images/florence/hurricane-florence_00000366_pre_disaster.png,102,87,1,860,962,445,532,2362,68.81784941375132,46.68922508789792
9214,/media/marda/TWOTB1/xBD/hurricanes/images/florence/hurricane-florence_00000366_pre_disaster.png,59,48,1,820,879,531,579,355,31.43307245108828,15.034071082741937
9215,/media/marda/TWOTB1/xBD/hurricanes/images/florence/hurricane-florence_00000366_pre_disaster.png,69,53,1,861,930,538,591,674,30.46853537664247,29.081524078640598
9216,/media/marda/TWOTB1/xBD/hurricanes/images/florence/hurricane-florence_00000366_pre_disaster.png,63,62,1,719,782,632,694,481,47.386294772873896,13.843590324418797
9217,/media/marda/TWOTB1/xBD/hurricanes/images/florence/hurricane-florence_00000352_post_disaster.png,40,26,1,171,211,0,26,739,35.59072302685607,27.73413441124394
9218,/media/marda/TWOTB1/xBD/hurricanes/images/florence/hurricane-florence_00000352_post_disaster.png,188,52,1,361,549,0,52,4022,173.18110881023716,42.96756007969772
9219,/media/marda/TWOTB1/xBD/hurricanes/images/florence/hurricane-florence_00000352_post_disaster.png,105,56,1,740,845,0,56,2296,69.69082190424423,47.32996044305993
9220,/media/marda/TWOTB1/xBD/hurricanes/images/florence/hurricane-florence_00000352_post_disaster.png,94,112,1,712,806,76,188,3982,121.21358931366233,43.814941583592635
9221,/media/marda/TWOTB1/xBD/hurricanes/images/florence/hurricane-florence_00000352_post_disaster.png,96,69,1,76,172,153,222,4315,98.95545327418824,57.52236532085631
9222,/media/marda/TWOTB1/xBD/hurricanes/images/florence/hurricane-florence_00000352_post_disaster.png,74,110,1,589,663,212,322,2761,92.44635808132942,44.12621245556522
9223,/media/marda/TWOTB1/xBD/hurricanes/images/florence/hurricane-florence_00000352_post_disaster.png,38,26,1,462,500,239,265,243,21.035503208699232,15.039522721839687
9224,/media/marda/TWOTB1/xBD/hurricanes/images/florence/hurricane-florence_00000352_post_disaster.png,21,31,1,67,88,275,306,242,22.900987496671853,14.127617540121596
9225,/media/marda/TWOTB1/xBD/hurricanes/images/florence/hurricane-florence_00000352_post_disaster.png,75,54,1,9,84,306,360,1932,68.2823079436978,38.60365864508905
9226,/media/marda/TWOTB1/xBD/hurricanes/images/florence/hurricane-florence_00000352_post_disaster.png,116,98,1,399,515,395,493,3875,101.34323277020412,51.002867439625824
9227,/media/marda/TWOTB1/xBD/hurricanes/images/florence/hurricane-florence_00000352_post_disaster.png,57,79,1,164,221,412,491,1773,67.91181092736089,35.33478494322828
9228,/media/marda/TWOTB1/xBD/hurricanes/images/florence/hurricane-florence_00000352_post_disaster.png,52,66,1,62,114,417,483,1584,47.993763684640165,44.03823634503984
9229,/media/marda/TWOTB1/xBD/hurricanes/images/florence/hurricane-florence_00000352_post_disaster.png,44,47,1,271,315,574,621,582,35.985519326395675,21.585023592971183
9230,/media/marda/TWOTB1/xBD/hurricanes/images/florence/hurricane-florence_00000352_post_disaster.png,62,68,1,293,355,651,719,1323,47.21611088187247,39.118221409152184
9231,/media/marda/TWOTB1/xBD/hurricanes/images/florence/hurricane-florence_00000352_post_disaster.png,24,36,1,359,383,686,722,91,13.146946016038266,9.193999426232534
9232,/media/marda/TWOTB1/xBD/hurricanes/images/florence/hurricane-florence_00000352_post_disaster.png,27,60,1,109,136,691,751,468,33.04165273948453,18.629947846448584
9233,/media/marda/TWOTB1/xBD/hurricanes/images/florence/hurricane-florence_00000352_post_disaster.png,109,90,1,261,370,740,830,3174,107.9063044806617,39.27060006199489
9234,/media/marda/TWOTB1/xBD/hurricanes/images/florence/hurricane-florence_00000352_post_disaster.png,218,160,1,826,1044,817,977,15155,194.725024382012,107.57633887572335
9235,/media/marda/TWOTB1/xBD/hurricanes/images/florence/hurricane-florence_00000352_post_disaster.png,63,81,1,182,245,837,918,1291,60.22724157915681,28.927605989323492
9236,/media/marda/TWOTB1/xBD/hurricanes/images/florence/hurricane-florence_00000352_post_disaster.png,36,58,1,113,149,890,948,258,39.12130856404113,8.709342314730298
9237,/media/marda/TWOTB1/xBD/hurricanes/images/florence/hurricane-florence_00000352_post_disaster.png,13,49,1,23,36,908,957,113,13.127366105761585,11.580561800014761
9238,/media/marda/TWOTB1/xBD/hurricanes/images/florence/hurricane-florence_00000352_post_disaster.png,62,104,1,413,475,937,1041,1420,78.16378546614278,25.739486431117815
9239,/media/marda/TWOTB1/xBD/hurricanes/images/florence/hurricane-florence_00000352_post_disaster.png,30,56,1,41,71,952,1008,257,36.08389625544336,9.27368226276682
9240,/media/marda/TWOTB1/xBD/hurricanes/images/florence/hurricane-florence_00000352_post_disaster.png,50,82,1,349,399,952,1034,1018,45.3788390986512,29.94067356946789
9241,/media/marda/TWOTB1/xBD/hurricanes/images/florence/hurricane-florence_00000352_post_disaster.png,44,59,1,19,63,961,1020,508,43.336974516328645,18.15118819496586
9242,/media/marda/TWOTB1/xBD/hurricanes/images/florence/hurricane-florence_00000352_post_disaster.png,74,53,1,717,791,990,1043,326,42.37200215300009,11.26510397196846
9243,/media/marda/TWOTB1/xBD/hurricanes/images/florence/hurricane-florence_00000541_pre_disaster.png,69,39,1,909,978,54,93,719,37.615616682390474,25.95858302217414
9244,/media/marda/TWOTB1/xBD/hurricanes/images/florence/hurricane-florence_00000541_pre_disaster.png,69,41,1,785,854,70,111,843,42.20762908594723,26.45375170837699
9245,/media/marda/TWOTB1/xBD/hurricanes/images/florence/hurricane-florence_00000541_pre_disaster.png,147,43,1,221,368,93,136,4015,154.04749630122902,34.58929800924197
9246,/media/marda/TWOTB1/xBD/hurricanes/images/florence/hurricane-florence_00000541_pre_disaster.png,59,46,1,724,783,134,180,621,38.52900961971848,25.925862374091327
9247,/media/marda/TWOTB1/xBD/hurricanes/images/florence/hurricane-florence_00000541_pre_disaster.png,65,56,1,117,182,273,329,1029,75.7532907466324,27.21945689251546
9248,/media/marda/TWOTB1/xBD/hurricanes/images/florence/hurricane-florence_00000541_pre_disaster.png,70,58,1,812,882,354,412,638,54.24130649540473,15.700573938462005
9249,/media/marda/TWOTB1/xBD/hurricanes/images/florence/hurricane-florence_00000541_pre_disaster.png,55,39,1,75,130,358,397,1053,59.23586371250829,25.00406586707964
9250,/media/marda/TWOTB1/xBD/hurricanes/images/florence/hurricane-florence_00000541_pre_disaster.png,47,43,1,389,436,527,570,599,36.036186663206344,22.202834769677676
9251,/media/marda/TWOTB1/xBD/hurricanes/images/florence/hurricane-florence_00000541_pre_disaster.png,30,42,1,392,422,560,602,297,25.38779482603211,15.571167124316975
9252,/media/marda/TWOTB1/xBD/hurricanes/images/florence/hurricane-florence_00000355_post_disaster.png,53,24,1,361,414,0,24,579,37.2164197858025,20.651737804157136
9253,/media/marda/TWOTB1/xBD/hurricanes/images/florence/hurricane-florence_00000355_post_disaster.png,44,20,1,472,516,0,20,394,26.270359023016447,20.153637261055614
9254,/media/marda/TWOTB1/xBD/hurricanes/images/florence/hurricane-florence_00000355_post_disaster.png,68,33,1,499,567,0,33,1056,53.21024226378551,26.434181445488015
9255,/media/marda/TWOTB1/xBD/hurricanes/images/florence/hurricane-florence_00000355_post_disaster.png,44,39,1,0,44,41,80,1107,42.962139447611705,36.67745183801453
9256,/media/marda/TWOTB1/xBD/hurricanes/images/florence/hurricane-florence_00000355_post_disaster.png,73,47,1,588,661,44,91,1375,53.33062357087236,42.27256929379782
9257,/media/marda/TWOTB1/xBD/hurricanes/images/florence/hurricane-florence_00000355_post_disaster.png,72,37,1,478,550,58,95,1085,55.36824963590276,27.479792425720706
9258,/media/marda/TWOTB1/xBD/hurricanes/images/florence/hurricane-florence_00000355_post_disaster.png,45,15,1,744,789,84,99,179,17.391065425168474,13.738322508292914
9259,/media/marda/TWOTB1/xBD/hurricanes/images/florence/hurricane-florence_00000355_post_disaster.png,80,22,1,682,762,90,112,602,60.09029314107267,13.375258278154103
9260,/media/marda/TWOTB1/xBD/hurricanes/images/florence/hurricane-florence_00000355_post_disaster.png,56,45,1,643,699,99,144,888,44.179095098213544,26.86932413732373
9261,/media/marda/TWOTB1/xBD/hurricanes/images/florence/hurricane-florence_00000355_post_disaster.png,11,18,1,62,73,98,116,128,14.083781797420853,12.248151185796862
9262,/media/marda/TWOTB1/xBD/hurricanes/images/florence/hurricane-florence_00000355_post_disaster.png,47,31,1,744,791,115,146,341,28.551349404742353,16.623284634816113
9263,/media/marda/TWOTB1/xBD/hurricanes/images/florence/hurricane-florence_00000355_post_disaster.png,54,44,1,104,158,130,174,1360,49.6295686242749,36.46041439455081
9264,/media/marda/TWOTB1/xBD/hurricanes/images/florence/hurricane-florence_00000355_post_disaster.png,53,40,1,197,250,159,199,999,44.87671782085913,29.301662539515736
9265,/media/marda/TWOTB1/xBD/hurricanes/images/florence/hurricane-florence_00000355_post_disaster.png,16,14,1,181,197,181,195,73,12.074988443997864,8.199740847595674
9266,/media/marda/TWOTB1/xBD/hurricanes/images/florence/hurricane-florence_00000355_post_disaster.png,22,21,1,120,142,184,205,200,17.06719873492919,15.216199503898192
9267,/media/marda/TWOTB1/xBD/hurricanes/images/florence/hurricane-florence_00000355_post_disaster.png,70,98,1,502,572,202,300,2522,93.58075942605034,43.110892529222035
9268,/media/marda/TWOTB1/xBD/hurricanes/images/florence/hurricane-florence_00000355_post_disaster.png,67,41,1,566,633,254,295,1097,48.66403595022038,30.551738812959726
9269,/media/marda/TWOTB1/xBD/hurricanes/images/florence/hurricane-florence_00000355_post_disaster.png,54,64,1,457,511,263,327,1107,57.913712127530246,28.106541046111555
9270,/media/marda/TWOTB1/xBD/hurricanes/images/florence/hurricane-florence_00000355_post_disaster.png,47,33,1,566,613,290,323,566,28.44831173355895,26.581343070250497
9271,/media/marda/TWOTB1/xBD/hurricanes/images/florence/hurricane-florence_00000355_post_disaster.png,76,66,1,527,603,559,625,1669,57.3041396100671,39.45563077410503
9272,/media/marda/TWOTB1/xBD/hurricanes/images/florence/hurricane-florence_00000355_post_disaster.png,38,40,1,590,628,560,600,143,21.02059269711857,9.156920439143402
9273,/media/marda/TWOTB1/xBD/hurricanes/images/florence/hurricane-florence_00000355_post_disaster.png,39,40,1,599,638,564,604,171,20.03703877780537,11.464586543209995
9274,/media/marda/TWOTB1/xBD/hurricanes/images/florence/hurricane-florence_00000355_post_disaster.png,32,46,1,280,312,589,635,364,26.879222761341435,18.118791970919787
9275,/media/marda/TWOTB1/xBD/hurricanes/images/florence/hurricane-florence_00000355_post_disaster.png,73,58,1,596,669,590,648,1096,52.795451817441574,27.506375760532016
9276,/media/marda/TWOTB1/xBD/hurricanes/images/florence/hurricane-florence_00000355_post_disaster.png,73,67,1,296,369,603,670,1540,65.47666855266382,31.259777581396825
9277,/media/marda/TWOTB1/xBD/hurricanes/images/florence/hurricane-florence_00000355_post_disaster.png,40,36,1,693,733,651,687,92,11.897579155022553,10.463166633322091
9278,/media/marda/TWOTB1/xBD/hurricanes/images/florence/hurricane-florence_00000355_post_disaster.png,46,55,1,722,768,659,714,318,33.668522008710504,12.636791023998008
9279,/media/marda/TWOTB1/xBD/hurricanes/images/florence/hurricane-florence_00000355_post_disaster.png,45,52,1,213,258,661,713,628,38.713872282892446,21.553127896495337
9280,/media/marda/TWOTB1/xBD/hurricanes/images/florence/hurricane-florence_00000355_post_disaster.png,51,73,1,646,697,682,755,589,55.15653382670004,14.25208060919482
9281,/media/marda/TWOTB1/xBD/hurricanes/images/florence/hurricane-florence_00000355_post_disaster.png,54,87,1,677,731,886,973,704,55.83866310346142,16.842804589928
9282,/media/marda/TWOTB1/xBD/hurricanes/images/florence/hurricane-florence_00000355_post_disaster.png,55,61,1,739,794,982,1043,375,25.339406102916676,19.823581437725522
9283,/media/marda/TWOTB1/xBD/hurricanes/images/florence/hurricane-florence_00000355_post_disaster.png,51,53,1,708,759,990,1043,209,22.410014711728817,12.628659933065308
9284,/media/marda/TWOTB1/xBD/hurricanes/images/florence/hurricane-florence_00000523_post_disaster.png,299,83,1,560,859,708,791,10350,315.0132596762856,44.541138612267105
9285,/media/marda/TWOTB1/xBD/hurricanes/images/florence/hurricane-florence_00000414_pre_disaster.png,28,77,1,0,28,374,451,1023,64.26086885430524,24.16305433123162
9286,/media/marda/TWOTB1/xBD/hurricanes/images/florence/hurricane-florence_00000414_pre_disaster.png,68,64,1,278,346,459,523,1013,68.09447619322708,19.812087973583893
9287,/media/marda/TWOTB1/xBD/hurricanes/images/florence/hurricane-florence_00000414_pre_disaster.png,55,76,1,2,57,549,625,1729,48.590431864098456,47.14381011971242
9288,/media/marda/TWOTB1/xBD/hurricanes/images/florence/hurricane-florence_00000158_post_disaster.png,33,20,1,345,378,95,115,231,18.33963226292025,16.641206497149536
9289,/media/marda/TWOTB1/xBD/hurricanes/images/florence/hurricane-florence_00000158_post_disaster.png,46,83,1,214,260,883,966,1291,48.85894589726755,35.41909528928282
9290,/media/marda/TWOTB1/xBD/hurricanes/images/florence/hurricane-florence_00000158_post_disaster.png,21,52,1,160,181,894,946,214,17.869574528157468,15.979182040003142
9291,/media/marda/TWOTB1/xBD/hurricanes/images/florence/hurricane-florence_00000158_post_disaster.png,27,66,1,279,306,968,1034,384,31.18127310278146,16.366692264348
9292,/media/marda/TWOTB1/xBD/hurricanes/images/florence/hurricane-florence_00000538_post_disaster.png,14,43,1,90,104,810,853,78,11.627857549469228,9.041581375319053
9293,/media/marda/TWOTB1/xBD/hurricanes/images/florence/hurricane-florence_00000048_post_disaster.png,52,17,1,819,871,100,117,153,20.679019046218635,9.947378769401757
9294,/media/marda/TWOTB1/xBD/hurricanes/images/florence/hurricane-florence_00000048_post_disaster.png,50,22,1,822,872,113,135,222,18.372095933043052,15.853595015783455
9295,/media/marda/TWOTB1/xBD/hurricanes/images/florence/hurricane-florence_00000048_post_disaster.png,68,35,1,837,905,127,162,745,37.078028451554395,26.622563074516332
9296,/media/marda/TWOTB1/xBD/hurricanes/images/florence/hurricane-florence_00000048_post_disaster.png,97,42,1,937,1034,202,244,1320,64.34170524908447,27.17903278830065
9297,/media/marda/TWOTB1/xBD/hurricanes/images/florence/hurricane-florence_00000048_post_disaster.png,69,43,1,820,889,175,218,1003,41.62143490661008,32.27594501742541
9298,/media/marda/TWOTB1/xBD/hurricanes/images/florence/hurricane-florence_00000048_post_disaster.png,83,66,1,892,975,457,523,1523,56.52612012147668,36.61948331430955
9299,/media/marda/TWOTB1/xBD/hurricanes/images/florence/hurricane-florence_00000048_post_disaster.png,56,39,1,987,1043,493,532,198,19.521028275192556,15.911138522166869
9300,/media/marda/TWOTB1/xBD/hurricanes/images/florence/hurricane-florence_00000048_post_disaster.png,70,45,1,961,1031,512,557,517,31.64085605318583,22.232598213799147
9301,/media/marda/TWOTB1/xBD/hurricanes/images/florence/hurricane-florence_00000048_post_disaster.png,69,68,1,923,992,558,626,1054,51.73334155596273,27.59006607639583
9302,/media/marda/TWOTB1/xBD/hurricanes/images/florence/hurricane-florence_00000048_post_disaster.png,50,57,1,55,105,27,84,1428,59.11490115194969,32.213191087006464
9303,/media/marda/TWOTB1/xBD/hurricanes/images/florence/hurricane-florence_00000048_post_disaster.png,52,46,1,95,147,98,144,1140,40.98416886424853,37.25317689884272
9304,/media/marda/TWOTB1/xBD/hurricanes/images/florence/hurricane-florence_00000048_post_disaster.png,47,44,1,371,418,296,340,551,29.722846628150094,24.518495377536325
9305,/media/marda/TWOTB1/xBD/hurricanes/images/florence/hurricane-florence_00000048_post_disaster.png,93,56,1,584,677,411,467,1583,78.84235414260321,26.577122543435074
9306,/media/marda/TWOTB1/xBD/hurricanes/images/florence/hurricane-florence_00000048_post_disaster.png,40,27,1,677,717,461,488,103,15.338656118981161,9.074622781095094
9307,/media/marda/TWOTB1/xBD/hurricanes/images/florence/hurricane-florence_00000048_post_disaster.png,36,24,1,636,672,484,508,60,13.129567844765273,6.187173415734562
9308,/media/marda/TWOTB1/xBD/hurricanes/images/florence/hurricane-florence_00000048_post_disaster.png,57,45,1,651,708,502,547,530,34.2588089988067,20.572255099735315
9309,/media/marda/TWOTB1/xBD/hurricanes/images/florence/hurricane-florence_00000048_post_disaster.png,91,61,1,844,935,520,581,1348,61.152692411575025,30.094149995932597
9310,/media/marda/TWOTB1/xBD/hurricanes/images/florence/hurricane-florence_00000048_post_disaster.png,51,29,1,877,928,525,554,93,18.84473770022277,6.713702627344354
9311,/media/marda/TWOTB1/xBD/hurricanes/images/florence/hurricane-florence_00000048_post_disaster.png,50,34,1,953,1003,533,567,146,15.099192969997954,13.027394282501419
9312,/media/marda/TWOTB1/xBD/hurricanes/images/florence/hurricane-florence_00000048_post_disaster.png,66,51,1,668,734,538,589,862,41.12609113554211,27.987718734129356
9313,/media/marda/TWOTB1/xBD/hurricanes/images/florence/hurricane-florence_00000048_post_disaster.png,65,52,1,890,955,555,607,573,30.676781218133875,24.841822849266343
9314,/media/marda/TWOTB1/xBD/hurricanes/images/florence/hurricane-florence_00000048_post_disaster.png,80,60,1,834,914,584,644,1262,45.771035272995604,36.798948469258704
9315,/media/marda/TWOTB1/xBD/hurricanes/images/florence/hurricane-florence_00000410_post_disaster.png,72,75,1,562,634,11,86,2021,72.28813849830638,42.8443304289184
9316,/media/marda/TWOTB1/xBD/hurricanes/images/florence/hurricane-florence_00000410_post_disaster.png,70,63,1,509,579,13,76,1785,58.035035043555425,43.200060864472945
9317,/media/marda/TWOTB1/xBD/hurricanes/images/florence/hurricane-florence_00000410_post_disaster.png,58,68,1,89,147,30,98,2013,70.11052417539277,40.434847134549095
9318,/media/marda/TWOTB1/xBD/hurricanes/images/florence/hurricane-florence_00000410_post_disaster.png,71,44,1,668,739,39,83,1499,49.12600246901457,41.81474412043212
9319,/media/marda/TWOTB1/xBD/hurricanes/images/florence/hurricane-florence_00000410_post_disaster.png,82,63,1,195,277,144,207,2234,67.90695104298337,46.91794785960259
9320,/media/marda/TWOTB1/xBD/hurricanes/images/florence/hurricane-florence_00000410_post_disaster.png,66,74,1,565,631,156,230,2061,70.8823667890095,43.64084807714724
9321,/media/marda/TWOTB1/xBD/hurricanes/images/florence/hurricane-florence_00000410_post_disaster.png,92,67,1,781,873,163,230,2054,67.28614794432168,43.27857793438905
9322,/media/marda/TWOTB1/xBD/hurricanes/images/florence/hurricane-florence_00000410_post_disaster.png,69,71,1,614,683,173,244,1946,64.3469544755509,42.2166903507388
9323,/media/marda/TWOTB1/xBD/hurricanes/images/florence/hurricane-florence_00000410_post_disaster.png,85,71,1,750,835,190,261,1979,60.34629107212353,46.150726133086046
9324,/media/marda/TWOTB1/xBD/hurricanes/images/florence/hurricane-florence_00000410_post_disaster.png,92,74,1,258,350,220,294,2730,85.31130409249766,46.422592570249975
9325,/media/marda/TWOTB1/xBD/hurricanes/images/florence/hurricane-florence_00000410_post_disaster.png,94,74,1,657,751,251,325,2248,74.03437618942256,42.36491665072459
9326,/media/marda/TWOTB1/xBD/hurricanes/images/florence/hurricane-florence_00000410_post_disaster.png,56,75,1,335,391,375,450,1947,63.3755906990329,43.30317825837319
9327,/media/marda/TWOTB1/xBD/hurricanes/images/florence/hurricane-florence_00000410_post_disaster.png,63,69,1,980,1043,375,444,746,49.793602821242736,22.37692392660112
9328,/media/marda/TWOTB1/xBD/hurricanes/images/florence/hurricane-florence_00000410_post_disaster.png,99,88,1,911,1010,433,521,2392,65.10371796063588,51.0971364602944
9329,/media/marda/TWOTB1/xBD/hurricanes/images/florence/hurricane-florence_00000410_post_disaster.png,73,81,1,716,789,549,630,2044,61.441751385713154,47.110502267649515
9330,/media/marda/TWOTB1/xBD/hurricanes/images/florence/hurricane-florence_00000410_post_disaster.png,82,81,1,635,717,562,643,2323,66.36046122199421,49.49538319458709
9331,/media/marda/TWOTB1/xBD/hurricanes/images/florence/hurricane-florence_00000410_post_disaster.png,74,69,1,538,612,578,647,1893,55.19573211408683,46.198112013830624
9332,/media/marda/TWOTB1/xBD/hurricanes/images/florence/hurricane-florence_00000410_post_disaster.png,87,105,1,769,856,692,797,2258,73.03462258105503,46.51115037616103
9333,/media/marda/TWOTB1/xBD/hurricanes/images/florence/hurricane-florence_00000410_post_disaster.png,16,58,1,0,16,704,762,465,34.623017678764825,17.887865955618757
9334,/media/marda/TWOTB1/xBD/hurricanes/images/florence/hurricane-florence_00000397_post_disaster.png,25,22,1,260,285,99,121,188,18.19734328107228,13.452033135317974
9335,/media/marda/TWOTB1/xBD/hurricanes/images/florence/hurricane-florence_00000397_post_disaster.png,36,24,1,568,604,291,315,128,13.51390863960617,12.693473649099278
9336,/media/marda/TWOTB1/xBD/hurricanes/images/florence/hurricane-florence_00000397_post_disaster.png,62,29,1,489,551,295,324,444,50.79524778389715,11.693822687331352
9337,/media/marda/TWOTB1/xBD/hurricanes/images/florence/hurricane-florence_00000397_post_disaster.png,35,28,1,570,605,305,333,120,13.175070703760273,12.227281007640524
9338,/media/marda/TWOTB1/xBD/hurricanes/images/florence/hurricane-florence_00000397_post_disaster.png,41,47,1,286,327,377,424,570,35.99068590592028,20.922672455895206
9339,/media/marda/TWOTB1/xBD/hurricanes/images/florence/hurricane-florence_00000397_post_disaster.png,41,60,1,354,395,437,497,567,48.43011466062795,17.30893205030234
9340,/media/marda/TWOTB1/xBD/hurricanes/images/florence/hurricane-florence_00000397_post_disaster.png,33,48,1,74,107,438,486,630,31.61247286444082,27.127535075900497
9341,/media/marda/TWOTB1/xBD/hurricanes/images/florence/hurricane-florence_00000397_post_disaster.png,37,60,1,154,191,439,499,858,43.42053267270516,25.98467824177049
9342,/media/marda/TWOTB1/xBD/hurricanes/images/florence/hurricane-florence_00000397_post_disaster.png,33,40,1,180,213,497,537,259,27.96702148995527,12.387652876996928
9343,/media/marda/TWOTB1/xBD/hurricanes/images/florence/hurricane-florence_00000397_post_disaster.png,54,62,1,256,310,501,563,959,44.61292866780315,28.978463267502296
9344,/media/marda/TWOTB1/xBD/hurricanes/images/florence/hurricane-florence_00000397_post_disaster.png,50,61,1,295,345,511,572,915,43.68897733929841,27.29553245343941
9345,/media/marda/TWOTB1/xBD/hurricanes/images/florence/hurricane-florence_00000397_post_disaster.png,45,52,1,393,438,553,605,536,29.359873488531218,24.022963012145453
9346,/media/marda/TWOTB1/xBD/hurricanes/images/florence/hurricane-florence_00000397_post_disaster.png,89,65,1,892,981,554,619,1206,54.010670512889,30.08736228869229
9347,/media/marda/TWOTB1/xBD/hurricanes/images/florence/hurricane-florence_00000397_post_disaster.png,52,71,1,281,333,580,651,1020,54.424830440678946,24.97885872521454
9348,/media/marda/TWOTB1/xBD/hurricanes/images/florence/hurricane-florence_00000397_post_disaster.png,53,38,1,882,935,589,627,160,16.535641732383528,12.802345585800134
9349,/media/marda/TWOTB1/xBD/hurricanes/images/florence/hurricane-florence_00000397_post_disaster.png,63,59,1,440,503,590,649,610,56.169946273594434,14.45707322773836
9350,/media/marda/TWOTB1/xBD/hurricanes/images/florence/hurricane-florence_00000397_post_disaster.png,182,292,1,0,182,593,885,31139,247.84835095959056,172.44253419874374
9351,/media/marda/TWOTB1/xBD/hurricanes/images/florence/hurricane-florence_00000397_post_disaster.png,47,48,1,452,499,614,662,424,32.976309716112176,17.08819717621214
9352,/media/marda/TWOTB1/xBD/hurricanes/images/florence/hurricane-florence_00000397_post_disaster.png,48,67,1,457,505,639,706,488,50.80328406413628,12.851962055457534
9353,/media/marda/TWOTB1/xBD/hurricanes/images/florence/hurricane-florence_00000397_post_disaster.png,74,78,1,750,824,645,723,842,64.32391695434463,17.493688894649125
9354,/media/marda/TWOTB1/xBD/hurricanes/images/florence/hurricane-florence_00000397_post_disaster.png,53,73,1,500,553,699,772,845,43.013028931138265,28.693745158627678
9355,/media/marda/TWOTB1/xBD/hurricanes/images/florence/hurricane-florence_00000397_post_disaster.png,78,63,1,689,767,701,764,745,54.52620797545306,19.3354135808187
9356,/media/marda/TWOTB1/xBD/hurricanes/images/florence/hurricane-florence_00000397_post_disaster.png,42,41,1,674,716,723,764,116,14.030798276767502,10.93804650881068
9357,/media/marda/TWOTB1/xBD/hurricanes/images/florence/hurricane-florence_00000397_post_disaster.png,65,77,1,833,898,735,812,850,48.84726231756758,23.460689422133072
9358,/media/marda/TWOTB1/xBD/hurricanes/images/florence/hurricane-florence_00000397_post_disaster.png,59,68,1,584,643,761,829,698,35.68448437531636,31.245734939230054
9359,/media/marda/TWOTB1/xBD/hurricanes/images/florence/hurricane-florence_00000397_post_disaster.png,55,63,1,394,449,900,963,599,35.718335051772165,22.963159327898676
9360,/media/marda/TWOTB1/xBD/hurricanes/images/florence/hurricane-florence_00000397_post_disaster.png,45,69,1,368,413,962,1031,442,38.13378257934068,15.449546341987782
9361,/media/marda/TWOTB1/xBD/hurricanes/images/florence/hurricane-florence_00000099_pre_disaster.png,64,26,1,896,960,0,26,585,29.12880237501685,26.863927682438007
9362,/media/marda/TWOTB1/xBD/hurricanes/images/florence/hurricane-florence_00000099_pre_disaster.png,64,33,1,885,949,36,69,707,34.2258069974262,27.524606452083404
9363,/media/marda/TWOTB1/xBD/hurricanes/images/florence/hurricane-florence_00000099_pre_disaster.png,63,15,1,865,928,82,97,258,32.36575335211579,10.62640494980332
9364,/media/marda/TWOTB1/xBD/hurricanes/images/florence/hurricane-florence_00000099_pre_disaster.png,69,45,1,873,942,179,224,1007,44.665747794569796,30.675967847525428
9365,/media/marda/TWOTB1/xBD/hurricanes/images/florence/hurricane-florence_00000099_pre_disaster.png,46,22,1,817,863,194,216,187,19.075350823278317,13.196067428542962
9366,/media/marda/TWOTB1/xBD/hurricanes/images/florence/hurricane-florence_00000099_pre_disaster.png,53,26,1,844,897,203,229,240,21.931313172570473,14.59153111583615
9367,/media/marda/TWOTB1/xBD/hurricanes/images/florence/hurricane-florence_00000099_pre_disaster.png,64,55,1,943,1007,297,352,961,46.60221296515269,27.34806557353392
9368,/media/marda/TWOTB1/xBD/hurricanes/images/florence/hurricane-florence_00000099_pre_disaster.png,64,36,1,980,1044,298,334,469,26.9788830375314,23.06920904417867
9369,/media/marda/TWOTB1/xBD/hurricanes/images/florence/hurricane-florence_00000099_pre_disaster.png,46,22,1,918,964,354,376,96,11.707458005610095,10.725813066419022
9370,/media/marda/TWOTB1/xBD/hurricanes/images/florence/hurricane-florence_00000099_pre_disaster.png,82,133,1,907,989,415,548,3059,129.30643776898967,31.207552317552977
9371,/media/marda/TWOTB1/xBD/hurricanes/images/florence/hurricane-florence_00000099_pre_disaster.png,73,47,1,971,1044,423,470,803,40.11152375792896,27.394174011910128
9372,/media/marda/TWOTB1/xBD/hurricanes/images/florence/hurricane-florence_00000099_pre_disaster.png,152,77,1,785,937,500,577,3012,136.2897858389204,30.244091497660467
9373,/media/marda/TWOTB1/xBD/hurricanes/images/florence/hurricane-florence_00000099_pre_disaster.png,85,110,1,752,837,559,669,2497,99.65027106382205,34.07540324238383
9374,/media/marda/TWOTB1/xBD/hurricanes/images/florence/hurricane-florence_00000099_pre_disaster.png,85,100,1,912,997,564,664,1972,87.29018854846132,30.93202489778951
9375,/media/marda/TWOTB1/xBD/hurricanes/images/florence/hurricane-florence_00000099_pre_disaster.png,152,82,1,807,959,616,698,3208,133.97250670087124,32.96101398516994
9376,/media/marda/TWOTB1/xBD/hurricanes/images/florence/hurricane-florence_00000099_pre_disaster.png,83,60,1,896,979,664,724,1004,47.18004947569203,28.405205165167107
9377,/media/marda/TWOTB1/xBD/hurricanes/images/florence/hurricane-florence_00000099_pre_disaster.png,46,65,1,23,69,803,868,960,49.52491975679399,25.615611359195356
9378,/media/marda/TWOTB1/xBD/hurricanes/images/florence/hurricane-florence_00000099_pre_disaster.png,21,58,1,74,95,810,868,440,27.229313794824265,21.387789229236223
9379,/media/marda/TWOTB1/xBD/hurricanes/images/florence/hurricane-florence_00000099_pre_disaster.png,42,60,1,123,165,821,881,594,40.15813265554684,19.756373164358926
9380,/media/marda/TWOTB1/xBD/hurricanes/images/florence/hurricane-florence_00000099_pre_disaster.png,6,52,1,0,6,881,933,74,20.71048362687942,5.305486169952909
9381,/media/marda/TWOTB1/xBD/hurricanes/images/florence/hurricane-florence_00000099_pre_disaster.png,82,101,1,142,224,941,1042,3688,74.86160378014341,65.98543893888574
9382,/media/marda/TWOTB1/xBD/hurricanes/images/florence/hurricane-florence_00000099_pre_disaster.png,23,61,1,0,23,944,1005,406,25.563048453877798,21.30585869830455
9383,/media/marda/TWOTB1/xBD/hurricanes/images/florence/hurricane-florence_00000099_pre_disaster.png,20,56,1,86,106,957,1013,220,18.684499617365383,15.747392899765407
9384,/media/marda/TWOTB1/xBD/hurricanes/images/florence/hurricane-florence_00000337_pre_disaster.png,52,58,1,422,474,340,398,923,47.22762701965762,26.09414194447562
9385,/media/marda/TWOTB1/xBD/hurricanes/images/florence/hurricane-florence_00000337_pre_disaster.png,36,38,1,147,183,386,424,459,34.830860326340385,18.101978410143634
9386,/media/marda/TWOTB1/xBD/hurricanes/images/florence/hurricane-florence_00000337_pre_disaster.png,61,48,1,269,330,398,446,865,55.03800164173448,20.982974339488607
9387,/media/marda/TWOTB1/xBD/hurricanes/images/florence/hurricane-florence_00000337_pre_disaster.png,58,46,1,477,535,408,454,782,39.35289926083516,27.142161483554602
9388,/media/marda/TWOTB1/xBD/hurricanes/images/florence/hurricane-florence_00000337_pre_disaster.png,34,59,1,167,201,412,471,803,45.00220880081479,23.770887101113175
9389,/media/marda/TWOTB1/xBD/hurricanes/images/florence/hurricane-florence_00000337_pre_disaster.png,51,51,1,490,541,440,491,726,32.81315921907853,29.206521577461757
9390,/media/marda/TWOTB1/xBD/hurricanes/images/florence/hurricane-florence_00000337_pre_disaster.png,38,34,1,420,458,460,494,289,23.372854799755896,16.580449944649413
9391,/media/marda/TWOTB1/xBD/hurricanes/images/florence/hurricane-florence_00000337_pre_disaster.png,60,71,1,499,559,522,593,1129,52.49219002287832,29.314184007990672
9392,/media/marda/TWOTB1/xBD/hurricanes/images/florence/hurricane-florence_00000337_pre_disaster.png,47,86,1,283,330,568,654,1362,71.75659600692273,25.996652754473892
9393,/media/marda/TWOTB1/xBD/hurricanes/images/florence/hurricane-florence_00000337_pre_disaster.png,47,68,1,528,575,586,654,596,53.88929500992743,14.786196268903145
9394,/media/marda/TWOTB1/xBD/hurricanes/images/florence/hurricane-florence_00000337_pre_disaster.png,44,46,1,635,679,801,847,150,21.19261606668809,9.532361362162199
9395,/media/marda/TWOTB1/xBD/hurricanes/images/florence/hurricane-florence_00000337_pre_disaster.png,61,51,1,634,695,812,863,460,39.61294910428876,15.308570641790059
9396,/media/marda/TWOTB1/xBD/hurricanes/images/florence/hurricane-florence_00000337_pre_disaster.png,54,97,1,351,405,825,922,1446,70.71035565499116,27.956500574675978
9397,/media/marda/TWOTB1/xBD/hurricanes/images/florence/hurricane-florence_00000341_pre_disaster.png,27,41,1,164,191,547,588,231,21.85575072531238,14.130866293741722
9398,/media/marda/TWOTB1/xBD/hurricanes/images/florence/hurricane-florence_00000341_pre_disaster.png,166,168,1,147,313,559,727,8744,184.17402359608755,63.74967726987223
9399,/media/marda/TWOTB1/xBD/hurricanes/images/florence/hurricane-florence_00000341_pre_disaster.png,162,170,1,89,251,615,785,7889,198.01296617828808,52.959830765200685
9400,/media/marda/TWOTB1/xBD/hurricanes/images/florence/hurricane-florence_00000341_pre_disaster.png,155,166,1,38,193,675,841,7464,191.75747030078492,51.77958815366529
9401,/media/marda/TWOTB1/xBD/hurricanes/images/florence/hurricane-florence_00000195_post_disaster.png,55,14,1,795,850,0,14,192,20.461527752147752,13.241690794745319
9402,/media/marda/TWOTB1/xBD/hurricanes/images/florence/hurricane-florence_00000195_post_disaster.png,26,46,1,93,119,583,629,424,26.419242626650703,21.518992793819027
9403,/media/marda/TWOTB1/xBD/hurricanes/images/florence/hurricane-florence_00000195_post_disaster.png,27,38,1,199,226,618,656,148,19.32470149602018,10.296376622345113
9404,/media/marda/TWOTB1/xBD/hurricanes/images/florence/hurricane-florence_00000195_post_disaster.png,77,78,1,146,223,627,705,1824,75.92818153840848,38.16229760848169
9405,/media/marda/TWOTB1/xBD/hurricanes/images/florence/hurricane-florence_00000195_post_disaster.png,44,52,1,282,326,643,695,526,31.78491070780989,23.78498889781097
9406,/media/marda/TWOTB1/xBD/hurricanes/images/florence/hurricane-florence_00000195_post_disaster.png,56,67,1,99,155,758,825,1236,58.34264692996903,27.86410348724796
9407,/media/marda/TWOTB1/xBD/hurricanes/images/florence/hurricane-florence_00000195_post_disaster.png,31,62,1,140,171,981,1043,354,24.30620583171802,19.375250212175455
9408,/media/marda/TWOTB1/xBD/hurricanes/images/florence/hurricane-florence_00000195_post_disaster.png,21,51,1,172,193,992,1043,112,15.23090069314117,10.333125887469107
9409,/media/marda/TWOTB1/xBD/hurricanes/images/florence/hurricane-florence_00000355_pre_disaster.png,53,24,1,361,414,0,24,579,37.2164197858025,20.651737804157136
9410,/media/marda/TWOTB1/xBD/hurricanes/images/florence/hurricane-florence_00000355_pre_disaster.png,44,20,1,472,516,0,20,394,26.270359023016447,20.153637261055614
9411,/media/marda/TWOTB1/xBD/hurricanes/images/florence/hurricane-florence_00000355_pre_disaster.png,68,33,1,499,567,0,33,1056,53.21024226378551,26.434181445488015
9412,/media/marda/TWOTB1/xBD/hurricanes/images/florence/hurricane-florence_00000355_pre_disaster.png,44,39,1,0,44,41,80,1107,42.962139447611705,36.67745183801453
9413,/media/marda/TWOTB1/xBD/hurricanes/images/florence/hurricane-florence_00000355_pre_disaster.png,73,47,1,588,661,44,91,1375,53.33062357087236,42.27256929379782
9414,/media/marda/TWOTB1/xBD/hurricanes/images/florence/hurricane-florence_00000355_pre_disaster.png,72,37,1,478,550,58,95,1085,55.36824963590276,27.479792425720706
9415,/media/marda/TWOTB1/xBD/hurricanes/images/florence/hurricane-florence_00000355_pre_disaster.png,45,15,1,744,789,84,99,179,17.391065425168474,13.738322508292914
9416,/media/marda/TWOTB1/xBD/hurricanes/images/florence/hurricane-florence_00000355_pre_disaster.png,80,22,1,682,762,90,112,602,60.09029314107267,13.375258278154103
9417,/media/marda/TWOTB1/xBD/hurricanes/images/florence/hurricane-florence_00000355_pre_disaster.png,56,45,1,643,699,99,144,888,44.179095098213544,26.86932413732373
9418,/media/marda/TWOTB1/xBD/hurricanes/images/florence/hurricane-florence_00000355_pre_disaster.png,11,18,1,62,73,98,116,128,14.083781797420853,12.248151185796862
9419,/media/marda/TWOTB1/xBD/hurricanes/images/florence/hurricane-florence_00000355_pre_disaster.png,47,31,1,744,791,115,146,354,28.196777657903475,17.499198533521312
9420,/media/marda/TWOTB1/xBD/hurricanes/images/florence/hurricane-florence_00000355_pre_disaster.png,54,44,1,104,158,130,174,1360,49.6295686242749,36.46041439455081
9421,/media/marda/TWOTB1/xBD/hurricanes/images/florence/hurricane-florence_00000355_pre_disaster.png,53,40,1,197,250,159,199,999,44.87671782085913,29.301662539515736
9422,/media/marda/TWOTB1/xBD/hurricanes/images/florence/hurricane-florence_00000355_pre_disaster.png,16,14,1,181,197,181,195,73,12.074988443997864,8.199740847595674
9423,/media/marda/TWOTB1/xBD/hurricanes/images/florence/hurricane-florence_00000355_pre_disaster.png,22,21,1,120,142,184,205,200,17.06719873492919,15.216199503898192
9424,/media/marda/TWOTB1/xBD/hurricanes/images/florence/hurricane-florence_00000355_pre_disaster.png,70,98,1,502,572,202,300,2522,93.58075942605034,43.110892529222035
9425,/media/marda/TWOTB1/xBD/hurricanes/images/florence/hurricane-florence_00000355_pre_disaster.png,67,41,1,566,633,254,295,1097,48.66403595022038,30.551738812959726
9426,/media/marda/TWOTB1/xBD/hurricanes/images/florence/hurricane-florence_00000355_pre_disaster.png,54,64,1,457,511,263,327,1107,57.913712127530246,28.106541046111555
9427,/media/marda/TWOTB1/xBD/hurricanes/images/florence/hurricane-florence_00000355_pre_disaster.png,47,33,1,566,613,290,323,566,28.44831173355895,26.581343070250497
9428,/media/marda/TWOTB1/xBD/hurricanes/images/florence/hurricane-florence_00000355_pre_disaster.png,76,66,1,527,603,559,625,1669,57.3041396100671,39.45563077410503
9429,/media/marda/TWOTB1/xBD/hurricanes/images/florence/hurricane-florence_00000355_pre_disaster.png,38,40,1,590,628,560,600,143,21.02059269711857,9.156920439143402
9430,/media/marda/TWOTB1/xBD/hurricanes/images/florence/hurricane-florence_00000355_pre_disaster.png,39,40,1,599,638,564,604,171,20.03703877780537,11.464586543209995
9431,/media/marda/TWOTB1/xBD/hurricanes/images/florence/hurricane-florence_00000355_pre_disaster.png,32,46,1,280,312,589,635,364,26.879222761341435,18.118791970919787
9432,/media/marda/TWOTB1/xBD/hurricanes/images/florence/hurricane-florence_00000355_pre_disaster.png,73,58,1,596,669,590,648,1096,52.795451817441574,27.506375760532016
9433,/media/marda/TWOTB1/xBD/hurricanes/images/florence/hurricane-florence_00000355_pre_disaster.png,73,67,1,296,369,603,670,1540,65.47666855266382,31.259777581396825
9434,/media/marda/TWOTB1/xBD/hurricanes/images/florence/hurricane-florence_00000355_pre_disaster.png,40,36,1,693,733,651,687,92,11.897579155022553,10.463166633322091
9435,/media/marda/TWOTB1/xBD/hurricanes/images/florence/hurricane-florence_00000355_pre_disaster.png,46,55,1,722,768,659,714,318,33.668522008710504,12.636791023998008
9436,/media/marda/TWOTB1/xBD/hurricanes/images/florence/hurricane-florence_00000355_pre_disaster.png,45,52,1,213,258,661,713,628,38.713872282892446,21.553127896495337
9437,/media/marda/TWOTB1/xBD/hurricanes/images/florence/hurricane-florence_00000355_pre_disaster.png,51,73,1,646,697,682,755,589,55.15653382670004,14.25208060919482
9438,/media/marda/TWOTB1/xBD/hurricanes/images/florence/hurricane-florence_00000355_pre_disaster.png,54,87,1,677,731,886,973,704,55.83866310346142,16.842804589928
9439,/media/marda/TWOTB1/xBD/hurricanes/images/florence/hurricane-florence_00000355_pre_disaster.png,55,62,1,739,794,982,1044,398,25.400476332676188,20.855683537521717
9440,/media/marda/TWOTB1/xBD/hurricanes/images/florence/hurricane-florence_00000355_pre_disaster.png,51,54,1,708,759,990,1044,223,21.988996832459463,13.700303639565604
9441,/media/marda/TWOTB1/xBD/hurricanes/images/florence/hurricane-florence_00000028_pre_disaster.png,55,75,1,175,230,0,75,1874,86.28004894363134,28.75431044710954
9442,/media/marda/TWOTB1/xBD/hurricanes/images/florence/hurricane-florence_00000028_pre_disaster.png,37,5,1,483,520,0,5,49,18.247147302663898,4.116935005620088
9443,/media/marda/TWOTB1/xBD/hurricanes/images/florence/hurricane-florence_00000028_pre_disaster.png,59,39,1,558,617,0,39,899,43.50131189848209,27.701888225248815
9444,/media/marda/TWOTB1/xBD/hurricanes/images/florence/hurricane-florence_00000028_pre_disaster.png,69,45,1,651,720,0,45,1047,53.121341473331505,26.448811456579232
9445,/media/marda/TWOTB1/xBD/hurricanes/images/florence/hurricane-florence_00000028_pre_disaster.png,55,6,1,775,830,0,6,78,24.91035437052572,4.714068000548087
9446,/media/marda/TWOTB1/xBD/hurricanes/images/florence/hurricane-florence_00000028_pre_disaster.png,80,36,1,964,1044,0,36,1039,41.83060302807896,33.339922805449326
9447,/media/marda/TWOTB1/xBD/hurricanes/images/florence/hurricane-florence_00000028_pre_disaster.png,72,79,1,281,353,1,80,2049,88.13435509743854,32.623304816045106
9448,/media/marda/TWOTB1/xBD/hurricanes/images/florence/hurricane-florence_00000028_pre_disaster.png,84,76,1,737,821,13,89,1732,84.86020974357787,27.46293604846021
9449,/media/marda/TWOTB1/xBD/hurricanes/images/florence/hurricane-florence_00000028_pre_disaster.png,85,73,1,418,503,14,87,1696,93.18313990714478,24.19263271941106
9450,/media/marda/TWOTB1/xBD/hurricanes/images/florence/hurricane-florence_00000028_pre_disaster.png,79,76,1,610,689,45,121,1759,86.25880479839466,26.914439991640076
9451,/media/marda/TWOTB1/xBD/hurricanes/images/florence/hurricane-florence_00000028_pre_disaster.png,70,56,1,515,585,57,113,1277,59.144022688304695,28.806649534311283
9452,/media/marda/TWOTB1/xBD/hurricanes/images/florence/hurricane-florence_00000028_pre_disaster.png,96,68,1,914,1010,60,128,1485,80.93703861470142,24.480555647548265
9453,/media/marda/TWOTB1/xBD/hurricanes/images/florence/hurricane-florence_00000028_pre_disaster.png,92,29,1,346,438,72,101,1955,86.08796118762213,30.026160430103214
9454,/media/marda/TWOTB1/xBD/hurricanes/images/florence/hurricane-florence_00000028_pre_disaster.png,63,65,1,209,272,79,144,1520,71.91007862385452,28.046602928008376
9455,/media/marda/TWOTB1/xBD/hurricanes/images/florence/hurricane-florence_00000028_pre_disaster.png,90,79,1,689,779,98,177,1614,91.7473062033993,23.377109419579487
9456,/media/marda/TWOTB1/xBD/hurricanes/images/florence/hurricane-florence_00000028_pre_disaster.png,89,77,1,561,650,121,198,1641,89.85012177406948,24.160365579183274
9457,/media/marda/TWOTB1/xBD/hurricanes/images/florence/hurricane-florence_00000028_pre_disaster.png,58,80,1,469,527,133,213,1730,83.58250058955018,27.959023095547476
9458,/media/marda/TWOTB1/xBD/hurricanes/images/florence/hurricane-florence_00000028_pre_disaster.png,78,78,1,889,967,133,211,1678,78.04949549924272,28.173475437639787
9459,/media/marda/TWOTB1/xBD/hurricanes/images/florence/hurricane-florence_00000028_pre_disaster.png,72,63,1,283,355,156,219,1514,71.15226981366017,28.475025662464827
9460,/media/marda/TWOTB1/xBD/hurricanes/images/florence/hurricane-florence_00000028_pre_disaster.png,52,44,1,992,1044,184,228,259,39.02475871913508,10.187330491251547
9461,/media/marda/TWOTB1/xBD/hurricanes/images/florence/hurricane-florence_00000028_pre_disaster.png,98,52,1,486,584,189,241,1804,89.09794667764095,27.17776141540809
9462,/media/marda/TWOTB1/xBD/hurricanes/images/florence/hurricane-florence_00000028_pre_disaster.png,84,73,1,637,721,192,265,1539,80.75410015486743,27.53215407937007
9463,/media/marda/TWOTB1/xBD/hurricanes/images/florence/hurricane-florence_00000028_pre_disaster.png,93,79,1,322,415,203,282,2084,91.80490623582943,31.823304369040386
9464,/media/marda/TWOTB1/xBD/hurricanes/images/florence/hurricane-florence_00000028_pre_disaster.png,75,85,1,853,928,211,296,1660,84.58112603491875,26.188520383311204
9465,/media/marda/TWOTB1/xBD/hurricanes/images/florence/hurricane-florence_00000028_pre_disaster.png,71,89,1,622,693,267,356,1835,91.22569722424987,26.777208960801367
9466,/media/marda/TWOTB1/xBD/hurricanes/images/florence/hurricane-florence_00000028_pre_disaster.png,85,76,1,392,477,269,345,1852,85.1368743697973,31.171689647196406
9467,/media/marda/TWOTB1/xBD/hurricanes/images/florence/hurricane-florence_00000028_pre_disaster.png,100,72,1,792,892,295,367,1783,78.05454055063488,30.18642670384048
9468,/media/marda/TWOTB1/xBD/hurricanes/images/florence/hurricane-florence_00000028_pre_disaster.png,87,62,1,957,1044,301,363,1113,61.19004274941432,24.543771753796932
9469,/media/marda/TWOTB1/xBD/hurricanes/images/florence/hurricane-florence_00000028_pre_disaster.png,85,69,1,453,538,322,391,1547,74.85225008163353,27.31068838852062
9470,/media/marda/TWOTB1/xBD/hurricanes/images/florence/hurricane-florence_00000028_pre_disaster.png,98,89,1,889,987,337,426,1624,92.01466549721718,23.580064613923035
9471,/media/marda/TWOTB1/xBD/hurricanes/images/florence/hurricane-florence_00000028_pre_disaster.png,109,56,1,710,819,345,401,1745,85.68272104278839,26.773294041521385
9472,/media/marda/TWOTB1/xBD/hurricanes/images/florence/hurricane-florence_00000028_pre_disaster.png,85,96,1,959,1044,365,461,1704,92.45332609451573,27.055601216123435
9473,/media/marda/TWOTB1/xBD/hurricanes/images/florence/hurricane-florence_00000028_pre_disaster.png,102,69,1,527,629,376,445,1850,87.8388047101658,28.125506594581477
9474,/media/marda/TWOTB1/xBD/hurricanes/images/florence/hurricane-florence_00000028_pre_disaster.png,99,90,1,838,937,408,498,1763,87.60293782001078,26.57664631805187
9475,/media/marda/TWOTB1/xBD/hurricanes/images/florence/hurricane-florence_00000028_pre_disaster.png,40,30,1,641,681,422,452,107,15.04024664889493,9.579821913929425
9476,/media/marda/TWOTB1/xBD/hurricanes/images/florence/hurricane-florence_00000028_pre_disaster.png,96,90,1,639,735,461,551,1951,89.61034213291222,31.042072898502497
9477,/media/marda/TWOTB1/xBD/hurricanes/images/florence/hurricane-florence_00000028_pre_disaster.png,78,82,1,960,1038,466,548,1468,71.79473402207061,27.284926823179852
9478,/media/marda/TWOTB1/xBD/hurricanes/images/florence/hurricane-florence_00000028_pre_disaster.png,103,91,1,845,948,494,585,1858,84.96143322152513,30.601264264434537
9479,/media/marda/TWOTB1/xBD/hurricanes/images/florence/hurricane-florence_00000028_pre_disaster.png,99,91,1,698,797,530,621,1809,88.99805374740588,26.829079864589694
9480,/media/marda/TWOTB1/xBD/hurricanes/images/florence/hurricane-florence_00000028_pre_disaster.png,57,50,1,987,1044,539,589,263,25.237044660200432,16.037379746944108
9481,/media/marda/TWOTB1/xBD/hurricanes/images/florence/hurricane-florence_00000028_pre_disaster.png,53,63,1,227,280,542,605,973,46.27929406593535,27.833955488179292
9482,/media/marda/TWOTB1/xBD/hurricanes/images/florence/hurricane-florence_00000028_pre_disaster.png,59,68,1,241,300,565,633,958,61.57608065607344,22.004239441833878
9483,/media/marda/TWOTB1/xBD/hurricanes/images/florence/hurricane-florence_00000028_pre_disaster.png,101,92,1,904,1005,575,667,1719,86.909433991754,26.17737091644792
9484,/media/marda/TWOTB1/xBD/hurricanes/images/florence/hurricane-florence_00000028_pre_disaster.png,101,85,1,765,866,589,674,1789,83.07285502512312,29.839330368542704
9485,/media/marda/TWOTB1/xBD/hurricanes/images/florence/hurricane-florence_00000028_pre_disaster.png,58,79,1,267,325,590,669,1026,58.07919758232279,26.773263464855276
9486,/media/marda/TWOTB1/xBD/hurricanes/images/florence/hurricane-florence_00000028_pre_disaster.png,52,69,1,185,237,604,673,643,60.12896982850495,14.27546365325557
9487,/media/marda/TWOTB1/xBD/hurricanes/images/florence/hurricane-florence_00000028_pre_disaster.png,19,34,1,256,275,611,645,54,10.062461072716959,7.216662004929232
9488,/media/marda/TWOTB1/xBD/hurricanes/images/florence/hurricane-florence_00000028_pre_disaster.png,53,66,1,292,345,612,678,749,53.55402968435606,19.346527835423966
9489,/media/marda/TWOTB1/xBD/hurricanes/images/florence/hurricane-florence_00000028_pre_disaster.png,53,70,1,207,260,626,696,773,56.54866723473714,18.418475490222043
9490,/media/marda/TWOTB1/xBD/hurricanes/images/florence/hurricane-florence_00000028_pre_disaster.png,57,67,1,323,380,630,697,895,47.941092840386,24.9125259890321
9491,/media/marda/TWOTB1/xBD/hurricanes/images/florence/hurricane-florence_00000028_pre_disaster.png,80,68,1,964,1044,640,708,954,52.62932032577603,24.198547411592354
9492,/media/marda/TWOTB1/xBD/hurricanes/images/florence/hurricane-florence_00000028_pre_disaster.png,96,91,1,830,926,646,737,1636,81.83593427872853,28.137977449840545
9493,/media/marda/TWOTB1/xBD/hurricanes/images/florence/hurricane-florence_00000028_pre_disaster.png,59,70,1,226,285,648,718,1022,56.924702090628024,23.908859793139413
9494,/media/marda/TWOTB1/xBD/hurricanes/images/florence/hurricane-florence_00000028_pre_disaster.png,54,67,1,347,401,654,721,843,50.27831908633532,22.097012022560623
9495,/media/marda/TWOTB1/xBD/hurricanes/images/florence/hurricane-florence_00000028_pre_disaster.png,41,62,1,114,155,665,727,560,46.61410721602224,16.754763510414524
9496,/media/marda/TWOTB1/xBD/hurricanes/images/florence/hurricane-florence_00000028_pre_disaster.png,59,78,1,254,313,666,744,910,65.07685131741647,21.4290972678244
9497,/media/marda/TWOTB1/xBD/hurricanes/images/florence/hurricane-florence_00000028_pre_disaster.png,57,69,1,367,424,674,743,630,57.19793429101465,14.7039093365345
9498,/media/marda/TWOTB1/xBD/hurricanes/images/florence/hurricane-florence_00000028_pre_disaster.png,24,37,1,324,348,676,713,73,12.73829327594526,7.755294416752066
9499,/media/marda/TWOTB1/xBD/hurricanes/images/florence/hurricane-florence_00000028_pre_disaster.png,49,67,1,134,183,687,754,783,54.94253491712299,19.43166291906601
9500,/media/marda/TWOTB1/xBD/hurricanes/images/florence/hurricane-florence_00000028_pre_disaster.png,52,76,1,282,334,689,765,601,57.57240531774648,15.841714000007364
9501,/media/marda/TWOTB1/xBD/hurricanes/images/florence/hurricane-florence_00000028_pre_disaster.png,64,77,1,392,456,689,766,759,65.1844319816996,15.559703575292115
9502,/media/marda/TWOTB1/xBD/hurricanes/images/florence/hurricane-florence_00000028_pre_disaster.png,54,74,1,154,208,704,778,732,63.44497020811703,15.128507535161042
9503,/media/marda/TWOTB1/xBD/hurricanes/images/florence/hurricane-florence_00000028_pre_disaster.png,106,100,1,883,989,705,805,1933,88.74846043535214,28.775289743574323
9504,/media/marda/TWOTB1/xBD/hurricanes/images/florence/hurricane-florence_00000028_pre_disaster.png,21,36,1,326,347,709,745,50,9.531164280244877,7.213661169127931
9505,/media/marda/TWOTB1/xBD/hurricanes/images/florence/hurricane-florence_00000028_pre_disaster.png,20,45,1,92,112,711,756,149,16.926191017460873,11.78431679106226
9506,/media/marda/TWOTB1/xBD/hurricanes/images/florence/hurricane-florence_00000028_pre_disaster.png,56,72,1,305,361,715,787,647,56.83467156254824,16.188627949115574
9507,/media/marda/TWOTB1/xBD/hurricanes/images/florence/hurricane-florence_00000028_pre_disaster.png,66,77,1,412,478,718,795,900,61.210914413201,19.638292555045584
9508,/media/marda/TWOTB1/xBD/hurricanes/images/florence/hurricane-florence_00000028_pre_disaster.png,37,64,1,78,115,730,794,494,43.17119664149673,16.158961800474664
9509,/media/marda/TWOTB1/xBD/hurricanes/images/florence/hurricane-florence_00000028_pre_disaster.png,44,66,1,182,226,733,799,532,46.899807844078296,15.139156165451919
9510,/media/marda/TWOTB1/xBD/hurricanes/images/florence/hurricane-florence_00000028_pre_disaster.png,18,38,1,229,247,735,773,50,8.517499240128604,7.933083051021756
9511,/media/marda/TWOTB1/xBD/hurricanes/images/florence/hurricane-florence_00000028_pre_disaster.png,58,74,1,327,385,737,811,633,61.51051638167162,13.521555075771355
9512,/media/marda/TWOTB1/xBD/hurricanes/images/florence/hurricane-florence_00000028_pre_disaster.png,62,73,1,438,500,743,816,863,52.21025950196949,22.04330893171262
9513,/media/marda/TWOTB1/xBD/hurricanes/images/florence/hurricane-florence_00000028_pre_disaster.png,44,68,1,95,139,749,817,791,46.14725790598539,22.64100343145701
9514,/media/marda/TWOTB1/xBD/hurricanes/images/florence/hurricane-florence_00000028_pre_disaster.png,49,68,1,206,255,752,820,507,53.5424112338361,12.642956258385523
9515,/media/marda/TWOTB1/xBD/hurricanes/images/florence/hurricane-florence_00000028_pre_disaster.png,53,89,1,117,170,757,846,1123,67.26861743484113,26.959481523580862
9516,/media/marda/TWOTB1/xBD/hurricanes/images/florence/hurricane-florence_00000028_pre_disaster.png,24,44,1,202,226,758,802,122,15.963741169203585,10.242484931841137
9517,/media/marda/TWOTB1/xBD/hurricanes/images/florence/hurricane-florence_00000028_pre_disaster.png,49,68,1,354,403,766,834,565,47.86165781597451,16.586874625137707
9518,/media/marda/TWOTB1/xBD/hurricanes/images/florence/hurricane-florence_00000028_pre_disaster.png,60,72,1,460,520,768,840,679,53.198037936155814,18.32266560035139
9519,/media/marda/TWOTB1/xBD/hurricanes/images/florence/hurricane-florence_00000028_pre_disaster.png,98,91,1,946,1044,770,861,1542,78.88416807946436,27.409045789371156
9520,/media/marda/TWOTB1/xBD/hurricanes/images/florence/hurricane-florence_00000028_pre_disaster.png,48,66,1,231,279,776,842,506,50.32375072269038,13.43217168587599
9521,/media/marda/TWOTB1/xBD/hurricanes/images/florence/hurricane-florence_00000028_pre_disaster.png,59,80,1,377,436,777,857,772,60.81327578132158,21.627961319663218
9522,/media/marda/TWOTB1/xBD/hurricanes/images/florence/hurricane-florence_00000028_pre_disaster.png,42,72,1,0,42,787,859,769,45.52183554748723,23.007552738212883
9523,/media/marda/TWOTB1/xBD/hurricanes/images/florence/hurricane-florence_00000028_pre_disaster.png,54,68,1,487,541,791,859,458,45.335558474739095,13.48575846178285
9524,/media/marda/TWOTB1/xBD/hurricanes/images/florence/hurricane-florence_00000028_pre_disaster.png,46,79,1,143,189,792,871,901,50.50932670298021,24.080056978666647
9525,/media/marda/TWOTB1/xBD/hurricanes/images/florence/hurricane-florence_00000028_pre_disaster.png,24,47,1,209,233,794,841,120,13.713975555818047,11.714861739070429
9526,/media/marda/TWOTB1/xBD/hurricanes/images/florence/hurricane-florence_00000028_pre_disaster.png,29,43,1,421,450,794,837,71,11.092441278687337,8.623583778400867
9527,/media/marda/TWOTB1/xBD/hurricanes/images/florence/hurricane-florence_00000028_pre_disaster.png,57,81,1,246,303,796,877,764,64.00485152412371,16.779267174119855
9528,/media/marda/TWOTB1/xBD/hurricanes/images/florence/hurricane-florence_00000028_pre_disaster.png,65,81,1,398,463,802,883,785,62.15215789886422,18.405378345234407
9529,/media/marda/TWOTB1/xBD/hurricanes/images/florence/hurricane-florence_00000028_pre_disaster.png,45,76,1,16,61,807,883,693,58.1972960748895,15.801808915962669
9530,/media/marda/TWOTB1/xBD/hurricanes/images/florence/hurricane-florence_00000028_pre_disaster.png,22,45,1,241,263,808,853,88,13.255321769296415,8.899749193179964
9531,/media/marda/TWOTB1/xBD/hurricanes/images/florence/hurricane-florence_00000028_pre_disaster.png,62,75,1,508,570,808,883,686,51.745281569334956,18.917799456194114
9532,/media/marda/TWOTB1/xBD/hurricanes/images/florence/hurricane-florence_00000028_pre_disaster.png,52,81,1,163,215,812,893,1030,56.01275155041162,24.697222068488298
9533,/media/marda/TWOTB1/xBD/hurricanes/images/florence/hurricane-florence_00000028_pre_disaster.png,30,46,1,444,474,816,862,98,11.661903789690601,11.313708498984761
9534,/media/marda/TWOTB1/xBD/hurricanes/images/florence/hurricane-florence_00000028_pre_disaster.png,54,73,1,278,332,823,896,874,45.59816824402441,25.98691787081723
9535,/media/marda/TWOTB1/xBD/hurricanes/images/florence/hurricane-florence_00000028_pre_disaster.png,59,74,1,424,483,828,902,602,54.777302205013925,14.67969153784609
9536,/media/marda/TWOTB1/xBD/hurricanes/images/florence/hurricane-florence_00000028_pre_disaster.png,63,85,1,190,253,830,915,809,69.58205299863646,24.407413686950555
9537,/media/marda/TWOTB1/xBD/hurricanes/images/florence/hurricane-florence_00000028_pre_disaster.png,47,77,1,41,88,831,908,677,60.99905928531263,16.36802777124581
9538,/media/marda/TWOTB1/xBD/hurricanes/images/florence/hurricane-florence_00000028_pre_disaster.png,61,83,1,534,595,832,915,704,58.17198621949998,20.107308420644813
9539,/media/marda/TWOTB1/xBD/hurricanes/images/florence/hurricane-florence_00000028_pre_disaster.png,60,88,1,296,356,844,932,916,65.05666736628265,23.661603569742034
9540,/media/marda/TWOTB1/xBD/hurricanes/images/florence/hurricane-florence_00000028_pre_disaster.png,50,81,1,63,113,853,934,989,58.18602687856836,23.622788648600693
9541,/media/marda/TWOTB1/xBD/hurricanes/images/florence/hurricane-florence_00000028_pre_disaster.png,55,71,1,446,501,854,925,508,50.20769887473881,13.497502424328255
9542,/media/marda/TWOTB1/xBD/hurricanes/images/florence/hurricane-florence_00000028_pre_disaster.png,63,68,1,561,624,854,922,679,44.100695113124786,20.587202470603938
9543,/media/marda/TWOTB1/xBD/hurricanes/images/florence/hurricane-florence_00000028_pre_disaster.png,60,74,1,216,276,862,936,743,57.41201108746583,23.83556687999054
9544,/media/marda/TWOTB1/xBD/hurricanes/images/florence/hurricane-florence_00000028_pre_disaster.png,64,89,1,466,530,864,953,721,71.47911925661613,19.10159502438511
9545,/media/marda/TWOTB1/xBD/hurricanes/images/florence/hurricane-florence_00000028_pre_disaster.png,53,75,1,322,375,867,942,589,55.45687619661136,14.490926799192197
9546,/media/marda/TWOTB1/xBD/hurricanes/images/florence/hurricane-florence_00000028_pre_disaster.png,26,68,1,0,26,869,937,380,38.77914408588264,13.216166987403327
9547,/media/marda/TWOTB1/xBD/hurricanes/images/florence/hurricane-florence_00000028_pre_disaster.png,75,80,1,598,673,872,952,1080,56.456037720207505,27.079881876872555
9548,/media/marda/TWOTB1/xBD/hurricanes/images/florence/hurricane-florence_00000028_pre_disaster.png,39,50,1,539,578,876,926,164,18.153310741121345,12.118067215473243
9549,/media/marda/TWOTB1/xBD/hurricanes/images/florence/hurricane-florence_00000028_pre_disaster.png,48,84,1,95,143,880,964,973,50.574661226342144,27.4804633357692
9550,/media/marda/TWOTB1/xBD/hurricanes/images/florence/hurricane-florence_00000028_pre_disaster.png,50,79,1,240,290,883,962,604,55.08324847918235,16.35405977767023
9551,/media/marda/TWOTB1/xBD/hurricanes/images/florence/hurricane-florence_00000028_pre_disaster.png,54,87,1,114,168,886,973,839,65.11274250062021,18.094996586928694
9552,/media/marda/TWOTB1/xBD/hurricanes/images/florence/hurricane-florence_00000028_pre_disaster.png,51,74,1,352,403,891,965,798,39.20109589800484,27.513541193073234
9553,/media/marda/TWOTB1/xBD/hurricanes/images/florence/hurricane-florence_00000028_pre_disaster.png,71,88,1,487,558,894,982,1094,63.75552833564725,23.089507223546143
9554,/media/marda/TWOTB1/xBD/hurricanes/images/florence/hurricane-florence_00000028_pre_disaster.png,42,76,1,3,45,896,972,834,44.633067411144324,25.293336763142218
9555,/media/marda/TWOTB1/xBD/hurricanes/images/florence/hurricane-florence_00000028_pre_disaster.png,31,53,1,390,421,898,951,123,19.145214465204745,8.620661789013736
9556,/media/marda/TWOTB1/xBD/hurricanes/images/florence/hurricane-florence_00000028_pre_disaster.png,37,51,1,569,606,904,955,127,16.354084597068663,10.29625290723452
9557,/media/marda/TWOTB1/xBD/hurricanes/images/florence/hurricane-florence_00000028_pre_disaster.png,67,80,1,584,651,905,985,902,49.86365407826206,24.60007187275411
9558,/media/marda/TWOTB1/xBD/hurricanes/images/florence/hurricane-florence_00000028_pre_disaster.png,28,52,1,331,359,907,959,122,15.963741169203587,10.242484931841139
9559,/media/marda/TWOTB1/xBD/hurricanes/images/florence/hurricane-florence_00000028_pre_disaster.png,12,47,1,86,98,910,957,62,11.724167133333351,7.163665163731003
9560,/media/marda/TWOTB1/xBD/hurricanes/images/florence/hurricane-florence_00000028_pre_disaster.png,59,84,1,258,317,910,994,1036,55.1397279532714,25.373048401424338
9561,/media/marda/TWOTB1/xBD/hurricanes/images/florence/hurricane-florence_00000028_pre_disaster.png,64,87,1,367,431,911,998,777,66.67448184504687,15.610798236872853
9562,/media/marda/TWOTB1/xBD/hurricanes/images/florence/hurricane-florence_00000028_pre_disaster.png,42,74,1,142,184,918,992,491,48.40433018161793,13.540873494098653
9563,/media/marda/TWOTB1/xBD/hurricanes/images/florence/hurricane-florence_00000028_pre_disaster.png,87,115,1,515,602,920,1035,1836,90.5125898944977,41.26756201463387
9564,/media/marda/TWOTB1/xBD/hurricanes/images/florence/hurricane-florence_00000028_pre_disaster.png,22,58,1,67,89,928,986,239,23.249120547082953,13.656125205676439
9565,/media/marda/TWOTB1/xBD/hurricanes/images/florence/hurricane-florence_00000028_pre_disaster.png,55,84,1,397,452,931,1015,685,55.9203420164153,19.862289845044618
9566,/media/marda/TWOTB1/xBD/hurricanes/images/florence/hurricane-florence_00000028_pre_disaster.png,52,74,1,283,335,935,1009,578,49.98042029433896,15.432153408631198
9567,/media/marda/TWOTB1/xBD/hurricanes/images/florence/hurricane-florence_00000028_pre_disaster.png,65,78,1,557,622,936,1014,832,46.45785714968721,23.983100246774416
9568,/media/marda/TWOTB1/xBD/hurricanes/images/florence/hurricane-florence_00000028_pre_disaster.png,34,68,1,60,94,945,1013,382,41.770567381247275,12.231480238865771
9569,/media/marda/TWOTB1/xBD/hurricanes/images/florence/hurricane-florence_00000028_pre_disaster.png,53,84,1,194,247,950,1034,1009,51.167585604890405,26.928907356665285
9570,/media/marda/TWOTB1/xBD/hurricanes/images/florence/hurricane-florence_00000028_pre_disaster.png,59,78,1,306,365,951,1029,679,55.64628317211397,18.543422330564344
9571,/media/marda/TWOTB1/xBD/hurricanes/images/florence/hurricane-florence_00000028_pre_disaster.png,50,84,1,72,122,958,1042,877,58.467164654416315,23.268030381043772
9572,/media/marda/TWOTB1/xBD/hurricanes/images/florence/hurricane-florence_00000028_pre_disaster.png,70,80,1,409,479,959,1039,1104,59.00461156450663,25.517271245316376
9573,/media/marda/TWOTB1/xBD/hurricanes/images/florence/hurricane-florence_00000028_pre_disaster.png,27,50,1,351,378,962,1012,103,13.623841070434988,10.136562287567074
9574,/media/marda/TWOTB1/xBD/hurricanes/images/florence/hurricane-florence_00000028_pre_disaster.png,50,76,1,171,221,966,1042,812,50.96537731289481,22.35820626529855
9575,/media/marda/TWOTB1/xBD/hurricanes/images/florence/hurricane-florence_00000028_pre_disaster.png,21,56,1,31,52,967,1023,208,18.565081984847488,14.99482435786129
9576,/media/marda/TWOTB1/xBD/hurricanes/images/florence/hurricane-florence_00000028_pre_disaster.png,19,49,1,152,171,967,1016,93,14.130323563872357,8.812904703535997
9577,/media/marda/TWOTB1/xBD/hurricanes/images/florence/hurricane-florence_00000028_pre_disaster.png,67,72,1,354,421,970,1042,983,50.971837244321144,27.996120002736227
9578,/media/marda/TWOTB1/xBD/hurricanes/images/florence/hurricane-florence_00000028_pre_disaster.png,32,63,1,105,137,973,1036,349,31.904060018421877,14.495827563620358
9579,/media/marda/TWOTB1/xBD/hurricanes/images/florence/hurricane-florence_00000028_pre_disaster.png,61,63,1,474,535,979,1042,604,38.73551566361609,21.782530744240464
9580,/media/marda/TWOTB1/xBD/hurricanes/images/florence/hurricane-florence_00000028_pre_disaster.png,52,62,1,120,172,982,1044,599,45.27444468123316,18.52407926019307
9581,/media/marda/TWOTB1/xBD/hurricanes/images/florence/hurricane-florence_00000028_pre_disaster.png,37,58,1,450,487,985,1043,193,20.47551304139328,12.533080197685946
9582,/media/marda/TWOTB1/xBD/hurricanes/images/florence/hurricane-florence_00000345_post_disaster.png,165,62,1,186,351,117,179,4887,164.27325909058024,40.65355540045552
9583,/media/marda/TWOTB1/xBD/hurricanes/images/florence/hurricane-florence_00000345_post_disaster.png,70,66,1,938,1008,776,842,601,41.31127275875477,19.28957189353113
9584,/media/marda/TWOTB1/xBD/hurricanes/images/florence/hurricane-florence_00000345_post_disaster.png,57,54,1,835,892,989,1043,210,22.60869828683526,13.113492207441379
9585,/media/marda/TWOTB1/xBD/hurricanes/images/florence/hurricane-florence_00000211_post_disaster.png,38,34,1,364,402,0,34,600,37.8241651404286,21.19665797259946
9586,/media/marda/TWOTB1/xBD/hurricanes/images/florence/hurricane-florence_00000211_post_disaster.png,48,16,1,598,646,0,16,267,22.273247545618695,16.374787680783815
9587,/media/marda/TWOTB1/xBD/hurricanes/images/florence/hurricane-florence_00000211_post_disaster.png,52,23,1,441,493,11,34,395,38.80617854344343,13.601941264591575
9588,/media/marda/TWOTB1/xBD/hurricanes/images/florence/hurricane-florence_00000211_post_disaster.png,10,19,1,0,10,12,31,99,16.33413555589898,9.369546636486692
9589,/media/marda/TWOTB1/xBD/hurricanes/images/florence/hurricane-florence_00000211_post_disaster.png,46,24,1,625,671,52,76,370,23.55864217410047,20.67966519947119
9590,/media/marda/TWOTB1/xBD/hurricanes/images/florence/hurricane-florence_00000211_post_disaster.png,32,35,1,98,130,76,111,652,33.17685135508252,25.917312511437455
9591,/media/marda/TWOTB1/xBD/hurricanes/images/florence/hurricane-florence_00000211_post_disaster.png,69,35,1,595,664,78,113,979,44.30577828568143,29.131518589583102
9592,/media/marda/TWOTB1/xBD/hurricanes/images/florence/hurricane-florence_00000211_post_disaster.png,32,36,1,88,120,128,164,469,30.44019054312081,20.57341409836538
9593,/media/marda/TWOTB1/xBD/hurricanes/images/florence/hurricane-florence_00000211_post_disaster.png,39,28,1,267,306,133,161,350,26.833523503886422,17.42769154801937
9594,/media/marda/TWOTB1/xBD/hurricanes/images/florence/hurricane-florence_00000211_post_disaster.png,38,18,1,575,613,145,163,123,14.9224488059333,11.092464870606216
9595,/media/marda/TWOTB1/xBD/hurricanes/images/florence/hurricane-florence_00000211_post_disaster.png,51,42,1,264,315,173,215,855,40.122318993441596,29.02584302042991
9596,/media/marda/TWOTB1/xBD/hurricanes/images/florence/hurricane-florence_00000211_post_disaster.png,32,29,1,41,73,217,246,506,36.072259951553974,18.727168071390583
9597,/media/marda/TWOTB1/xBD/hurricanes/images/florence/hurricane-florence_00000211_post_disaster.png,41,22,1,593,634,217,239,216,19.185130955498,15.014499937802055
9598,/media/marda/TWOTB1/xBD/hurricanes/images/florence/hurricane-florence_00000211_post_disaster.png,38,19,1,603,641,248,267,131,15.25120518867732,11.488496624781543
9599,/media/marda/TWOTB1/xBD/hurricanes/images/florence/hurricane-florence_00000211_post_disaster.png,77,35,1,580,657,267,302,1097,60.447606878950864,24.486566456511667
9600,/media/marda/TWOTB1/xBD/hurricanes/images/florence/hurricane-florence_00000211_post_disaster.png,49,33,1,486,535,275,308,456,32.61877363356993,18.67243847895244
9601,/media/marda/TWOTB1/xBD/hurricanes/images/florence/hurricane-florence_00000211_post_disaster.png,32,37,1,103,135,284,321,578,31.94654364663368,25.05516140696337
9602,/media/marda/TWOTB1/xBD/hurricanes/images/florence/hurricane-florence_00000211_post_disaster.png,38,30,1,159,197,324,354,297,38.226558146157046,10.408923496937087
9603,/media/marda/TWOTB1/xBD/hurricanes/images/florence/hurricane-florence_00000211_post_disaster.png,23,31,1,112,135,328,359,246,18.95609283469325,17.40697331529433
9604,/media/marda/TWOTB1/xBD/hurricanes/images/florence/hurricane-florence_00000211_post_disaster.png,87,48,1,688,775,350,398,1192,61.56062245016585,27.087277040622524
9605,/media/marda/TWOTB1/xBD/hurricanes/images/florence/hurricane-florence_00000211_post_disaster.png,58,45,1,254,312,359,404,554,55.718305733771636,13.244896880852746
9606,/media/marda/TWOTB1/xBD/hurricanes/images/florence/hurricane-florence_00000211_post_disaster.png,52,31,1,883,935,416,447,147,16.772190451550937,11.80840027986532
9607,/media/marda/TWOTB1/xBD/hurricanes/images/florence/hurricane-florence_00000211_post_disaster.png,87,45,1,858,945,453,498,1020,56.28069791574041,23.949866841006628
9608,/media/marda/TWOTB1/xBD/hurricanes/images/florence/hurricane-florence_00000211_post_disaster.png,64,42,1,979,1043,461,503,530,29.175117856398415,24.207443837669143
9609,/media/marda/TWOTB1/xBD/hurricanes/images/florence/hurricane-florence_00000211_post_disaster.png,85,49,1,761,846,475,524,1154,59.18645185259806,25.867667658986566
9610,/media/marda/TWOTB1/xBD/hurricanes/images/florence/hurricane-florence_00000211_post_disaster.png,89,102,1,462,551,526,628,2568,86.5696401308846,42.6587295294691
9611,/media/marda/TWOTB1/xBD/hurricanes/images/florence/hurricane-florence_00000211_post_disaster.png,77,63,1,935,1012,568,631,850,41.809003122405045,27.135455983003784
9612,/media/marda/TWOTB1/xBD/hurricanes/images/florence/hurricane-florence_00000211_post_disaster.png,60,62,1,409,469,578,640,682,53.14850137540078,17.121589441679554
9613,/media/marda/TWOTB1/xBD/hurricanes/images/florence/hurricane-florence_00000211_post_disaster.png,65,62,1,566,631,655,717,621,51.60165769352865,16.37557467121413
9614,/media/marda/TWOTB1/xBD/hurricanes/images/florence/hurricane-florence_00000211_post_disaster.png,43,60,1,463,506,686,746,402,31.91249539299744,16.83859944332876
9615,/media/marda/TWOTB1/xBD/hurricanes/images/florence/hurricane-florence_00000211_post_disaster.png,61,69,1,798,859,686,755,592,45.337357816705754,17.383700471424223
9616,/media/marda/TWOTB1/xBD/hurricanes/images/florence/hurricane-florence_00000211_post_disaster.png,57,70,1,795,852,762,832,601,45.08013132756153,17.8063216097592
9617,/media/marda/TWOTB1/xBD/hurricanes/images/florence/hurricane-florence_00000211_post_disaster.png,89,67,1,898,987,785,852,1149,53.845332644893475,28.248624998438387
9618,/media/marda/TWOTB1/xBD/hurricanes/images/florence/hurricane-florence_00000211_post_disaster.png,39,54,1,642,681,791,845,305,24.336095861639638,16.751064694315552
9619,/media/marda/TWOTB1/xBD/hurricanes/images/florence/hurricane-florence_00000211_post_disaster.png,55,88,1,683,738,803,891,1082,60.08400991117183,24.094057500877184
9620,/media/marda/TWOTB1/xBD/hurricanes/images/florence/hurricane-florence_00000211_post_disaster.png,62,58,1,660,722,908,966,578,36.81158646913663,20.72179355158942
9621,/media/marda/TWOTB1/xBD/hurricanes/images/florence/hurricane-florence_00000032_post_disaster.png,31,11,1,126,157,0,11,171,24.31867940014419,10.007838958119235
9622,/media/marda/TWOTB1/xBD/hurricanes/images/florence/hurricane-florence_00000032_post_disaster.png,31,10,1,242,273,0,10,151,23.443418226557306,8.975341179265522
9623,/media/marda/TWOTB1/xBD/hurricanes/images/florence/hurricane-florence_00000032_post_disaster.png,25,17,1,195,220,15,32,185,18.976216864131143,12.98670309284052
9624,/media/marda/TWOTB1/xBD/hurricanes/images/florence/hurricane-florence_00000032_post_disaster.png,55,61,1,416,471,19,80,1430,63.6578499512506,29.928402048451836
9625,/media/marda/TWOTB1/xBD/hurricanes/images/florence/hurricane-florence_00000032_post_disaster.png,39,43,1,20,59,22,65,1048,48.60316930361198,32.635312184494445
9626,/media/marda/TWOTB1/xBD/hurricanes/images/florence/hurricane-florence_00000032_post_disaster.png,12,13,1,80,92,84,97,128,13.461908178565245,12.65893786537315
9627,/media/marda/TWOTB1/xBD/hurricanes/images/florence/hurricane-florence_00000032_post_disaster.png,31,44,1,29,60,91,135,1129,47.343593790626386,31.722601138523636
9628,/media/marda/TWOTB1/xBD/hurricanes/images/florence/hurricane-florence_00000032_post_disaster.png,85,40,1,583,668,98,138,1712,67.16474475954907,33.93350846637444
9629,/media/marda/TWOTB1/xBD/hurricanes/images/florence/hurricane-florence_00000032_post_disaster.png,62,36,1,719,781,150,186,344,43.39499606195503,10.584758262737132
9630,/media/marda/TWOTB1/xBD/hurricanes/images/florence/hurricane-florence_00000032_post_disaster.png,52,34,1,576,628,204,238,384,31.628633314033436,16.311265970744234
9631,/media/marda/TWOTB1/xBD/hurricanes/images/florence/hurricane-florence_00000032_post_disaster.png,42,78,1,2,44,865,943,1367,44.39001853438314,40.553829037356024
9632,/media/marda/TWOTB1/xBD/hurricanes/images/florence/hurricane-florence_00000032_post_disaster.png,44,69,1,220,264,866,935,1002,40.81074471754867,34.246274447166286
9633,/media/marda/TWOTB1/xBD/hurricanes/images/florence/hurricane-florence_00000032_post_disaster.png,50,68,1,140,190,884,952,1139,49.12467953667483,30.66306477320813
9634,/media/marda/TWOTB1/xBD/hurricanes/images/florence/hurricane-florence_00000032_post_disaster.png,29,55,1,412,441,900,955,199,19.938680011187756,13.384980701684542
9635,/media/marda/TWOTB1/xBD/hurricanes/images/florence/hurricane-florence_00000032_post_disaster.png,35,57,1,246,281,922,979,432,28.211053334384932,20.09934769390771
9636,/media/marda/TWOTB1/xBD/hurricanes/images/florence/hurricane-florence_00000032_post_disaster.png,36,68,1,145,181,933,1001,615,35.0201557593744,25.138061111788236
9637,/media/marda/TWOTB1/xBD/hurricanes/images/florence/hurricane-florence_00000032_post_disaster.png,42,71,1,153,195,970,1041,889,38.855066130040186,31.95558585877256
9638,/media/marda/TWOTB1/xBD/hurricanes/images/florence/hurricane-florence_00000505_pre_disaster.png,32,41,1,175,207,620,661,254,27.413725476664492,12.415995603601784
9639,/media/marda/TWOTB1/xBD/hurricanes/images/florence/hurricane-florence_00000505_pre_disaster.png,96,194,1,308,404,622,816,5382,194.6249624192158,36.87908423241272
9640,/media/marda/TWOTB1/xBD/hurricanes/images/florence/hurricane-florence_00000505_pre_disaster.png,43,49,1,171,214,641,690,529,40.30609206750964,17.535716300794714
9641,/media/marda/TWOTB1/xBD/hurricanes/images/florence/hurricane-florence_00000505_pre_disaster.png,45,43,1,165,210,657,700,297,43.57225202127685,9.11528844436449
9642,/media/marda/TWOTB1/xBD/hurricanes/images/florence/hurricane-florence_00000505_pre_disaster.png,66,56,1,264,330,678,734,708,60.67785069857043,19.411184425696074
9643,/media/marda/TWOTB1/xBD/hurricanes/images/florence/hurricane-florence_00000505_pre_disaster.png,49,44,1,683,732,686,730,310,25.596342971886706,16.22030191480669
9644,/media/marda/TWOTB1/xBD/hurricanes/images/florence/hurricane-florence_00000505_pre_disaster.png,43,64,1,161,204,714,778,850,38.80368159237108,30.379451670581847
9645,/media/marda/TWOTB1/xBD/hurricanes/images/florence/hurricane-florence_00000505_pre_disaster.png,69,54,1,858,927,724,778,851,39.36910036909919,28.83131513880669
9646,/media/marda/TWOTB1/xBD/hurricanes/images/florence/hurricane-florence_00000505_pre_disaster.png,79,52,1,662,741,739,791,1034,59.34703216829455,23.115458071383802
9647,/media/marda/TWOTB1/xBD/hurricanes/images/florence/hurricane-florence_00000505_pre_disaster.png,73,73,1,779,852,766,839,1407,51.74373475896918,40.05339267799207
9648,/media/marda/TWOTB1/xBD/hurricanes/images/florence/hurricane-florence_00000505_pre_disaster.png,50,70,1,136,186,879,949,1082,49.110398153180455,31.42306526901836
9649,/media/marda/TWOTB1/xBD/hurricanes/images/florence/hurricane-florence_00000505_pre_disaster.png,78,57,1,576,654,923,980,602,59.972781572172714,15.283876459918643
9650,/media/marda/TWOTB1/xBD/hurricanes/images/florence/hurricane-florence_00000505_pre_disaster.png,37,58,1,133,170,935,993,524,36.17095177982819,19.368041205556437
9651,/media/marda/TWOTB1/xBD/hurricanes/images/florence/hurricane-florence_00000520_post_disaster.png,309,42,1,734,1043,0,42,8960,311.55875101863256,38.58116595588906
9652,/media/marda/TWOTB1/xBD/hurricanes/images/florence/hurricane-florence_00000520_post_disaster.png,61,15,1,977,1038,59,74,283,26.115100802823655,14.407728864710723
9653,/media/marda/TWOTB1/xBD/hurricanes/images/florence/hurricane-florence_00000520_post_disaster.png,308,55,1,727,1035,74,129,10201,313.2609900879449,43.321501513828004
9654,/media/marda/TWOTB1/xBD/hurricanes/images/florence/hurricane-florence_00000520_post_disaster.png,48,7,1,986,1034,75,82,45,8.165711355093652,6.98044340741045
9655,/media/marda/TWOTB1/xBD/hurricanes/images/florence/hurricane-florence_00000520_post_disaster.png,308,53,1,702,1010,429,482,9706,315.7629015591411,40.917474104888534
9656,/media/marda/TWOTB1/xBD/hurricanes/images/florence/hurricane-florence_00000520_post_disaster.png,44,29,1,958,1002,467,496,76,14.247888523304018,7.540134501862152
9657,/media/marda/TWOTB1/xBD/hurricanes/images/florence/hurricane-florence_00000520_post_disaster.png,309,58,1,700,1009,513,571,9869,316.57616821157296,41.46625663645213
9658,/media/marda/TWOTB1/xBD/hurricanes/images/florence/hurricane-florence_00000520_post_disaster.png,44,33,1,958,1002,553,586,88,15.01198989084629,8.249823089299074
9659,/media/marda/TWOTB1/xBD/hurricanes/images/florence/hurricane-florence_00000520_post_disaster.png,46,34,1,957,1003,585,619,115,15.689356295948508,9.687613003761678
9660,/media/marda/TWOTB1/xBD/hurricanes/images/florence/hurricane-florence_00000520_post_disaster.png,307,63,1,700,1007,597,660,9946,314.7083426582557,42.05778763190926
9661,/media/marda/TWOTB1/xBD/hurricanes/images/florence/hurricane-florence_00000520_post_disaster.png,60,50,1,946,1006,639,689,546,28.427513740990616,25.421475776181826
9662,/media/marda/TWOTB1/xBD/hurricanes/images/florence/hurricane-florence_00000520_post_disaster.png,70,59,1,935,1005,734,793,966,37.48192783300528,34.11998874270393
9663,/media/marda/TWOTB1/xBD/hurricanes/images/florence/hurricane-florence_00000151_pre_disaster.png,19,6,1,171,190,0,6,48,13.315129257002745,5.458082648938437
9664,/media/marda/TWOTB1/xBD/hurricanes/images/florence/hurricane-florence_00000151_pre_disaster.png,33,28,1,99,132,22,50,489,28.813101289472478,22.671639834956967
9665,/media/marda/TWOTB1/xBD/hurricanes/images/florence/hurricane-florence_00000151_pre_disaster.png,77,56,1,544,621,154,210,1293,64.4250697651311,26.385867433140152
9666,/media/marda/TWOTB1/xBD/hurricanes/images/florence/hurricane-florence_00000151_pre_disaster.png,89,50,1,769,858,253,303,1242,60.03115498624527,33.38818178308082
9667,/media/marda/TWOTB1/xBD/hurricanes/images/florence/hurricane-florence_00000151_pre_disaster.png,66,49,1,720,786,367,416,765,36.206426715779976,28.94853644709233
9668,/media/marda/TWOTB1/xBD/hurricanes/images/florence/hurricane-florence_00000151_pre_disaster.png,58,57,1,712,770,397,454,738,41.48847306316324,23.681421638109608
9669,/media/marda/TWOTB1/xBD/hurricanes/images/florence/hurricane-florence_00000151_pre_disaster.png,98,85,1,919,1017,606,691,1886,52.22732394456719,48.17770608046491
9670,/media/marda/TWOTB1/xBD/hurricanes/images/florence/hurricane-florence_00000298_pre_disaster.png,32,10,1,294,326,0,10,147,19.17588880062219,11.1983385394997
9671,/media/marda/TWOTB1/xBD/hurricanes/images/florence/hurricane-florence_00000298_pre_disaster.png,57,27,1,644,701,0,27,601,32.98983814319529,24.25655649558376
9672,/media/marda/TWOTB1/xBD/hurricanes/images/florence/hurricane-florence_00000298_pre_disaster.png,43,55,1,339,382,8,63,1316,60.048649937779096,29.56394641345529
9673,/media/marda/TWOTB1/xBD/hurricanes/images/florence/hurricane-florence_00000298_pre_disaster.png,38,27,1,271,309,116,143,638,32.092424888673044,26.32708315076168
9674,/media/marda/TWOTB1/xBD/hurricanes/images/florence/hurricane-florence_00000298_pre_disaster.png,47,44,1,598,645,125,169,878,45.08651552756655,25.987006490578707
9675,/media/marda/TWOTB1/xBD/hurricanes/images/florence/hurricane-florence_00000298_pre_disaster.png,46,22,1,323,369,137,159,544,38.45317442656214,18.86694220079864
9676,/media/marda/TWOTB1/xBD/hurricanes/images/florence/hurricane-florence_00000298_pre_disaster.png,66,33,1,343,409,164,197,1152,54.873231063679576,27.831070958607018
9677,/media/marda/TWOTB1/xBD/hurricanes/images/florence/hurricane-florence_00000298_pre_disaster.png,44,40,1,549,593,195,235,838,40.31939274397188,27.64823111984388
9678,/media/marda/TWOTB1/xBD/hurricanes/images/florence/hurricane-florence_00000298_pre_disaster.png,7,23,1,0,7,253,276,56,13.232657960740044,6.431652279870638
9679,/media/marda/TWOTB1/xBD/hurricanes/images/florence/hurricane-florence_00000298_pre_disaster.png,28,32,1,25,53,260,292,232,31.888174529729373,11.451605636494369
9680,/media/marda/TWOTB1/xBD/hurricanes/images/florence/hurricane-florence_00000298_pre_disaster.png,46,46,1,589,635,284,330,743,40.9333413879032,24.143558215902225
9681,/media/marda/TWOTB1/xBD/hurricanes/images/florence/hurricane-florence_00000298_pre_disaster.png,64,52,1,367,431,305,357,1047,52.94528827103139,26.45778900420851
9682,/media/marda/TWOTB1/xBD/hurricanes/images/florence/hurricane-florence_00000298_pre_disaster.png,31,51,1,0,31,308,359,728,38.12981272139286,25.498800767732725
9683,/media/marda/TWOTB1/xBD/hurricanes/images/florence/hurricane-florence_00000298_pre_disaster.png,36,22,1,641,677,320,342,115,13.382995689743744,11.388788350492248
9684,/media/marda/TWOTB1/xBD/hurricanes/images/florence/hurricane-florence_00000298_pre_disaster.png,46,67,1,609,655,356,423,860,59.947267943803695,20.157381415038518
9685,/media/marda/TWOTB1/xBD/hurricanes/images/florence/hurricane-florence_00000298_pre_disaster.png,56,35,1,619,675,432,467,399,34.167421279681925,15.643424957289376
9686,/media/marda/TWOTB1/xBD/hurricanes/images/florence/hurricane-florence_00000298_pre_disaster.png,69,72,1,276,345,462,534,1467,66.20229495147524,32.33087120745244
9687,/media/marda/TWOTB1/xBD/hurricanes/images/florence/hurricane-florence_00000298_pre_disaster.png,28,41,1,259,287,491,532,225,20.70285095471407,14.36929929909231
9688,/media/marda/TWOTB1/xBD/hurricanes/images/florence/hurricane-florence_00000298_pre_disaster.png,28,34,1,335,363,512,546,122,13.592516150605132,12.390114491245871
9689,/media/marda/TWOTB1/xBD/hurricanes/images/florence/hurricane-florence_00000298_pre_disaster.png,43,48,1,134,177,520,568,480,41.335346067741696,15.506638324495027
9690,/media/marda/TWOTB1/xBD/hurricanes/images/florence/hurricane-florence_00000298_pre_disaster.png,41,38,1,584,625,521,559,221,18.48000976025015,15.821438234172623
9691,/media/marda/TWOTB1/xBD/hurricanes/images/florence/hurricane-florence_00000298_pre_disaster.png,57,76,1,607,664,533,609,738,62.39255597385363,15.797296479981709
9692,/media/marda/TWOTB1/xBD/hurricanes/images/florence/hurricane-florence_00000298_pre_disaster.png,34,43,1,298,332,560,603,231,24.16363765891881,12.79876365271102
9693,/media/marda/TWOTB1/xBD/hurricanes/images/florence/hurricane-florence_00000298_pre_disaster.png,39,50,1,37,76,578,628,479,44.207688402353874,14.668450451631706
9694,/media/marda/TWOTB1/xBD/hurricanes/images/florence/hurricane-florence_00000298_pre_disaster.png,52,51,1,630,682,629,680,340,28.412910692716405,18.109820714566517
9695,/media/marda/TWOTB1/xBD/hurricanes/images/florence/hurricane-florence_00000298_pre_disaster.png,34,58,1,20,54,630,688,581,33.723029594164636,22.85427115429312
9696,/media/marda/TWOTB1/xBD/hurricanes/images/florence/hurricane-florence_00000439_pre_disaster.png,113,91,1,800,913,181,272,3308,95.07082132241212,46.0844283197805
9697,/media/marda/TWOTB1/xBD/hurricanes/images/florence/hurricane-florence_00000439_pre_disaster.png,47,31,1,784,831,301,332,163,17.516757327999898,12.537652124113208
9698,/media/marda/TWOTB1/xBD/hurricanes/images/florence/hurricane-florence_00000439_pre_disaster.png,61,34,1,54,115,329,363,654,65.22907414242144,13.390157836614913
9699,/media/marda/TWOTB1/xBD/hurricanes/images/florence/hurricane-florence_00000439_pre_disaster.png,96,60,1,687,783,336,396,1121,80.78311093259882,18.463425034179696
9700,/media/marda/TWOTB1/xBD/hurricanes/images/florence/hurricane-florence_00000439_pre_disaster.png,88,67,1,775,863,341,408,1596,57.77598420071619,37.90861161753804
9701,/media/marda/TWOTB1/xBD/hurricanes/images/florence/hurricane-florence_00000439_pre_disaster.png,50,35,1,714,764,388,423,279,19.81050706386376,18.668098687663477
9702,/media/marda/TWOTB1/xBD/hurricanes/images/florence/hurricane-florence_00000439_pre_disaster.png,56,50,1,741,797,397,447,453,34.955195617105545,18.205302354831943
9703,/media/marda/TWOTB1/xBD/hurricanes/images/florence/hurricane-florence_00000439_pre_disaster.png,61,56,1,752,813,415,471,703,41.70742586758026,22.243991516345563
9704,/media/marda/TWOTB1/xBD/hurricanes/images/florence/hurricane-florence_00000439_pre_disaster.png,72,66,1,873,945,457,523,781,58.145335414037845,18.186908620441628
9705,/media/marda/TWOTB1/xBD/hurricanes/images/florence/hurricane-florence_00000439_pre_disaster.png,65,61,1,713,778,480,541,1005,41.54434233741745,33.19486874572988
9706,/media/marda/TWOTB1/xBD/hurricanes/images/florence/hurricane-florence_00000439_pre_disaster.png,42,40,1,673,715,508,548,258,20.518694224247817,16.86361232390823
9707,/media/marda/TWOTB1/xBD/hurricanes/images/florence/hurricane-florence_00000439_pre_disaster.png,60,45,1,878,938,512,557,382,24.891085725760366,20.103628987967724
9708,/media/marda/TWOTB1/xBD/hurricanes/images/florence/hurricane-florence_00000439_pre_disaster.png,35,27,1,680,715,527,554,52,9.974308312539248,7.0057990995809
9709,/media/marda/TWOTB1/xBD/hurricanes/images/florence/hurricane-florence_00000439_pre_disaster.png,59,58,1,644,703,613,671,691,32.48450685894625,28.872133733496387
9710,/media/marda/TWOTB1/xBD/hurricanes/images/florence/hurricane-florence_00000439_pre_disaster.png,63,77,1,808,871,656,733,875,56.28113468707321,20.73709130728184
9711,/media/marda/TWOTB1/xBD/hurricanes/images/florence/hurricane-florence_00000439_pre_disaster.png,111,118,1,933,1044,700,818,3727,78.58902518082515,62.62716599724392
9712,/media/marda/TWOTB1/xBD/hurricanes/images/florence/hurricane-florence_00000439_pre_disaster.png,105,89,1,796,901,769,858,2080,83.51689885224569,33.69401639340648
9713,/media/marda/TWOTB1/xBD/hurricanes/images/florence/hurricane-florence_00000439_pre_disaster.png,58,76,1,556,614,791,867,990,43.40182139424774,30.855056252349108
9714,/media/marda/TWOTB1/xBD/hurricanes/images/florence/hurricane-florence_00000439_pre_disaster.png,109,102,1,897,1006,804,906,2176,80.3091051362047,42.03385763613153
9715,/media/marda/TWOTB1/xBD/hurricanes/images/florence/hurricane-florence_00000439_pre_disaster.png,96,90,1,788,884,851,941,1634,59.824940048567626,41.445599926154465
9716,/media/marda/TWOTB1/xBD/hurricanes/images/florence/hurricane-florence_00000439_pre_disaster.png,74,85,1,705,779,891,976,826,61.48290291421708,17.836885876176314
9717,/media/marda/TWOTB1/xBD/hurricanes/images/florence/hurricane-florence_00000439_pre_disaster.png,71,79,1,764,835,948,1027,790,46.19536085288314,22.808437381180998
9718,/media/marda/TWOTB1/xBD/hurricanes/images/florence/hurricane-florence_00000439_pre_disaster.png,68,63,1,670,738,981,1044,862,45.78155555155162,25.249393927440927
9719,/media/marda/TWOTB1/xBD/hurricanes/images/florence/hurricane-florence_00000240_pre_disaster.png,61,41,1,586,647,93,134,849,38.43307793937631,29.568148628416598
9720,/media/marda/TWOTB1/xBD/hurricanes/images/florence/hurricane-florence_00000240_pre_disaster.png,59,42,1,507,566,139,181,812,40.72226298283839,26.068941284634338
9721,/media/marda/TWOTB1/xBD/hurricanes/images/florence/hurricane-florence_00000240_pre_disaster.png,52,37,1,585,637,157,194,495,30.839098833671283,21.53135308947188
9722,/media/marda/TWOTB1/xBD/hurricanes/images/florence/hurricane-florence_00000240_pre_disaster.png,35,20,1,561,596,180,200,147,15.71999294184912,12.089029285757215
9723,/media/marda/TWOTB1/xBD/hurricanes/images/florence/hurricane-florence_00000240_pre_disaster.png,43,23,1,617,660,187,210,191,16.044708141058262,15.958629764310993
9724,/media/marda/TWOTB1/xBD/hurricanes/images/florence/hurricane-florence_00000240_pre_disaster.png,57,71,1,282,339,547,618,828,62.61223475597258,17.65004364204719
9725,/media/marda/TWOTB1/xBD/hurricanes/images/florence/hurricane-florence_00000240_pre_disaster.png,71,74,1,197,268,599,673,1460,67.62296602546824,29.888683729206747
9726,/media/marda/TWOTB1/xBD/hurricanes/images/florence/hurricane-florence_00000240_pre_disaster.png,32,45,1,265,297,672,717,233,24.613186899850824,12.668391540711383
9727,/media/marda/TWOTB1/xBD/hurricanes/images/florence/hurricane-florence_00000240_pre_disaster.png,59,80,1,159,218,675,755,1322,59.250776408238416,31.055414326983435
9728,/media/marda/TWOTB1/xBD/hurricanes/images/florence/hurricane-florence_00000240_pre_disaster.png,27,41,1,231,258,678,719,156,17.848141246838875,11.69439089584132
9729,/media/marda/TWOTB1/xBD/hurricanes/images/florence/hurricane-florence_00000240_pre_disaster.png,43,81,1,105,148,797,878,1036,43.57812936846865,32.75595797062797
9730,/media/marda/TWOTB1/xBD/hurricanes/images/florence/hurricane-florence_00000240_pre_disaster.png,30,57,1,149,179,812,869,322,22.157423043929537,19.448422831586917
9731,/media/marda/TWOTB1/xBD/hurricanes/images/florence/hurricane-florence_00000240_pre_disaster.png,24,53,1,117,141,858,911,250,18.686842514890227,17.480269014625925
9732,/media/marda/TWOTB1/xBD/hurricanes/images/florence/hurricane-florence_00000493_post_disaster.png,25,21,1,175,200,81,102,224,18.719979167721927,15.895642046878953
9733,/media/marda/TWOTB1/xBD/hurricanes/images/florence/hurricane-florence_00000493_post_disaster.png,24,16,1,228,252,91,107,176,16.45987459847926,14.358392573447986
9734,/media/marda/TWOTB1/xBD/hurricanes/images/florence/hurricane-florence_00000493_post_disaster.png,19,19,1,164,183,104,123,112,12.556668154913018,12.04841352713554
9735,/media/marda/TWOTB1/xBD/hurricanes/images/florence/hurricane-florence_00000220_post_disaster.png,34,10,1,8,42,0,10,214,31.694452467210947,9.659938976728531
9736,/media/marda/TWOTB1/xBD/hurricanes/images/florence/hurricane-florence_00000388_post_disaster.png,346,69,1,86,432,696,765,10174,385.2779595398478,35.284797559803714
9737,/media/marda/TWOTB1/xBD/hurricanes/images/florence/hurricane-florence_00000388_post_disaster.png,348,70,1,84,432,755,825,10151,386.63544701681093,35.31544536126288
9738,/media/marda/TWOTB1/xBD/hurricanes/images/florence/hurricane-florence_00000388_post_disaster.png,41,58,1,425,466,798,856,503,28.82381040141925,23.884481278464975
9739,/media/marda/TWOTB1/xBD/hurricanes/images/florence/hurricane-florence_00000388_post_disaster.png,41,46,1,0,41,997,1043,184,46.66507687647328,5.265008695051079
9740,/media/marda/TWOTB1/xBD/hurricanes/images/florence/hurricane-florence_00000040_post_disaster.png,61,29,1,502,563,0,29,722,36.43065466019972,27.40182465167993
9741,/media/marda/TWOTB1/xBD/hurricanes/images/florence/hurricane-florence_00000040_post_disaster.png,67,25,1,787,854,29,54,604,36.574972960236614,21.75089836541014
9742,/media/marda/TWOTB1/xBD/hurricanes/images/florence/hurricane-florence_00000040_post_disaster.png,81,44,1,633,714,73,117,1361,59.84151453947617,30.456022378126043
9743,/media/marda/TWOTB1/xBD/hurricanes/images/florence/hurricane-florence_00000040_post_disaster.png,43,13,1,565,608,75,88,163,25.047898333619198,8.718591171368338
9744,/media/marda/TWOTB1/xBD/hurricanes/images/florence/hurricane-florence_00000040_post_disaster.png,42,35,1,705,747,80,115,426,39.39827001039264,14.442535427231842
9745,/media/marda/TWOTB1/xBD/hurricanes/images/florence/hurricane-florence_00000040_post_disaster.png,58,47,1,518,576,232,279,903,38.5709170318062,32.450376294382295
9746,/media/marda/TWOTB1/xBD/hurricanes/images/florence/hurricane-florence_00000040_post_disaster.png,49,60,1,450,499,234,294,1030,55.69810695497962,24.50561357976079
9747,/media/marda/TWOTB1/xBD/hurricanes/images/florence/hurricane-florence_00000499_pre_disaster.png,68,67,1,737,805,677,744,1147,44.167361314925664,36.70681068342374
9748,/media/marda/TWOTB1/xBD/hurricanes/images/florence/hurricane-florence_00000499_pre_disaster.png,94,83,1,760,854,757,840,2444,67.24840720412185,49.81327392497261
9749,/media/marda/TWOTB1/xBD/hurricanes/images/florence/hurricane-florence_00000499_pre_disaster.png,75,50,1,541,616,784,834,768,59.0311734063284,17.410862671666735
9750,/media/marda/TWOTB1/xBD/hurricanes/images/florence/hurricane-florence_00000499_pre_disaster.png,54,42,1,904,958,820,862,111,17.669621709233347,8.531833276951996
9751,/media/marda/TWOTB1/xBD/hurricanes/images/florence/hurricane-florence_00000467_pre_disaster.png,75,16,1,721,796,0,16,487,46.484794969635985,14.577355942519699
9752,/media/marda/TWOTB1/xBD/hurricanes/images/florence/hurricane-florence_00000467_pre_disaster.png,39,11,1,712,751,3,14,59,11.01235043382277,7.1946836342279665
9753,/media/marda/TWOTB1/xBD/hurricanes/images/florence/hurricane-florence_00000467_pre_disaster.png,20,31,1,104,124,6,37,346,32.84878574102723,14.104811755087146
9754,/media/marda/TWOTB1/xBD/hurricanes/images/florence/hurricane-florence_00000467_pre_disaster.png,54,17,1,665,719,31,48,278,30.96983646530192,12.03018472095791
9755,/media/marda/TWOTB1/xBD/hurricanes/images/florence/hurricane-florence_00000467_pre_disaster.png,74,44,1,566,640,46,90,1377,51.08562401071935,38.21144311278098
9756,/media/marda/TWOTB1/xBD/hurricanes/images/florence/hurricane-florence_00000467_pre_disaster.png,38,17,1,508,546,99,116,198,16.879327020617758,15.613288567636603
9757,/media/marda/TWOTB1/xBD/hurricanes/images/florence/hurricane-florence_00000467_pre_disaster.png,69,37,1,416,485,101,138,761,61.129901554499135,19.241356458558275
9758,/media/marda/TWOTB1/xBD/hurricanes/images/florence/hurricane-florence_00000467_pre_disaster.png,40,19,1,488,528,106,125,212,22.259298689870985,12.753779882606956
9759,/media/marda/TWOTB1/xBD/hurricanes/images/florence/hurricane-florence_00000467_pre_disaster.png,56,31,1,279,335,134,165,509,51.07659101846226,13.287240119997158
9760,/media/marda/TWOTB1/xBD/hurricanes/images/florence/hurricane-florence_00000467_pre_disaster.png,58,39,1,191,249,159,198,1144,53.73218770407772,28.225760169161774
9761,/media/marda/TWOTB1/xBD/hurricanes/images/florence/hurricane-florence_00000467_pre_disaster.png,51,21,1,988,1039,262,283,76,11.327694736476243,9.300415925610068
9762,/media/marda/TWOTB1/xBD/hurricanes/images/florence/hurricane-florence_00000467_pre_disaster.png,78,51,1,947,1025,267,318,660,51.50214857338433,17.975491577906247
9763,/media/marda/TWOTB1/xBD/hurricanes/images/florence/hurricane-florence_00000467_pre_disaster.png,56,27,1,929,985,276,303,202,18.538653123874646,14.407023843922456
9764,/media/marda/TWOTB1/xBD/hurricanes/images/florence/hurricane-florence_00000467_pre_disaster.png,60,43,1,308,368,322,365,553,55.15478710009056,13.40726507211258
9765,/media/marda/TWOTB1/xBD/hurricanes/images/florence/hurricane-florence_00000467_pre_disaster.png,78,46,1,918,996,339,385,481,51.83439530273154,12.298660726176552
9766,/media/marda/TWOTB1/xBD/hurricanes/images/florence/hurricane-florence_00000467_pre_disaster.png,61,29,1,672,733,359,388,318,38.49241835407283,11.046293891153747
9767,/media/marda/TWOTB1/xBD/hurricanes/images/florence/hurricane-florence_00000467_pre_disaster.png,59,49,1,372,431,363,412,522,55.9845536993852,12.410469791238228
9768,/media/marda/TWOTB1/xBD/hurricanes/images/florence/hurricane-florence_00000467_pre_disaster.png,52,42,1,636,688,366,408,322,35.63545952968605,12.081576587516382
9769,/media/marda/TWOTB1/xBD/hurricanes/images/florence/hurricane-florence_00000467_pre_disaster.png,75,55,1,858,933,378,433,918,42.56542404100563,29.33065583572636
9770,/media/marda/TWOTB1/xBD/hurricanes/images/florence/hurricane-florence_00000467_pre_disaster.png,47,36,1,650,697,391,427,219,28.148267929854402,10.42063685083147
9771,/media/marda/TWOTB1/xBD/hurricanes/images/florence/hurricane-florence_00000467_pre_disaster.png,48,38,1,434,482,406,444,255,36.45623069466846,9.35197052635897
9772,/media/marda/TWOTB1/xBD/hurricanes/images/florence/hurricane-florence_00000467_pre_disaster.png,70,40,1,491,561,432,472,522,56.26276462678272,12.39775712317944
9773,/media/marda/TWOTB1/xBD/hurricanes/images/florence/hurricane-florence_00000467_pre_disaster.png,47,43,1,341,388,447,490,325,41.00803544273955,10.574400796448948
9774,/media/marda/TWOTB1/xBD/hurricanes/images/florence/hurricane-florence_00000467_pre_disaster.png,59,38,1,918,977,449,487,253,19.88732485090083,17.02332047764515
9775,/media/marda/TWOTB1/xBD/hurricanes/images/florence/hurricane-florence_00000467_pre_disaster.png,55,41,1,395,450,478,519,373,44.02827292685271,11.332271090983467
9776,/media/marda/TWOTB1/xBD/hurricanes/images/florence/hurricane-florence_00000467_pre_disaster.png,56,30,1,1,57,484,514,618,64.87869814515564,12.729593586589726
9777,/media/marda/TWOTB1/xBD/hurricanes/images/florence/hurricane-florence_00000467_pre_disaster.png,83,65,1,906,989,489,554,778,62.328390536683244,16.76239876846613
9778,/media/marda/TWOTB1/xBD/hurricanes/images/florence/hurricane-florence_00000467_pre_disaster.png,47,58,1,587,634,490,548,526,40.87733281535989,17.205056002849496
9779,/media/marda/TWOTB1/xBD/hurricanes/images/florence/hurricane-florence_00000467_pre_disaster.png,68,42,1,453,521,501,543,469,56.69881596653357,11.057748231666888
9780,/media/marda/TWOTB1/xBD/hurricanes/images/florence/hurricane-florence_00000467_pre_disaster.png,54,33,1,278,332,511,544,464,50.96603300556006,12.18131385128316
9781,/media/marda/TWOTB1/xBD/hurricanes/images/florence/hurricane-florence_00000467_pre_disaster.png,59,32,1,521,580,511,543,468,45.01851470969102,13.808210118138652
9782,/media/marda/TWOTB1/xBD/hurricanes/images/florence/hurricane-florence_00000467_pre_disaster.png,56,32,1,77,133,553,585,642,61.82459008860671,13.73835192639836
9783,/media/marda/TWOTB1/xBD/hurricanes/images/florence/hurricane-florence_00000467_pre_disaster.png,61,33,1,155,216,553,586,649,62.5289234741544,13.77280058701633
9784,/media/marda/TWOTB1/xBD/hurricanes/images/florence/hurricane-florence_00000467_pre_disaster.png,82,71,1,852,934,553,624,1150,52.67985747869764,31.446260538359876
9785,/media/marda/TWOTB1/xBD/hurricanes/images/florence/hurricane-florence_00000467_pre_disaster.png,57,32,1,273,330,555,587,508,53.34018527926362,12.618754581593727
9786,/media/marda/TWOTB1/xBD/hurricanes/images/florence/hurricane-florence_00000467_pre_disaster.png,63,32,1,355,418,555,587,534,56.05445295527224,12.684209555252087
9787,/media/marda/TWOTB1/xBD/hurricanes/images/florence/hurricane-florence_00000467_pre_disaster.png,68,32,1,443,511,555,587,546,57.30735531604787,12.67267648179111
9788,/media/marda/TWOTB1/xBD/hurricanes/images/florence/hurricane-florence_00000467_pre_disaster.png,69,34,1,512,581,555,589,566,56.70117180542449,13.341155984970365
9789,/media/marda/TWOTB1/xBD/hurricanes/images/florence/hurricane-florence_00000467_pre_disaster.png,54,38,1,906,960,582,620,170,16.36206953790216,13.778064740017259
9790,/media/marda/TWOTB1/xBD/hurricanes/images/florence/hurricane-florence_00000467_pre_disaster.png,60,44,1,903,963,601,645,233,20.679136075369946,15.817411130596565
9791,/media/marda/TWOTB1/xBD/hurricanes/images/florence/hurricane-florence_00000467_pre_disaster.png,55,41,1,888,943,610,651,154,18.78947650338026,10.972877759878621
9792,/media/marda/TWOTB1/xBD/hurricanes/images/florence/hurricane-florence_00000467_pre_disaster.png,54,43,1,869,923,614,657,186,18.386380543091647,13.522794568728111
9793,/media/marda/TWOTB1/xBD/hurricanes/images/florence/hurricane-florence_00000467_pre_disaster.png,28,45,1,0,28,632,677,544,31.540783262650752,22.841417504945653
9794,/media/marda/TWOTB1/xBD/hurricanes/images/florence/hurricane-florence_00000467_pre_disaster.png,39,43,1,427,466,632,675,387,25.09004115524639,20.105117409870555
9795,/media/marda/TWOTB1/xBD/hurricanes/images/florence/hurricane-florence_00000467_pre_disaster.png,39,45,1,64,103,633,678,701,40.79917784413263,22.49737885361749
9796,/media/marda/TWOTB1/xBD/hurricanes/images/florence/hurricane-florence_00000467_pre_disaster.png,36,44,1,135,171,633,677,572,35.60829975878567,21.20251554501236
9797,/media/marda/TWOTB1/xBD/hurricanes/images/florence/hurricane-florence_00000467_pre_disaster.png,47,42,1,196,243,633,675,584,40.799811424746295,18.99980341366879
9798,/media/marda/TWOTB1/xBD/hurricanes/images/florence/hurricane-florence_00000467_pre_disaster.png,43,43,1,267,310,633,676,565,36.41023721992651,20.374240157733475
9799,/media/marda/TWOTB1/xBD/hurricanes/images/florence/hurricane-florence_00000467_pre_disaster.png,36,42,1,347,383,633,675,393,25.417474637853,20.157066666090707
9800,/media/marda/TWOTB1/xBD/hurricanes/images/florence/hurricane-florence_00000467_pre_disaster.png,42,43,1,508,550,633,676,339,23.323939788045763,19.07018189881606
9801,/media/marda/TWOTB1/xBD/hurricanes/images/florence/hurricane-florence_00000467_pre_disaster.png,43,42,1,570,613,633,675,328,22.437190043286428,19.270513571888202
9802,/media/marda/TWOTB1/xBD/hurricanes/images/florence/hurricane-florence_00000467_pre_disaster.png,47,35,1,888,935,637,672,60,9.21410791774517,8.852256068504117
9803,/media/marda/TWOTB1/xBD/hurricanes/images/florence/hurricane-florence_00000467_pre_disaster.png,45,33,1,898,943,644,677,42,7.800480137763199,7.355294380604385
9804,/media/marda/TWOTB1/xBD/hurricanes/images/florence/hurricane-florence_00000467_pre_disaster.png,43,32,1,914,957,649,681,56,9.16515138991168,8.0
9805,/media/marda/TWOTB1/xBD/hurricanes/images/florence/hurricane-florence_00000467_pre_disaster.png,43,68,1,648,691,685,753,619,48.48970851335333,17.723302970888398
9806,/media/marda/TWOTB1/xBD/hurricanes/images/florence/hurricane-florence_00000467_pre_disaster.png,49,57,1,508,557,699,756,424,26.285906076160273,21.562978762490935
9807,/media/marda/TWOTB1/xBD/hurricanes/images/florence/hurricane-florence_00000467_pre_disaster.png,31,77,1,33,64,708,785,1092,52.107092251298525,27.82522452781526
9808,/media/marda/TWOTB1/xBD/hurricanes/images/florence/hurricane-florence_00000467_pre_disaster.png,59,74,1,476,535,743,817,959,48.44024249179368,26.257333061182187
9809,/media/marda/TWOTB1/xBD/hurricanes/images/florence/hurricane-florence_00000467_pre_disaster.png,42,76,1,655,697,775,851,695,53.35113275177914,17.42568273829714
9810,/media/marda/TWOTB1/xBD/hurricanes/images/florence/hurricane-florence_00000467_pre_disaster.png,58,80,1,427,485,807,887,1077,51.14155343809167,27.86768488460084
9811,/media/marda/TWOTB1/xBD/hurricanes/images/florence/hurricane-florence_00000467_pre_disaster.png,29,44,1,405,434,826,870,125,13.947748399863139,12.164792253635705
9812,/media/marda/TWOTB1/xBD/hurricanes/images/florence/hurricane-florence_00000467_pre_disaster.png,42,88,1,661,703,843,931,800,61.61265478261433,17.340361029643848
9813,/media/marda/TWOTB1/xBD/hurricanes/images/florence/hurricane-florence_00000467_pre_disaster.png,66,63,1,386,452,855,918,553,59.92596858619194,12.280948051679744
9814,/media/marda/TWOTB1/xBD/hurricanes/images/florence/hurricane-florence_00000467_pre_disaster.png,49,83,1,516,565,907,990,586,54.1105011725059,14.345759776765115
9815,/media/marda/TWOTB1/xBD/hurricanes/images/florence/hurricane-florence_00000467_pre_disaster.png,72,80,1,425,497,962,1042,1065,62.681277159235805,22.469117194810437
9816,/media/marda/TWOTB1/xBD/hurricanes/images/florence/hurricane-florence_00000084_post_disaster.png,70,24,1,973,1043,0,24,461,36.29339587079653,16.99708467657321
9817,/media/marda/TWOTB1/xBD/hurricanes/images/florence/hurricane-florence_00000084_post_disaster.png,58,35,1,703,761,7,42,686,33.68513306770596,27.18846602599181
9818,/media/marda/TWOTB1/xBD/hurricanes/images/florence/hurricane-florence_00000084_post_disaster.png,87,45,1,589,676,29,74,1836,68.9276607267094,35.19753568577127
9819,/media/marda/TWOTB1/xBD/hurricanes/images/florence/hurricane-florence_00000084_post_disaster.png,45,23,1,713,758,39,62,251,22.423598660302964,14.991566143198924
9820,/media/marda/TWOTB1/xBD/hurricanes/images/florence/hurricane-florence_00000084_post_disaster.png,51,38,1,476,527,51,89,829,37.97400869639612,29.033185865697778
9821,/media/marda/TWOTB1/xBD/hurricanes/images/florence/hurricane-florence_00000084_post_disaster.png,82,34,1,614,696,103,137,914,64.04681009872421,19.64622727809014
9822,/media/marda/TWOTB1/xBD/hurricanes/images/florence/hurricane-florence_00000084_post_disaster.png,53,42,1,490,543,108,150,769,35.23244466724881,29.634543377661362
9823,/media/marda/TWOTB1/xBD/hurricanes/images/florence/hurricane-florence_00000084_post_disaster.png,75,44,1,438,513,136,180,1387,63.05973533443626,29.622576799031616
9824,/media/marda/TWOTB1/xBD/hurricanes/images/florence/hurricane-florence_00000084_post_disaster.png,60,51,1,181,241,141,192,1524,52.61091497390468,38.07724674134124
9825,/media/marda/TWOTB1/xBD/hurricanes/images/florence/hurricane-florence_00000084_post_disaster.png,97,51,1,339,436,157,208,2111,92.46792468505322,30.308809193830996
9826,/media/marda/TWOTB1/xBD/hurricanes/images/florence/hurricane-florence_00000084_post_disaster.png,75,39,1,968,1043,157,196,825,43.23916336622387,26.726492757509245
9827,/media/marda/TWOTB1/xBD/hurricanes/images/florence/hurricane-florence_00000084_post_disaster.png,53,20,1,805,858,167,187,219,22.45941578082016,12.900350273850425
9828,/media/marda/TWOTB1/xBD/hurricanes/images/florence/hurricane-florence_00000084_post_disaster.png,76,38,1,917,993,174,212,848,42.595879709148,26.27681602256408
9829,/media/marda/TWOTB1/xBD/hurricanes/images/florence/hurricane-florence_00000084_post_disaster.png,75,41,1,868,943,185,226,993,41.14941707001024,33.34190577604985
9830,/media/marda/TWOTB1/xBD/hurricanes/images/florence/hurricane-florence_00000084_post_disaster.png,72,39,1,816,888,201,240,810,42.88158669047891,25.060045311702996
9831,/media/marda/TWOTB1/xBD/hurricanes/images/florence/hurricane-florence_00000084_post_disaster.png,48,24,1,732,780,202,226,193,20.08714217311694,12.670425669446505
9832,/media/marda/TWOTB1/xBD/hurricanes/images/florence/hurricane-florence_00000084_post_disaster.png,19,49,1,0,19,245,294,397,35.52176509274098,17.197129088904838
9833,/media/marda/TWOTB1/xBD/hurricanes/images/florence/hurricane-florence_00000084_post_disaster.png,172,162,1,871,1043,335,497,7927,150.0311598239652,119.19299618927418
9834,/media/marda/TWOTB1/xBD/hurricanes/images/florence/hurricane-florence_00000084_post_disaster.png,64,53,1,209,273,341,394,1128,64.70735241829894,23.027926803987874
9835,/media/marda/TWOTB1/xBD/hurricanes/images/florence/hurricane-florence_00000084_post_disaster.png,21,35,1,17,38,432,467,276,21.272666194600596,17.17377335615493
9836,/media/marda/TWOTB1/xBD/hurricanes/images/florence/hurricane-florence_00000084_post_disaster.png,7,35,1,0,7,453,488,78,19.872816869178028,6.5144969914518045
9837,/media/marda/TWOTB1/xBD/hurricanes/images/florence/hurricane-florence_00000084_post_disaster.png,47,45,1,402,449,557,602,480,29.919664650714772,21.253187354943364
9838,/media/marda/TWOTB1/xBD/hurricanes/images/florence/hurricane-florence_00000084_post_disaster.png,33,62,1,65,98,581,643,759,41.580132643187255,24.3797860745175
9839,/media/marda/TWOTB1/xBD/hurricanes/images/florence/hurricane-florence_00000084_post_disaster.png,64,66,1,371,435,590,656,1375,49.31904774944977,37.16761107142769
9840,/media/marda/TWOTB1/xBD/hurricanes/images/florence/hurricane-florence_00000084_post_disaster.png,23,42,1,74,97,633,675,244,24.505812955136346,13.131196188779237
9841,/media/marda/TWOTB1/xBD/hurricanes/images/florence/hurricane-florence_00000084_post_disaster.png,78,63,1,939,1017,639,702,1048,41.41047365390784,35.60358963174352
9842,/media/marda/TWOTB1/xBD/hurricanes/images/florence/hurricane-florence_00000084_post_disaster.png,78,55,1,831,909,673,728,847,50.23400512249365,22.279680863381355
9843,/media/marda/TWOTB1/xBD/hurricanes/images/florence/hurricane-florence_00000084_post_disaster.png,68,64,1,965,1033,685,749,778,40.57932928610642,25.54702682138477
9844,/media/marda/TWOTB1/xBD/hurricanes/images/florence/hurricane-florence_00000084_post_disaster.png,44,64,1,312,356,686,750,677,36.764924691648815,24.53680610263913
9845,/media/marda/TWOTB1/xBD/hurricanes/images/florence/hurricane-florence_00000084_post_disaster.png,62,69,1,856,918,714,783,689,43.17975516573681,21.29263704672977
9846,/media/marda/TWOTB1/xBD/hurricanes/images/florence/hurricane-florence_00000084_post_disaster.png,64,65,1,979,1043,737,802,694,35.89869442269783,25.222414319631334
9847,/media/marda/TWOTB1/xBD/hurricanes/images/florence/hurricane-florence_00000084_post_disaster.png,26,39,1,303,329,738,777,92,13.902414728731426,8.914251819659482
9848,/media/marda/TWOTB1/xBD/hurricanes/images/florence/hurricane-florence_00000084_post_disaster.png,59,64,1,342,401,752,816,1041,48.99422394805873,27.900157841607758
9849,/media/marda/TWOTB1/xBD/hurricanes/images/florence/hurricane-florence_00000084_post_disaster.png,81,70,1,854,935,764,834,1300,46.41743972247241,37.385670224450315
9850,/media/marda/TWOTB1/xBD/hurricanes/images/florence/hurricane-florence_00000084_post_disaster.png,64,59,1,646,710,766,825,799,42.36292008181368,24.948702619463734
9851,/media/marda/TWOTB1/xBD/hurricanes/images/florence/hurricane-florence_00000084_post_disaster.png,53,48,1,818,871,781,829,264,19.836348787990673,17.847416789130232
9852,/media/marda/TWOTB1/xBD/hurricanes/images/florence/hurricane-florence_00000084_post_disaster.png,62,65,1,981,1043,789,854,585,33.875735328624984,23.011058390789625
9853,/media/marda/TWOTB1/xBD/hurricanes/images/florence/hurricane-florence_00000084_post_disaster.png,67,71,1,883,950,815,886,783,38.44143130924345,27.188353213602305
9854,/media/marda/TWOTB1/xBD/hurricanes/images/florence/hurricane-florence_00000084_post_disaster.png,54,54,1,828,882,828,882,318,21.36097090988266,19.932977025680817
9855,/media/marda/TWOTB1/xBD/hurricanes/images/florence/hurricane-florence_00000084_post_disaster.png,72,68,1,893,965,868,936,838,36.46220258048931,30.76137316842149
9856,/media/marda/TWOTB1/xBD/hurricanes/images/florence/hurricane-florence_00000084_post_disaster.png,63,63,1,697,760,955,1018,656,36.37563362054145,23.884087921890362
9857,/media/marda/TWOTB1/xBD/hurricanes/images/florence/hurricane-florence_00000084_post_disaster.png,59,83,1,588,647,958,1041,1044,48.63751231255953,28.42118281356161
9858,/media/marda/TWOTB1/xBD/hurricanes/images/florence/hurricane-florence_00000084_post_disaster.png,49,60,1,531,580,963,1023,432,30.03184613282712,19.116123582388767
9859,/media/marda/TWOTB1/xBD/hurricanes/images/florence/hurricane-florence_00000084_post_disaster.png,59,56,1,647,706,987,1043,393,35.49069229845065,15.50620129727051
9860,/media/marda/TWOTB1/xBD/hurricanes/images/florence/hurricane-florence_00000084_post_disaster.png,35,49,1,529,564,994,1043,90,14.931297902051355,8.370645195257541
9861,/media/marda/TWOTB1/xBD/hurricanes/images/florence/hurricane-florence_00000364_pre_disaster.png,358,408,1,428,786,0,408,86585,434.4350701792331,297.0737839095982
9862,/media/marda/TWOTB1/xBD/hurricanes/images/florence/hurricane-florence_00000364_pre_disaster.png,46,3,1,784,830,0,3,22,14.73527769800844,2.134839941494035
9863,/media/marda/TWOTB1/xBD/hurricanes/images/florence/hurricane-florence_00000364_pre_disaster.png,42,31,1,57,99,38,69,869,43.75216058200869,26.007039141024702
9864,/media/marda/TWOTB1/xBD/hurricanes/images/florence/hurricane-florence_00000364_pre_disaster.png,8,23,1,0,8,68,91,99,22.177207826316533,6.879406453527937
9865,/media/marda/TWOTB1/xBD/hurricanes/images/florence/hurricane-florence_00000364_pre_disaster.png,33,19,1,97,130,78,97,332,33.00812980668291,15.33943678692614
9866,/media/marda/TWOTB1/xBD/hurricanes/images/florence/hurricane-florence_00000364_pre_disaster.png,30,23,1,55,85,84,107,321,35.036028856676914,17.171670129508726
9867,/media/marda/TWOTB1/xBD/hurricanes/images/florence/hurricane-florence_00000364_pre_disaster.png,19,22,1,16,35,101,123,210,17.88070560168307,15.677807728371944
9868,/media/marda/TWOTB1/xBD/hurricanes/images/florence/hurricane-florence_00000364_pre_disaster.png,231,135,1,167,398,227,362,15397,244.54773563327643,83.86794563738248
9869,/media/marda/TWOTB1/xBD/hurricanes/images/florence/hurricane-florence_00000364_pre_disaster.png,62,46,1,864,926,249,295,704,40.68003426506058,22.812661993159825
9870,/media/marda/TWOTB1/xBD/hurricanes/images/florence/hurricane-florence_00000364_pre_disaster.png,128,117,1,275,403,418,535,7894,117.44787449297839,90.76258576709606
9871,/media/marda/TWOTB1/xBD/hurricanes/images/florence/hurricane-florence_00000364_pre_disaster.png,37,31,1,531,568,421,452,167,16.665502063013953,13.439060472253974
9872,/media/marda/TWOTB1/xBD/hurricanes/images/florence/hurricane-florence_00000364_pre_disaster.png,41,68,1,433,474,510,578,634,53.53317171870943,17.82505900058294
9873,/media/marda/TWOTB1/xBD/hurricanes/images/florence/hurricane-florence_00000364_pre_disaster.png,51,63,1,395,446,531,594,590,50.52546293750198,15.51091402528208
9874,/media/marda/TWOTB1/xBD/hurricanes/images/florence/hurricane-florence_00000364_pre_disaster.png,62,59,1,358,420,544,603,653,56.373064930921174,15.476991813054939
9875,/media/marda/TWOTB1/xBD/hurricanes/images/florence/hurricane-florence_00000364_pre_disaster.png,61,58,1,332,393,555,613,628,58.11317668626475,14.398076117078393
9876,/media/marda/TWOTB1/xBD/hurricanes/images/florence/hurricane-florence_00000364_pre_disaster.png,61,58,1,310,371,566,624,602,58.36797846287089,13.774513773368723
9877,/media/marda/TWOTB1/xBD/hurricanes/images/florence/hurricane-florence_00000364_pre_disaster.png,60,56,1,286,346,579,635,612,56.961059427486305,14.360291235057755
9878,/media/marda/TWOTB1/xBD/hurricanes/images/florence/hurricane-florence_00000364_pre_disaster.png,53,59,1,266,319,589,648,493,51.8207192672419,12.707803795991843
9879,/media/marda/TWOTB1/xBD/hurricanes/images/florence/hurricane-florence_00000364_pre_disaster.png,48,53,1,243,291,602,655,404,45.93710255605537,11.766223459504163
9880,/media/marda/TWOTB1/xBD/hurricanes/images/florence/hurricane-florence_00000364_pre_disaster.png,87,71,1,182,269,611,682,1583,73.7146448425305,37.04216118244833
9881,/media/marda/TWOTB1/xBD/hurricanes/images/florence/hurricane-florence_00000364_pre_disaster.png,47,50,1,385,432,613,663,354,36.29195401720442,13.031957900502306
9882,/media/marda/TWOTB1/xBD/hurricanes/images/florence/hurricane-florence_00000364_pre_disaster.png,28,80,1,37,65,616,696,700,63.1481538273167,14.746473768657738
9883,/media/marda/TWOTB1/xBD/hurricanes/images/florence/hurricane-florence_00000364_pre_disaster.png,70,64,1,365,435,622,686,798,64.6388993807744,17.485492877027703
9884,/media/marda/TWOTB1/xBD/hurricanes/images/florence/hurricane-florence_00000364_pre_disaster.png,38,46,1,421,459,629,675,254,23.885827656268397,14.545498320223075
9885,/media/marda/TWOTB1/xBD/hurricanes/images/florence/hurricane-florence_00000364_pre_disaster.png,56,58,1,170,226,634,692,689,55.69020291692226,17.35178157533541
9886,/media/marda/TWOTB1/xBD/hurricanes/images/florence/hurricane-florence_00000364_pre_disaster.png,78,92,1,337,415,634,726,1306,86.47638143264203,23.779549852215645
9887,/media/marda/TWOTB1/xBD/hurricanes/images/florence/hurricane-florence_00000364_pre_disaster.png,55,63,1,139,194,642,705,838,56.53420898543478,21.17615963017332
9888,/media/marda/TWOTB1/xBD/hurricanes/images/florence/hurricane-florence_00000364_pre_disaster.png,59,58,1,380,439,653,711,526,52.42528807032864,13.399422616889044
9889,/media/marda/TWOTB1/xBD/hurricanes/images/florence/hurricane-florence_00000364_pre_disaster.png,53,61,1,120,173,657,718,633,53.02648097517671,18.66003449926441
9890,/media/marda/TWOTB1/xBD/hurricanes/images/florence/hurricane-florence_00000364_pre_disaster.png,55,77,1,320,375,659,736,695,65.08748308554377,14.269172839786737
9891,/media/marda/TWOTB1/xBD/hurricanes/images/florence/hurricane-florence_00000364_pre_disaster.png,49,79,1,275,324,662,741,935,59.72661596495007,21.29415321915672
9892,/media/marda/TWOTB1/xBD/hurricanes/images/florence/hurricane-florence_00000364_pre_disaster.png,46,71,1,254,300,668,739,642,56.84893980729077,14.993951196368972
9893,/media/marda/TWOTB1/xBD/hurricanes/images/florence/hurricane-florence_00000364_pre_disaster.png,42,57,1,482,524,680,737,506,35.501837947194375,18.864564118862987
9894,/media/marda/TWOTB1/xBD/hurricanes/images/florence/hurricane-florence_00000364_pre_disaster.png,12,35,1,1,13,681,716,88,11.847612688246057,9.918145531267108
9895,/media/marda/TWOTB1/xBD/hurricanes/images/florence/hurricane-florence_00000364_pre_disaster.png,28,73,1,107,135,681,754,734,55.561221630608806,18.13007482993154
9896,/media/marda/TWOTB1/xBD/hurricanes/images/florence/hurricane-florence_00000364_pre_disaster.png,39,73,1,51,90,683,756,988,55.62487180102387,24.930094770228163
9897,/media/marda/TWOTB1/xBD/hurricanes/images/florence/hurricane-florence_00000364_pre_disaster.png,56,62,1,202,258,691,753,639,55.20840538291652,17.622907060751224
9898,/media/marda/TWOTB1/xBD/hurricanes/images/florence/hurricane-florence_00000364_pre_disaster.png,8,43,1,0,8,702,745,79,14.338753881822873,7.690071422612406
9899,/media/marda/TWOTB1/xBD/hurricanes/images/florence/hurricane-florence_00000364_pre_disaster.png,43,68,1,420,463,702,770,564,41.5340166652904,19.036588026229275
9900,/media/marda/TWOTB1/xBD/hurricanes/images/florence/hurricane-florence_00000364_pre_disaster.png,40,61,1,390,430,709,770,473,31.86827801004517,20.265592999509963
9901,/media/marda/TWOTB1/xBD/hurricanes/images/florence/hurricane-florence_00000364_pre_disaster.png,50,77,1,171,221,711,788,729,60.20586812789499,16.187468818537806
9902,/media/marda/TWOTB1/xBD/hurricanes/images/florence/hurricane-florence_00000364_pre_disaster.png,70,74,1,223,293,712,786,1198,58.122157056486124,39.59471679954003
9903,/media/marda/TWOTB1/xBD/hurricanes/images/florence/hurricane-florence_00000364_pre_disaster.png,23,62,1,0,23,722,784,472,30.57644048040498,21.509295719359365
9904,/media/marda/TWOTB1/xBD/hurricanes/images/florence/hurricane-florence_00000364_pre_disaster.png,38,63,1,362,400,728,791,385,38.35838363943384,13.424466859295986
9905,/media/marda/TWOTB1/xBD/hurricanes/images/florence/hurricane-florence_00000364_pre_disaster.png,49,55,1,107,156,733,788,569,49.535996140656636,15.230211612458069
9906,/media/marda/TWOTB1/xBD/hurricanes/images/florence/hurricane-florence_00000364_pre_disaster.png,36,76,1,74,110,736,812,697,55.2374587711766,16.829329262120613
9907,/media/marda/TWOTB1/xBD/hurricanes/images/florence/hurricane-florence_00000364_pre_disaster.png,35,65,1,337,372,743,808,415,39.91397305010826,14.605918847704018
9908,/media/marda/TWOTB1/xBD/hurricanes/images/florence/hurricane-florence_00000364_pre_disaster.png,46,65,1,188,234,748,813,735,39.70207913937586,31.03022672786236
9909,/media/marda/TWOTB1/xBD/hurricanes/images/florence/hurricane-florence_00000364_pre_disaster.png,31,57,1,302,333,757,814,335,28.872061015388034,15.787748804212365
9910,/media/marda/TWOTB1/xBD/hurricanes/images/florence/hurricane-florence_00000364_pre_disaster.png,36,59,1,0,36,762,821,527,42.45954157560167,16.637884497326077
9911,/media/marda/TWOTB1/xBD/hurricanes/images/florence/hurricane-florence_00000364_pre_disaster.png,48,55,1,115,163,765,820,534,48.58742101828442,14.702332798388017
9912,/media/marda/TWOTB1/xBD/hurricanes/images/florence/hurricane-florence_00000364_pre_disaster.png,51,64,1,6,57,788,852,720,56.796646352053465,16.856894225000598
9913,/media/marda/TWOTB1/xBD/hurricanes/images/florence/hurricane-florence_00000364_pre_disaster.png,54,62,1,128,182,794,856,630,57.22368762052267,14.736135244247622
9914,/media/marda/TWOTB1/xBD/hurricanes/images/florence/hurricane-florence_00000364_pre_disaster.png,25,61,1,99,124,795,856,332,28.733936697037716,15.507274340140448
9915,/media/marda/TWOTB1/xBD/hurricanes/images/florence/hurricane-florence_00000364_pre_disaster.png,29,58,1,218,247,798,856,290,23.271825973623887,16.931129974893278
9916,/media/marda/TWOTB1/xBD/hurricanes/images/florence/hurricane-florence_00000364_pre_disaster.png,45,66,1,147,192,830,896,677,41.176867769672064,29.15306639849121
9917,/media/marda/TWOTB1/xBD/hurricanes/images/florence/hurricane-florence_00000364_pre_disaster.png,25,60,1,197,222,830,890,338,27.300604575948398,16.465801907203794
9918,/media/marda/TWOTB1/xBD/hurricanes/images/florence/hurricane-florence_00000364_pre_disaster.png,26,54,1,7,33,832,886,316,26.79195952231467,15.78279725790351
9919,/media/marda/TWOTB1/xBD/hurricanes/images/florence/hurricane-florence_00000364_pre_disaster.png,55,65,1,27,82,849,914,803,61.58716555329641,17.25159101212408
9920,/media/marda/TWOTB1/xBD/hurricanes/images/florence/hurricane-florence_00000364_pre_disaster.png,33,79,1,119,152,850,929,787,48.815096371693265,22.429355710880476
9921,/media/marda/TWOTB1/xBD/hurricanes/images/florence/hurricane-florence_00000364_pre_disaster.png,52,62,1,40,92,881,943,738,56.23890319241538,18.820392562159757
9922,/media/marda/TWOTB1/xBD/hurricanes/images/florence/hurricane-florence_00000364_pre_disaster.png,40,65,1,68,108,906,971,638,40.807064010317916,20.66138908816319
9923,/media/marda/TWOTB1/xBD/hurricanes/images/florence/hurricane-florence_00000364_pre_disaster.png,25,68,1,135,160,939,1007,390,33.46159114295514,15.574291379554413
9924,/media/marda/TWOTB1/xBD/hurricanes/images/florence/hurricane-florence_00000364_pre_disaster.png,23,70,1,111,134,947,1017,330,37.52432786901319,11.777635448878481
9925,/media/marda/TWOTB1/xBD/hurricanes/images/florence/hurricane-florence_00000364_pre_disaster.png,22,59,1,86,108,965,1024,296,21.323722155780413,18.256589866926724
9926,/media/marda/TWOTB1/xBD/hurricanes/images/florence/hurricane-florence_00000364_pre_disaster.png,37,72,1,29,66,970,1042,856,39.8280249162002,28.148394808364294
9927,/media/marda/TWOTB1/xBD/hurricanes/images/florence/hurricane-florence_00000424_pre_disaster.png,65,56,1,849,914,618,674,493,37.65131424079412,17.20795241729779
9928,/media/marda/TWOTB1/xBD/hurricanes/images/florence/hurricane-florence_00000424_pre_disaster.png,61,69,1,700,761,812,881,480,45.11794815388455,14.156807508327237
9929,/media/marda/TWOTB1/xBD/hurricanes/images/florence/hurricane-florence_00000424_pre_disaster.png,58,82,1,622,680,905,987,589,53.29399439043431,14.687131652709486
9930,/media/marda/TWOTB1/xBD/hurricanes/images/florence/hurricane-florence_00000424_pre_disaster.png,40,50,1,726,766,949,999,90,12.65857162026289,9.566586480054102
9931,/media/marda/TWOTB1/xBD/hurricanes/images/florence/hurricane-florence_00000424_pre_disaster.png,42,54,1,742,784,989,1043,117,14.273492592362926,11.039719907872655
9932,/media/marda/TWOTB1/xBD/hurricanes/images/florence/hurricane-florence_00000236_post_disaster.png,64,43,1,469,533,142,185,506,57.81863311037261,12.20383855070609
9933,/media/marda/TWOTB1/xBD/hurricanes/images/florence/hurricane-florence_00000236_post_disaster.png,72,74,1,439,511,179,253,1930,72.90446746406697,35.02982799784597
9934,/media/marda/TWOTB1/xBD/hurricanes/images/florence/hurricane-florence_00000236_post_disaster.png,33,21,1,410,443,180,201,146,14.229253937688664,13.768782584090978
9935,/media/marda/TWOTB1/xBD/hurricanes/images/florence/hurricane-florence_00000236_post_disaster.png,87,82,1,457,544,275,357,2382,79.50152182449659,40.18493909094046
9936,/media/marda/TWOTB1/xBD/hurricanes/images/florence/hurricane-florence_00000236_post_disaster.png,35,33,1,364,399,302,335,220,23.383524690325157,12.582325114554902
9937,/media/marda/TWOTB1/xBD/hurricanes/images/florence/hurricane-florence_00000236_post_disaster.png,40,30,1,596,636,390,420,148,16.779821266236684,11.853348841988241
9938,/media/marda/TWOTB1/xBD/hurricanes/images/florence/hurricane-florence_00000236_post_disaster.png,50,36,1,694,744,418,454,217,18.721362830827818,15.531676399177686
9939,/media/marda/TWOTB1/xBD/hurricanes/images/florence/hurricane-florence_00000236_post_disaster.png,62,50,1,621,683,422,472,624,39.63947606793837,21.084748941214418
9940,/media/marda/TWOTB1/xBD/hurricanes/images/florence/hurricane-florence_00000236_post_disaster.png,64,53,1,661,725,437,490,598,43.52083406122305,18.280038810546387
9941,/media/marda/TWOTB1/xBD/hurricanes/images/florence/hurricane-florence_00000236_post_disaster.png,83,76,1,601,684,477,553,1447,71.91464122877895,28.26960329002954
9942,/media/marda/TWOTB1/xBD/hurricanes/images/florence/hurricane-florence_00000236_post_disaster.png,56,48,1,729,785,504,552,411,30.529650749573303,17.630800327927112
9943,/media/marda/TWOTB1/xBD/hurricanes/images/florence/hurricane-florence_00000236_post_disaster.png,59,65,1,424,483,523,588,1002,45.61456408497171,28.81917703056075
9944,/media/marda/TWOTB1/xBD/hurricanes/images/florence/hurricane-florence_00000236_post_disaster.png,65,67,1,392,457,590,657,1143,45.81873642772062,36.01963102928318
9945,/media/marda/TWOTB1/xBD/hurricanes/images/florence/hurricane-florence_00000236_post_disaster.png,42,49,1,457,499,597,646,335,24.7291931686497,17.959039969079367
9946,/media/marda/TWOTB1/xBD/hurricanes/images/florence/hurricane-florence_00000236_post_disaster.png,26,49,1,263,289,811,860,152,15.291097661627067,13.360007916425797
9947,/media/marda/TWOTB1/xBD/hurricanes/images/florence/hurricane-florence_00000236_post_disaster.png,65,70,1,400,465,824,894,1141,46.52962883250886,31.893963594494537
9948,/media/marda/TWOTB1/xBD/hurricanes/images/florence/hurricane-florence_00000236_post_disaster.png,47,69,1,370,417,829,898,633,32.47620802297309,26.64483852881137
9949,/media/marda/TWOTB1/xBD/hurricanes/images/florence/hurricane-florence_00000236_post_disaster.png,64,78,1,491,555,886,964,975,49.885495729073455,25.823813592781352
9950,/media/marda/TWOTB1/xBD/hurricanes/images/florence/hurricane-florence_00000236_post_disaster.png,31,49,1,491,522,951,1000,84,11.291169973129106,10.022613995136396
9951,/media/marda/TWOTB1/xBD/hurricanes/images/florence/hurricane-florence_00000236_post_disaster.png,41,54,1,506,547,956,1010,201,17.4997384746561,15.244413975361663
9952,/media/marda/TWOTB1/xBD/hurricanes/images/florence/hurricane-florence_00000205_pre_disaster.png,86,54,1,712,798,230,284,1561,64.70860276737946,32.21487220953711
9953,/media/marda/TWOTB1/xBD/hurricanes/images/florence/hurricane-florence_00000205_pre_disaster.png,102,53,1,853,955,268,321,1625,74.19398228153939,29.099632093885994
9954,/media/marda/TWOTB1/xBD/hurricanes/images/florence/hurricane-florence_00000205_pre_disaster.png,52,27,1,817,869,279,306,241,21.920861928992725,14.740880217542951
9955,/media/marda/TWOTB1/xBD/hurricanes/images/florence/hurricane-florence_00000205_pre_disaster.png,98,55,1,946,1044,330,385,1716,62.461892322970535,38.10002355617349
9956,/media/marda/TWOTB1/xBD/hurricanes/images/florence/hurricane-florence_00000247_pre_disaster.png,49,25,1,337,386,1,26,745,39.980563431856396,24.419731526332296
9957,/media/marda/TWOTB1/xBD/hurricanes/images/florence/hurricane-florence_00000247_pre_disaster.png,31,17,1,345,376,37,54,195,17.630079091128174,14.87004882316199
9958,/media/marda/TWOTB1/xBD/hurricanes/images/florence/hurricane-florence_00000247_pre_disaster.png,60,44,1,305,365,195,239,1054,51.02366952094545,27.329018752270414
9959,/media/marda/TWOTB1/xBD/hurricanes/images/florence/hurricane-florence_00000247_pre_disaster.png,18,26,1,28,46,251,277,164,14.968827263042193,14.697735981056672
9960,/media/marda/TWOTB1/xBD/hurricanes/images/florence/hurricane-florence_00000247_pre_disaster.png,47,43,1,99,146,274,317,861,46.22361244763738,24.673948698199872
9961,/media/marda/TWOTB1/xBD/hurricanes/images/florence/hurricane-florence_00000247_pre_disaster.png,42,46,1,234,276,327,373,501,43.23890450474649,15.25462128898371
9962,/media/marda/TWOTB1/xBD/hurricanes/images/florence/hurricane-florence_00000247_pre_disaster.png,40,46,1,165,205,343,389,574,35.658211423335224,21.971961356860707
9963,/media/marda/TWOTB1/xBD/hurricanes/images/florence/hurricane-florence_00000102_pre_disaster.png,52,117,1,330,382,771,888,1313,102.77733934642353,17.050662501976568
9964,/media/marda/TWOTB1/xBD/hurricanes/images/florence/hurricane-florence_00000102_pre_disaster.png,39,44,1,384,423,777,821,185,27.7346486705401,8.95245216227174
9965,/media/marda/TWOTB1/xBD/hurricanes/images/florence/hurricane-florence_00000102_pre_disaster.png,53,103,1,388,441,788,891,1195,78.71356894845506,20.266510138421907
9966,/media/marda/TWOTB1/xBD/hurricanes/images/florence/hurricane-florence_00000102_pre_disaster.png,62,46,1,552,614,803,849,423,46.3925213565907,12.205537564127596
9967,/media/marda/TWOTB1/xBD/hurricanes/images/florence/hurricane-florence_00000102_pre_disaster.png,55,54,1,245,300,821,875,524,51.08209059050954,13.70106775197458
9968,/media/marda/TWOTB1/xBD/hurricanes/images/florence/hurricane-florence_00000102_pre_disaster.png,45,47,1,592,637,826,873,291,23.99809450776505,16.115090477365356
9969,/media/marda/TWOTB1/xBD/hurricanes/images/florence/hurricane-florence_00000102_pre_disaster.png,69,50,1,829,898,826,876,438,41.34533130878063,14.169181399257898
9970,/media/marda/TWOTB1/xBD/hurricanes/images/florence/hurricane-florence_00000102_pre_disaster.png,26,48,1,227,253,832,880,171,17.190004631705822,13.549860152570728
9971,/media/marda/TWOTB1/xBD/hurricanes/images/florence/hurricane-florence_00000102_pre_disaster.png,52,49,1,851,903,880,929,248,22.088285973970084,14.869932979378245
9972,/media/marda/TWOTB1/xBD/hurricanes/images/florence/hurricane-florence_00000102_pre_disaster.png,30,50,1,397,427,951,1001,140,15.15002979337867,12.462640714803157
9973,/media/marda/TWOTB1/xBD/hurricanes/images/florence/hurricane-florence_00000483_pre_disaster.png,27,37,1,222,249,0,37,649,40.547191213433635,21.35741327636449
9974,/media/marda/TWOTB1/xBD/hurricanes/images/florence/hurricane-florence_00000483_pre_disaster.png,38,7,1,272,310,0,7,142,32.0414341060329,6.028953954775115
9975,/media/marda/TWOTB1/xBD/hurricanes/images/florence/hurricane-florence_00000483_pre_disaster.png,66,37,1,663,729,8,45,1040,45.254146609699056,37.05880436414607
9976,/media/marda/TWOTB1/xBD/hurricanes/images/florence/hurricane-florence_00000483_pre_disaster.png,36,31,1,271,307,24,55,611,33.62757333298511,25.138019055687753
9977,/media/marda/TWOTB1/xBD/hurricanes/images/florence/hurricane-florence_00000483_pre_disaster.png,34,15,1,409,443,53,68,230,20.40225359317232,15.103594231733805
9978,/media/marda/TWOTB1/xBD/hurricanes/images/florence/hurricane-florence_00000483_pre_disaster.png,54,25,1,793,847,61,86,417,25.073571785219247,21.94710589409663
9979,/media/marda/TWOTB1/xBD/hurricanes/images/florence/hurricane-florence_00000483_pre_disaster.png,59,33,1,262,321,67,100,1291,50.71721821438075,32.920080912271615
9980,/media/marda/TWOTB1/xBD/hurricanes/images/florence/hurricane-florence_00000483_pre_disaster.png,70,40,1,767,837,89,129,1123,45.57599132334845,33.8275510236217
9981,/media/marda/TWOTB1/xBD/hurricanes/images/florence/hurricane-florence_00000483_pre_disaster.png,43,36,1,854,897,512,548,176,18.439088914585774,12.649110640673518
9982,/media/marda/TWOTB1/xBD/hurricanes/images/florence/hurricane-florence_00000483_pre_disaster.png,215,126,1,705,920,759,885,5967,203.3580896931947,39.36893614257489
9983,/media/marda/TWOTB1/xBD/hurricanes/images/florence/hurricane-florence_00000483_pre_disaster.png,57,51,1,895,952,805,856,255,21.057386910826192,16.07580386618749
9984,/media/marda/TWOTB1/xBD/hurricanes/images/florence/hurricane-florence_00000483_pre_disaster.png,240,141,1,669,909,822,963,7795,247.27644397993458,41.99271569029784
9985,/media/marda/TWOTB1/xBD/hurricanes/images/florence/hurricane-florence_00000300_pre_disaster.png,25,22,1,226,251,119,141,282,19.821897112273493,18.976502194885704
9986,/media/marda/TWOTB1/xBD/hurricanes/images/florence/hurricane-florence_00000300_pre_disaster.png,21,25,1,224,245,165,190,241,23.25746990725642,13.844982506149462
9987,/media/marda/TWOTB1/xBD/hurricanes/images/florence/hurricane-florence_00000300_pre_disaster.png,34,28,1,183,217,194,222,559,28.46024300345237,25.5311934872348
9988,/media/marda/TWOTB1/xBD/hurricanes/images/florence/hurricane-florence_00000300_pre_disaster.png,77,42,1,905,982,194,236,840,36.969341827218074,30.14919380864575
9989,/media/marda/TWOTB1/xBD/hurricanes/images/florence/hurricane-florence_00000300_pre_disaster.png,65,30,1,276,341,265,295,639,62.71946661505628,13.616478908791704
9990,/media/marda/TWOTB1/xBD/hurricanes/images/florence/hurricane-florence_00000300_pre_disaster.png,21,34,1,8,29,279,313,463,26.622715078921605,23.405941707477037
9991,/media/marda/TWOTB1/xBD/hurricanes/images/florence/hurricane-florence_00000300_pre_disaster.png,7,19,1,0,7,299,318,49,8.0,8.0
9992,/media/marda/TWOTB1/xBD/hurricanes/images/florence/hurricane-florence_00000300_pre_disaster.png,17,22,1,268,285,317,339,74,10.646707566258483,9.372129277158077
9993,/media/marda/TWOTB1/xBD/hurricanes/images/florence/hurricane-florence_00000300_pre_disaster.png,58,34,1,37,95,331,365,1208,66.32450329805557,24.315362087972982
9994,/media/marda/TWOTB1/xBD/hurricanes/images/florence/hurricane-florence_00000300_pre_disaster.png,20,25,1,262,282,355,380,114,13.505096903004997,11.381659905384993
9995,/media/marda/TWOTB1/xBD/hurricanes/images/florence/hurricane-florence_00000300_pre_disaster.png,28,64,1,257,285,374,438,766,59.28568290196195,17.242632320868594
9996,/media/marda/TWOTB1/xBD/hurricanes/images/florence/hurricane-florence_00000300_pre_disaster.png,43,68,1,388,431,391,459,1249,62.916357330837805,26.52711369311977
9997,/media/marda/TWOTB1/xBD/hurricanes/images/florence/hurricane-florence_00000300_pre_disaster.png,42,37,1,735,777,432,469,243,21.887947306737832,14.720219813913332
9998,/media/marda/TWOTB1/xBD/hurricanes/images/florence/hurricane-florence_00000300_pre_disaster.png,51,59,1,752,803,446,505,795,47.07008887949999,22.574393373440767
9999,/media/marda/TWOTB1/xBD/hurricanes/images/florence/hurricane-florence_00000300_pre_disaster.png,55,72,1,989,1044,466,538,726,61.94100299798729,15.653940342486333
10000,/media/marda/TWOTB1/xBD/hurricanes/images/florence/hurricane-florence_00000300_pre_disaster.png,44,43,1,702,746,481,524,365,28.756418896480575,16.934156350091794
10001,/media/marda/TWOTB1/xBD/hurricanes/images/florence/hurricane-florence_00000300_pre_disaster.png,43,42,1,686,729,484,526,261,26.763057076353128,13.052353359849908
10002,/media/marda/TWOTB1/xBD/hurricanes/images/florence/hurricane-florence_00000300_pre_disaster.png,46,42,1,250,296,493,535,836,43.86342439892262,25.37715508089904
10003,/media/marda/TWOTB1/xBD/hurricanes/images/florence/hurricane-florence_00000300_pre_disaster.png,61,42,1,668,729,553,595,394,39.95415162830014,13.175534208257124
10004,/media/marda/TWOTB1/xBD/hurricanes/images/florence/hurricane-florence_00000193_post_disaster.png,26,38,1,62,88,23,61,479,38.50967729609677,17.635639027739582
10005,/media/marda/TWOTB1/xBD/hurricanes/images/florence/hurricane-florence_00000193_post_disaster.png,36,41,1,21,57,36,77,879,38.2612916023462,30.506486852733893
10006,/media/marda/TWOTB1/xBD/hurricanes/images/florence/hurricane-florence_00000193_post_disaster.png,45,26,1,533,578,102,128,300,21.57379871519209,18.532345540125196
10007,/media/marda/TWOTB1/xBD/hurricanes/images/florence/hurricane-florence_00000193_post_disaster.png,35,35,1,248,283,220,255,354,27.095028799201653,17.346121131609433
10008,/media/marda/TWOTB1/xBD/hurricanes/images/florence/hurricane-florence_00000193_post_disaster.png,45,43,1,294,339,261,304,724,34.099553594765005,30.033923102762046
10009,/media/marda/TWOTB1/xBD/hurricanes/images/florence/hurricane-florence_00000193_post_disaster.png,21,57,1,0,21,197,254,571,48.30729448572832,18.180398215397695
10010,/media/marda/TWOTB1/xBD/hurricanes/images/florence/hurricane-florence_00000193_post_disaster.png,37,34,1,0,37,261,295,860,41.534517143676496,27.585159009765558
10011,/media/marda/TWOTB1/xBD/hurricanes/images/florence/hurricane-florence_00000193_post_disaster.png,25,41,1,0,25,294,335,516,30.13131160795807,24.317412667286863
10012,/media/marda/TWOTB1/xBD/hurricanes/images/florence/hurricane-florence_00000193_post_disaster.png,42,50,1,0,42,362,412,716,50.50651889916966,19.023426996193816
10013,/media/marda/TWOTB1/xBD/hurricanes/images/florence/hurricane-florence_00000193_post_disaster.png,24,41,1,17,41,460,501,300,25.275423808105664,15.88136210882922
10014,/media/marda/TWOTB1/xBD/hurricanes/images/florence/hurricane-florence_00000431_post_disaster.png,43,48,1,658,701,786,834,186,20.59612959035736,12.09698641421937
10015,/media/marda/TWOTB1/xBD/hurricanes/images/florence/hurricane-florence_00000171_pre_disaster.png,71,52,1,452,523,483,535,1069,51.89959734732778,27.77681670718077
10016,/media/marda/TWOTB1/xBD/hurricanes/images/florence/hurricane-florence_00000171_pre_disaster.png,55,49,1,361,416,485,534,882,45.23363326939825,29.56452327915323
10017,/media/marda/TWOTB1/xBD/hurricanes/images/florence/hurricane-florence_00000319_post_disaster.png,42,57,1,391,433,746,803,615,29.883169119897396,27.104580769036932
10018,/media/marda/TWOTB1/xBD/hurricanes/images/florence/hurricane-florence_00000319_post_disaster.png,26,62,1,214,240,902,964,354,27.01194831409318,17.52814890993804
10019,/media/marda/TWOTB1/xBD/hurricanes/images/florence/hurricane-florence_00000319_post_disaster.png,27,58,1,425,452,975,1033,203,24.649215584161286,11.436584156286546
10020,/media/marda/TWOTB1/xBD/hurricanes/images/florence/hurricane-florence_00000309_post_disaster.png,79,36,1,903,982,537,573,441,48.69617428705457,13.07665036045735
10021,/media/marda/TWOTB1/xBD/hurricanes/images/florence/hurricane-florence_00000309_post_disaster.png,80,41,1,604,684,567,608,653,62.58473182966854,13.929892652682472
10022,/media/marda/TWOTB1/xBD/hurricanes/images/florence/hurricane-florence_00000309_post_disaster.png,9,39,1,0,9,657,696,119,15.292692004910785,10.426974946601502
10023,/media/marda/TWOTB1/xBD/hurricanes/images/florence/hurricane-florence_00000309_post_disaster.png,45,42,1,34,79,666,708,492,50.232777036577126,13.0845212583183
10024,/media/marda/TWOTB1/xBD/hurricanes/images/florence/hurricane-florence_00000309_post_disaster.png,38,49,1,94,132,667,716,402,42.73424315154201,18.72405364485781
10025,/media/marda/TWOTB1/xBD/hurricanes/images/florence/hurricane-florence_00000309_post_disaster.png,48,40,1,581,629,667,707,212,27.752901081103058,10.251694313599574
10026,/media/marda/TWOTB1/xBD/hurricanes/images/florence/hurricane-florence_00000309_post_disaster.png,43,40,1,235,278,719,759,344,39.69709111751198,11.50822428277826
10027,/media/marda/TWOTB1/xBD/hurricanes/images/florence/hurricane-florence_00000309_post_disaster.png,38,43,1,309,347,724,767,330,29.998231171705797,14.68609944250678
10028,/media/marda/TWOTB1/xBD/hurricanes/images/florence/hurricane-florence_00000309_post_disaster.png,81,50,1,517,598,764,814,706,68.41102174172643,13.787895866501064
10029,/media/marda/TWOTB1/xBD/hurricanes/images/florence/hurricane-florence_00000309_post_disaster.png,62,52,1,964,1026,790,842,378,26.174921085676043,19.329304939295035
10030,/media/marda/TWOTB1/xBD/hurricanes/images/florence/hurricane-florence_00000309_post_disaster.png,72,64,1,806,878,797,861,854,40.066565658566745,28.553789628102955
10031,/media/marda/TWOTB1/xBD/hurricanes/images/florence/hurricane-florence_00000309_post_disaster.png,78,49,1,931,1009,813,862,442,47.79213592983421,12.374917428879131
10032,/media/marda/TWOTB1/xBD/hurricanes/images/florence/hurricane-florence_00000309_post_disaster.png,47,47,1,977,1024,817,864,93,16.728255629263465,7.461831770236174
10033,/media/marda/TWOTB1/xBD/hurricanes/images/florence/hurricane-florence_00000309_post_disaster.png,67,79,1,248,315,877,956,1623,62.29919132491495,37.447377543723384
10034,/media/marda/TWOTB1/xBD/hurricanes/images/florence/hurricane-florence_00000309_post_disaster.png,54,97,1,381,435,905,1002,1657,63.2793060412897,35.70738285322306
10035,/media/marda/TWOTB1/xBD/hurricanes/images/florence/hurricane-florence_00000309_post_disaster.png,64,68,1,837,901,933,1001,784,33.424355356985515,31.332317573555528
10036,/media/marda/TWOTB1/xBD/hurricanes/images/florence/hurricane-florence_00000309_post_disaster.png,84,66,1,721,805,939,1005,1298,62.00967822806064,27.66118179112902
10037,/media/marda/TWOTB1/xBD/hurricanes/images/florence/hurricane-florence_00000309_post_disaster.png,73,67,1,928,1001,942,1009,748,39.96190505341096,24.80441415491833
10038,/media/marda/TWOTB1/xBD/hurricanes/images/florence/hurricane-florence_00000309_post_disaster.png,73,80,1,529,602,956,1036,1454,51.91325666231695,37.628419696040886
10039,/media/marda/TWOTB1/xBD/hurricanes/images/florence/hurricane-florence_00000309_post_disaster.png,23,52,1,220,243,959,1011,168,16.62236615608759,13.620492100176058
10040,/media/marda/TWOTB1/xBD/hurricanes/images/florence/hurricane-florence_00000309_post_disaster.png,56,59,1,940,996,984,1043,198,16.710945208501446,15.844808351747876
10041,/media/marda/TWOTB1/xBD/hurricanes/images/florence/hurricane-florence_00000309_post_disaster.png,58,48,1,902,960,995,1043,101,22.196388345407204,6.724972542923788
10042,/media/marda/TWOTB1/xBD/hurricanes/images/florence/hurricane-florence_00000406_pre_disaster.png,51,43,1,265,316,12,55,612,53.4507134876837,15.289082068952055
10043,/media/marda/TWOTB1/xBD/hurricanes/images/florence/hurricane-florence_00000406_pre_disaster.png,55,39,1,384,439,17,56,546,51.08714000518594,14.299618674067531
10044,/media/marda/TWOTB1/xBD/hurricanes/images/florence/hurricane-florence_00000406_pre_disaster.png,45,39,1,319,364,91,130,485,45.910575276805574,14.05411894738955
10045,/media/marda/TWOTB1/xBD/hurricanes/images/florence/hurricane-florence_00000406_pre_disaster.png,58,18,1,653,711,108,126,382,38.01965849246505,13.294860417396116
10046,/media/marda/TWOTB1/xBD/hurricanes/images/florence/hurricane-florence_00000406_pre_disaster.png,39,15,1,635,674,112,127,159,16.740331301835106,12.623701630345726
10047,/media/marda/TWOTB1/xBD/hurricanes/images/florence/hurricane-florence_00000406_pre_disaster.png,58,27,1,595,653,115,142,687,38.62826781038599,23.85430269582813
10048,/media/marda/TWOTB1/xBD/hurricanes/images/florence/hurricane-florence_00000406_pre_disaster.png,46,18,1,811,857,115,133,99,12.105007688969527,10.99023135043489
10049,/media/marda/TWOTB1/xBD/hurricanes/images/florence/hurricane-florence_00000406_pre_disaster.png,50,41,1,655,705,127,168,811,40.51897402950432,26.602849890570788
10050,/media/marda/TWOTB1/xBD/hurricanes/images/florence/hurricane-florence_00000406_pre_disaster.png,65,49,1,821,886,129,178,534,54.515683702744894,13.048753631516703
10051,/media/marda/TWOTB1/xBD/hurricanes/images/florence/hurricane-florence_00000406_pre_disaster.png,50,46,1,218,268,147,193,757,47.91578430972283,24.88204648352526
10052,/media/marda/TWOTB1/xBD/hurricanes/images/florence/hurricane-florence_00000406_pre_disaster.png,62,50,1,781,843,153,203,647,50.859852620854404,17.486333641651928
10053,/media/marda/TWOTB1/xBD/hurricanes/images/florence/hurricane-florence_00000406_pre_disaster.png,48,48,1,647,695,226,274,693,44.191913301362895,20.887272030320084
10054,/media/marda/TWOTB1/xBD/hurricanes/images/florence/hurricane-florence_00000406_pre_disaster.png,50,48,1,129,179,228,276,584,56.61617271692135,13.764385273459327
10055,/media/marda/TWOTB1/xBD/hurricanes/images/florence/hurricane-florence_00000406_pre_disaster.png,36,22,1,668,704,292,314,98,13.913576553443127,9.521411946274634
10056,/media/marda/TWOTB1/xBD/hurricanes/images/florence/hurricane-florence_00000406_pre_disaster.png,63,65,1,700,763,371,436,1064,54.14894227793499,26.130285192958056
10057,/media/marda/TWOTB1/xBD/hurricanes/images/florence/hurricane-florence_00000406_pre_disaster.png,44,33,1,679,723,382,415,271,22.311713713416292,16.1833235868904
10058,/media/marda/TWOTB1/xBD/hurricanes/images/florence/hurricane-florence_00000406_pre_disaster.png,48,33,1,707,755,425,458,207,21.13629415587012,13.033017960646987
10059,/media/marda/TWOTB1/xBD/hurricanes/images/florence/hurricane-florence_00000406_pre_disaster.png,77,53,1,967,1044,639,692,500,47.86485856414485,13.856685412984213
10060,/media/marda/TWOTB1/xBD/hurricanes/images/florence/hurricane-florence_00000406_pre_disaster.png,42,48,1,567,609,689,737,346,24.17828472649092,19.003081852837948
10061,/media/marda/TWOTB1/xBD/hurricanes/images/florence/hurricane-florence_00000406_pre_disaster.png,27,52,1,444,471,698,750,209,26.552254912210355,10.753276889260853
10062,/media/marda/TWOTB1/xBD/hurricanes/images/florence/hurricane-florence_00000406_pre_disaster.png,54,55,1,990,1044,703,758,219,26.106308526785362,12.284068709507602
10063,/media/marda/TWOTB1/xBD/hurricanes/images/florence/hurricane-florence_00000406_pre_disaster.png,49,88,1,267,316,711,799,2121,67.13994249279331,42.156231107000806
10064,/media/marda/TWOTB1/xBD/hurricanes/images/florence/hurricane-florence_00000406_pre_disaster.png,67,59,1,576,643,716,775,1003,47.58827764871156,28.768356937504088
10065,/media/marda/TWOTB1/xBD/hurricanes/images/florence/hurricane-florence_00000406_pre_disaster.png,69,44,1,382,451,734,778,644,61.8237716355514,13.860593098751554
10066,/media/marda/TWOTB1/xBD/hurricanes/images/florence/hurricane-florence_00000406_pre_disaster.png,68,68,1,976,1044,852,920,632,34.151049220872075,25.451425437289508
10067,/media/marda/TWOTB1/xBD/hurricanes/images/florence/hurricane-florence_00000406_pre_disaster.png,64,77,1,836,900,862,939,1234,50.315482133184574,32.660954243573784
10068,/media/marda/TWOTB1/xBD/hurricanes/images/florence/hurricane-florence_00000406_pre_disaster.png,60,71,1,687,747,865,936,1150,41.49204454037,36.47007648472032
10069,/media/marda/TWOTB1/xBD/hurricanes/images/florence/hurricane-florence_00000406_pre_disaster.png,84,88,1,571,655,866,954,2812,67.45705403575654,55.66084851111188
10070,/media/marda/TWOTB1/xBD/hurricanes/images/florence/hurricane-florence_00000406_pre_disaster.png,66,55,1,754,820,883,938,710,39.91561359004403,23.647166117870228
10071,/media/marda/TWOTB1/xBD/hurricanes/images/florence/hurricane-florence_00000406_pre_disaster.png,62,91,1,840,902,916,1007,1290,58.27806628964866,29.10455284435206
10072,/media/marda/TWOTB1/xBD/hurricanes/images/florence/hurricane-florence_00000470_post_disaster.png,35,19,1,453,488,47,66,278,21.02041434957985,17.586267396273794
10073,/media/marda/TWOTB1/xBD/hurricanes/images/florence/hurricane-florence_00000470_post_disaster.png,28,13,1,448,476,98,111,105,12.932784078318434,11.018650991829187
10074,/media/marda/TWOTB1/xBD/hurricanes/images/florence/hurricane-florence_00000470_post_disaster.png,53,23,1,483,536,110,133,366,37.98331737307649,12.906602597517148
10075,/media/marda/TWOTB1/xBD/hurricanes/images/florence/hurricane-florence_00000470_post_disaster.png,66,33,1,603,669,341,374,478,46.25253142524176,15.446444879743106
10076,/media/marda/TWOTB1/xBD/hurricanes/images/florence/hurricane-florence_00000470_post_disaster.png,45,28,1,633,678,388,416,194,20.264843538978045,12.728997187379882
10077,/media/marda/TWOTB1/xBD/hurricanes/images/florence/hurricane-florence_00000470_post_disaster.png,43,47,1,272,315,410,457,723,32.62726345196027,29.161038124075716
10078,/media/marda/TWOTB1/xBD/hurricanes/images/florence/hurricane-florence_00000470_post_disaster.png,81,41,1,644,725,412,453,810,59.889466807410024,19.957287242222126
10079,/media/marda/TWOTB1/xBD/hurricanes/images/florence/hurricane-florence_00000470_post_disaster.png,19,29,1,252,271,421,450,103,13.024524259021891,10.543331695143763
10080,/media/marda/TWOTB1/xBD/hurricanes/images/florence/hurricane-florence_00000470_post_disaster.png,49,63,1,697,746,423,486,487,53.42981957780735,12.148605439349325
10081,/media/marda/TWOTB1/xBD/hurricanes/images/florence/hurricane-florence_00000470_post_disaster.png,62,46,1,209,271,446,492,883,55.74383192068757,23.84859912998971
10082,/media/marda/TWOTB1/xBD/hurricanes/images/florence/hurricane-florence_00000470_post_disaster.png,90,136,1,637,727,613,749,4434,120.30613904173089,49.16458160901806
10083,/media/marda/TWOTB1/xBD/hurricanes/images/florence/hurricane-florence_00000470_post_disaster.png,76,66,1,505,581,648,714,1553,59.34281237666569,34.71666068013401
10084,/media/marda/TWOTB1/xBD/hurricanes/images/florence/hurricane-florence_00000470_post_disaster.png,49,53,1,421,470,665,718,659,33.94382590058685,25.715422782532816
10085,/media/marda/TWOTB1/xBD/hurricanes/images/florence/hurricane-florence_00000470_post_disaster.png,40,47,1,545,585,689,736,226,18.312119310840657,16.50081530757081
10086,/media/marda/TWOTB1/xBD/hurricanes/images/florence/hurricane-florence_00000470_post_disaster.png,62,51,1,353,415,695,746,537,53.94702405987711,13.334449245550857
10087,/media/marda/TWOTB1/xBD/hurricanes/images/florence/hurricane-florence_00000470_post_disaster.png,42,61,1,463,505,700,761,608,33.47838637073061,23.972092151213296
10088,/media/marda/TWOTB1/xBD/hurricanes/images/florence/hurricane-florence_00000470_post_disaster.png,37,47,1,474,511,738,785,230,18.01319877166472,17.100954020890036
10089,/media/marda/TWOTB1/xBD/hurricanes/images/florence/hurricane-florence_00000470_post_disaster.png,57,67,1,355,412,873,940,1034,41.59364110963238,32.59071686258947
10090,/media/marda/TWOTB1/xBD/hurricanes/images/florence/hurricane-florence_00000432_post_disaster.png,60,30,1,933,993,127,157,566,28.069701537219828,26.741488384897536
10091,/media/marda/TWOTB1/xBD/hurricanes/images/florence/hurricane-florence_00000432_post_disaster.png,79,35,1,858,937,163,198,1132,49.41686227510283,30.12857207989455
10092,/media/marda/TWOTB1/xBD/hurricanes/images/florence/hurricane-florence_00000432_post_disaster.png,57,60,1,702,759,299,359,778,48.818817404038,23.737378186708742
10093,/media/marda/TWOTB1/xBD/hurricanes/images/florence/hurricane-florence_00000432_post_disaster.png,54,37,1,791,845,366,403,485,26.164637448508405,24.549632248623716
10094,/media/marda/TWOTB1/xBD/hurricanes/images/florence/hurricane-florence_00000432_post_disaster.png,34,23,1,687,721,376,399,76,11.810217755428805,8.5964095967093
10095,/media/marda/TWOTB1/xBD/hurricanes/images/florence/hurricane-florence_00000432_post_disaster.png,35,20,1,687,722,388,408,64,10.10566749386685,8.359155729103442
10096,/media/marda/TWOTB1/xBD/hurricanes/images/florence/hurricane-florence_00000432_post_disaster.png,88,42,1,706,794,414,456,1380,66.51893847914546,27.648089933262977
10097,/media/marda/TWOTB1/xBD/hurricanes/images/florence/hurricane-florence_00000248_pre_disaster.png,34,11,1,578,612,17,28,66,11.453479158196597,7.72094813800736
10098,/media/marda/TWOTB1/xBD/hurricanes/images/florence/hurricane-florence_00000248_pre_disaster.png,39,15,1,631,670,30,45,127,14.60118455990708,11.670068218210922
10099,/media/marda/TWOTB1/xBD/hurricanes/images/florence/hurricane-florence_00000248_pre_disaster.png,60,47,1,582,642,37,84,966,44.00526386851032,28.707682230707196
10100,/media/marda/TWOTB1/xBD/hurricanes/images/florence/hurricane-florence_00000248_pre_disaster.png,89,67,1,508,597,88,155,1997,78.5667083595053,34.40708366696127
10101,/media/marda/TWOTB1/xBD/hurricanes/images/florence/hurricane-florence_00000248_pre_disaster.png,115,50,1,641,756,99,149,2345,95.87555387110869,32.62999235998708
10102,/media/marda/TWOTB1/xBD/hurricanes/images/florence/hurricane-florence_00000248_pre_disaster.png,49,29,1,596,645,142,171,333,24.949564542235787,17.726254827629326
10103,/media/marda/TWOTB1/xBD/hurricanes/images/florence/hurricane-florence_00000248_pre_disaster.png,37,21,1,568,605,152,173,141,15.900969790014152,11.8949327368534
10104,/media/marda/TWOTB1/xBD/hurricanes/images/florence/hurricane-florence_00000248_pre_disaster.png,82,67,1,710,792,323,390,1198,63.78393002593526,30.225474642354328
10105,/media/marda/TWOTB1/xBD/hurricanes/images/florence/hurricane-florence_00000248_pre_disaster.png,57,42,1,762,819,333,375,443,25.409361102303052,23.125822524323798
10106,/media/marda/TWOTB1/xBD/hurricanes/images/florence/hurricane-florence_00000248_pre_disaster.png,108,107,1,635,743,585,692,3528,92.36290522364297,50.559462157759334
10107,/media/marda/TWOTB1/xBD/hurricanes/images/florence/hurricane-florence_00000398_post_disaster.png,66,57,1,250,316,0,57,2020,57.86683024851622,47.721765109179145
10108,/media/marda/TWOTB1/xBD/hurricanes/images/florence/hurricane-florence_00000398_post_disaster.png,37,12,1,335,372,0,12,206,23.82605937789958,12.03922310668966
10109,/media/marda/TWOTB1/xBD/hurricanes/images/florence/hurricane-florence_00000398_post_disaster.png,102,63,1,541,643,107,170,2678,70.48599587339679,53.10396239446077
10110,/media/marda/TWOTB1/xBD/hurricanes/images/florence/hurricane-florence_00000398_post_disaster.png,108,58,1,882,990,182,240,1974,71.04560476834978,39.30564035768599
10111,/media/marda/TWOTB1/xBD/hurricanes/images/florence/hurricane-florence_00000398_post_disaster.png,73,74,1,430,503,196,270,2327,65.45941565901339,48.09476629883784
10112,/media/marda/TWOTB1/xBD/hurricanes/images/florence/hurricane-florence_00000398_post_disaster.png,59,55,1,25,84,203,258,1607,58.59596052676739,36.95675413559045
10113,/media/marda/TWOTB1/xBD/hurricanes/images/florence/hurricane-florence_00000398_post_disaster.png,79,65,1,778,857,275,340,1507,53.920873966694266,38.356525769064284
10114,/media/marda/TWOTB1/xBD/hurricanes/images/florence/hurricane-florence_00000398_post_disaster.png,55,60,1,292,347,317,377,1494,52.24325651828817,37.54066714508285
10115,/media/marda/TWOTB1/xBD/hurricanes/images/florence/hurricane-florence_00000398_post_disaster.png,95,69,1,837,932,363,432,1775,60.038267178994516,41.013943671786144
10116,/media/marda/TWOTB1/xBD/hurricanes/images/florence/hurricane-florence_00000398_post_disaster.png,61,48,1,611,672,383,431,684,32.56572915413277,27.82606656347798
10117,/media/marda/TWOTB1/xBD/hurricanes/images/florence/hurricane-florence_00000398_post_disaster.png,113,107,1,536,649,410,517,3845,95.16807920013719,53.822490774836716
10118,/media/marda/TWOTB1/xBD/hurricanes/images/florence/hurricane-florence_00000398_post_disaster.png,89,82,1,926,1015,433,515,1761,59.61159293110227,41.822789013029215
10119,/media/marda/TWOTB1/xBD/hurricanes/images/florence/hurricane-florence_00000398_post_disaster.png,51,39,1,691,742,455,494,252,22.985349764665596,14.664526919103702
10120,/media/marda/TWOTB1/xBD/hurricanes/images/florence/hurricane-florence_00000398_post_disaster.png,96,69,1,947,1043,471,540,1707,56.1001260450958,42.059265685012356
10121,/media/marda/TWOTB1/xBD/hurricanes/images/florence/hurricane-florence_00000398_post_disaster.png,88,80,1,612,700,473,553,2008,63.68440863116159,41.91556294325193
10122,/media/marda/TWOTB1/xBD/hurricanes/images/florence/hurricane-florence_00000398_post_disaster.png,11,45,1,0,11,486,531,169,27.540855997954225,9.40119793239704
10123,/media/marda/TWOTB1/xBD/hurricanes/images/florence/hurricane-florence_00000398_post_disaster.png,40,31,1,753,793,525,556,66,9.893238061249852,9.04599320676632
10124,/media/marda/TWOTB1/xBD/hurricanes/images/florence/hurricane-florence_00000398_post_disaster.png,82,70,1,783,865,547,617,1333,48.51543355261498,36.61428227870283
10125,/media/marda/TWOTB1/xBD/hurricanes/images/florence/hurricane-florence_00000398_post_disaster.png,89,73,1,844,933,556,629,1661,49.69546088449661,46.818184673145865
10126,/media/marda/TWOTB1/xBD/hurricanes/images/florence/hurricane-florence_00000398_post_disaster.png,42,37,1,681,723,565,602,133,15.689956301915473,11.37989044064125
10127,/media/marda/TWOTB1/xBD/hurricanes/images/florence/hurricane-florence_00000398_post_disaster.png,61,66,1,982,1043,637,703,749,44.07038764536658,22.69115693089658
10128,/media/marda/TWOTB1/xBD/hurricanes/images/florence/hurricane-florence_00000398_post_disaster.png,72,75,1,352,424,743,818,1833,62.060271808995374,41.45405652629337
10129,/media/marda/TWOTB1/xBD/hurricanes/images/florence/hurricane-florence_00000398_post_disaster.png,79,93,1,674,753,746,839,1814,60.41108188550812,43.34302098733512
10130,/media/marda/TWOTB1/xBD/hurricanes/images/florence/hurricane-florence_00000398_post_disaster.png,68,91,1,430,498,778,869,1859,60.04023083305501,43.23154179880133
10131,/media/marda/TWOTB1/xBD/hurricanes/images/florence/hurricane-florence_00000398_post_disaster.png,77,82,1,919,996,838,920,1015,47.24764825169141,32.782449086429246
10132,/media/marda/TWOTB1/xBD/hurricanes/images/florence/hurricane-florence_00000077_post_disaster.png,80,47,1,418,498,0,47,1836,55.04267373425225,47.62866587947134
10133,/media/marda/TWOTB1/xBD/hurricanes/images/florence/hurricane-florence_00000077_post_disaster.png,30,34,1,26,56,2,36,585,30.28465940036271,25.65589514022037
10134,/media/marda/TWOTB1/xBD/hurricanes/images/florence/hurricane-florence_00000077_post_disaster.png,92,64,1,532,624,19,83,2593,61.81457889160724,55.700720713163385
10135,/media/marda/TWOTB1/xBD/hurricanes/images/florence/hurricane-florence_00000077_post_disaster.png,35,28,1,262,297,27,55,449,25.886420915404194,23.165089108828887
10136,/media/marda/TWOTB1/xBD/hurricanes/images/florence/hurricane-florence_00000077_post_disaster.png,28,20,1,222,250,29,49,228,17.854279138008803,17.105318072653596
10137,/media/marda/TWOTB1/xBD/hurricanes/images/florence/hurricane-florence_00000077_post_disaster.png,77,69,1,589,666,47,116,1890,69.06745600745896,43.06473671709239
10138,/media/marda/TWOTB1/xBD/hurricanes/images/florence/hurricane-florence_00000077_post_disaster.png,67,33,1,395,462,50,83,793,53.26848862424747,22.30958722128174
10139,/media/marda/TWOTB1/xBD/hurricanes/images/florence/hurricane-florence_00000077_post_disaster.png,102,80,1,638,740,54,134,3127,79.12649370060373,57.28832812205066
10140,/media/marda/TWOTB1/xBD/hurricanes/images/florence/hurricane-florence_00000077_post_disaster.png,65,35,1,142,207,66,101,1331,59.217600737615584,30.68521620419435
10141,/media/marda/TWOTB1/xBD/hurricanes/images/florence/hurricane-florence_00000077_post_disaster.png,101,87,1,456,557,75,162,4105,85.8453444258806,65.64849577215081
10142,/media/marda/TWOTB1/xBD/hurricanes/images/florence/hurricane-florence_00000077_post_disaster.png,107,148,1,498,605,98,246,3263,172.95210375170538,26.10734645746731
10143,/media/marda/TWOTB1/xBD/hurricanes/images/florence/hurricane-florence_00000077_post_disaster.png,38,25,1,392,430,100,125,266,22.35410282858421,15.956499497156877
10144,/media/marda/TWOTB1/xBD/hurricanes/images/florence/hurricane-florence_00000077_post_disaster.png,61,52,1,577,638,116,168,863,51.937112506719416,22.181926480463563
10145,/media/marda/TWOTB1/xBD/hurricanes/images/florence/hurricane-florence_00000077_post_disaster.png,84,70,1,825,909,125,195,1682,68.9655926232586,32.54104364394037
10146,/media/marda/TWOTB1/xBD/hurricanes/images/florence/hurricane-florence_00000077_post_disaster.png,83,55,1,337,420,144,199,2005,70.314571678944,38.047010126219426
10147,/media/marda/TWOTB1/xBD/hurricanes/images/florence/hurricane-florence_00000077_post_disaster.png,42,36,1,303,345,150,186,595,29.396346352716648,26.89095268015821
10148,/media/marda/TWOTB1/xBD/hurricanes/images/florence/hurricane-florence_00000077_post_disaster.png,69,49,1,945,1014,185,234,686,48.58767404441778,18.717390837330804
10149,/media/marda/TWOTB1/xBD/hurricanes/images/florence/hurricane-florence_00000077_post_disaster.png,62,51,1,408,470,200,251,1083,42.355359789801035,34.12203979175294
10150,/media/marda/TWOTB1/xBD/hurricanes/images/florence/hurricane-florence_00000077_post_disaster.png,72,41,1,853,925,229,270,877,35.90383461334086,31.946276846379067
10151,/media/marda/TWOTB1/xBD/hurricanes/images/florence/hurricane-florence_00000077_post_disaster.png,54,34,1,559,613,233,267,456,32.228155870377165,18.90545277514586
10152,/media/marda/TWOTB1/xBD/hurricanes/images/florence/hurricane-florence_00000077_post_disaster.png,66,55,1,977,1043,238,293,819,43.38685261001631,26.159458137422742
10153,/media/marda/TWOTB1/xBD/hurricanes/images/florence/hurricane-florence_00000077_post_disaster.png,68,58,1,608,676,254,312,1172,47.31296866085143,33.05643230716866
10154,/media/marda/TWOTB1/xBD/hurricanes/images/florence/hurricane-florence_00000077_post_disaster.png,80,46,1,918,998,265,311,925,45.50991201183838,27.030495169045405
10155,/media/marda/TWOTB1/xBD/hurricanes/images/florence/hurricane-florence_00000077_post_disaster.png,105,61,1,839,944,303,364,2084,77.010387217441,35.842538012116904
10156,/media/marda/TWOTB1/xBD/hurricanes/images/florence/hurricane-florence_00000077_post_disaster.png,69,55,1,974,1043,447,502,807,37.03037690090932,29.004007843759084
10157,/media/marda/TWOTB1/xBD/hurricanes/images/florence/hurricane-florence_00000077_post_disaster.png,72,54,1,795,867,481,535,881,38.860882822729124,30.39201098631767
10158,/media/marda/TWOTB1/xBD/hurricanes/images/florence/hurricane-florence_00000077_post_disaster.png,89,77,1,942,1031,555,632,1652,53.24840775206878,41.38209124998291
10159,/media/marda/TWOTB1/xBD/hurricanes/images/florence/hurricane-florence_00000077_post_disaster.png,54,45,1,983,1037,630,675,173,21.490741168973038,10.801550238643605
10160,/media/marda/TWOTB1/xBD/hurricanes/images/florence/hurricane-florence_00000077_post_disaster.png,80,69,1,753,833,641,710,1206,51.97540262709329,34.63536959326771
10161,/media/marda/TWOTB1/xBD/hurricanes/images/florence/hurricane-florence_00000077_post_disaster.png,54,52,1,830,884,667,719,358,28.47652646033619,16.8261986291273
10162,/media/marda/TWOTB1/xBD/hurricanes/images/florence/hurricane-florence_00000121_post_disaster.png,63,52,1,349,412,57,109,1322,48.74855989485212,35.916900246616166
10163,/media/marda/TWOTB1/xBD/hurricanes/images/florence/hurricane-florence_00000451_pre_disaster.png,29,35,1,238,267,11,46,624,36.86416928411054,22.54837342172346
10164,/media/marda/TWOTB1/xBD/hurricanes/images/florence/hurricane-florence_00000451_pre_disaster.png,27,27,1,292,319,32,59,354,27.45457323981374,17.282442217422116
10165,/media/marda/TWOTB1/xBD/hurricanes/images/florence/hurricane-florence_00000451_pre_disaster.png,32,48,1,264,296,112,160,902,47.3204759573995,25.358294201475562
10166,/media/marda/TWOTB1/xBD/hurricanes/images/florence/hurricane-florence_00000451_pre_disaster.png,23,15,1,342,365,163,178,74,10.477126781232585,9.627716560555156
10167,/media/marda/TWOTB1/xBD/hurricanes/images/florence/hurricane-florence_00000451_pre_disaster.png,23,21,1,94,117,198,219,273,24.221202832779934,14.966629547095765
10168,/media/marda/TWOTB1/xBD/hurricanes/images/florence/hurricane-florence_00000451_pre_disaster.png,14,50,1,0,14,203,253,470,47.112325291218966,13.532927027759419
10169,/media/marda/TWOTB1/xBD/hurricanes/images/florence/hurricane-florence_00000451_pre_disaster.png,29,57,1,45,74,431,488,840,42.49923806853195,26.447252974517028
10170,/media/marda/TWOTB1/xBD/hurricanes/images/florence/hurricane-florence_00000451_pre_disaster.png,31,48,1,72,103,491,539,623,31.28921340074359,26.601479403084703
10171,/media/marda/TWOTB1/xBD/hurricanes/images/florence/hurricane-florence_00000451_pre_disaster.png,37,58,1,83,120,531,589,1024,40.844125122154985,33.25616851832784
10172,/media/marda/TWOTB1/xBD/hurricanes/images/florence/hurricane-florence_00000451_pre_disaster.png,81,65,1,721,802,698,763,1116,59.90691659858688,34.614346083013665
10173,/media/marda/TWOTB1/xBD/hurricanes/images/florence/hurricane-florence_00000451_pre_disaster.png,60,44,1,849,909,743,787,397,30.62734801102789,17.134534590576052
10174,/media/marda/TWOTB1/xBD/hurricanes/images/florence/hurricane-florence_00000451_pre_disaster.png,120,78,1,907,1027,760,838,1773,91.13551724435108,26.40644915027149
10175,/media/marda/TWOTB1/xBD/hurricanes/images/florence/hurricane-florence_00000451_pre_disaster.png,53,67,1,833,886,763,830,757,42.690499503389326,23.631960013098592
10176,/media/marda/TWOTB1/xBD/hurricanes/images/florence/hurricane-florence_00000451_pre_disaster.png,57,64,1,987,1044,777,841,386,35.67178848786717,15.370641705182356
10177,/media/marda/TWOTB1/xBD/hurricanes/images/florence/hurricane-florence_00000451_pre_disaster.png,59,64,1,887,946,804,868,619,32.867031177251114,25.00336620526306
10178,/media/marda/TWOTB1/xBD/hurricanes/images/florence/hurricane-florence_00000451_pre_disaster.png,129,97,1,896,1025,836,933,3145,100.12135851312911,41.81032789342195
10179,/media/marda/TWOTB1/xBD/hurricanes/images/florence/hurricane-florence_00000451_pre_disaster.png,70,108,1,644,714,901,1009,1705,77.17463404693953,28.768199342085406
10180,/media/marda/TWOTB1/xBD/hurricanes/images/florence/hurricane-florence_00000097_pre_disaster.png,57,32,1,159,216,477,509,524,53.85444814967031,12.865873800477914
10181,/media/marda/TWOTB1/xBD/hurricanes/images/florence/hurricane-florence_00000097_pre_disaster.png,60,35,1,238,298,479,514,509,57.6626922576813,11.809110081817826
10182,/media/marda/TWOTB1/xBD/hurricanes/images/florence/hurricane-florence_00000097_pre_disaster.png,42,56,1,294,336,503,559,482,44.15195355082146,16.09400856724629
10183,/media/marda/TWOTB1/xBD/hurricanes/images/florence/hurricane-florence_00000097_pre_disaster.png,23,54,1,126,149,512,566,463,36.16407762333587,17.50635043078983
10184,/media/marda/TWOTB1/xBD/hurricanes/images/florence/hurricane-florence_00000097_pre_disaster.png,47,33,1,131,178,575,608,404,48.71301451757373,11.044378719884104
10185,/media/marda/TWOTB1/xBD/hurricanes/images/florence/hurricane-florence_00000097_pre_disaster.png,61,38,1,262,323,585,623,585,57.968485197670375,14.083974474824009
10186,/media/marda/TWOTB1/xBD/hurricanes/images/florence/hurricane-florence_00000097_pre_disaster.png,40,43,1,0,40,596,639,528,45.563870887722516,16.671638826721335
10187,/media/marda/TWOTB1/xBD/hurricanes/images/florence/hurricane-florence_00000097_pre_disaster.png,46,43,1,254,300,615,658,448,39.00224115720496,17.271444165652987
10188,/media/marda/TWOTB1/xBD/hurricanes/images/florence/hurricane-florence_00000097_pre_disaster.png,53,40,1,131,184,628,668,548,55.49890765335127,13.43626802383543
10189,/media/marda/TWOTB1/xBD/hurricanes/images/florence/hurricane-florence_00000097_pre_disaster.png,62,42,1,241,303,663,705,655,61.00094581992344,15.552577967918099
10190,/media/marda/TWOTB1/xBD/hurricanes/images/florence/hurricane-florence_00000097_pre_disaster.png,55,37,1,127,182,670,707,488,59.052114766555746,11.054799812477595
10191,/media/marda/TWOTB1/xBD/hurricanes/images/florence/hurricane-florence_00000097_pre_disaster.png,49,36,1,41,90,686,722,455,57.533831528755634,10.870822006695796
10192,/media/marda/TWOTB1/xBD/hurricanes/images/florence/hurricane-florence_00000097_pre_disaster.png,43,71,1,140,183,808,879,1177,45.4307490570697,36.46315285953985
10193,/media/marda/TWOTB1/xBD/hurricanes/images/florence/hurricane-florence_00000097_pre_disaster.png,53,76,1,279,332,829,905,1426,50.54346322936674,39.799606470618286
10194,/media/marda/TWOTB1/xBD/hurricanes/images/florence/hurricane-florence_00000097_pre_disaster.png,66,64,1,336,402,882,946,1359,60.12802425861285,30.299916686187487
10195,/media/marda/TWOTB1/xBD/hurricanes/images/florence/hurricane-florence_00000465_post_disaster.png,72,18,1,101,173,0,18,705,71.34688715013041,15.673372637561405
10196,/media/marda/TWOTB1/xBD/hurricanes/images/florence/hurricane-florence_00000465_post_disaster.png,72,69,1,214,286,294,363,2020,63.40213937459522,42.64392874040783
10197,/media/marda/TWOTB1/xBD/hurricanes/images/florence/hurricane-florence_00000465_post_disaster.png,98,90,1,852,950,302,392,2456,76.52847540270952,43.626141051172304
10198,/media/marda/TWOTB1/xBD/hurricanes/images/florence/hurricane-florence_00000465_post_disaster.png,86,64,1,710,796,360,424,1618,51.25599017510494,42.20279989344068
10199,/media/marda/TWOTB1/xBD/hurricanes/images/florence/hurricane-florence_00000465_post_disaster.png,86,71,1,425,511,374,445,2308,67.2490819913374,52.15947894009574
10200,/media/marda/TWOTB1/xBD/hurricanes/images/florence/hurricane-florence_00000465_post_disaster.png,80,96,1,719,799,472,568,2537,76.40173672076014,47.42333903091464
10201,/media/marda/TWOTB1/xBD/hurricanes/images/florence/hurricane-florence_00000465_post_disaster.png,91,96,1,681,772,555,651,2751,71.59388325401856,53.28106255852334
10202,/media/marda/TWOTB1/xBD/hurricanes/images/florence/hurricane-florence_00000465_post_disaster.png,112,93,1,785,897,705,798,2726,78.97960608524015,55.11456719311838
10203,/media/marda/TWOTB1/xBD/hurricanes/images/florence/hurricane-florence_00000465_post_disaster.png,106,86,1,734,840,783,869,2200,69.2443256054016,48.06297968375685
10204,/media/marda/TWOTB1/xBD/hurricanes/images/florence/hurricane-florence_00000465_post_disaster.png,66,100,1,222,288,807,907,2223,64.67594333187826,48.39230977026159
10205,/media/marda/TWOTB1/xBD/hurricanes/images/florence/hurricane-florence_00000465_post_disaster.png,80,85,1,570,650,882,967,1807,53.5399940065912,43.98177575542652
10206,/media/marda/TWOTB1/xBD/hurricanes/images/florence/hurricane-florence_00000465_post_disaster.png,74,95,1,246,320,883,978,2269,69.37763667101754,48.21571424172851
10207,/media/marda/TWOTB1/xBD/hurricanes/images/florence/hurricane-florence_00000465_post_disaster.png,91,96,1,482,573,906,1002,2410,68.66377584355693,48.70635598245769
10208,/media/marda/TWOTB1/xBD/hurricanes/images/florence/hurricane-florence_00000465_post_disaster.png,26,52,1,59,85,991,1043,162,22.134839932615453,11.220304186647276
10209,/media/marda/TWOTB1/xBD/hurricanes/images/florence/hurricane-florence_00000507_post_disaster.png,15,30,1,180,195,567,597,90,12.890551152345214,9.40746287026625
10210,/media/marda/TWOTB1/xBD/hurricanes/images/florence/hurricane-florence_00000507_post_disaster.png,30,39,1,197,227,581,620,418,25.37715508089904,21.908902300206645
10211,/media/marda/TWOTB1/xBD/hurricanes/images/florence/hurricane-florence_00000507_post_disaster.png,22,30,1,158,180,584,614,163,20.689347870929325,10.413981774909269
10212,/media/marda/TWOTB1/xBD/hurricanes/images/florence/hurricane-florence_00000507_post_disaster.png,57,37,1,137,194,628,665,528,60.80475638543277,11.608336606843315
10213,/media/marda/TWOTB1/xBD/hurricanes/images/florence/hurricane-florence_00000507_post_disaster.png,21,37,1,299,320,748,785,73,10.456994410450253,9.302818361581979
10214,/media/marda/TWOTB1/xBD/hurricanes/images/florence/hurricane-florence_00000507_post_disaster.png,25,41,1,291,316,775,816,128,14.922714942648918,11.55620946409084
10215,/media/marda/TWOTB1/xBD/hurricanes/images/florence/hurricane-florence_00000507_post_disaster.png,62,63,1,286,348,828,891,955,57.728758303460545,21.940246260475657
10216,/media/marda/TWOTB1/xBD/hurricanes/images/florence/hurricane-florence_00000507_post_disaster.png,51,77,1,391,442,829,906,1127,46.69569826735756,33.66470909822419
10217,/media/marda/TWOTB1/xBD/hurricanes/images/florence/hurricane-florence_00000315_post_disaster.png,82,56,1,872,954,185,241,1095,55.94150632892327,26.161543390730767
10218,/media/marda/TWOTB1/xBD/hurricanes/images/florence/hurricane-florence_00000315_post_disaster.png,51,26,1,847,898,204,230,146,20.938392440589205,9.349570015678518
10219,/media/marda/TWOTB1/xBD/hurricanes/images/florence/hurricane-florence_00000315_post_disaster.png,47,26,1,777,824,274,300,158,15.00888143811322,14.13787283058326
10220,/media/marda/TWOTB1/xBD/hurricanes/images/florence/hurricane-florence_00000305_post_disaster.png,18,5,1,234,252,0,5,27,9.055859441242617,4.555365507922765
10221,/media/marda/TWOTB1/xBD/hurricanes/images/florence/hurricane-florence_00000305_post_disaster.png,53,32,1,307,360,0,32,929,38.578255428614156,32.370267476160556
10222,/media/marda/TWOTB1/xBD/hurricanes/images/florence/hurricane-florence_00000305_post_disaster.png,34,16,1,349,383,0,16,259,21.15204102202599,16.181986139775614
10223,/media/marda/TWOTB1/xBD/hurricanes/images/florence/hurricane-florence_00000305_post_disaster.png,33,25,1,428,461,1,26,312,26.417983151596726,15.72903241604567
10224,/media/marda/TWOTB1/xBD/hurricanes/images/florence/hurricane-florence_00000305_post_disaster.png,41,33,1,201,242,3,36,489,35.697967770119725,18.38510505533424
10225,/media/marda/TWOTB1/xBD/hurricanes/images/florence/hurricane-florence_00000305_post_disaster.png,78,74,1,433,511,8,82,2364,84.01763576439785,41.15938925052904
10226,/media/marda/TWOTB1/xBD/hurricanes/images/florence/hurricane-florence_00000305_post_disaster.png,56,24,1,389,445,20,44,757,43.24256833347007,23.833283639411437
10227,/media/marda/TWOTB1/xBD/hurricanes/images/florence/hurricane-florence_00000305_post_disaster.png,48,32,1,462,510,62,94,710,33.334799438209664,28.60637043550074
10228,/media/marda/TWOTB1/xBD/hurricanes/images/florence/hurricane-florence_00000305_post_disaster.png,73,50,1,385,458,100,150,1308,63.88328863243546,35.510550179127776
10229,/media/marda/TWOTB1/xBD/hurricanes/images/florence/hurricane-florence_00000305_post_disaster.png,49,36,1,446,495,126,162,590,30.247008988895278,26.287326888699678
10230,/media/marda/TWOTB1/xBD/hurricanes/images/florence/hurricane-florence_00000305_post_disaster.png,52,46,1,686,738,342,388,655,35.88399757398938,24.217301824920472
10231,/media/marda/TWOTB1/xBD/hurricanes/images/florence/hurricane-florence_00000305_post_disaster.png,45,47,1,0,45,346,393,743,49.06607952771851,22.794719889297326
10232,/media/marda/TWOTB1/xBD/hurricanes/images/florence/hurricane-florence_00000305_post_disaster.png,65,51,1,964,1029,602,653,602,28.973962499760052,27.737344146459066
10233,/media/marda/TWOTB1/xBD/hurricanes/images/florence/hurricane-florence_00000305_post_disaster.png,71,55,1,911,982,628,683,776,39.11426083633509,27.963390472734115
10234,/media/marda/TWOTB1/xBD/hurricanes/images/florence/hurricane-florence_00000305_post_disaster.png,82,55,1,961,1043,640,695,795,47.64660895104335,28.351218034748225
10235,/media/marda/TWOTB1/xBD/hurricanes/images/florence/hurricane-florence_00000305_post_disaster.png,67,67,1,891,958,667,734,1146,46.39129422200208,32.99166095107238
10236,/media/marda/TWOTB1/xBD/hurricanes/images/florence/hurricane-florence_00000305_post_disaster.png,62,75,1,818,880,790,865,967,45.144212447933995,28.611934309220313
10237,/media/marda/TWOTB1/xBD/hurricanes/images/florence/hurricane-florence_00000305_post_disaster.png,59,68,1,725,784,830,898,736,36.15123152146405,27.289858557464516
10238,/media/marda/TWOTB1/xBD/hurricanes/images/florence/hurricane-florence_00000305_post_disaster.png,51,49,1,792,843,845,894,236,19.35016555297412,16.25221329355478
10239,/media/marda/TWOTB1/xBD/hurricanes/images/florence/hurricane-florence_00000305_post_disaster.png,55,61,1,814,869,847,908,522,29.59484976983141,23.712829240807615
10240,/media/marda/TWOTB1/xBD/hurricanes/images/florence/hurricane-florence_00000305_post_disaster.png,46,41,1,838,884,866,907,109,15.72328549216739,9.268102703511817
10241,/media/marda/TWOTB1/xBD/hurricanes/images/florence/hurricane-florence_00000438_pre_disaster.png,333,117,1,161,494,158,275,11910,373.101931560077,42.566101275807966
10242,/media/marda/TWOTB1/xBD/hurricanes/images/florence/hurricane-florence_00000438_pre_disaster.png,333,124,1,162,495,242,366,11924,373.23302172704376,42.55852951018516
10243,/media/marda/TWOTB1/xBD/hurricanes/images/florence/hurricane-florence_00000438_pre_disaster.png,281,118,1,214,495,327,445,9984,309.30677389840963,43.0416287200009
10244,/media/marda/TWOTB1/xBD/hurricanes/images/florence/hurricane-florence_00000438_pre_disaster.png,280,126,1,215,495,412,538,10283,310.19897109072934,44.19104635941044
10245,/media/marda/TWOTB1/xBD/hurricanes/images/florence/hurricane-florence_00000438_pre_disaster.png,40,39,1,435,475,484,523,343,24.52176417137977,18.773891674888425
10246,/media/marda/TWOTB1/xBD/hurricanes/images/florence/hurricane-florence_00000438_pre_disaster.png,23,38,1,388,411,699,737,80,11.820834889915222,8.959233365939465
10247,/media/marda/TWOTB1/xBD/hurricanes/images/florence/hurricane-florence_00000438_pre_disaster.png,19,36,1,370,389,701,737,56,9.16515138991168,8.0
10248,/media/marda/TWOTB1/xBD/hurricanes/images/florence/hurricane-florence_00000103_pre_disaster.png,54,37,1,384,438,100,137,1045,42.66481727622366,32.45627662023398
10249,/media/marda/TWOTB1/xBD/hurricanes/images/florence/hurricane-florence_00000103_pre_disaster.png,35,19,1,347,382,113,132,284,25.325920452152708,14.713600393117945
10250,/media/marda/TWOTB1/xBD/hurricanes/images/florence/hurricane-florence_00000103_pre_disaster.png,246,312,1,798,1044,138,450,30018,348.15333691463246,122.49610112404743
10251,/media/marda/TWOTB1/xBD/hurricanes/images/florence/hurricane-florence_00000103_pre_disaster.png,36,27,1,295,331,143,170,427,24.64540669985407,22.900692006919382
10252,/media/marda/TWOTB1/xBD/hurricanes/images/florence/hurricane-florence_00000103_pre_disaster.png,41,39,1,355,396,150,189,774,37.759751699421486,27.32388841172862
10253,/media/marda/TWOTB1/xBD/hurricanes/images/florence/hurricane-florence_00000103_pre_disaster.png,29,21,1,104,133,214,235,259,26.676187250496998,12.839030993269827
10254,/media/marda/TWOTB1/xBD/hurricanes/images/florence/hurricane-florence_00000103_pre_disaster.png,123,117,1,626,749,224,341,5746,113.77584664362675,67.07028035960253
10255,/media/marda/TWOTB1/xBD/hurricanes/images/florence/hurricane-florence_00000103_pre_disaster.png,49,42,1,89,138,232,274,1259,51.51094060214409,32.53869322631981
10256,/media/marda/TWOTB1/xBD/hurricanes/images/florence/hurricane-florence_00000103_pre_disaster.png,21,19,1,175,196,245,264,143,18.67197603603715,10.097663952191345
10257,/media/marda/TWOTB1/xBD/hurricanes/images/florence/hurricane-florence_00000103_pre_disaster.png,71,38,1,252,323,261,299,1196,67.77976847418253,23.551347384575763
10258,/media/marda/TWOTB1/xBD/hurricanes/images/florence/hurricane-florence_00000103_pre_disaster.png,46,39,1,164,210,264,303,880,40.42848618511728,30.355912610224983
10259,/media/marda/TWOTB1/xBD/hurricanes/images/florence/hurricane-florence_00000103_pre_disaster.png,44,41,1,453,497,281,322,656,33.18919560460779,26.067243851618404
10260,/media/marda/TWOTB1/xBD/hurricanes/images/florence/hurricane-florence_00000103_pre_disaster.png,34,52,1,362,396,300,352,494,44.97607785993902,14.520356793176152
10261,/media/marda/TWOTB1/xBD/hurricanes/images/florence/hurricane-florence_00000103_pre_disaster.png,13,35,1,0,13,302,337,227,23.4208162912688,13.102502660792487
10262,/media/marda/TWOTB1/xBD/hurricanes/images/florence/hurricane-florence_00000103_pre_disaster.png,26,46,1,39,65,302,348,647,37.33677388660972,22.944161062579656
10263,/media/marda/TWOTB1/xBD/hurricanes/images/florence/hurricane-florence_00000103_pre_disaster.png,38,42,1,446,484,339,381,530,30.59103491167466,22.97385120078212
10264,/media/marda/TWOTB1/xBD/hurricanes/images/florence/hurricane-florence_00000103_pre_disaster.png,61,46,1,234,295,369,415,1155,55.80535164171138,27.470868053326434
10265,/media/marda/TWOTB1/xBD/hurricanes/images/florence/hurricane-florence_00000103_pre_disaster.png,73,54,1,306,379,377,431,1769,63.2694795598716,36.91690090302253
10266,/media/marda/TWOTB1/xBD/hurricanes/images/florence/hurricane-florence_00000103_pre_disaster.png,38,41,1,436,474,381,422,513,31.005206282664126,21.99770889434823
10267,/media/marda/TWOTB1/xBD/hurricanes/images/florence/hurricane-florence_00000103_pre_disaster.png,27,36,1,268,295,401,437,222,17.57588203651483,16.937080252980827
10268,/media/marda/TWOTB1/xBD/hurricanes/images/florence/hurricane-florence_00000103_pre_disaster.png,42,54,1,429,471,420,474,710,39.604001521060724,23.91151745853637
10269,/media/marda/TWOTB1/xBD/hurricanes/images/florence/hurricane-florence_00000103_pre_disaster.png,47,53,1,0,47,428,481,1110,53.81391447270668,29.204263996044087
10270,/media/marda/TWOTB1/xBD/hurricanes/images/florence/hurricane-florence_00000103_pre_disaster.png,46,44,1,324,370,440,484,662,34.83479844127209,25.60682378970055
10271,/media/marda/TWOTB1/xBD/hurricanes/images/florence/hurricane-florence_00000103_pre_disaster.png,25,40,1,67,92,441,481,460,26.193311457551992,23.491571913257072
10272,/media/marda/TWOTB1/xBD/hurricanes/images/florence/hurricane-florence_00000103_pre_disaster.png,93,60,1,93,186,445,505,2023,99.6698668102189,27.907506592512366
10273,/media/marda/TWOTB1/xBD/hurricanes/images/florence/hurricane-florence_00000103_pre_disaster.png,114,162,1,521,635,445,607,5203,164.3461278819057,69.40530071403116
10274,/media/marda/TWOTB1/xBD/hurricanes/images/florence/hurricane-florence_00000103_pre_disaster.png,63,54,1,981,1044,460,514,500,35.04319146897289,20.348534582836812
10275,/media/marda/TWOTB1/xBD/hurricanes/images/florence/hurricane-florence_00000103_pre_disaster.png,59,49,1,420,479,471,520,885,44.3333087371345,27.19620629245917
10276,/media/marda/TWOTB1/xBD/hurricanes/images/florence/hurricane-florence_00000103_pre_disaster.png,40,94,1,180,220,480,574,1682,86.37372753173355,26.758357416116358
10277,/media/marda/TWOTB1/xBD/hurricanes/images/florence/hurricane-florence_00000103_pre_disaster.png,28,28,1,471,499,481,509,127,13.436815602821452,12.671532688956072
10278,/media/marda/TWOTB1/xBD/hurricanes/images/florence/hurricane-florence_00000103_pre_disaster.png,84,61,1,27,111,509,570,1912,92.20853454055919,28.25804228732041
10279,/media/marda/TWOTB1/xBD/hurricanes/images/florence/hurricane-florence_00000103_pre_disaster.png,43,63,1,413,456,521,584,792,44.825375580517075,23.607167791591856
10280,/media/marda/TWOTB1/xBD/hurricanes/images/florence/hurricane-florence_00000103_pre_disaster.png,43,97,1,0,43,541,638,1857,82.1976058408365,30.379837990291573
10281,/media/marda/TWOTB1/xBD/hurricanes/images/florence/hurricane-florence_00000103_pre_disaster.png,30,31,1,458,488,548,579,120,15.388075147362175,10.482070879640208
10282,/media/marda/TWOTB1/xBD/hurricanes/images/florence/hurricane-florence_00000103_pre_disaster.png,82,57,1,113,195,554,611,1893,86.2242409841718,29.821417078373486
10283,/media/marda/TWOTB1/xBD/hurricanes/images/florence/hurricane-florence_00000103_pre_disaster.png,96,85,1,882,978,563,648,1968,71.28377497929166,36.12928654855386
10284,/media/marda/TWOTB1/xBD/hurricanes/images/florence/hurricane-florence_00000103_pre_disaster.png,49,53,1,402,451,571,624,785,33.75515439371219,30.8336943935749
10285,/media/marda/TWOTB1/xBD/hurricanes/images/florence/hurricane-florence_00000103_pre_disaster.png,43,43,1,561,604,577,620,265,19.605892793560933,18.091331035007677
10286,/media/marda/TWOTB1/xBD/hurricanes/images/florence/hurricane-florence_00000103_pre_disaster.png,98,95,1,611,709,597,692,2110,84.09958428351752,38.38078899797153
10287,/media/marda/TWOTB1/xBD/hurricanes/images/florence/hurricane-florence_00000103_pre_disaster.png,37,39,1,548,585,618,657,126,13.917232623667957,12.16137103687514
10288,/media/marda/TWOTB1/xBD/hurricanes/images/florence/hurricane-florence_00000103_pre_disaster.png,47,50,1,581,628,623,673,350,21.843882061827593,21.33484301964859
10289,/media/marda/TWOTB1/xBD/hurricanes/images/florence/hurricane-florence_00000103_pre_disaster.png,85,103,1,408,493,630,733,3025,89.24089472700801,54.227224782256926
10290,/media/marda/TWOTB1/xBD/hurricanes/images/florence/hurricane-florence_00000103_pre_disaster.png,36,39,1,516,552,640,679,119,13.706185177375373,11.654542592206512
10291,/media/marda/TWOTB1/xBD/hurricanes/images/florence/hurricane-florence_00000103_pre_disaster.png,64,74,1,544,608,686,760,935,48.20827234378287,25.8616800147302
10292,/media/marda/TWOTB1/xBD/hurricanes/images/florence/hurricane-florence_00000103_pre_disaster.png,60,69,1,984,1044,715,784,657,43.95542860430331,20.14323352404103
10293,/media/marda/TWOTB1/xBD/hurricanes/images/florence/hurricane-florence_00000103_pre_disaster.png,118,113,1,703,821,730,843,3867,72.16168230684332,71.28338511942077
10294,/media/marda/TWOTB1/xBD/hurricanes/images/florence/hurricane-florence_00000103_pre_disaster.png,96,91,1,689,785,857,948,1880,69.60765804398973,36.76899143474705
10295,/media/marda/TWOTB1/xBD/hurricanes/images/florence/hurricane-florence_00000103_pre_disaster.png,94,97,1,871,965,867,964,1416,78.11081647544533,24.18798453556057
10296,/media/marda/TWOTB1/xBD/hurricanes/images/florence/hurricane-florence_00000103_pre_disaster.png,43,78,1,360,403,886,964,935,43.346352436647535,29.320129618555164
10297,/media/marda/TWOTB1/xBD/hurricanes/images/florence/hurricane-florence_00000103_pre_disaster.png,72,74,1,855,927,918,992,477,48.807094570066795,13.769121816875998
10298,/media/marda/TWOTB1/xBD/hurricanes/images/florence/hurricane-florence_00000103_pre_disaster.png,59,62,1,821,880,950,1012,358,24.19401079409812,19.760988410383828
10299,/media/marda/TWOTB1/xBD/hurricanes/images/florence/hurricane-florence_00000103_pre_disaster.png,124,91,1,900,1024,951,1042,2615,79.74094811885173,48.530799567530735
10300,/media/marda/TWOTB1/xBD/hurricanes/images/florence/hurricane-florence_00000103_pre_disaster.png,40,77,1,347,387,952,1029,814,42.3561287266664,25.67444317816335
10301,/media/marda/TWOTB1/xBD/hurricanes/images/florence/hurricane-florence_00000103_pre_disaster.png,68,72,1,657,725,953,1025,770,35.22697335280554,29.649447939916715
10302,/media/marda/TWOTB1/xBD/hurricanes/images/florence/hurricane-florence_00000103_pre_disaster.png,63,68,1,864,927,974,1042,277,42.73629683676075,8.678441909767866
10303,/media/marda/TWOTB1/xBD/hurricanes/images/florence/hurricane-florence_00000103_pre_disaster.png,43,66,1,151,194,976,1042,755,40.40586143027444,27.4289692495973
10304,/media/marda/TWOTB1/xBD/hurricanes/images/florence/hurricane-florence_00000103_pre_disaster.png,9,45,1,29,38,980,1025,58,8.970631220330615,8.316485011851418
10305,/media/marda/TWOTB1/xBD/hurricanes/images/florence/hurricane-florence_00000103_pre_disaster.png,64,62,1,569,633,980,1042,598,36.57861939635903,23.521538574299015
10306,/media/marda/TWOTB1/xBD/hurricanes/images/florence/hurricane-florence_00000455_post_disaster.png,54,50,1,491,545,253,303,605,46.24172508981636,17.934354230370463
10307,/media/marda/TWOTB1/xBD/hurricanes/images/florence/hurricane-florence_00000455_post_disaster.png,13,22,1,32,45,254,276,164,15.196610883135426,14.397970903902246
10308,/media/marda/TWOTB1/xBD/hurricanes/images/florence/hurricane-florence_00000455_post_disaster.png,42,33,1,435,477,264,297,321,24.505748018022242,17.5051867089868
10309,/media/marda/TWOTB1/xBD/hurricanes/images/florence/hurricane-florence_00000455_post_disaster.png,30,46,1,148,178,277,323,793,40.808798317367504,25.67841357213501
10310,/media/marda/TWOTB1/xBD/hurricanes/images/florence/hurricane-florence_00000455_post_disaster.png,25,44,1,62,87,290,334,691,38.09671564059823,24.16817155994784
10311,/media/marda/TWOTB1/xBD/hurricanes/images/florence/hurricane-florence_00000455_post_disaster.png,11,26,1,41,52,347,373,134,14.127406107169685,12.724344147991971
10312,/media/marda/TWOTB1/xBD/hurricanes/images/florence/hurricane-florence_00000455_post_disaster.png,56,30,1,148,204,362,392,553,56.418618568037964,13.007623954318772
10313,/media/marda/TWOTB1/xBD/hurricanes/images/florence/hurricane-florence_00000455_post_disaster.png,49,27,1,58,107,374,401,497,54.51933526716004,12.194061205239256
10314,/media/marda/TWOTB1/xBD/hurricanes/images/florence/hurricane-florence_00000455_post_disaster.png,37,43,1,388,425,580,623,507,26.58360273541604,25.42891337449257
10315,/media/marda/TWOTB1/xBD/hurricanes/images/florence/hurricane-florence_00000455_post_disaster.png,61,42,1,422,483,613,655,494,50.83193426849618,12.99052127152393
10316,/media/marda/TWOTB1/xBD/hurricanes/images/florence/hurricane-florence_00000455_post_disaster.png,68,78,1,311,379,685,763,2282,60.0625370127941,53.573988526694436
10317,/media/marda/TWOTB1/xBD/hurricanes/images/florence/hurricane-florence_00000455_post_disaster.png,55,52,1,707,762,695,747,555,29.777756735733988,24.697963081932286
10318,/media/marda/TWOTB1/xBD/hurricanes/images/florence/hurricane-florence_00000455_post_disaster.png,71,68,1,757,828,706,774,965,45.31073676803891,32.07607410481621
10319,/media/marda/TWOTB1/xBD/hurricanes/images/florence/hurricane-florence_00000455_post_disaster.png,73,98,1,536,609,738,836,2203,77.89648799549288,42.55278428238685
10320,/media/marda/TWOTB1/xBD/hurricanes/images/florence/hurricane-florence_00000455_post_disaster.png,38,60,1,327,365,761,821,599,32.54320788469453,24.594329131308676
10321,/media/marda/TWOTB1/xBD/hurricanes/images/florence/hurricane-florence_00000455_post_disaster.png,35,55,1,308,343,783,838,453,27.201694780747047,22.253343319910346
10322,/media/marda/TWOTB1/xBD/hurricanes/images/florence/hurricane-florence_00000455_post_disaster.png,85,88,1,926,1011,840,928,1406,56.168555387844755,33.03914877221028
10323,/media/marda/TWOTB1/xBD/hurricanes/images/florence/hurricane-florence_00000455_post_disaster.png,41,59,1,368,409,849,908,389,26.841949810438074,19.158030018604475
10324,/media/marda/TWOTB1/xBD/hurricanes/images/florence/hurricane-florence_00000455_post_disaster.png,61,85,1,323,384,859,944,1260,57.23525881710087,31.482367430817927
10325,/media/marda/TWOTB1/xBD/hurricanes/images/florence/hurricane-florence_00000455_post_disaster.png,33,52,1,356,389,862,914,232,18.168834371473586,16.861086912606467
10326,/media/marda/TWOTB1/xBD/hurricanes/images/florence/hurricane-florence_00000455_post_disaster.png,68,74,1,975,1043,896,970,694,34.262029691701905,27.80308573735579
10327,/media/marda/TWOTB1/xBD/hurricanes/images/florence/hurricane-florence_00000299_pre_disaster.png,24,11,1,116,140,0,11,119,17.027384165790636,10.218721031066618
10328,/media/marda/TWOTB1/xBD/hurricanes/images/florence/hurricane-florence_00000299_pre_disaster.png,17,6,1,136,153,0,6,42,11.69847698065079,5.428409693274464
10329,/media/marda/TWOTB1/xBD/hurricanes/images/florence/hurricane-florence_00000299_pre_disaster.png,65,57,1,465,530,16,73,1400,60.793137052852124,30.34803395319306
10330,/media/marda/TWOTB1/xBD/hurricanes/images/florence/hurricane-florence_00000299_pre_disaster.png,29,20,1,286,315,26,46,183,20.105829175004704,12.164308047313892
10331,/media/marda/TWOTB1/xBD/hurricanes/images/florence/hurricane-florence_00000299_pre_disaster.png,69,57,1,389,458,45,102,1516,58.02917943720812,35.348374230061815
10332,/media/marda/TWOTB1/xBD/hurricanes/images/florence/hurricane-florence_00000299_pre_disaster.png,31,20,1,377,408,73,93,176,18.121000669549296,13.089811981438102
10333,/media/marda/TWOTB1/xBD/hurricanes/images/florence/hurricane-florence_00000299_pre_disaster.png,75,67,1,572,647,398,465,1477,47.42747629956522,41.78121784415372
10334,/media/marda/TWOTB1/xBD/hurricanes/images/florence/hurricane-florence_00000299_pre_disaster.png,52,40,1,672,724,477,517,397,23.945490980521633,21.868483367302176
10335,/media/marda/TWOTB1/xBD/hurricanes/images/florence/hurricane-florence_00000299_pre_disaster.png,72,58,1,697,769,485,543,1114,39.88900549203392,37.0995884735772
10336,/media/marda/TWOTB1/xBD/hurricanes/images/florence/hurricane-florence_00000299_pre_disaster.png,78,60,1,769,847,679,739,1007,50.40757761147396,26.040338546927376
10337,/media/marda/TWOTB1/xBD/hurricanes/images/florence/hurricane-florence_00000299_pre_disaster.png,44,44,1,758,802,731,775,156,14.762813057922964,14.188346847017458
10338,/media/marda/TWOTB1/xBD/hurricanes/images/florence/hurricane-florence_00000299_pre_disaster.png,61,85,1,99,160,792,877,1592,58.12483074221779,36.40279840204098
10339,/media/marda/TWOTB1/xBD/hurricanes/images/florence/hurricane-florence_00000299_pre_disaster.png,53,81,1,15,68,946,1027,1363,54.35562530470714,33.463601145792275
10340,/media/marda/TWOTB1/xBD/hurricanes/images/florence/hurricane-florence_00000299_pre_disaster.png,7,54,1,0,7,990,1044,56,13.939289398438065,5.9093739822853095
10341,/media/marda/TWOTB1/xBD/hurricanes/images/florence/hurricane-florence_00000392_pre_disaster.png,35,17,1,231,266,0,17,246,27.01737714699559,12.16262850877295
10342,/media/marda/TWOTB1/xBD/hurricanes/images/florence/hurricane-florence_00000392_pre_disaster.png,89,33,1,763,852,0,33,1096,50.11653789737642,31.0867168390036
10343,/media/marda/TWOTB1/xBD/hurricanes/images/florence/hurricane-florence_00000392_pre_disaster.png,113,57,1,714,827,58,115,2058,79.20234447210186,45.18414886295723
10344,/media/marda/TWOTB1/xBD/hurricanes/images/florence/hurricane-florence_00000392_pre_disaster.png,73,65,1,410,483,182,247,1813,56.79746847129174,42.47312063017083
10345,/media/marda/TWOTB1/xBD/hurricanes/images/florence/hurricane-florence_00000392_pre_disaster.png,75,47,1,921,996,186,233,941,40.05688308183009,31.939176489448126
10346,/media/marda/TWOTB1/xBD/hurricanes/images/florence/hurricane-florence_00000392_pre_disaster.png,64,33,1,970,1034,231,264,348,23.551199008084854,19.533312569930153
10347,/media/marda/TWOTB1/xBD/hurricanes/images/florence/hurricane-florence_00000392_pre_disaster.png,79,106,1,212,291,936,1042,2042,87.0433031328113,35.51557365736858
10348,/media/marda/TWOTB1/xBD/hurricanes/images/florence/hurricane-florence_00000327_post_disaster.png,56,38,1,587,643,0,38,654,40.79889592822801,21.98909175525582
10349,/media/marda/TWOTB1/xBD/hurricanes/images/florence/hurricane-florence_00000327_post_disaster.png,73,23,1,951,1024,31,54,350,41.578852237943416,11.184629104620361
10350,/media/marda/TWOTB1/xBD/hurricanes/images/florence/hurricane-florence_00000327_post_disaster.png,47,48,1,384,431,82,130,638,54.64466626779234,15.559335324277043
10351,/media/marda/TWOTB1/xBD/hurricanes/images/florence/hurricane-florence_00000327_post_disaster.png,41,31,1,451,492,143,174,375,24.390766620420052,20.523074853588106
10352,/media/marda/TWOTB1/xBD/hurricanes/images/florence/hurricane-florence_00000327_post_disaster.png,74,66,1,544,618,252,318,1806,55.72063955493165,42.50627080029859
10353,/media/marda/TWOTB1/xBD/hurricanes/images/florence/hurricane-florence_00000327_post_disaster.png,58,49,1,469,527,275,324,889,36.47962107907664,32.104671838409985
10354,/media/marda/TWOTB1/xBD/hurricanes/images/florence/hurricane-florence_00000327_post_disaster.png,58,48,1,271,329,323,371,926,50.376490887414235,23.920758385213777
10355,/media/marda/TWOTB1/xBD/hurricanes/images/florence/hurricane-florence_00000327_post_disaster.png,49,41,1,501,550,366,407,425,26.37873373427257,21.47114180596326
10356,/media/marda/TWOTB1/xBD/hurricanes/images/florence/hurricane-florence_00000327_post_disaster.png,34,34,1,278,312,376,410,290,22.852884345834372,16.995156140745873
10357,/media/marda/TWOTB1/xBD/hurricanes/images/florence/hurricane-florence_00000327_post_disaster.png,28,38,1,214,242,401,439,216,20.921085705919076,13.810701305640743
10358,/media/marda/TWOTB1/xBD/hurricanes/images/florence/hurricane-florence_00000327_post_disaster.png,29,37,1,353,382,403,440,175,21.113962838725943,11.102127107276527
10359,/media/marda/TWOTB1/xBD/hurricanes/images/florence/hurricane-florence_00000327_post_disaster.png,38,44,1,332,370,442,486,377,26.719717416969548,18.854398165159605
10360,/media/marda/TWOTB1/xBD/hurricanes/images/florence/hurricane-florence_00000327_post_disaster.png,25,30,1,372,397,451,481,137,13.39205904839086,13.082197194420493
10361,/media/marda/TWOTB1/xBD/hurricanes/images/florence/hurricane-florence_00000327_post_disaster.png,45,58,1,341,386,483,541,711,39.01032025041729,24.73982032927558
10362,/media/marda/TWOTB1/xBD/hurricanes/images/florence/hurricane-florence_00000327_post_disaster.png,31,44,1,322,353,558,602,251,23.55537344266493,14.278238153741658
10363,/media/marda/TWOTB1/xBD/hurricanes/images/florence/hurricane-florence_00000386_pre_disaster.png,31,12,1,609,640,27,39,72,11.93662267124668,8.094259645222644
10364,/media/marda/TWOTB1/xBD/hurricanes/images/florence/hurricane-florence_00000386_pre_disaster.png,78,14,1,582,660,61,75,633,63.55304519990852,13.321873376401985
10365,/media/marda/TWOTB1/xBD/hurricanes/images/florence/hurricane-florence_00000386_pre_disaster.png,76,31,1,422,498,84,115,1403,64.03845519043189,30.472502207774546
10366,/media/marda/TWOTB1/xBD/hurricanes/images/florence/hurricane-florence_00000386_pre_disaster.png,16,36,1,0,16,361,397,342,25.261310278272123,17.946458185346206
10367,/media/marda/TWOTB1/xBD/hurricanes/images/florence/hurricane-florence_00000386_pre_disaster.png,25,42,1,342,367,544,586,207,22.38493229764592,12.409897928977971
10368,/media/marda/TWOTB1/xBD/hurricanes/images/florence/hurricane-florence_00000386_pre_disaster.png,31,41,1,338,369,590,631,207,20.178579792885888,13.546371713608739
10369,/media/marda/TWOTB1/xBD/hurricanes/images/florence/hurricane-florence_00000386_pre_disaster.png,69,51,1,345,414,604,655,738,62.15977279628664,15.79046214827437
10370,/media/marda/TWOTB1/xBD/hurricanes/images/florence/hurricane-florence_00000386_pre_disaster.png,43,55,1,120,163,675,730,899,41.38094943974186,28.703159514855415
10371,/media/marda/TWOTB1/xBD/hurricanes/images/florence/hurricane-florence_00000464_pre_disaster.png,37,50,1,37,74,450,500,644,36.85383395195701,23.523429389940677
10372,/media/marda/TWOTB1/xBD/hurricanes/images/florence/hurricane-florence_00000464_pre_disaster.png,7,30,1,0,7,491,521,46,12.056351925547709,6.206112617726296
10373,/media/marda/TWOTB1/xBD/hurricanes/images/florence/hurricane-florence_00000464_pre_disaster.png,17,60,1,0,17,503,563,418,39.43512845344494,15.226437052178202
10374,/media/marda/TWOTB1/xBD/hurricanes/images/florence/hurricane-florence_00000464_pre_disaster.png,63,56,1,755,818,741,797,562,32.98511954734151,22.83305023864957
10375,/media/marda/TWOTB1/xBD/hurricanes/images/florence/hurricane-florence_00000464_pre_disaster.png,90,79,1,763,853,799,878,1937,59.93891439288879,43.197805768145486
10376,/media/marda/TWOTB1/xBD/hurricanes/images/florence/hurricane-florence_00000464_pre_disaster.png,96,94,1,498,594,850,944,2014,94.31373892482208,34.84836838642117
10377,/media/marda/TWOTB1/xBD/hurricanes/images/florence/hurricane-florence_00000464_pre_disaster.png,39,59,1,199,238,957,1016,447,29.60063511560006,20.254961146744865
10378,/media/marda/TWOTB1/xBD/hurricanes/images/florence/hurricane-florence_00000464_pre_disaster.png,21,59,1,59,80,985,1044,246,21.91434871406683,15.129181366469636
10379,/media/marda/TWOTB1/xBD/hurricanes/images/florence/hurricane-florence_00000190_post_disaster.png,37,44,1,0,37,43,87,945,40.45219530262454,30.658846683154767
10380,/media/marda/TWOTB1/xBD/hurricanes/images/florence/hurricane-florence_00000190_post_disaster.png,62,45,1,197,259,70,115,1263,49.11951643653408,35.193721089966196
10381,/media/marda/TWOTB1/xBD/hurricanes/images/florence/hurricane-florence_00000190_post_disaster.png,30,15,1,368,398,183,198,183,19.463509710676067,12.243381362692555
10382,/media/marda/TWOTB1/xBD/hurricanes/images/florence/hurricane-florence_00000190_post_disaster.png,24,31,1,370,394,197,228,275,26.448419149346687,13.768410383935814
10383,/media/marda/TWOTB1/xBD/hurricanes/images/florence/hurricane-florence_00000190_post_disaster.png,66,27,1,384,450,204,231,854,58.25996177138456,19.54922519327666
10384,/media/marda/TWOTB1/xBD/hurricanes/images/florence/hurricane-florence_00000190_post_disaster.png,55,34,1,491,546,207,241,881,40.843233706099966,28.403083141971162
10385,/media/marda/TWOTB1/xBD/hurricanes/images/florence/hurricane-florence_00000190_post_disaster.png,71,38,1,802,873,209,247,1020,42.31497532549537,31.59343251016004
10386,/media/marda/TWOTB1/xBD/hurricanes/images/florence/hurricane-florence_00000190_post_disaster.png,61,35,1,558,619,212,247,824,41.89034805570744,26.591841644801423
10387,/media/marda/TWOTB1/xBD/hurricanes/images/florence/hurricane-florence_00000190_post_disaster.png,64,34,1,608,672,225,259,886,43.60187522288376,26.764310685766773
10388,/media/marda/TWOTB1/xBD/hurricanes/images/florence/hurricane-florence_00000190_post_disaster.png,59,36,1,675,734,226,262,837,35.92624869295671,30.620459435106348
10389,/media/marda/TWOTB1/xBD/hurricanes/images/florence/hurricane-florence_00000190_post_disaster.png,62,33,1,744,806,230,263,748,37.19875937561151,26.360083017420923
10390,/media/marda/TWOTB1/xBD/hurricanes/images/florence/hurricane-florence_00000190_post_disaster.png,11,32,1,0,11,343,375,128,17.609532981597795,10.102069545767318
10391,/media/marda/TWOTB1/xBD/hurricanes/images/florence/hurricane-florence_00000190_post_disaster.png,50,43,1,46,96,345,388,1366,56.42084745943153,32.22441266295659
10392,/media/marda/TWOTB1/xBD/hurricanes/images/florence/hurricane-florence_00000190_post_disaster.png,66,27,1,762,828,362,389,453,40.059354747680636,14.948166412278146
10393,/media/marda/TWOTB1/xBD/hurricanes/images/florence/hurricane-florence_00000190_post_disaster.png,65,39,1,569,634,363,402,1011,47.8251877114359,28.023112313586537
10394,/media/marda/TWOTB1/xBD/hurricanes/images/florence/hurricane-florence_00000190_post_disaster.png,47,26,1,383,430,366,392,344,37.24993012350476,12.322686430824781
10395,/media/marda/TWOTB1/xBD/hurricanes/images/florence/hurricane-florence_00000190_post_disaster.png,80,26,1,692,772,366,392,722,59.59287517571506,16.044022156009184
10396,/media/marda/TWOTB1/xBD/hurricanes/images/florence/hurricane-florence_00000190_post_disaster.png,70,49,1,197,267,380,429,2107,68.78277518062431,40.10672306937247
10397,/media/marda/TWOTB1/xBD/hurricanes/images/florence/hurricane-florence_00000190_post_disaster.png,52,101,1,0,52,385,486,1285,105.81969147473698,32.13798413219748
10398,/media/marda/TWOTB1/xBD/hurricanes/images/florence/hurricane-florence_00000190_post_disaster.png,47,30,1,198,245,416,446,532,43.91434721828209,16.109938187099296
10399,/media/marda/TWOTB1/xBD/hurricanes/images/florence/hurricane-florence_00000190_post_disaster.png,19,29,1,283,302,417,446,132,13.912757250478327,12.586666214908385
10400,/media/marda/TWOTB1/xBD/hurricanes/images/florence/hurricane-florence_00000190_post_disaster.png,58,44,1,173,231,453,497,1283,57.204454396132896,29.452610443383787
10401,/media/marda/TWOTB1/xBD/hurricanes/images/florence/hurricane-florence_00000190_post_disaster.png,29,41,1,49,78,461,502,307,33.2523499924727,12.304396617720704
10402,/media/marda/TWOTB1/xBD/hurricanes/images/florence/hurricane-florence_00000164_pre_disaster.png,50,30,1,490,540,73,103,470,32.06649988293114,19.432060423715814
10403,/media/marda/TWOTB1/xBD/hurricanes/images/florence/hurricane-florence_00000164_pre_disaster.png,59,48,1,432,491,132,180,975,44.39641686290189,28.99010135726572
10404,/media/marda/TWOTB1/xBD/hurricanes/images/florence/hurricane-florence_00000164_pre_disaster.png,55,48,1,54,109,401,449,1228,57.56318437724369,28.072583101996134
10405,/media/marda/TWOTB1/xBD/hurricanes/images/florence/hurricane-florence_00000164_pre_disaster.png,52,43,1,107,159,405,448,967,51.0613946250116,25.123569337483872
10406,/media/marda/TWOTB1/xBD/hurricanes/images/florence/hurricane-florence_00000164_pre_disaster.png,90,56,1,161,251,461,517,2240,95.59078398299687,31.723760986656014
10407,/media/marda/TWOTB1/xBD/hurricanes/images/florence/hurricane-florence_00000164_pre_disaster.png,75,53,1,22,97,484,537,1932,80.00271559060005,31.930654121681147
10408,/media/marda/TWOTB1/xBD/hurricanes/images/florence/hurricane-florence_00000164_pre_disaster.png,68,54,1,465,533,687,741,732,52.5640688486113,19.817448329008034
10409,/media/marda/TWOTB1/xBD/hurricanes/images/florence/hurricane-florence_00000164_pre_disaster.png,63,63,1,330,393,709,772,1148,54.73945807031718,29.704381292452513
10410,/media/marda/TWOTB1/xBD/hurricanes/images/florence/hurricane-florence_00000164_pre_disaster.png,57,68,1,531,588,720,788,839,37.631131636690704,31.18368976970612
10411,/media/marda/TWOTB1/xBD/hurricanes/images/florence/hurricane-florence_00000164_pre_disaster.png,30,45,1,357,387,746,791,230,18.81034444885477,16.414643064435783
10412,/media/marda/TWOTB1/xBD/hurricanes/images/florence/hurricane-florence_00000164_pre_disaster.png,27,37,1,450,477,770,807,79,12.175686722488571,8.679412848481157
10413,/media/marda/TWOTB1/xBD/hurricanes/images/florence/hurricane-florence_00000164_pre_disaster.png,27,40,1,362,389,775,815,132,16.134091367843332,10.932575868003719
10414,/media/marda/TWOTB1/xBD/hurricanes/images/florence/hurricane-florence_00000259_post_disaster.png,66,36,1,484,550,214,250,479,54.68285344723917,13.752367409950361
10415,/media/marda/TWOTB1/xBD/hurricanes/images/florence/hurricane-florence_00000259_post_disaster.png,50,61,1,421,471,228,289,903,49.051674654044724,27.9283898889128
10416,/media/marda/TWOTB1/xBD/hurricanes/images/florence/hurricane-florence_00000259_post_disaster.png,30,22,1,475,505,232,254,117,13.918462503236546,11.119226690235713
10417,/media/marda/TWOTB1/xBD/hurricanes/images/florence/hurricane-florence_00000259_post_disaster.png,55,73,1,616,671,579,652,788,60.106629675472135,17.31058456219916
10418,/media/marda/TWOTB1/xBD/hurricanes/images/florence/hurricane-florence_00000259_post_disaster.png,60,66,1,664,724,655,721,887,45.3135807687922,26.031787168202115
10419,/media/marda/TWOTB1/xBD/hurricanes/images/florence/hurricane-florence_00000259_post_disaster.png,53,73,1,615,668,672,745,830,54.74876021208675,20.109550292563473
10420,/media/marda/TWOTB1/xBD/hurricanes/images/florence/hurricane-florence_00000259_post_disaster.png,57,83,1,641,698,752,835,1021,60.790930052390486,22.191041469152495
10421,/media/marda/TWOTB1/xBD/hurricanes/images/florence/hurricane-florence_00000259_post_disaster.png,40,94,1,285,325,897,991,1001,65.18914351912255,24.67817293282606
10422,/media/marda/TWOTB1/xBD/hurricanes/images/florence/hurricane-florence_00000259_post_disaster.png,29,67,1,287,316,974,1041,446,34.57013837186115,17.00343607112873
10423,/media/marda/TWOTB1/xBD/hurricanes/images/florence/hurricane-florence_00000004_pre_disaster.png,37,12,1,126,163,0,12,229,32.5610167335713,10.32418302302475
10424,/media/marda/TWOTB1/xBD/hurricanes/images/florence/hurricane-florence_00000004_pre_disaster.png,62,37,1,165,227,0,37,1181,50.723519050090715,35.685044158353925
10425,/media/marda/TWOTB1/xBD/hurricanes/images/florence/hurricane-florence_00000004_pre_disaster.png,75,46,1,415,490,0,46,1542,50.305156067125466,43.247403354016726
10426,/media/marda/TWOTB1/xBD/hurricanes/images/florence/hurricane-florence_00000004_pre_disaster.png,92,54,1,494,586,0,54,2028,63.533708221297395,44.38641779357375
10427,/media/marda/TWOTB1/xBD/hurricanes/images/florence/hurricane-florence_00000004_pre_disaster.png,43,8,1,582,625,0,8,96,20.538952226465554,6.937122145471271
10428,/media/marda/TWOTB1/xBD/hurricanes/images/florence/hurricane-florence_00000004_pre_disaster.png,51,14,1,630,681,0,14,209,23.518498244051454,12.960689895912719
10429,/media/marda/TWOTB1/xBD/hurricanes/images/florence/hurricane-florence_00000004_pre_disaster.png,64,57,1,206,270,12,69,1655,49.55774684421609,45.419228952532066
10430,/media/marda/TWOTB1/xBD/hurricanes/images/florence/hurricane-florence_00000004_pre_disaster.png,76,43,1,647,723,20,63,1796,53.822150114410306,47.54593512117575
10431,/media/marda/TWOTB1/xBD/hurricanes/images/florence/hurricane-florence_00000004_pre_disaster.png,89,54,1,361,450,30,84,2055,67.20775866485819,44.33546089871259
10432,/media/marda/TWOTB1/xBD/hurricanes/images/florence/hurricane-florence_00000004_pre_disaster.png,61,73,1,237,298,39,112,2061,68.42687634219455,42.14511465072244
10433,/media/marda/TWOTB1/xBD/hurricanes/images/florence/hurricane-florence_00000004_pre_disaster.png,90,89,1,814,904,43,132,2855,93.1316579928567,40.89091629948345
10434,/media/marda/TWOTB1/xBD/hurricanes/images/florence/hurricane-florence_00000004_pre_disaster.png,86,52,1,464,550,44,96,2063,61.886395557345594,45.11562589012949
10435,/media/marda/TWOTB1/xBD/hurricanes/images/florence/hurricane-florence_00000004_pre_disaster.png,84,63,1,621,705,69,132,1887,53.299270346984336,48.622315893811056
10436,/media/marda/TWOTB1/xBD/hurricanes/images/florence/hurricane-florence_00000004_pre_disaster.png,73,75,1,266,339,72,147,2189,70.40809762961528,46.17002910615878
10437,/media/marda/TWOTB1/xBD/hurricanes/images/florence/hurricane-florence_00000004_pre_disaster.png,74,55,1,427,501,93,148,1758,49.97332840990018,47.11389423115578
10438,/media/marda/TWOTB1/xBD/hurricanes/images/florence/hurricane-florence_00000004_pre_disaster.png,85,64,1,575,660,98,162,1897,54.373128332571305,48.262473933690565
10439,/media/marda/TWOTB1/xBD/hurricanes/images/florence/hurricane-florence_00000004_pre_disaster.png,66,78,1,312,378,106,184,1985,70.7700574254365,40.88793629938225
10440,/media/marda/TWOTB1/xBD/hurricanes/images/florence/hurricane-florence_00000004_pre_disaster.png,77,72,1,548,625,129,201,1949,61.24489240346301,44.9108423785886
10441,/media/marda/TWOTB1/xBD/hurricanes/images/florence/hurricane-florence_00000004_pre_disaster.png,75,63,1,345,420,154,217,1915,54.77131202683137,48.639030437141294
10442,/media/marda/TWOTB1/xBD/hurricanes/images/florence/hurricane-florence_00000004_pre_disaster.png,84,60,1,491,575,175,235,1763,53.455663835960785,45.930959554692286
10443,/media/marda/TWOTB1/xBD/hurricanes/images/florence/hurricane-florence_00000004_pre_disaster.png,66,72,1,382,448,196,268,1903,64.7294973718939,41.52897592941829
10444,/media/marda/TWOTB1/xBD/hurricanes/images/florence/hurricane-florence_00000004_pre_disaster.png,75,61,1,641,716,199,260,1778,52.197053846293024,47.325968923748576
10445,/media/marda/TWOTB1/xBD/hurricanes/images/florence/hurricane-florence_00000004_pre_disaster.png,78,48,1,694,772,200,248,1411,54.426014109279855,36.49570764924367
10446,/media/marda/TWOTB1/xBD/hurricanes/images/florence/hurricane-florence_00000004_pre_disaster.png,73,60,1,590,663,214,274,1663,48.73894144430034,47.21905167122072
10447,/media/marda/TWOTB1/xBD/hurricanes/images/florence/hurricane-florence_00000004_pre_disaster.png,79,80,1,402,481,228,308,2211,69.72165107254304,46.40219998037627
10448,/media/marda/TWOTB1/xBD/hurricanes/images/florence/hurricane-florence_00000004_pre_disaster.png,75,59,1,544,619,232,291,1521,50.15917810223315,40.78005550059012
10449,/media/marda/TWOTB1/xBD/hurricanes/images/florence/hurricane-florence_00000004_pre_disaster.png,53,61,1,991,1044,238,299,683,60.71177173757671,14.891306709373085
10450,/media/marda/TWOTB1/xBD/hurricanes/images/florence/hurricane-florence_00000004_pre_disaster.png,87,63,1,872,959,256,319,1914,57.824710396298215,45.46062637202348
10451,/media/marda/TWOTB1/xBD/hurricanes/images/florence/hurricane-florence_00000004_pre_disaster.png,78,63,1,827,905,269,332,1577,56.42456148123902,38.658327790738184
10452,/media/marda/TWOTB1/xBD/hurricanes/images/florence/hurricane-florence_00000004_pre_disaster.png,84,69,1,451,535,283,352,2140,60.987050578223744,48.067536835586
10453,/media/marda/TWOTB1/xBD/hurricanes/images/florence/hurricane-florence_00000004_pre_disaster.png,82,73,1,715,797,306,379,2260,63.723989875255086,49.18081398641792
10454,/media/marda/TWOTB1/xBD/hurricanes/images/florence/hurricane-florence_00000004_pre_disaster.png,76,67,1,410,486,316,383,1647,51.78599055793992,43.61046637102555
10455,/media/marda/TWOTB1/xBD/hurricanes/images/florence/hurricane-florence_00000004_pre_disaster.png,80,65,1,664,744,319,384,2033,56.14185856870731,49.40945359242596
10456,/media/marda/TWOTB1/xBD/hurricanes/images/florence/hurricane-florence_00000004_pre_disaster.png,274,187,1,418,692,325,512,10522,318.3033783638902,48.385224914282816
10457,/media/marda/TWOTB1/xBD/hurricanes/images/florence/hurricane-florence_00000004_pre_disaster.png,73,68,1,375,448,350,418,1722,50.24689614620283,47.516902159352355
10458,/media/marda/TWOTB1/xBD/hurricanes/images/florence/hurricane-florence_00000004_pre_disaster.png,221,173,1,194,415,383,556,9246,271.18238759694344,64.72532929464437
10459,/media/marda/TWOTB1/xBD/hurricanes/images/florence/hurricane-florence_00000004_pre_disaster.png,70,84,1,708,778,443,527,1885,73.07982032726287,34.358872357322255
10460,/media/marda/TWOTB1/xBD/hurricanes/images/florence/hurricane-florence_00000004_pre_disaster.png,41,26,1,686,727,457,483,98,15.684764126825396,8.346554715487656
10461,/media/marda/TWOTB1/xBD/hurricanes/images/florence/hurricane-florence_00000004_pre_disaster.png,62,77,1,142,204,495,572,1884,52.4181630494677,49.439406611771474
10462,/media/marda/TWOTB1/xBD/hurricanes/images/florence/hurricane-florence_00000004_pre_disaster.png,61,77,1,95,156,505,582,1963,61.77088715081578,44.5946771653044
10463,/media/marda/TWOTB1/xBD/hurricanes/images/florence/hurricane-florence_00000004_pre_disaster.png,53,71,1,54,107,531,602,1557,50.020257190368525,41.85647760214915
10464,/media/marda/TWOTB1/xBD/hurricanes/images/florence/hurricane-florence_00000004_pre_disaster.png,53,75,1,2,55,544,619,1767,50.95337347987817,49.68327091253952
10465,/media/marda/TWOTB1/xBD/hurricanes/images/florence/hurricane-florence_00000004_pre_disaster.png,38,38,1,614,652,562,600,161,18.285848778669127,11.839859184924242
10466,/media/marda/TWOTB1/xBD/hurricanes/images/florence/hurricane-florence_00000004_pre_disaster.png,76,57,1,556,632,586,643,1307,56.81886346184032,30.57577339695133
10467,/media/marda/TWOTB1/xBD/hurricanes/images/florence/hurricane-florence_00000004_pre_disaster.png,77,75,1,814,891,631,706,1454,51.38499452158493,37.61331004625411
10468,/media/marda/TWOTB1/xBD/hurricanes/images/florence/hurricane-florence_00000004_pre_disaster.png,77,81,1,775,852,639,720,1663,59.26312844760889,37.360733498194406
10469,/media/marda/TWOTB1/xBD/hurricanes/images/florence/hurricane-florence_00000004_pre_disaster.png,70,74,1,739,809,661,735,1309,48.50279424864989,35.930499912554865
10470,/media/marda/TWOTB1/xBD/hurricanes/images/florence/hurricane-florence_00000004_pre_disaster.png,71,75,1,696,767,671,746,1405,50.74156701664276,36.880321150111676
10471,/media/marda/TWOTB1/xBD/hurricanes/images/florence/hurricane-florence_00000004_pre_disaster.png,71,74,1,659,730,685,759,1451,49.244558398703845,39.22598010240379
10472,/media/marda/TWOTB1/xBD/hurricanes/images/florence/hurricane-florence_00000004_pre_disaster.png,71,86,1,619,690,688,774,1728,61.20979410217785,37.72436162093389
10473,/media/marda/TWOTB1/xBD/hurricanes/images/florence/hurricane-florence_00000004_pre_disaster.png,62,80,1,585,647,707,787,1301,51.21049390665178,33.822188985465004
10474,/media/marda/TWOTB1/xBD/hurricanes/images/florence/hurricane-florence_00000004_pre_disaster.png,71,77,1,544,615,723,800,1595,48.99108240648382,42.915272194166235
10475,/media/marda/TWOTB1/xBD/hurricanes/images/florence/hurricane-florence_00000004_pre_disaster.png,67,80,1,503,570,736,816,1537,49.56643201447938,40.84247256052247
10476,/media/marda/TWOTB1/xBD/hurricanes/images/florence/hurricane-florence_00000004_pre_disaster.png,64,80,1,464,528,748,828,1486,52.621895566992315,37.50199118700067
10477,/media/marda/TWOTB1/xBD/hurricanes/images/florence/hurricane-florence_00000004_pre_disaster.png,79,80,1,807,886,752,832,1535,53.78535726540334,38.31147814933432
10478,/media/marda/TWOTB1/xBD/hurricanes/images/florence/hurricane-florence_00000004_pre_disaster.png,64,84,1,424,488,756,840,1764,55.46234191781715,41.819278643253554
10479,/media/marda/TWOTB1/xBD/hurricanes/images/florence/hurricane-florence_00000004_pre_disaster.png,76,84,1,770,846,763,847,1631,56.09927184626328,38.758637875567345
10480,/media/marda/TWOTB1/xBD/hurricanes/images/florence/hurricane-florence_00000004_pre_disaster.png,58,85,1,389,447,770,855,1553,56.19097018772155,36.418420615698274
10481,/media/marda/TWOTB1/xBD/hurricanes/images/florence/hurricane-florence_00000004_pre_disaster.png,74,80,1,731,805,775,855,1541,54.89328204389299,37.781951650688065
10482,/media/marda/TWOTB1/xBD/hurricanes/images/florence/hurricane-florence_00000004_pre_disaster.png,57,86,1,348,405,782,868,1591,57.066559495371585,37.07413312579575
10483,/media/marda/TWOTB1/xBD/hurricanes/images/florence/hurricane-florence_00000004_pre_disaster.png,72,85,1,692,764,785,870,1566,51.21847901189031,40.06404212531126
10484,/media/marda/TWOTB1/xBD/hurricanes/images/florence/hurricane-florence_00000004_pre_disaster.png,70,88,1,656,726,796,884,1685,53.685722823193295,40.923159238951854
10485,/media/marda/TWOTB1/xBD/hurricanes/images/florence/hurricane-florence_00000004_pre_disaster.png,57,80,1,268,325,803,883,1504,48.24640731534439,40.90435599515375
10486,/media/marda/TWOTB1/xBD/hurricanes/images/florence/hurricane-florence_00000004_pre_disaster.png,55,73,1,314,369,808,881,1232,44.45955022846485,36.24994314896212
10487,/media/marda/TWOTB1/xBD/hurricanes/images/florence/hurricane-florence_00000004_pre_disaster.png,67,82,1,617,684,813,895,1397,51.02028801351377,36.43849044542119
10488,/media/marda/TWOTB1/xBD/hurricanes/images/florence/hurricane-florence_00000004_pre_disaster.png,53,76,1,228,281,817,893,1347,43.580764905720265,40.42894851140159
10489,/media/marda/TWOTB1/xBD/hurricanes/images/florence/hurricane-florence_00000004_pre_disaster.png,69,91,1,579,648,824,915,1684,59.11264572322203,37.950137347388406
10490,/media/marda/TWOTB1/xBD/hurricanes/images/florence/hurricane-florence_00000004_pre_disaster.png,62,83,1,539,601,839,922,1487,50.681211915868644,38.52457180225032
10491,/media/marda/TWOTB1/xBD/hurricanes/images/florence/hurricane-florence_00000004_pre_disaster.png,65,89,1,497,562,850,939,1574,55.601111244219524,37.643229326718135
10492,/media/marda/TWOTB1/xBD/hurricanes/images/florence/hurricane-florence_00000004_pre_disaster.png,63,84,1,461,524,865,949,1484,52.72985847151974,37.55889341240224
10493,/media/marda/TWOTB1/xBD/hurricanes/images/florence/hurricane-florence_00000004_pre_disaster.png,63,89,1,421,484,878,967,1687,58.6582953278774,38.14696341455648
10494,/media/marda/TWOTB1/xBD/hurricanes/images/florence/hurricane-florence_00000004_pre_disaster.png,58,84,1,385,443,887,971,1417,47.88538248609895,39.07182268819373
10495,/media/marda/TWOTB1/xBD/hurricanes/images/florence/hurricane-florence_00000004_pre_disaster.png,62,86,1,343,405,898,984,1629,51.76151892024331,41.83833418712131
10496,/media/marda/TWOTB1/xBD/hurricanes/images/florence/hurricane-florence_00000004_pre_disaster.png,54,77,1,309,363,933,1010,1144,40.9618271562429,37.87790438456263
10497,/media/marda/TWOTB1/xBD/hurricanes/images/florence/hurricane-florence_00000004_pre_disaster.png,56,88,1,273,329,943,1031,1619,51.64914485130642,41.38810152559067
10498,/media/marda/TWOTB1/xBD/hurricanes/images/florence/hurricane-florence_00000526_post_disaster.png,64,87,1,624,688,382,469,2144,81.8041835738001,34.970149709710064
10499,/media/marda/TWOTB1/xBD/hurricanes/images/florence/hurricane-florence_00000499_post_disaster.png,68,67,1,737,805,677,744,1147,44.167361314925664,36.70681068342374
10500,/media/marda/TWOTB1/xBD/hurricanes/images/florence/hurricane-florence_00000499_post_disaster.png,94,83,1,760,854,757,840,2444,67.24840720412185,49.81327392497261
10501,/media/marda/TWOTB1/xBD/hurricanes/images/florence/hurricane-florence_00000499_post_disaster.png,75,50,1,541,616,784,834,768,59.0311734063284,17.410862671666735
10502,/media/marda/TWOTB1/xBD/hurricanes/images/florence/hurricane-florence_00000468_post_disaster.png,50,29,1,958,1008,435,464,112,14.446943981437135,10.4547173907125
10503,/media/marda/TWOTB1/xBD/hurricanes/images/florence/hurricane-florence_00000468_post_disaster.png,37,15,1,418,455,89,104,216,23.032323378170815,12.464383066781323
10504,/media/marda/TWOTB1/xBD/hurricanes/images/florence/hurricane-florence_00000468_post_disaster.png,53,40,1,423,476,133,173,968,38.221623042456315,32.8863631831006
10505,/media/marda/TWOTB1/xBD/hurricanes/images/florence/hurricane-florence_00000468_post_disaster.png,61,41,1,880,941,418,459,484,27.754721970800443,23.075818192161947
10506,/media/marda/TWOTB1/xBD/hurricanes/images/florence/hurricane-florence_00000468_post_disaster.png,78,46,1,727,805,447,493,943,54.14615358633374,23.258279569578917
10507,/media/marda/TWOTB1/xBD/hurricanes/images/florence/hurricane-florence_00000468_post_disaster.png,78,54,1,884,962,490,544,943,44.38129614709858,28.168986535697695
10508,/media/marda/TWOTB1/xBD/hurricanes/images/florence/hurricane-florence_00000468_post_disaster.png,147,139,1,70,217,655,794,6562,172.6935172035115,78.23066379920728
10509,/media/marda/TWOTB1/xBD/hurricanes/images/florence/hurricane-florence_00000468_post_disaster.png,27,50,1,120,147,689,739,344,22.8694196534191,19.965964185101118
10510,/media/marda/TWOTB1/xBD/hurricanes/images/florence/hurricane-florence_00000468_post_disaster.png,48,74,1,381,429,912,986,844,37.05581382007946,31.031230366038876
10511,/media/marda/TWOTB1/xBD/hurricanes/images/florence/hurricane-florence_00000468_post_disaster.png,38,56,1,414,452,958,1014,310,22.232540062330322,18.557672571857317
10512,/media/marda/TWOTB1/xBD/hurricanes/images/florence/hurricane-florence_00000328_post_disaster.png,27,28,1,0,27,148,176,461,29.8011724790846,20.68463834809945
10513,/media/marda/TWOTB1/xBD/hurricanes/images/florence/hurricane-florence_00000328_post_disaster.png,112,53,1,3,115,165,218,2960,123.9844171858047,31.743849475725778
10514,/media/marda/TWOTB1/xBD/hurricanes/images/florence/hurricane-florence_00000328_post_disaster.png,8,16,1,5,13,214,230,49,8.554933350390092,7.305731662228463
10515,/media/marda/TWOTB1/xBD/hurricanes/images/florence/hurricane-florence_00000328_post_disaster.png,114,58,1,15,129,217,275,3130,126.17832120499594,32.93684946176162
10516,/media/marda/TWOTB1/xBD/hurricanes/images/florence/hurricane-florence_00000328_post_disaster.png,28,16,1,531,559,235,251,44,8.064292936694622,7.055288568623478
10517,/media/marda/TWOTB1/xBD/hurricanes/images/florence/hurricane-florence_00000328_post_disaster.png,132,59,1,442,574,245,304,3311,127.7655664909357,34.240375115259006
10518,/media/marda/TWOTB1/xBD/hurricanes/images/florence/hurricane-florence_00000328_post_disaster.png,8,15,1,16,24,271,286,43,8.014381369814155,6.802401475951732
10519,/media/marda/TWOTB1/xBD/hurricanes/images/florence/hurricane-florence_00000328_post_disaster.png,115,58,1,26,141,274,332,3248,126.4375964844354,34.10324922670662
10520,/media/marda/TWOTB1/xBD/hurricanes/images/florence/hurricane-florence_00000328_post_disaster.png,31,18,1,541,572,290,308,76,10.322914657212545,9.411331842620818
10521,/media/marda/TWOTB1/xBD/hurricanes/images/florence/hurricane-florence_00000328_post_disaster.png,132,62,1,453,585,299,361,3207,128.54880025261028,33.04894836807995
10522,/media/marda/TWOTB1/xBD/hurricanes/images/florence/hurricane-florence_00000328_post_disaster.png,9,20,1,27,36,324,344,58,9.213545319815026,7.974095992433984
10523,/media/marda/TWOTB1/xBD/hurricanes/images/florence/hurricane-florence_00000328_post_disaster.png,114,61,1,37,151,329,390,3040,126.11665208153998,31.97118048808909
10524,/media/marda/TWOTB1/xBD/hurricanes/images/florence/hurricane-florence_00000328_post_disaster.png,9,21,1,37,46,380,401,69,9.853433481761975,8.960153445991399
10525,/media/marda/TWOTB1/xBD/hurricanes/images/florence/hurricane-florence_00000328_post_disaster.png,112,60,1,50,162,385,445,2944,124.76927935474636,31.320695232623997
10526,/media/marda/TWOTB1/xBD/hurricanes/images/florence/hurricane-florence_00000328_post_disaster.png,11,26,1,40,51,393,419,86,11.00543792082219,9.931886512771262
10527,/media/marda/TWOTB1/xBD/hurricanes/images/florence/hurricane-florence_00000394_post_disaster.png,43,18,1,584,627,9,27,180,21.458583944047284,11.243798391858956
10528,/media/marda/TWOTB1/xBD/hurricanes/images/florence/hurricane-florence_00000394_post_disaster.png,49,25,1,539,588,39,64,464,27.496479945691945,22.305026139231156
10529,/media/marda/TWOTB1/xBD/hurricanes/images/florence/hurricane-florence_00000394_post_disaster.png,46,17,1,591,637,65,82,179,20.852101549186845,11.500621585872198
10530,/media/marda/TWOTB1/xBD/hurricanes/images/florence/hurricane-florence_00000394_post_disaster.png,39,20,1,520,559,87,107,218,19.43582260511546,15.031101468122724
10531,/media/marda/TWOTB1/xBD/hurricanes/images/florence/hurricane-florence_00000394_post_disaster.png,56,35,1,680,736,157,192,496,29.11137334359055,22.551866218512885
10532,/media/marda/TWOTB1/xBD/hurricanes/images/florence/hurricane-florence_00000227_post_disaster.png,85,56,1,932,1017,206,262,1367,46.1048433943955,38.6508129058692
10533,/media/marda/TWOTB1/xBD/hurricanes/images/florence/hurricane-florence_00000227_post_disaster.png,35,40,1,233,268,295,335,535,31.24201820331555,22.863971245306253
10534,/media/marda/TWOTB1/xBD/hurricanes/images/florence/hurricane-florence_00000227_post_disaster.png,82,60,1,931,1013,300,360,1076,49.625339757424555,28.764257469823193
10535,/media/marda/TWOTB1/xBD/hurricanes/images/florence/hurricane-florence_00000227_post_disaster.png,35,39,1,319,354,320,359,327,27.61310398759522,15.674030997831505
10536,/media/marda/TWOTB1/xBD/hurricanes/images/florence/hurricane-florence_00000227_post_disaster.png,30,57,1,0,30,325,382,827,41.384818584826824,26.916561087100494
10537,/media/marda/TWOTB1/xBD/hurricanes/images/florence/hurricane-florence_00000227_post_disaster.png,75,50,1,416,491,344,394,1020,65.04518822633115,20.934374251880563
10538,/media/marda/TWOTB1/xBD/hurricanes/images/florence/hurricane-florence_00000227_post_disaster.png,33,32,1,469,502,408,440,172,15.958041398815558,14.439657385525573
10539,/media/marda/TWOTB1/xBD/hurricanes/images/florence/hurricane-florence_00000227_post_disaster.png,76,53,1,449,525,421,474,902,65.57235891324846,18.35881362455475
10540,/media/marda/TWOTB1/xBD/hurricanes/images/florence/hurricane-florence_00000227_post_disaster.png,29,36,1,363,392,442,478,180,19.195273803899948,12.482708312028642
10541,/media/marda/TWOTB1/xBD/hurricanes/images/florence/hurricane-florence_00000227_post_disaster.png,68,56,1,900,968,446,502,638,40.149419592706174,20.987268860738766
10542,/media/marda/TWOTB1/xBD/hurricanes/images/florence/hurricane-florence_00000227_post_disaster.png,52,30,1,956,1008,488,518,124,15.144447084572278,10.873099213123547
10543,/media/marda/TWOTB1/xBD/hurricanes/images/florence/hurricane-florence_00000227_post_disaster.png,62,78,1,375,437,492,570,1546,59.66977716416848,35.15320803478361
10544,/media/marda/TWOTB1/xBD/hurricanes/images/florence/hurricane-florence_00000227_post_disaster.png,62,41,1,924,986,499,540,295,22.36508931419068,17.46773343367256
10545,/media/marda/TWOTB1/xBD/hurricanes/images/florence/hurricane-florence_00000227_post_disaster.png,34,42,1,380,414,605,647,174,19.58556842769897,11.901572045140203
10546,/media/marda/TWOTB1/xBD/hurricanes/images/florence/hurricane-florence_00000227_post_disaster.png,66,74,1,418,484,614,688,1247,52.45349830462049,33.06468836550857
10547,/media/marda/TWOTB1/xBD/hurricanes/images/florence/hurricane-florence_00000227_post_disaster.png,44,45,1,353,397,616,661,300,29.83604992255455,13.734756905058598
10548,/media/marda/TWOTB1/xBD/hurricanes/images/florence/hurricane-florence_00000227_post_disaster.png,52,67,1,152,204,620,687,1112,40.4841353792035,36.49405349376649
10549,/media/marda/TWOTB1/xBD/hurricanes/images/florence/hurricane-florence_00000227_post_disaster.png,33,49,1,334,367,626,675,285,21.177519266812446,17.859460670597844
10550,/media/marda/TWOTB1/xBD/hurricanes/images/florence/hurricane-florence_00000227_post_disaster.png,53,58,1,360,413,659,717,802,40.08024655023589,26.161912855985808
10551,/media/marda/TWOTB1/xBD/hurricanes/images/florence/hurricane-florence_00000227_post_disaster.png,59,68,1,180,239,672,740,1120,54.305335016008954,27.51341003322153
10552,/media/marda/TWOTB1/xBD/hurricanes/images/florence/hurricane-florence_00000227_post_disaster.png,59,75,1,285,344,732,807,1184,49.43857902247621,32.83063123738402
10553,/media/marda/TWOTB1/xBD/hurricanes/images/florence/hurricane-florence_00000227_post_disaster.png,47,72,1,243,290,739,811,887,41.16027008675819,29.54959950718619
10554,/media/marda/TWOTB1/xBD/hurricanes/images/florence/hurricane-florence_00000227_post_disaster.png,61,55,1,883,944,764,819,364,23.261848680652307,20.92288139664099
10555,/media/marda/TWOTB1/xBD/hurricanes/images/florence/hurricane-florence_00000227_post_disaster.png,85,78,1,828,913,789,867,1181,53.653107850095765,31.1127590237545
10556,/media/marda/TWOTB1/xBD/hurricanes/images/florence/hurricane-florence_00000343_pre_disaster.png,34,14,1,288,322,0,14,188,20.88085025741278,13.099768889160407
10557,/media/marda/TWOTB1/xBD/hurricanes/images/florence/hurricane-florence_00000343_pre_disaster.png,28,20,1,264,292,66,86,272,20.27204196581668,17.9439541630811
10558,/media/marda/TWOTB1/xBD/hurricanes/images/florence/hurricane-florence_00000343_pre_disaster.png,52,50,1,177,229,69,119,1136,47.33820728744161,32.13234475620635
10559,/media/marda/TWOTB1/xBD/hurricanes/images/florence/hurricane-florence_00000343_pre_disaster.png,27,25,1,274,301,93,118,331,24.991801292466768,17.704921598880606
10560,/media/marda/TWOTB1/xBD/hurricanes/images/florence/hurricane-florence_00000343_pre_disaster.png,65,53,1,613,678,95,148,1191,53.31686095920902,29.813557864571386
10561,/media/marda/TWOTB1/xBD/hurricanes/images/florence/hurricane-florence_00000343_pre_disaster.png,51,71,1,257,308,727,798,1036,40.5983097679703,33.97163533054578
10562,/media/marda/TWOTB1/xBD/hurricanes/images/florence/hurricane-florence_00000109_post_disaster.png,29,18,1,10,39,0,18,444,31.143044298584627,19.213379976720486
10563,/media/marda/TWOTB1/xBD/hurricanes/images/florence/hurricane-florence_00000109_post_disaster.png,34,35,1,136,170,35,70,407,40.89343777187059,13.342986591000752
10564,/media/marda/TWOTB1/xBD/hurricanes/images/florence/hurricane-florence_00000109_post_disaster.png,48,33,1,329,377,97,130,724,36.76829635832322,27.24241356198164
10565,/media/marda/TWOTB1/xBD/hurricanes/images/florence/hurricane-florence_00000109_post_disaster.png,54,33,1,385,439,112,145,769,42.49499445111122,23.797637487119577
10566,/media/marda/TWOTB1/xBD/hurricanes/images/florence/hurricane-florence_00000109_post_disaster.png,55,34,1,436,491,128,162,782,41.72545215944572,24.926806969108764
10567,/media/marda/TWOTB1/xBD/hurricanes/images/florence/hurricane-florence_00000109_post_disaster.png,37,18,1,491,528,156,174,175,17.41426526167992,13.325064386563094
10568,/media/marda/TWOTB1/xBD/hurricanes/images/florence/hurricane-florence_00000109_post_disaster.png,56,36,1,637,693,189,225,553,30.208697724529067,24.30749145953605
10569,/media/marda/TWOTB1/xBD/hurricanes/images/florence/hurricane-florence_00000109_post_disaster.png,46,20,1,760,806,197,217,170,17.090903214250833,13.355013689356882
10570,/media/marda/TWOTB1/xBD/hurricanes/images/florence/hurricane-florence_00000109_post_disaster.png,54,33,1,857,911,243,276,368,24.73301576878528,19.89620516908582
10571,/media/marda/TWOTB1/xBD/hurricanes/images/florence/hurricane-florence_00000144_pre_disaster.png,48,31,1,822,870,281,312,196,23.87737486592897,10.980202505551704
10572,/media/marda/TWOTB1/xBD/hurricanes/images/florence/hurricane-florence_00000144_pre_disaster.png,34,52,1,140,174,952,1004,220,33.25770164658124,8.874067998380463
10573,/media/marda/TWOTB1/xBD/hurricanes/images/florence/hurricane-florence_00000144_pre_disaster.png,48,75,1,150,198,967,1042,1240,43.13309666541237,38.450389257729526
10574,/media/marda/TWOTB1/xBD/hurricanes/images/florence/hurricane-florence_00000017_post_disaster.png,104,242,1,0,104,0,242,10899,203.56213935324118,91.51165628491293
10575,/media/marda/TWOTB1/xBD/hurricanes/images/florence/hurricane-florence_00000017_post_disaster.png,95,72,1,116,211,0,72,3630,83.85239604076823,56.851745564242506
10576,/media/marda/TWOTB1/xBD/hurricanes/images/florence/hurricane-florence_00000017_post_disaster.png,140,75,1,511,651,0,75,4995,108.25153183423801,63.66954731844685
10577,/media/marda/TWOTB1/xBD/hurricanes/images/florence/hurricane-florence_00000017_post_disaster.png,98,74,1,622,720,22,96,2260,85.47538661677977,36.703502037085634
10578,/media/marda/TWOTB1/xBD/hurricanes/images/florence/hurricane-florence_00000017_post_disaster.png,119,92,1,410,529,48,140,3644,105.80578313090051,60.62381190729501
10579,/media/marda/TWOTB1/xBD/hurricanes/images/florence/hurricane-florence_00000017_post_disaster.png,160,148,1,512,672,80,228,5305,200.02947983330301,36.84905517368871
10580,/media/marda/TWOTB1/xBD/hurricanes/images/florence/hurricane-florence_00000017_post_disaster.png,43,14,1,744,787,85,99,103,13.568223077696707,10.205866381701401
10581,/media/marda/TWOTB1/xBD/hurricanes/images/florence/hurricane-florence_00000017_post_disaster.png,51,16,1,989,1040,92,108,118,15.601684749167044,10.184746386491788
10582,/media/marda/TWOTB1/xBD/hurricanes/images/florence/hurricane-florence_00000017_post_disaster.png,172,170,1,576,748,103,273,6032,224.0667089472372,36.34049620983979
10583,/media/marda/TWOTB1/xBD/hurricanes/images/florence/hurricane-florence_00000017_post_disaster.png,86,56,1,958,1044,119,175,1871,53.74385130609288,47.479978279812435
10584,/media/marda/TWOTB1/xBD/hurricanes/images/florence/hurricane-florence_00000017_post_disaster.png,48,18,1,853,901,132,150,176,17.133139176713883,13.817133804789298
10585,/media/marda/TWOTB1/xBD/hurricanes/images/florence/hurricane-florence_00000017_post_disaster.png,83,58,1,896,979,154,212,1555,52.56644422864649,43.31445268226469
10586,/media/marda/TWOTB1/xBD/hurricanes/images/florence/hurricane-florence_00000017_post_disaster.png,98,114,1,338,436,167,281,4188,110.60832560331983,51.865368441306984
10587,/media/marda/TWOTB1/xBD/hurricanes/images/florence/hurricane-florence_00000017_post_disaster.png,90,50,1,838,928,170,220,2024,60.81226955811211,44.19304364821166
10588,/media/marda/TWOTB1/xBD/hurricanes/images/florence/hurricane-florence_00000017_post_disaster.png,68,58,1,445,513,237,295,1221,48.278011626286016,33.75408406030601
10589,/media/marda/TWOTB1/xBD/hurricanes/images/florence/hurricane-florence_00000017_post_disaster.png,68,75,1,976,1044,249,324,1077,63.814333234994315,24.381565948524017
10590,/media/marda/TWOTB1/xBD/hurricanes/images/florence/hurricane-florence_00000017_post_disaster.png,23,18,1,312,335,254,272,54,10.085094162802685,7.270026822063393
10591,/media/marda/TWOTB1/xBD/hurricanes/images/florence/hurricane-florence_00000017_post_disaster.png,22,48,1,0,22,259,307,487,34.957655943506076,20.567480783005838
10592,/media/marda/TWOTB1/xBD/hurricanes/images/florence/hurricane-florence_00000017_post_disaster.png,64,56,1,263,327,280,336,1111,58.50897086197475,25.344331612798275
10593,/media/marda/TWOTB1/xBD/hurricanes/images/florence/hurricane-florence_00000017_post_disaster.png,79,45,1,901,980,285,330,1118,49.019368588651716,32.485254223053616
10594,/media/marda/TWOTB1/xBD/hurricanes/images/florence/hurricane-florence_00000017_post_disaster.png,52,30,1,704,756,289,319,229,27.729957498898756,10.967937709581047
10595,/media/marda/TWOTB1/xBD/hurricanes/images/florence/hurricane-florence_00000017_post_disaster.png,73,53,1,858,931,294,347,1471,49.190767527153604,38.96595285253245
10596,/media/marda/TWOTB1/xBD/hurricanes/images/florence/hurricane-florence_00000017_post_disaster.png,67,56,1,490,557,294,350,1034,45.12113482190694,30.454224784230654
10597,/media/marda/TWOTB1/xBD/hurricanes/images/florence/hurricane-florence_00000017_post_disaster.png,72,59,1,715,787,315,374,1178,46.20555474698159,34.82354546170994
10598,/media/marda/TWOTB1/xBD/hurricanes/images/florence/hurricane-florence_00000017_post_disaster.png,84,89,1,212,296,323,412,2514,84.04964390874265,40.98404775509842
10599,/media/marda/TWOTB1/xBD/hurricanes/images/florence/hurricane-florence_00000017_post_disaster.png,66,57,1,446,512,325,382,1139,40.61647503169706,37.17757946934795
10600,/media/marda/TWOTB1/xBD/hurricanes/images/florence/hurricane-florence_00000017_post_disaster.png,83,66,1,961,1044,326,392,1321,51.64560090438549,33.803224504456786
10601,/media/marda/TWOTB1/xBD/hurricanes/images/florence/hurricane-florence_00000017_post_disaster.png,87,59,1,752,839,347,406,1381,51.76683200888377,37.43422017180585
10602,/media/marda/TWOTB1/xBD/hurricanes/images/florence/hurricane-florence_00000017_post_disaster.png,84,67,1,915,999,363,430,1243,57.12717250026041,31.059726175322734
10603,/media/marda/TWOTB1/xBD/hurricanes/images/florence/hurricane-florence_00000017_post_disaster.png,248,273,1,5,253,377,650,17962,342.8524907089119,75.98913387682686
10604,/media/marda/TWOTB1/xBD/hurricanes/images/florence/hurricane-florence_00000017_post_disaster.png,72,75,1,309,381,383,458,1703,67.20241782802997,33.80234679059284
10605,/media/marda/TWOTB1/xBD/hurricanes/images/florence/hurricane-florence_00000017_post_disaster.png,56,50,1,417,473,401,451,668,33.67681553127837,27.255607706761086
10606,/media/marda/TWOTB1/xBD/hurricanes/images/florence/hurricane-florence_00000017_post_disaster.png,84,82,1,364,448,414,496,2299,61.62323978379825,49.796516912653004
10607,/media/marda/TWOTB1/xBD/hurricanes/images/florence/hurricane-florence_00000017_post_disaster.png,84,73,1,874,958,434,507,1550,51.85792025861858,41.643492961500286
10608,/media/marda/TWOTB1/xBD/hurricanes/images/florence/hurricane-florence_00000017_post_disaster.png,116,106,1,281,397,437,543,3395,124.75851646116527,36.2944624988679
10609,/media/marda/TWOTB1/xBD/hurricanes/images/florence/hurricane-florence_00000017_post_disaster.png,106,95,1,265,371,469,564,1883,123.459527466673,20.360071920488448
10610,/media/marda/TWOTB1/xBD/hurricanes/images/florence/hurricane-florence_00000017_post_disaster.png,68,83,1,220,288,490,573,1702,67.17596014371601,33.80743478463854
10611,/media/marda/TWOTB1/xBD/hurricanes/images/florence/hurricane-florence_00000017_post_disaster.png,90,70,1,951,1041,491,561,1308,43.29603065000649,40.302862849514334
10612,/media/marda/TWOTB1/xBD/hurricanes/images/florence/hurricane-florence_00000017_post_disaster.png,76,76,1,279,355,511,587,1270,79.35728024807882,21.353710524066855
10613,/media/marda/TWOTB1/xBD/hurricanes/images/florence/hurricane-florence_00000017_post_disaster.png,84,71,1,793,877,529,600,1344,54.71992955957677,34.82589397857702
10614,/media/marda/TWOTB1/xBD/hurricanes/images/florence/hurricane-florence_00000017_post_disaster.png,77,77,1,263,340,532,609,1287,80.81804821464776,21.256239040796622
10615,/media/marda/TWOTB1/xBD/hurricanes/images/florence/hurricane-florence_00000017_post_disaster.png,90,112,1,149,239,543,655,2815,110.17397582886368,34.07922333278289
10616,/media/marda/TWOTB1/xBD/hurricanes/images/florence/hurricane-florence_00000017_post_disaster.png,75,76,1,248,323,553,629,1214,79.13104379514141,20.463421860519734
10617,/media/marda/TWOTB1/xBD/hurricanes/images/florence/hurricane-florence_00000017_post_disaster.png,75,73,1,231,306,575,648,1042,79.67485690775221,17.4485752274359
10618,/media/marda/TWOTB1/xBD/hurricanes/images/florence/hurricane-florence_00000017_post_disaster.png,77,64,1,695,772,579,643,1097,49.94800729324662,29.831389434449676
10619,/media/marda/TWOTB1/xBD/hurricanes/images/florence/hurricane-florence_00000017_post_disaster.png,72,75,1,548,620,587,662,1363,50.93522261682443,35.99489521699922
10620,/media/marda/TWOTB1/xBD/hurricanes/images/florence/hurricane-florence_00000017_post_disaster.png,87,86,1,740,827,595,681,1814,62.42646268639553,38.554409598600195
10621,/media/marda/TWOTB1/xBD/hurricanes/images/florence/hurricane-florence_00000017_post_disaster.png,96,79,1,907,1003,608,687,1627,52.34099008461758,41.897364027940746
10622,/media/marda/TWOTB1/xBD/hurricanes/images/florence/hurricane-florence_00000017_post_disaster.png,69,65,1,596,665,618,683,1029,43.21526936450365,31.8464153352717
10623,/media/marda/TWOTB1/xBD/hurricanes/images/florence/hurricane-florence_00000017_post_disaster.png,87,75,1,957,1044,642,717,1268,50.66270181258651,34.22255019308512
10624,/media/marda/TWOTB1/xBD/hurricanes/images/florence/hurricane-florence_00000017_post_disaster.png,77,81,1,631,708,653,734,1513,50.32566970437725,41.1745478691988
10625,/media/marda/TWOTB1/xBD/hurricanes/images/florence/hurricane-florence_00000017_post_disaster.png,72,88,1,848,920,671,759,1775,71.85929312930112,33.32489187397383
10626,/media/marda/TWOTB1/xBD/hurricanes/images/florence/hurricane-florence_00000017_post_disaster.png,57,49,1,886,943,673,722,498,28.549736375083878,23.06801830901158
10627,/media/marda/TWOTB1/xBD/hurricanes/images/florence/hurricane-florence_00000017_post_disaster.png,11,45,1,0,11,674,719,121,18.342748323543308,10.110588605189305
10628,/media/marda/TWOTB1/xBD/hurricanes/images/florence/hurricane-florence_00000017_post_disaster.png,77,78,1,670,747,683,761,1235,59.21928661772962,27.810276736888422
10629,/media/marda/TWOTB1/xBD/hurricanes/images/florence/hurricane-florence_00000017_post_disaster.png,63,77,1,537,600,690,767,1143,43.530457516429124,35.44857738436896
10630,/media/marda/TWOTB1/xBD/hurricanes/images/florence/hurricane-florence_00000017_post_disaster.png,64,80,1,313,377,697,777,1272,54.193161723409624,31.293874546857882
10631,/media/marda/TWOTB1/xBD/hurricanes/images/florence/hurricane-florence_00000017_post_disaster.png,106,127,1,33,139,708,835,4064,105.66989960133927,65.74430141226752
10632,/media/marda/TWOTB1/xBD/hurricanes/images/florence/hurricane-florence_00000017_post_disaster.png,79,72,1,745,824,739,811,1227,45.013218574359165,36.47701430536301
10633,/media/marda/TWOTB1/xBD/hurricanes/images/florence/hurricane-florence_00000017_post_disaster.png,55,83,1,245,300,741,824,1212,55.12875157502127,30.017412124024222
10634,/media/marda/TWOTB1/xBD/hurricanes/images/florence/hurricane-florence_00000017_post_disaster.png,89,86,1,605,694,755,841,1784,66.0779952507812,38.49407010096156
10635,/media/marda/TWOTB1/xBD/hurricanes/images/florence/hurricane-florence_00000017_post_disaster.png,82,78,1,779,861,769,847,1439,45.35227620451008,42.199454703868454
10636,/media/marda/TWOTB1/xBD/hurricanes/images/florence/hurricane-florence_00000017_post_disaster.png,54,71,1,275,329,780,851,940,41.26484278897981,30.391391974409494
10637,/media/marda/TWOTB1/xBD/hurricanes/images/florence/hurricane-florence_00000017_post_disaster.png,82,101,1,461,543,787,888,2306,60.358483291925246,50.67711316175457
10638,/media/marda/TWOTB1/xBD/hurricanes/images/florence/hurricane-florence_00000017_post_disaster.png,49,67,1,354,403,789,856,644,30.980298807997766,27.774252106177684
10639,/media/marda/TWOTB1/xBD/hurricanes/images/florence/hurricane-florence_00000017_post_disaster.png,76,90,1,344,420,821,911,1706,58.16257384787342,40.800654447300246
10640,/media/marda/TWOTB1/xBD/hurricanes/images/florence/hurricane-florence_00000017_post_disaster.png,64,64,1,824,888,827,891,497,30.59267905678992,21.68773797081082
10641,/media/marda/TWOTB1/xBD/hurricanes/images/florence/hurricane-florence_00000017_post_disaster.png,77,79,1,862,939,830,909,995,46.88466214085627,29.01774459474589
10642,/media/marda/TWOTB1/xBD/hurricanes/images/florence/hurricane-florence_00000017_post_disaster.png,38,83,1,0,38,835,918,886,56.73509213765536,20.53197196214522
10643,/media/marda/TWOTB1/xBD/hurricanes/images/florence/hurricane-florence_00000017_post_disaster.png,35,60,1,186,221,839,899,392,27.84200042975584,18.809641248737584
10644,/media/marda/TWOTB1/xBD/hurricanes/images/florence/hurricane-florence_00000017_post_disaster.png,80,83,1,899,979,854,937,1185,44.84152001804912,35.48239171800695
10645,/media/marda/TWOTB1/xBD/hurricanes/images/florence/hurricane-florence_00000017_post_disaster.png,48,49,1,779,827,857,906,142,18.59162448546567,10.240723967506304
10646,/media/marda/TWOTB1/xBD/hurricanes/images/florence/hurricane-florence_00000017_post_disaster.png,68,92,1,4,72,864,956,2134,59.64818706770717,47.38968306613813
10647,/media/marda/TWOTB1/xBD/hurricanes/images/florence/hurricane-florence_00000017_post_disaster.png,23,49,1,210,233,883,932,93,14.130323563872357,8.812904703535997
10648,/media/marda/TWOTB1/xBD/hurricanes/images/florence/hurricane-florence_00000017_post_disaster.png,65,104,1,93,158,901,1005,1725,78.17976132522978,29.41106609167906
10649,/media/marda/TWOTB1/xBD/hurricanes/images/florence/hurricane-florence_00000017_post_disaster.png,74,79,1,786,860,903,982,880,42.11616058787115,27.879411017074258
10650,/media/marda/TWOTB1/xBD/hurricanes/images/florence/hurricane-florence_00000017_post_disaster.png,79,79,1,825,904,933,1012,1105,39.876038152519136,36.822282775504604
10651,/media/marda/TWOTB1/xBD/hurricanes/images/florence/hurricane-florence_00000017_post_disaster.png,88,77,1,956,1044,935,1012,1042,58.8486928581555,23.669651335494358
10652,/media/marda/TWOTB1/xBD/hurricanes/images/florence/hurricane-florence_00000017_post_disaster.png,11,59,1,0,11,964,1023,133,19.837480320993432,10.267707303066365
10653,/media/marda/TWOTB1/xBD/hurricanes/images/florence/hurricane-florence_00000017_post_disaster.png,26,51,1,328,354,971,1022,105,13.138644764339846,10.777605704957937
10654,/media/marda/TWOTB1/xBD/hurricanes/images/florence/hurricane-florence_00000545_post_disaster.png,40,12,1,373,413,0,12,214,27.383725750305082,10.834320605313069
10655,/media/marda/TWOTB1/xBD/hurricanes/images/florence/hurricane-florence_00000545_post_disaster.png,43,36,1,386,429,53,89,676,36.174957268559154,24.945615029930003
10656,/media/marda/TWOTB1/xBD/hurricanes/images/florence/hurricane-florence_00000545_post_disaster.png,74,38,1,273,347,191,229,1247,70.73886812351785,23.45862940881253
10657,/media/marda/TWOTB1/xBD/hurricanes/images/florence/hurricane-florence_00000545_post_disaster.png,48,38,1,177,225,215,253,1049,47.75306191560917,29.696151949841088
10658,/media/marda/TWOTB1/xBD/hurricanes/images/florence/hurricane-florence_00000545_post_disaster.png,41,41,1,103,144,219,260,1016,40.74941921823603,32.927299575290164
10659,/media/marda/TWOTB1/xBD/hurricanes/images/florence/hurricane-florence_00000545_post_disaster.png,89,136,1,283,372,241,377,5034,130.14383587424194,73.8028869652761
10660,/media/marda/TWOTB1/xBD/hurricanes/images/florence/hurricane-florence_00000545_post_disaster.png,29,45,1,142,171,276,321,708,38.783365151262245,24.31924238208645
10661,/media/marda/TWOTB1/xBD/hurricanes/images/florence/hurricane-florence_00000545_post_disaster.png,29,34,1,82,111,294,328,275,28.407821497796988,12.870414856396408
10662,/media/marda/TWOTB1/xBD/hurricanes/images/florence/hurricane-florence_00000545_post_disaster.png,29,34,1,55,84,333,367,314,30.198543808620187,13.879490911310416
10663,/media/marda/TWOTB1/xBD/hurricanes/images/florence/hurricane-florence_00000545_post_disaster.png,21,52,1,170,191,337,389,466,42.765047853581,14.493157048615059
10664,/media/marda/TWOTB1/xBD/hurricanes/images/florence/hurricane-florence_00000545_post_disaster.png,68,54,1,790,858,339,393,752,39.798378748309,27.19961792693083
10665,/media/marda/TWOTB1/xBD/hurricanes/images/florence/hurricane-florence_00000545_post_disaster.png,24,35,1,69,93,348,383,266,23.154123819560663,15.358598573712822
10666,/media/marda/TWOTB1/xBD/hurricanes/images/florence/hurricane-florence_00000545_post_disaster.png,68,65,1,752,820,605,670,759,38.92817768761636,25.994678286669387
10667,/media/marda/TWOTB1/xBD/hurricanes/images/florence/hurricane-florence_00000545_post_disaster.png,58,60,1,520,578,612,672,647,39.198711829343324,22.00960688818555
10668,/media/marda/TWOTB1/xBD/hurricanes/images/florence/hurricane-florence_00000545_post_disaster.png,51,43,1,765,816,659,702,197,19.85370407861977,13.169842467753442
10669,/media/marda/TWOTB1/xBD/hurricanes/images/florence/hurricane-florence_00000545_post_disaster.png,34,39,1,484,518,669,708,128,13.650370181550862,12.349144840094276
10670,/media/marda/TWOTB1/xBD/hurricanes/images/florence/hurricane-florence_00000545_post_disaster.png,65,64,1,493,558,672,736,870,42.510314579706915,27.50211922113797
10671,/media/marda/TWOTB1/xBD/hurricanes/images/florence/hurricane-florence_00000545_post_disaster.png,36,49,1,445,481,698,747,221,18.25727583393597,16.082047142560672
10672,/media/marda/TWOTB1/xBD/hurricanes/images/florence/hurricane-florence_00000545_post_disaster.png,61,66,1,449,510,720,786,855,43.35460111301059,26.434888350187514
10673,/media/marda/TWOTB1/xBD/hurricanes/images/florence/hurricane-florence_00000545_post_disaster.png,42,56,1,292,334,764,820,470,29.523895112033227,21.14840847480257
10674,/media/marda/TWOTB1/xBD/hurricanes/images/florence/hurricane-florence_00000545_post_disaster.png,51,74,1,325,376,791,865,773,46.26148191546309,23.158410771362245
10675,/media/marda/TWOTB1/xBD/hurricanes/images/florence/hurricane-florence_00000545_post_disaster.png,62,62,1,402,464,979,1041,576,42.20597219451803,20.911436897955518
10676,/media/marda/TWOTB1/xBD/hurricanes/images/florence/hurricane-florence_00000351_pre_disaster.png,50,27,1,334,384,0,27,607,35.30713484279084,22.90947241062968
10677,/media/marda/TWOTB1/xBD/hurricanes/images/florence/hurricane-florence_00000351_pre_disaster.png,32,18,1,317,349,19,37,189,20.94129124259933,12.013545973403078
10678,/media/marda/TWOTB1/xBD/hurricanes/images/florence/hurricane-florence_00000351_pre_disaster.png,50,38,1,294,344,47,85,704,36.84299137671041,25.523465520982178
10679,/media/marda/TWOTB1/xBD/hurricanes/images/florence/hurricane-florence_00000351_pre_disaster.png,20,22,1,66,86,231,253,250,22.377225253183948,14.697169726456401
10680,/media/marda/TWOTB1/xBD/hurricanes/images/florence/hurricane-florence_00000351_pre_disaster.png,45,67,1,28,73,247,314,1885,63.199573719995385,43.50766632160182
10681,/media/marda/TWOTB1/xBD/hurricanes/images/florence/hurricane-florence_00000351_pre_disaster.png,27,30,1,103,130,252,282,463,25.85297377183837,23.90018723393609
10682,/media/marda/TWOTB1/xBD/hurricanes/images/florence/hurricane-florence_00000351_pre_disaster.png,31,33,1,136,167,268,301,651,30.56562637426931,28.355326089843807
10683,/media/marda/TWOTB1/xBD/hurricanes/images/florence/hurricane-florence_00000351_pre_disaster.png,15,22,1,87,102,271,293,175,16.226068626250505,14.33176531123117
10684,/media/marda/TWOTB1/xBD/hurricanes/images/florence/hurricane-florence_00000351_pre_disaster.png,81,53,1,25,106,326,379,2445,87.71620368981108,38.158281918708894
10685,/media/marda/TWOTB1/xBD/hurricanes/images/florence/hurricane-florence_00000351_pre_disaster.png,55,52,1,114,169,333,385,1361,50.11955007342131,36.0522467843197
10686,/media/marda/TWOTB1/xBD/hurricanes/images/florence/hurricane-florence_00000351_pre_disaster.png,33,25,1,538,571,346,371,104,13.542446165676482,10.106390755273372
10687,/media/marda/TWOTB1/xBD/hurricanes/images/florence/hurricane-florence_00000351_pre_disaster.png,68,52,1,573,641,359,411,899,48.894647539129615,24.429565951795826
10688,/media/marda/TWOTB1/xBD/hurricanes/images/florence/hurricane-florence_00000351_pre_disaster.png,15,24,1,55,70,369,393,163,17.099355343461053,12.658807864670228
10689,/media/marda/TWOTB1/xBD/hurricanes/images/florence/hurricane-florence_00000351_pre_disaster.png,29,63,1,17,46,379,442,1253,57.189281435176575,29.318674249774435
10690,/media/marda/TWOTB1/xBD/hurricanes/images/florence/hurricane-florence_00000351_pre_disaster.png,47,46,1,455,502,387,433,511,36.96160315012289,18.431890436732363
10691,/media/marda/TWOTB1/xBD/hurricanes/images/florence/hurricane-florence_00000351_pre_disaster.png,72,76,1,486,558,396,472,1748,58.376804842390726,40.81759175160195
10692,/media/marda/TWOTB1/xBD/hurricanes/images/florence/hurricane-florence_00000351_pre_disaster.png,46,43,1,373,419,437,480,386,33.49717021624314,15.384165456017037
10693,/media/marda/TWOTB1/xBD/hurricanes/images/florence/hurricane-florence_00000351_pre_disaster.png,67,56,1,409,476,462,518,1270,50.29991510838439,33.269997828039514
10694,/media/marda/TWOTB1/xBD/hurricanes/images/florence/hurricane-florence_00000351_pre_disaster.png,25,37,1,53,78,490,527,480,27.90402425463748,22.97154368529665
10695,/media/marda/TWOTB1/xBD/hurricanes/images/florence/hurricane-florence_00000351_pre_disaster.png,24,60,1,17,41,494,554,960,46.17358552246078,27.688746209726915
10696,/media/marda/TWOTB1/xBD/hurricanes/images/florence/hurricane-florence_00000351_pre_disaster.png,55,57,1,354,409,500,557,828,42.621671092694754,25.801083584300205
10697,/media/marda/TWOTB1/xBD/hurricanes/images/florence/hurricane-florence_00000351_pre_disaster.png,47,55,1,307,354,532,587,659,35.29824438693598,24.6979881045811
10698,/media/marda/TWOTB1/xBD/hurricanes/images/florence/hurricane-florence_00000351_pre_disaster.png,49,73,1,19,68,569,642,1838,56.6247209897064,46.49390284514353
10699,/media/marda/TWOTB1/xBD/hurricanes/images/florence/hurricane-florence_00000351_pre_disaster.png,39,51,1,245,284,578,629,525,28.832223948245783,24.08162675164322
10700,/media/marda/TWOTB1/xBD/hurricanes/images/florence/hurricane-florence_00000351_pre_disaster.png,71,84,1,144,215,601,685,1932,58.28898876285536,46.58412586267567
10701,/media/marda/TWOTB1/xBD/hurricanes/images/florence/hurricane-florence_00000351_pre_disaster.png,26,41,1,111,137,617,658,190,21.43365017340607,11.869440862721145
10702,/media/marda/TWOTB1/xBD/hurricanes/images/florence/hurricane-florence_00000351_pre_disaster.png,16,40,1,34,50,661,701,136,13.503812097939996,13.503812097939996
10703,/media/marda/TWOTB1/xBD/hurricanes/images/florence/hurricane-florence_00000351_pre_disaster.png,49,73,1,15,64,708,781,1043,50.83470422607489,27.381645159173665
10704,/media/marda/TWOTB1/xBD/hurricanes/images/florence/hurricane-florence_00000351_pre_disaster.png,94,153,1,47,141,889,1042,6219,133.6999573258283,62.142971815580566
10705,/media/marda/TWOTB1/xBD/hurricanes/images/florence/hurricane-florence_00000351_pre_disaster.png,22,59,1,140,162,936,995,226,23.43651334030477,12.733493468794775
10706,/media/marda/TWOTB1/xBD/hurricanes/images/florence/hurricane-florence_00000351_pre_disaster.png,95,98,1,148,243,944,1042,3578,87.38995365232827,53.98917190103742
10707,/media/marda/TWOTB1/xBD/hurricanes/images/florence/hurricane-florence_00000351_pre_disaster.png,13,58,1,0,13,965,1023,189,20.85748165003202,12.509139648787086
10708,/media/marda/TWOTB1/xBD/hurricanes/images/florence/hurricane-florence_00000351_pre_disaster.png,41,59,1,0,41,985,1044,532,45.41044372797427,18.42013120294755
10709,/media/marda/TWOTB1/xBD/hurricanes/images/florence/hurricane-florence_00000255_pre_disaster.png,40,36,1,98,138,22,58,848,36.01957273454474,31.12775879151745
10710,/media/marda/TWOTB1/xBD/hurricanes/images/florence/hurricane-florence_00000255_pre_disaster.png,26,22,1,10,36,50,72,256,26.49210680130104,12.929357185431112
10711,/media/marda/TWOTB1/xBD/hurricanes/images/florence/hurricane-florence_00000119_pre_disaster.png,4,18,1,0,4,0,18,49,19.4210673850145,3.486151698273833
10712,/media/marda/TWOTB1/xBD/hurricanes/images/florence/hurricane-florence_00000119_pre_disaster.png,7,13,1,0,7,63,76,49,11.45048093548742,6.510570449573432
10713,/media/marda/TWOTB1/xBD/hurricanes/images/florence/hurricane-florence_00000119_pre_disaster.png,19,16,1,5,24,66,82,156,15.808876707322858,13.22109549056407
10714,/media/marda/TWOTB1/xBD/hurricanes/images/florence/hurricane-florence_00000119_pre_disaster.png,12,17,1,46,58,70,87,137,17.49579009337517,10.545621462712466
10715,/media/marda/TWOTB1/xBD/hurricanes/images/florence/hurricane-florence_00000119_pre_disaster.png,49,25,1,205,254,91,116,821,43.12016710716762,25.584711396262442
10716,/media/marda/TWOTB1/xBD/hurricanes/images/florence/hurricane-florence_00000119_pre_disaster.png,27,30,1,14,41,104,134,637,29.542925137570645,28.435906114022096
10717,/media/marda/TWOTB1/xBD/hurricanes/images/florence/hurricane-florence_00000119_pre_disaster.png,58,32,1,419,477,135,167,753,44.82348640759236,22.30568225778402
10718,/media/marda/TWOTB1/xBD/hurricanes/images/florence/hurricane-florence_00000119_pre_disaster.png,47,23,1,533,580,165,188,355,26.807686301322477,17.55333212693422
10719,/media/marda/TWOTB1/xBD/hurricanes/images/florence/hurricane-florence_00000119_pre_disaster.png,67,45,1,723,790,198,243,865,37.107822317178965,30.859664857301166
10720,/media/marda/TWOTB1/xBD/hurricanes/images/florence/hurricane-florence_00000119_pre_disaster.png,71,43,1,899,970,284,327,782,33.12489155491074,31.53938522946187
10721,/media/marda/TWOTB1/xBD/hurricanes/images/florence/hurricane-florence_00000279_post_disaster.png,29,24,1,389,418,361,385,142,16.41743408091548,11.65418254854673
10722,/media/marda/TWOTB1/xBD/hurricanes/images/florence/hurricane-florence_00000279_post_disaster.png,22,32,1,347,369,482,514,106,17.922006956356896,8.369915987689911
10723,/media/marda/TWOTB1/xBD/hurricanes/images/florence/hurricane-florence_00000279_post_disaster.png,151,65,1,224,375,497,562,4175,159.74507646384416,34.71496508239535
10724,/media/marda/TWOTB1/xBD/hurricanes/images/florence/hurricane-florence_00000279_post_disaster.png,21,34,1,354,375,535,569,83,15.706729582282769,7.606774863432381
10725,/media/marda/TWOTB1/xBD/hurricanes/images/florence/hurricane-florence_00000279_post_disaster.png,152,64,1,229,381,551,615,4001,160.6986223621812,33.04625853896941
10726,/media/marda/TWOTB1/xBD/hurricanes/images/florence/hurricane-florence_00000279_post_disaster.png,19,27,1,361,380,586,613,39,7.045638767423834,7.026202485519569
10727,/media/marda/TWOTB1/xBD/hurricanes/images/florence/hurricane-florence_00000279_post_disaster.png,21,32,1,360,381,592,624,48,8.396005829706,7.381950773247812
10728,/media/marda/TWOTB1/xBD/hurricanes/images/florence/hurricane-florence_00000279_post_disaster.png,151,68,1,235,386,602,670,3948,160.33359367214283,32.707687894750855
10729,/media/marda/TWOTB1/xBD/hurricanes/images/florence/hurricane-florence_00000279_post_disaster.png,34,40,1,355,389,635,675,299,23.300597552174473,16.66513054354808
10730,/media/marda/TWOTB1/xBD/hurricanes/images/florence/hurricane-florence_00000279_post_disaster.png,31,43,1,404,435,640,683,256,20.80081346834241,16.501124099746203
10731,/media/marda/TWOTB1/xBD/hurricanes/images/florence/hurricane-florence_00000279_post_disaster.png,61,57,1,338,399,750,807,1032,53.27976721824268,25.695238520807283
10732,/media/marda/TWOTB1/xBD/hurricanes/images/florence/hurricane-florence_00000045_post_disaster.png,26,17,1,475,501,191,208,115,13.966809088803258,11.024550795721026
10733,/media/marda/TWOTB1/xBD/hurricanes/images/florence/hurricane-florence_00000045_post_disaster.png,27,23,1,129,156,197,220,379,26.057891807773256,19.42435938815798
10734,/media/marda/TWOTB1/xBD/hurricanes/images/florence/hurricane-florence_00000045_post_disaster.png,15,20,1,83,98,207,227,174,16.80949810124836,13.745363816854432
10735,/media/marda/TWOTB1/xBD/hurricanes/images/florence/hurricane-florence_00000045_post_disaster.png,22,23,1,119,141,226,249,237,19.71973626050699,16.197578252371798
10736,/media/marda/TWOTB1/xBD/hurricanes/images/florence/hurricane-florence_00000045_post_disaster.png,38,35,1,58,96,242,277,882,41.23994360202934,28.181605455514706
10737,/media/marda/TWOTB1/xBD/hurricanes/images/florence/hurricane-florence_00000045_post_disaster.png,54,40,1,111,165,244,284,1186,54.122337050867195,29.25314670221972
10738,/media/marda/TWOTB1/xBD/hurricanes/images/florence/hurricane-florence_00000045_post_disaster.png,43,41,1,358,401,258,299,783,35.18333070779207,30.861506870267505
10739,/media/marda/TWOTB1/xBD/hurricanes/images/florence/hurricane-florence_00000045_post_disaster.png,25,33,1,239,264,266,299,412,28.87495476678261,19.01208915691289
10740,/media/marda/TWOTB1/xBD/hurricanes/images/florence/hurricane-florence_00000045_post_disaster.png,50,48,1,723,773,267,315,840,46.21840675659505,24.218289443075765
10741,/media/marda/TWOTB1/xBD/hurricanes/images/florence/hurricane-florence_00000045_post_disaster.png,45,34,1,455,500,270,304,627,31.340570024240815,26.75962197434054
10742,/media/marda/TWOTB1/xBD/hurricanes/images/florence/hurricane-florence_00000045_post_disaster.png,75,24,1,809,884,270,294,536,49.247348601357736,14.551909798044742
10743,/media/marda/TWOTB1/xBD/hurricanes/images/florence/hurricane-florence_00000045_post_disaster.png,65,23,1,552,617,392,415,473,49.63869458396343,12.649110640673518
10744,/media/marda/TWOTB1/xBD/hurricanes/images/florence/hurricane-florence_00000045_post_disaster.png,35,50,1,6,41,393,443,899,38.402282265437066,33.027979757235954
10745,/media/marda/TWOTB1/xBD/hurricanes/images/florence/hurricane-florence_00000045_post_disaster.png,67,25,1,468,535,393,418,541,56.76498920013948,12.70882329910165
10746,/media/marda/TWOTB1/xBD/hurricanes/images/florence/hurricane-florence_00000045_post_disaster.png,33,33,1,430,463,394,427,273,19.66446627592801,18.50980413341272
10747,/media/marda/TWOTB1/xBD/hurricanes/images/florence/hurricane-florence_00000045_post_disaster.png,13,32,1,43,56,417,449,184,16.358365260120507,14.979863970671083
10748,/media/marda/TWOTB1/xBD/hurricanes/images/florence/hurricane-florence_00000045_post_disaster.png,55,44,1,543,598,421,465,354,40.94456336635686,11.544818912946965
10749,/media/marda/TWOTB1/xBD/hurricanes/images/florence/hurricane-florence_00000045_post_disaster.png,33,44,1,429,462,422,466,392,29.542780229455218,17.745589186173056
10750,/media/marda/TWOTB1/xBD/hurricanes/images/florence/hurricane-florence_00000045_post_disaster.png,28,46,1,403,431,432,478,305,33.63787986300407,12.115206579945404
10751,/media/marda/TWOTB1/xBD/hurricanes/images/florence/hurricane-florence_00000045_post_disaster.png,18,29,1,39,57,446,475,181,19.387390423149515,12.359951023573466
10752,/media/marda/TWOTB1/xBD/hurricanes/images/florence/hurricane-florence_00000045_post_disaster.png,51,36,1,484,535,451,487,412,34.999695181612125,16.978196433723802
10753,/media/marda/TWOTB1/xBD/hurricanes/images/florence/hurricane-florence_00000045_post_disaster.png,53,73,1,181,234,516,589,1665,63.68311659401299,41.471904856640556
10754,/media/marda/TWOTB1/xBD/hurricanes/images/florence/hurricane-florence_00000045_post_disaster.png,58,49,1,74,132,542,591,1215,61.413996084581846,26.278708333368353
10755,/media/marda/TWOTB1/xBD/hurricanes/images/florence/hurricane-florence_00000045_post_disaster.png,65,57,1,95,160,591,648,1287,68.39888769637055,25.006262344383543
10756,/media/marda/TWOTB1/xBD/hurricanes/images/florence/hurricane-florence_00000476_pre_disaster.png,65,56,1,264,329,119,175,1639,62.450585696200314,37.12767458217762
10757,/media/marda/TWOTB1/xBD/hurricanes/images/florence/hurricane-florence_00000476_pre_disaster.png,67,55,1,86,153,140,195,1573,65.4371608831429,37.38248045944768
10758,/media/marda/TWOTB1/xBD/hurricanes/images/florence/hurricane-florence_00000476_pre_disaster.png,79,69,1,130,209,407,476,2059,67.2103034337999,42.68571851070546
10759,/media/marda/TWOTB1/xBD/hurricanes/images/florence/hurricane-florence_00000476_pre_disaster.png,71,72,1,65,136,426,498,1976,62.5170125381507,45.265571381534485
10760,/media/marda/TWOTB1/xBD/hurricanes/images/florence/hurricane-florence_00000476_pre_disaster.png,43,56,1,344,387,746,802,450,25.90166555496627,23.22202271040627
10761,/media/marda/TWOTB1/xBD/hurricanes/images/florence/hurricane-florence_00000476_pre_disaster.png,55,85,1,189,244,844,929,1649,48.753638555161224,46.285378705306854
10762,/media/marda/TWOTB1/xBD/hurricanes/images/florence/hurricane-florence_00000476_pre_disaster.png,50,86,1,68,118,881,967,1553,54.037372716782066,40.54182445256728
10763,/media/marda/TWOTB1/xBD/hurricanes/images/florence/hurricane-florence_00000476_pre_disaster.png,55,95,1,20,75,891,986,1805,61.36472989147154,39.61671429126712
10764,/media/marda/TWOTB1/xBD/hurricanes/images/florence/hurricane-florence_00000466_post_disaster.png,56,71,1,49,105,500,571,1608,48.67271703477596,44.801181493945585
10765,/media/marda/TWOTB1/xBD/hurricanes/images/florence/hurricane-florence_00000466_post_disaster.png,69,90,1,360,429,568,658,2059,65.07604443752055,47.072299070719964
10766,/media/marda/TWOTB1/xBD/hurricanes/images/florence/hurricane-florence_00000466_post_disaster.png,60,73,1,305,365,631,704,1264,48.179926649897546,34.862058323738935
10767,/media/marda/TWOTB1/xBD/hurricanes/images/florence/hurricane-florence_00000466_post_disaster.png,23,98,1,0,23,770,868,1006,76.32334035659764,22.25121580665255
10768,/media/marda/TWOTB1/xBD/hurricanes/images/florence/hurricane-florence_00000110_post_disaster.png,30,16,1,163,193,0,16,291,25.67218207817685,15.399169972616825
10769,/media/marda/TWOTB1/xBD/hurricanes/images/florence/hurricane-florence_00000110_post_disaster.png,59,20,1,293,352,0,20,686,51.35581418159012,18.207494400924404
10770,/media/marda/TWOTB1/xBD/hurricanes/images/florence/hurricane-florence_00000110_post_disaster.png,107,85,1,759,866,0,85,3784,88.42117706345863,59.377451381616204
10771,/media/marda/TWOTB1/xBD/hurricanes/images/florence/hurricane-florence_00000110_post_disaster.png,51,45,1,126,177,3,48,1384,44.92840179283126,40.72635341229802
10772,/media/marda/TWOTB1/xBD/hurricanes/images/florence/hurricane-florence_00000110_post_disaster.png,16,14,1,87,103,4,18,133,13.78804234262056,12.805370491939486
10773,/media/marda/TWOTB1/xBD/hurricanes/images/florence/hurricane-florence_00000110_post_disaster.png,47,45,1,85,132,20,65,1186,50.19074701108999,35.55057596609841
10774,/media/marda/TWOTB1/xBD/hurricanes/images/florence/hurricane-florence_00000110_post_disaster.png,68,42,1,636,704,33,75,1039,51.753794725954165,27.839516904475403
10775,/media/marda/TWOTB1/xBD/hurricanes/images/florence/hurricane-florence_00000110_post_disaster.png,61,32,1,580,641,49,81,846,39.62826998114609,27.927898703705793
10776,/media/marda/TWOTB1/xBD/hurricanes/images/florence/hurricane-florence_00000110_post_disaster.png,101,41,1,457,558,73,114,2195,88.68452015367237,33.18143809878765
10777,/media/marda/TWOTB1/xBD/hurricanes/images/florence/hurricane-florence_00000110_post_disaster.png,78,58,1,891,969,102,160,1287,58.51543329534099,30.247715309025747
10778,/media/marda/TWOTB1/xBD/hurricanes/images/florence/hurricane-florence_00000110_post_disaster.png,84,52,1,339,423,107,159,2027,69.0373323289636,40.10803558268213
10779,/media/marda/TWOTB1/xBD/hurricanes/images/florence/hurricane-florence_00000110_post_disaster.png,96,87,1,814,910,115,202,3458,84.66353840129018,54.270419304780035
10780,/media/marda/TWOTB1/xBD/hurricanes/images/florence/hurricane-florence_00000110_post_disaster.png,79,84,1,752,831,136,220,2399,85.03538677726497,37.48000248178224
10781,/media/marda/TWOTB1/xBD/hurricanes/images/florence/hurricane-florence_00000110_post_disaster.png,43,40,1,240,283,140,180,911,35.19283198881864,33.710251434680245
10782,/media/marda/TWOTB1/xBD/hurricanes/images/florence/hurricane-florence_00000110_post_disaster.png,63,37,1,169,232,159,196,1164,60.28868432665721,28.44704767417516
10783,/media/marda/TWOTB1/xBD/hurricanes/images/florence/hurricane-florence_00000110_post_disaster.png,39,29,1,251,290,179,208,502,32.174548364234965,20.655952559248103
10784,/media/marda/TWOTB1/xBD/hurricanes/images/florence/hurricane-florence_00000110_post_disaster.png,84,61,1,890,974,184,245,1715,58.381477287393366,40.15216257234789
10785,/media/marda/TWOTB1/xBD/hurricanes/images/florence/hurricane-florence_00000110_post_disaster.png,91,55,1,74,165,189,244,2669,92.32086501217327,38.27191155539155
10786,/media/marda/TWOTB1/xBD/hurricanes/images/florence/hurricane-florence_00000110_post_disaster.png,55,44,1,640,695,198,242,859,36.69437917087174,30.871140731151055
10787,/media/marda/TWOTB1/xBD/hurricanes/images/florence/hurricane-florence_00000110_post_disaster.png,41,30,1,491,532,199,229,360,24.534528410026017,19.28057942226115
10788,/media/marda/TWOTB1/xBD/hurricanes/images/florence/hurricane-florence_00000110_post_disaster.png,61,46,1,490,551,221,267,916,39.082328792543635,32.60280725990557
10789,/media/marda/TWOTB1/xBD/hurricanes/images/florence/hurricane-florence_00000110_post_disaster.png,25,26,1,141,166,254,280,254,21.973630954259566,15.496451614706697
10790,/media/marda/TWOTB1/xBD/hurricanes/images/florence/hurricane-florence_00000110_post_disaster.png,63,34,1,960,1023,272,306,354,23.256573461159128,20.207237998673595
10791,/media/marda/TWOTB1/xBD/hurricanes/images/florence/hurricane-florence_00000110_post_disaster.png,94,65,1,381,475,281,346,2727,87.28833535834264,46.23232675805608
10792,/media/marda/TWOTB1/xBD/hurricanes/images/florence/hurricane-florence_00000110_post_disaster.png,79,58,1,902,981,293,351,1453,48.87035763551191,40.17280685297735
10793,/media/marda/TWOTB1/xBD/hurricanes/images/florence/hurricane-florence_00000110_post_disaster.png,62,79,1,286,348,299,378,1863,70.08214793036106,44.01457342907732
10794,/media/marda/TWOTB1/xBD/hurricanes/images/florence/hurricane-florence_00000110_post_disaster.png,13,35,1,0,13,304,339,242,23.5866589795635,13.709369848561785
10795,/media/marda/TWOTB1/xBD/hurricanes/images/florence/hurricane-florence_00000110_post_disaster.png,92,80,1,905,997,336,416,2456,71.54369968039938,48.30449723666137
10796,/media/marda/TWOTB1/xBD/hurricanes/images/florence/hurricane-florence_00000110_post_disaster.png,75,62,1,818,893,342,404,1202,53.08864747520121,31.010405582796814
10797,/media/marda/TWOTB1/xBD/hurricanes/images/florence/hurricane-florence_00000110_post_disaster.png,56,50,1,236,292,350,400,1158,48.34463721642339,33.97556785274225
10798,/media/marda/TWOTB1/xBD/hurricanes/images/florence/hurricane-florence_00000110_post_disaster.png,53,68,1,25,78,376,444,1532,55.77221782305987,43.50405910508665
10799,/media/marda/TWOTB1/xBD/hurricanes/images/florence/hurricane-florence_00000110_post_disaster.png,124,72,1,919,1043,396,468,2972,91.68603798275436,47.45921362423024
10800,/media/marda/TWOTB1/xBD/hurricanes/images/florence/hurricane-florence_00000110_post_disaster.png,75,61,1,747,822,398,459,1260,44.53994231500119,38.58302312705651
10801,/media/marda/TWOTB1/xBD/hurricanes/images/florence/hurricane-florence_00000110_post_disaster.png,30,49,1,0,30,426,475,685,33.81198695770918,27.166962960711185
10802,/media/marda/TWOTB1/xBD/hurricanes/images/florence/hurricane-florence_00000110_post_disaster.png,62,64,1,424,486,466,530,1281,47.31629282340065,39.597607020653896
10803,/media/marda/TWOTB1/xBD/hurricanes/images/florence/hurricane-florence_00000110_post_disaster.png,55,62,1,320,375,484,546,1216,46.445486256129975,35.337477068538064
10804,/media/marda/TWOTB1/xBD/hurricanes/images/florence/hurricane-florence_00000110_post_disaster.png,54,30,1,971,1025,488,518,161,16.497819554591633,12.91257705547456
10805,/media/marda/TWOTB1/xBD/hurricanes/images/florence/hurricane-florence_00000110_post_disaster.png,44,56,1,266,310,502,558,832,33.6027107326746,32.4774668765132
10806,/media/marda/TWOTB1/xBD/hurricanes/images/florence/hurricane-florence_00000110_post_disaster.png,50,65,1,220,270,517,582,1117,46.30071361113845,32.92307308254252
10807,/media/marda/TWOTB1/xBD/hurricanes/images/florence/hurricane-florence_00000110_post_disaster.png,63,68,1,479,542,522,590,1378,47.737996358147214,38.49917157993026
10808,/media/marda/TWOTB1/xBD/hurricanes/images/florence/hurricane-florence_00000110_post_disaster.png,55,90,1,162,217,533,623,1680,78.7536978893019,35.824716028339026
10809,/media/marda/TWOTB1/xBD/hurricanes/images/florence/hurricane-florence_00000110_post_disaster.png,44,56,1,312,356,574,630,729,35.95187311355743,27.336776595502876
10810,/media/marda/TWOTB1/xBD/hurricanes/images/florence/hurricane-florence_00000110_post_disaster.png,43,112,1,0,43,584,696,2594,89.55645005211792,40.65278707359149
10811,/media/marda/TWOTB1/xBD/hurricanes/images/florence/hurricane-florence_00000110_post_disaster.png,54,69,1,171,225,616,685,1715,58.58196066216961,41.58170621779843
10812,/media/marda/TWOTB1/xBD/hurricanes/images/florence/hurricane-florence_00000110_post_disaster.png,78,113,1,558,636,618,731,2839,94.51643975074056,45.128551939571835
10813,/media/marda/TWOTB1/xBD/hurricanes/images/florence/hurricane-florence_00000110_post_disaster.png,64,82,1,325,389,641,723,1779,55.22293191377802,45.941973112142854
10814,/media/marda/TWOTB1/xBD/hurricanes/images/florence/hurricane-florence_00000110_post_disaster.png,71,74,1,972,1043,660,734,1158,51.031281114005246,29.838330041833345
10815,/media/marda/TWOTB1/xBD/hurricanes/images/florence/hurricane-florence_00000110_post_disaster.png,108,63,1,898,1006,668,731,1550,80.8288774150149,25.393034624916485
10816,/media/marda/TWOTB1/xBD/hurricanes/images/florence/hurricane-florence_00000110_post_disaster.png,80,58,1,843,923,687,745,1037,50.74300885298465,27.206792575603103
10817,/media/marda/TWOTB1/xBD/hurricanes/images/florence/hurricane-florence_00000110_post_disaster.png,25,61,1,85,110,703,764,629,36.0795033368892,23.74714724465697
10818,/media/marda/TWOTB1/xBD/hurricanes/images/florence/hurricane-florence_00000110_post_disaster.png,63,63,1,980,1043,715,778,659,33.091305464141314,26.434585127743805
10819,/media/marda/TWOTB1/xBD/hurricanes/images/florence/hurricane-florence_00000110_post_disaster.png,87,98,1,756,843,722,820,2557,83.29481863278637,51.55883136930385
10820,/media/marda/TWOTB1/xBD/hurricanes/images/florence/hurricane-florence_00000110_post_disaster.png,61,86,1,274,335,732,818,1797,75.39924864800963,35.534141615561005
10821,/media/marda/TWOTB1/xBD/hurricanes/images/florence/hurricane-florence_00000110_post_disaster.png,59,77,1,179,238,735,812,1929,57.17090959769141,48.883523220595876
10822,/media/marda/TWOTB1/xBD/hurricanes/images/florence/hurricane-florence_00000110_post_disaster.png,101,70,1,896,997,736,806,2039,70.62419203291363,38.13623697670132
10823,/media/marda/TWOTB1/xBD/hurricanes/images/florence/hurricane-florence_00000110_post_disaster.png,114,74,1,812,926,749,823,2446,85.01827167234514,38.463994453348334
10824,/media/marda/TWOTB1/xBD/hurricanes/images/florence/hurricane-florence_00000110_post_disaster.png,67,57,1,365,432,757,814,1433,61.26902942870779,31.20360556195091
10825,/media/marda/TWOTB1/xBD/hurricanes/images/florence/hurricane-florence_00000110_post_disaster.png,47,68,1,0,47,763,831,1211,53.78591897264678,29.97849460169534
10826,/media/marda/TWOTB1/xBD/hurricanes/images/florence/hurricane-florence_00000110_post_disaster.png,32,64,1,44,76,805,869,725,31.75590540194797,30.26288196810955
10827,/media/marda/TWOTB1/xBD/hurricanes/images/florence/hurricane-florence_00000110_post_disaster.png,107,88,1,852,959,828,916,2142,66.51371288380669,44.39712682099086
10828,/media/marda/TWOTB1/xBD/hurricanes/images/florence/hurricane-florence_00000110_post_disaster.png,43,84,1,554,597,867,951,959,61.81378643780577,21.938290775677817
10829,/media/marda/TWOTB1/xBD/hurricanes/images/florence/hurricane-florence_00000110_post_disaster.png,36,67,1,331,367,870,937,830,40.01154929000162,27.467663291484484
10830,/media/marda/TWOTB1/xBD/hurricanes/images/florence/hurricane-florence_00000110_post_disaster.png,100,72,1,208,308,888,960,1969,101.69481490377837,27.35379308407637
10831,/media/marda/TWOTB1/xBD/hurricanes/images/florence/hurricane-florence_00000110_post_disaster.png,79,92,1,700,779,894,986,2200,64.1139847679229,45.92368885989957
10832,/media/marda/TWOTB1/xBD/hurricanes/images/florence/hurricane-florence_00000110_post_disaster.png,53,50,1,935,988,896,946,167,17.41336416552298,12.637890116635864
10833,/media/marda/TWOTB1/xBD/hurricanes/images/florence/hurricane-florence_00000110_post_disaster.png,39,58,1,34,73,902,960,754,44.57095321001711,22.595901845975405
10834,/media/marda/TWOTB1/xBD/hurricanes/images/florence/hurricane-florence_00000110_post_disaster.png,86,82,1,895,981,924,1006,1793,55.228134801542375,42.88476940551567
10835,/media/marda/TWOTB1/xBD/hurricanes/images/florence/hurricane-florence_00000110_post_disaster.png,52,47,1,968,1020,979,1026,106,14.015500059208115,10.13339674593131
10836,/media/marda/TWOTB1/xBD/hurricanes/images/florence/hurricane-florence_00000110_post_disaster.png,81,60,1,715,796,983,1043,832,54.635434370790406,20.969727182762593
10837,/media/marda/TWOTB1/xBD/hurricanes/images/florence/hurricane-florence_00000110_post_disaster.png,71,49,1,908,979,994,1043,231,33.49261776781791,10.331286241021665
10838,/media/marda/TWOTB1/xBD/hurricanes/images/florence/hurricane-florence_00000404_post_disaster.png,62,7,1,929,991,0,7,97,24.578672366602266,5.883034000826257
10839,/media/marda/TWOTB1/xBD/hurricanes/images/florence/hurricane-florence_00000404_post_disaster.png,48,3,1,966,1014,0,3,19,12.69858887860888,2.1644626732323204
10840,/media/marda/TWOTB1/xBD/hurricanes/images/florence/hurricane-florence_00000404_post_disaster.png,69,26,1,975,1044,42,68,387,33.82547704790456,16.694018979638173
10841,/media/marda/TWOTB1/xBD/hurricanes/images/florence/hurricane-florence_00000404_post_disaster.png,75,35,1,950,1025,56,91,499,41.97906129265549,17.872255671577822
10842,/media/marda/TWOTB1/xBD/hurricanes/images/florence/hurricane-florence_00000404_post_disaster.png,74,36,1,918,992,62,98,561,42.341648098266866,19.150511279445716
10843,/media/marda/TWOTB1/xBD/hurricanes/images/florence/hurricane-florence_00000404_post_disaster.png,59,31,1,908,967,98,129,416,31.963390527901034,17.698596966989772
10844,/media/marda/TWOTB1/xBD/hurricanes/images/florence/hurricane-florence_00000404_post_disaster.png,73,60,1,419,492,450,510,1611,53.87933917565287,39.52117919488285
10845,/media/marda/TWOTB1/xBD/hurricanes/images/florence/hurricane-florence_00000404_post_disaster.png,287,352,1,757,1044,483,835,51206,312.0503211416864,218.8203717717256
10846,/media/marda/TWOTB1/xBD/hurricanes/images/florence/hurricane-florence_00000404_post_disaster.png,49,49,1,492,541,581,630,563,28.4989234158268,26.071578480965773
10847,/media/marda/TWOTB1/xBD/hurricanes/images/florence/hurricane-florence_00000404_post_disaster.png,50,90,1,256,306,653,743,1486,69.68819926864474,28.41877695377932
10848,/media/marda/TWOTB1/xBD/hurricanes/images/florence/hurricane-florence_00000404_post_disaster.png,44,59,1,325,369,710,769,579,34.887676827838945,21.921351359106254
10849,/media/marda/TWOTB1/xBD/hurricanes/images/florence/hurricane-florence_00000404_post_disaster.png,84,115,1,960,1044,853,968,2319,82.44606522591701,41.98989404695487
10850,/media/marda/TWOTB1/xBD/hurricanes/images/florence/hurricane-florence_00000404_post_disaster.png,43,87,1,257,300,866,953,1053,57.912893494865536,24.270221794045277
10851,/media/marda/TWOTB1/xBD/hurricanes/images/florence/hurricane-florence_00000404_post_disaster.png,44,78,1,355,399,899,977,856,41.80622897561374,27.20453284393534
10852,/media/marda/TWOTB1/xBD/hurricanes/images/florence/hurricane-florence_00000404_post_disaster.png,47,48,1,997,1044,939,987,72,12.498613443764096,7.575592402905817
10853,/media/marda/TWOTB1/xBD/hurricanes/images/florence/hurricane-florence_00000404_post_disaster.png,29,32,1,65,94,215,247,403,29.437879994586805,18.233065403379225
10854,/media/marda/TWOTB1/xBD/hurricanes/images/florence/hurricane-florence_00000404_post_disaster.png,7,25,1,0,7,284,309,65,16.226921349848936,6.114618709891507
10855,/media/marda/TWOTB1/xBD/hurricanes/images/florence/hurricane-florence_00000128_pre_disaster.png,35,20,1,770,805,303,323,44,8.348617343403225,7.1196220549614155
10856,/media/marda/TWOTB1/xBD/hurricanes/images/florence/hurricane-florence_00000089_post_disaster.png,30,25,1,446,476,206,231,145,16.356122892883164,11.771729073816577
10857,/media/marda/TWOTB1/xBD/hurricanes/images/florence/hurricane-florence_00000089_post_disaster.png,29,22,1,457,486,212,234,110,14.134220916751543,10.458844842529194
10858,/media/marda/TWOTB1/xBD/hurricanes/images/florence/hurricane-florence_00000089_post_disaster.png,51,33,1,477,528,219,252,484,30.483898195248877,22.061072088931557
10859,/media/marda/TWOTB1/xBD/hurricanes/images/florence/hurricane-florence_00000089_post_disaster.png,64,48,1,405,469,243,291,1073,50.184595178274236,28.550133365761255
10860,/media/marda/TWOTB1/xBD/hurricanes/images/florence/hurricane-florence_00000089_post_disaster.png,45,57,1,249,294,375,432,1066,43.802766568968195,33.030959034628836
10861,/media/marda/TWOTB1/xBD/hurricanes/images/florence/hurricane-florence_00000089_post_disaster.png,69,74,1,373,442,375,449,1826,65.20618707604609,37.78562998727408
10862,/media/marda/TWOTB1/xBD/hurricanes/images/florence/hurricane-florence_00000089_post_disaster.png,29,36,1,268,297,438,474,230,20.01546851228958,15.280787182161534
10863,/media/marda/TWOTB1/xBD/hurricanes/images/florence/hurricane-florence_00000089_post_disaster.png,31,42,1,256,287,465,507,369,26.170009507446732,18.610918083706004
10864,/media/marda/TWOTB1/xBD/hurricanes/images/florence/hurricane-florence_00000089_post_disaster.png,37,41,1,440,477,489,530,249,26.40377888343693,12.630850521702751
10865,/media/marda/TWOTB1/xBD/hurricanes/images/florence/hurricane-florence_00000089_post_disaster.png,22,32,1,371,393,509,541,92,12.03269054769746,10.362831236048885
10866,/media/marda/TWOTB1/xBD/hurricanes/images/florence/hurricane-florence_00000089_post_disaster.png,103,61,1,542,645,589,650,1551,92.04269143245604,22.42969404884953
10867,/media/marda/TWOTB1/xBD/hurricanes/images/florence/hurricane-florence_00000089_post_disaster.png,30,47,1,167,197,634,681,405,25.507122077613886,21.15268583955746
10868,/media/marda/TWOTB1/xBD/hurricanes/images/florence/hurricane-florence_00000089_post_disaster.png,59,55,1,191,250,638,693,948,57.27210810617059,21.939777032518805
10869,/media/marda/TWOTB1/xBD/hurricanes/images/florence/hurricane-florence_00000089_post_disaster.png,23,42,1,214,237,744,786,156,14.700979413993137,13.723059476764458
10870,/media/marda/TWOTB1/xBD/hurricanes/images/florence/hurricane-florence_00000089_post_disaster.png,54,75,1,450,504,951,1026,871,37.462599558226664,31.343259983028133
10871,/media/marda/TWOTB1/xBD/hurricanes/images/florence/hurricane-florence_00000204_pre_disaster.png,38,33,1,185,223,18,51,699,31.587099751335657,29.197104456375516
10872,/media/marda/TWOTB1/xBD/hurricanes/images/florence/hurricane-florence_00000204_pre_disaster.png,47,46,1,745,792,738,784,162,18.985935906751507,11.404067531510076
10873,/media/marda/TWOTB1/xBD/hurricanes/images/florence/hurricane-florence_00000204_pre_disaster.png,52,58,1,385,437,986,1044,534,40.957921061864425,17.23283348670407
10874,/media/marda/TWOTB1/xBD/hurricanes/images/florence/hurricane-florence_00000335_pre_disaster.png,148,88,1,121,269,0,88,6326,126.96847571002846,69.63498664725104
10875,/media/marda/TWOTB1/xBD/hurricanes/images/florence/hurricane-florence_00000335_pre_disaster.png,44,20,1,699,743,195,215,128,13.51390863960617,12.693473649099278
10876,/media/marda/TWOTB1/xBD/hurricanes/images/florence/hurricane-florence_00000335_pre_disaster.png,116,98,1,600,716,284,382,3950,84.23587857833304,63.07712018159927
10877,/media/marda/TWOTB1/xBD/hurricanes/images/florence/hurricane-florence_00000335_pre_disaster.png,127,103,1,826,953,381,484,4120,84.25311397935741,66.34940729932858
10878,/media/marda/TWOTB1/xBD/hurricanes/images/florence/hurricane-florence_00000335_pre_disaster.png,50,55,1,336,386,406,461,502,49.39226496919721,13.570029076051014
10879,/media/marda/TWOTB1/xBD/hurricanes/images/florence/hurricane-florence_00000335_pre_disaster.png,27,31,1,330,357,419,450,112,13.574568649644753,11.036879931807857
10880,/media/marda/TWOTB1/xBD/hurricanes/images/florence/hurricane-florence_00000335_pre_disaster.png,40,43,1,300,340,425,468,407,25.158082166313683,21.507452623970398
10881,/media/marda/TWOTB1/xBD/hurricanes/images/florence/hurricane-florence_00000335_pre_disaster.png,186,167,1,590,776,436,603,10176,177.25440962042455,76.86566634062845
10882,/media/marda/TWOTB1/xBD/hurricanes/images/florence/hurricane-florence_00000335_pre_disaster.png,190,177,1,646,836,491,668,11214,180.7532793216613,83.00483864094842
10883,/media/marda/TWOTB1/xBD/hurricanes/images/florence/hurricane-florence_00000335_pre_disaster.png,74,55,1,947,1021,532,587,431,47.233568921251624,12.134733411071563
10884,/media/marda/TWOTB1/xBD/hurricanes/images/florence/hurricane-florence_00000335_pre_disaster.png,184,172,1,696,880,552,724,10255,168.71221557995165,81.06285555747384
10885,/media/marda/TWOTB1/xBD/hurricanes/images/florence/hurricane-florence_00000335_pre_disaster.png,132,118,1,903,1035,614,732,4316,88.58845029673301,64.97227553080576
10886,/media/marda/TWOTB1/xBD/hurricanes/images/florence/hurricane-florence_00000335_pre_disaster.png,57,45,1,890,947,656,701,203,22.084477307172893,12.250263895820423
10887,/media/marda/TWOTB1/xBD/hurricanes/images/florence/hurricane-florence_00000335_pre_disaster.png,60,62,1,984,1044,693,755,350,28.443677650990097,18.919636965625322
10888,/media/marda/TWOTB1/xBD/hurricanes/images/florence/hurricane-florence_00000335_pre_disaster.png,87,80,1,846,933,737,817,1353,52.23262691137381,34.3296869207611
10889,/media/marda/TWOTB1/xBD/hurricanes/images/florence/hurricane-florence_00000335_pre_disaster.png,50,49,1,994,1044,820,869,94,14.896903307393048,9.157535259129805
10890,/media/marda/TWOTB1/xBD/hurricanes/images/florence/hurricane-florence_00000335_pre_disaster.png,100,93,1,944,1044,830,923,1493,74.30979665548364,29.15917546139698
10891,/media/marda/TWOTB1/xBD/hurricanes/images/florence/hurricane-florence_00000335_pre_disaster.png,72,106,1,972,1044,872,978,1269,62.87259922534505,31.194410745698537
10892,/media/marda/TWOTB1/xBD/hurricanes/images/florence/hurricane-florence_00000335_pre_disaster.png,42,48,1,848,890,961,1009,73,10.775186576394377,9.177042905436041
10893,/media/marda/TWOTB1/xBD/hurricanes/images/florence/hurricane-florence_00000335_pre_disaster.png,62,70,1,846,908,969,1039,612,32.89662828797599,24.852303716190523
10894,/media/marda/TWOTB1/xBD/hurricanes/images/florence/hurricane-florence_00000189_pre_disaster.png,49,58,1,231,280,563,621,973,42.15538680070053,30.60250675270512
10895,/media/marda/TWOTB1/xBD/hurricanes/images/florence/hurricane-florence_00000189_pre_disaster.png,50,63,1,350,400,701,764,772,35.828784716043664,29.612784758890427
10896,/media/marda/TWOTB1/xBD/hurricanes/images/florence/hurricane-florence_00000189_pre_disaster.png,44,70,1,99,143,938,1008,849,39.97758596192637,27.765303642537404
10897,/media/marda/TWOTB1/xBD/hurricanes/images/florence/hurricane-florence_00000189_pre_disaster.png,60,75,1,28,88,967,1042,1419,58.13402153186688,33.04904925595609
10898,/media/marda/TWOTB1/xBD/hurricanes/images/florence/hurricane-florence_00000311_post_disaster.png,65,56,1,883,948,769,825,524,28.203909035544708,24.812991622991742
10899,/media/marda/TWOTB1/xBD/hurricanes/images/florence/hurricane-florence_00000311_post_disaster.png,50,46,1,860,910,784,830,150,18.066677774490948,11.156843379411344
10900,/media/marda/TWOTB1/xBD/hurricanes/images/florence/hurricane-florence_00000311_post_disaster.png,51,48,1,915,966,790,838,134,14.486593741147484,12.448872345496557
10901,/media/marda/TWOTB1/xBD/hurricanes/images/florence/hurricane-florence_00000311_post_disaster.png,67,63,1,866,933,798,861,657,30.316492425122604,28.324307058366774
10902,/media/marda/TWOTB1/xBD/hurricanes/images/florence/hurricane-florence_00000311_post_disaster.png,76,76,1,888,964,872,948,1114,44.43955028660081,33.62544343517435
10903,/media/marda/TWOTB1/xBD/hurricanes/images/florence/hurricane-florence_00000311_post_disaster.png,52,53,1,938,990,882,935,172,16.10466411056615,14.30198484931475
10904,/media/marda/TWOTB1/xBD/hurricanes/images/florence/hurricane-florence_00000311_post_disaster.png,64,54,1,951,1015,989,1043,277,27.934792287837617,13.44416149627376
10905,/media/marda/TWOTB1/xBD/hurricanes/images/florence/hurricane-florence_00000311_post_disaster.png,28,19,1,291,319,0,19,282,22.68948716088564,16.562666577247015
10906,/media/marda/TWOTB1/xBD/hurricanes/images/florence/hurricane-florence_00000311_post_disaster.png,19,10,1,270,289,11,21,105,12.34801186491647,11.267841173323225
10907,/media/marda/TWOTB1/xBD/hurricanes/images/florence/hurricane-florence_00000311_post_disaster.png,38,53,1,434,472,307,360,576,44.31357136540809,19.09883970169153
10908,/media/marda/TWOTB1/xBD/hurricanes/images/florence/hurricane-florence_00000311_post_disaster.png,26,22,1,461,487,317,339,68,10.218753853058553,8.902542916641433
10909,/media/marda/TWOTB1/xBD/hurricanes/images/florence/hurricane-florence_00000311_post_disaster.png,28,26,1,418,446,335,361,128,14.418164461635705,11.983278158843897
10910,/media/marda/TWOTB1/xBD/hurricanes/images/florence/hurricane-florence_00000311_post_disaster.png,60,48,1,903,963,703,751,310,23.12605286771909,17.74698102120926
10911,/media/marda/TWOTB1/xBD/hurricanes/images/florence/hurricane-florence_00000311_post_disaster.png,65,79,1,865,930,716,795,842,55.33645905534258,20.310129437118594
10912,/media/marda/TWOTB1/xBD/hurricanes/images/florence/hurricane-florence_00000311_post_disaster.png,52,46,1,906,958,727,773,189,17.04671957832748,14.87091743871583
10913,/media/marda/TWOTB1/xBD/hurricanes/images/florence/hurricane-florence_00000311_post_disaster.png,59,47,1,940,999,752,799,269,22.232359230841066,16.18511896606893
10914,/media/marda/TWOTB1/xBD/hurricanes/images/florence/hurricane-florence_00000311_post_disaster.png,59,49,1,919,978,758,807,292,22.50531802710724,17.375675909275188
10915,/media/marda/TWOTB1/xBD/hurricanes/images/florence/hurricane-florence_00000086_post_disaster.png,51,43,1,158,209,0,43,1371,46.462687968924364,39.869962591901555
10916,/media/marda/TWOTB1/xBD/hurricanes/images/florence/hurricane-florence_00000086_post_disaster.png,16,25,1,0,16,106,131,189,18.196784741910587,14.114724494411524
10917,/media/marda/TWOTB1/xBD/hurricanes/images/florence/hurricane-florence_00000086_post_disaster.png,37,40,1,31,68,166,206,718,37.8542004373035,26.26725064154199
10918,/media/marda/TWOTB1/xBD/hurricanes/images/florence/hurricane-florence_00000086_post_disaster.png,50,58,1,993,1043,625,683,274,37.975867181033664,9.564342465902564
10919,/media/marda/TWOTB1/xBD/hurricanes/images/florence/hurricane-florence_00000086_post_disaster.png,49,67,1,817,866,891,958,443,35.02219570171285,16.8141998128631
10920,/media/marda/TWOTB1/xBD/hurricanes/images/florence/hurricane-florence_00000086_post_disaster.png,81,72,1,917,998,908,980,1482,50.42496975604461,39.22104944283571
10921,/media/marda/TWOTB1/xBD/hurricanes/images/florence/hurricane-florence_00000086_post_disaster.png,62,66,1,981,1043,965,1031,373,30.652312878895064,16.489964481312935
10922,/media/marda/TWOTB1/xBD/hurricanes/images/florence/hurricane-florence_00000444_pre_disaster.png,48,15,1,271,319,0,15,454,41.57735444762905,14.716991389719126
10923,/media/marda/TWOTB1/xBD/hurricanes/images/florence/hurricane-florence_00000444_pre_disaster.png,30,8,1,360,390,0,8,123,20.275252679609235,8.105237872867418
10924,/media/marda/TWOTB1/xBD/hurricanes/images/florence/hurricane-florence_00000444_pre_disaster.png,58,21,1,275,333,62,83,717,54.88134546266903,18.71725594759189
10925,/media/marda/TWOTB1/xBD/hurricanes/images/florence/hurricane-florence_00000444_pre_disaster.png,36,18,1,373,409,62,80,278,22.2846484586738,16.721981309063395
10926,/media/marda/TWOTB1/xBD/hurricanes/images/florence/hurricane-florence_00000444_pre_disaster.png,47,13,1,836,883,75,88,130,15.324123014368583,11.310659448242117
10927,/media/marda/TWOTB1/xBD/hurricanes/images/florence/hurricane-florence_00000444_pre_disaster.png,21,12,1,316,337,91,103,108,13.808210118138652,10.327955589886445
10928,/media/marda/TWOTB1/xBD/hurricanes/images/florence/hurricane-florence_00000444_pre_disaster.png,68,45,1,737,805,92,137,1345,45.02141612418372,39.2294553779279
10929,/media/marda/TWOTB1/xBD/hurricanes/images/florence/hurricane-florence_00000444_pre_disaster.png,90,36,1,903,993,142,178,1180,60.22691428627522,26.214292945755236
10930,/media/marda/TWOTB1/xBD/hurricanes/images/florence/hurricane-florence_00000444_pre_disaster.png,80,27,1,537,617,180,207,702,64.24297324071829,14.567876443516525
10931,/media/marda/TWOTB1/xBD/hurricanes/images/florence/hurricane-florence_00000444_pre_disaster.png,69,29,1,870,939,194,223,641,36.7595487949355,22.873962485948454
10932,/media/marda/TWOTB1/xBD/hurricanes/images/florence/hurricane-florence_00000444_pre_disaster.png,63,65,1,685,748,209,274,1590,59.682155272917626,35.34322931558708
10933,/media/marda/TWOTB1/xBD/hurricanes/images/florence/hurricane-florence_00000444_pre_disaster.png,29,23,1,560,589,227,250,92,15.058743794383954,8.242991007002859
10934,/media/marda/TWOTB1/xBD/hurricanes/images/florence/hurricane-florence_00000444_pre_disaster.png,44,33,1,577,621,286,319,406,24.975614240740192,21.83602884891982
10935,/media/marda/TWOTB1/xBD/hurricanes/images/florence/hurricane-florence_00000444_pre_disaster.png,331,89,1,492,823,953,1042,9188,344.8026505485681,35.365576917261585
10936,/media/marda/TWOTB1/xBD/hurricanes/images/florence/hurricane-florence_00000444_pre_disaster.png,59,50,1,823,882,994,1044,140,24.364455788429552,8.841704762841468
10937,/media/marda/TWOTB1/xBD/hurricanes/images/florence/hurricane-florence_00000069_post_disaster.png,58,79,1,320,378,704,783,1519,47.664381542929746,42.51957008136125
10938,/media/marda/TWOTB1/xBD/hurricanes/images/florence/hurricane-florence_00000069_post_disaster.png,32,46,1,265,297,713,759,247,25.406864190511975,13.02288932758351
10939,/media/marda/TWOTB1/xBD/hurricanes/images/florence/hurricane-florence_00000069_post_disaster.png,32,48,1,369,401,775,823,245,19.166111962793035,16.98949163793792
10940,/media/marda/TWOTB1/xBD/hurricanes/images/florence/hurricane-florence_00000069_post_disaster.png,56,69,1,392,448,784,853,1054,43.666967020890226,31.3768387387202
10941,/media/marda/TWOTB1/xBD/hurricanes/images/florence/hurricane-florence_00000069_post_disaster.png,53,95,1,253,306,812,907,1696,62.35846712813222,37.96382905864735
10942,/media/marda/TWOTB1/xBD/hurricanes/images/florence/hurricane-florence_00000069_post_disaster.png,22,58,1,62,84,859,917,365,23.777972634974898,20.474383963387012
10943,/media/marda/TWOTB1/xBD/hurricanes/images/florence/hurricane-florence_00000069_post_disaster.png,46,47,1,815,861,913,960,89,14.567779621393392,8.252759434648457
10944,/media/marda/TWOTB1/xBD/hurricanes/images/florence/hurricane-florence_00000069_post_disaster.png,75,89,1,785,860,916,1005,1289,55.761238742895515,32.0424281536504
10945,/media/marda/TWOTB1/xBD/hurricanes/images/florence/hurricane-florence_00000069_post_disaster.png,49,70,1,108,157,958,1028,1000,45.38355892904893,28.706963387539663
10946,/media/marda/TWOTB1/xBD/hurricanes/images/florence/hurricane-florence_00000357_pre_disaster.png,53,24,1,490,543,0,24,446,31.422443566263354,19.163656681415432
10947,/media/marda/TWOTB1/xBD/hurricanes/images/florence/hurricane-florence_00000357_pre_disaster.png,56,30,1,397,453,55,85,600,39.42336258346796,20.286627077165242
10948,/media/marda/TWOTB1/xBD/hurricanes/images/florence/hurricane-florence_00000357_pre_disaster.png,55,38,1,445,500,57,95,791,33.45688244148772,31.57337814197029
10949,/media/marda/TWOTB1/xBD/hurricanes/images/florence/hurricane-florence_00000357_pre_disaster.png,65,36,1,584,649,85,121,814,40.47552785635607,29.24181479658447
10950,/media/marda/TWOTB1/xBD/hurricanes/images/florence/hurricane-florence_00000357_pre_disaster.png,50,26,1,634,684,89,115,326,22.786348975314297,19.41786402868903
10951,/media/marda/TWOTB1/xBD/hurricanes/images/florence/hurricane-florence_00000357_pre_disaster.png,55,45,1,395,450,116,161,802,40.47242650057543,26.45729157903176
10952,/media/marda/TWOTB1/xBD/hurricanes/images/florence/hurricane-florence_00000357_pre_disaster.png,66,48,1,531,597,135,183,1055,39.62370470227993,35.36018167923322
10953,/media/marda/TWOTB1/xBD/hurricanes/images/florence/hurricane-florence_00000357_pre_disaster.png,38,20,1,576,614,139,159,127,14.415139938236884,11.809653809041691
10954,/media/marda/TWOTB1/xBD/hurricanes/images/florence/hurricane-florence_00000357_pre_disaster.png,64,45,1,491,555,202,247,763,45.3828310666112,22.756408751415492
10955,/media/marda/TWOTB1/xBD/hurricanes/images/florence/hurricane-florence_00000357_pre_disaster.png,36,53,1,197,233,756,809,353,23.336763127019317,20.204668292171466
10956,/media/marda/TWOTB1/xBD/hurricanes/images/florence/hurricane-florence_00000357_pre_disaster.png,59,65,1,295,354,758,823,909,45.495674356454316,26.856163638957735
10957,/media/marda/TWOTB1/xBD/hurricanes/images/florence/hurricane-florence_00000357_pre_disaster.png,29,55,1,177,206,801,856,215,26.855912650539352,10.733262293953176
10958,/media/marda/TWOTB1/xBD/hurricanes/images/florence/hurricane-florence_00000357_pre_disaster.png,15,50,1,16,31,834,884,171,16.58102428232971,13.867055982728996
10959,/media/marda/TWOTB1/xBD/hurricanes/images/florence/hurricane-florence_00000357_pre_disaster.png,62,67,1,412,474,856,923,856,47.53646670599009,24.02364231275428
10960,/media/marda/TWOTB1/xBD/hurricanes/images/florence/hurricane-florence_00000357_pre_disaster.png,39,56,1,382,421,880,936,344,24.527619262194207,18.817359722196993
10961,/media/marda/TWOTB1/xBD/hurricanes/images/florence/hurricane-florence_00000357_pre_disaster.png,49,71,1,345,394,886,957,832,36.85884248634018,29.720787475988995
10962,/media/marda/TWOTB1/xBD/hurricanes/images/florence/hurricane-florence_00000357_pre_disaster.png,15,52,1,27,42,887,939,124,13.926360868001217,11.924156374027845
10963,/media/marda/TWOTB1/xBD/hurricanes/images/florence/hurricane-florence_00000357_pre_disaster.png,32,67,1,152,184,895,962,557,30.339872875886947,25.01179341024636
10964,/media/marda/TWOTB1/xBD/hurricanes/images/florence/hurricane-florence_00000357_pre_disaster.png,35,61,1,42,77,901,962,470,33.94657874412859,18.081008416504922
10965,/media/marda/TWOTB1/xBD/hurricanes/images/florence/hurricane-florence_00000357_pre_disaster.png,27,52,1,188,215,921,973,185,22.47590506050863,10.9563328746512
10966,/media/marda/TWOTB1/xBD/hurricanes/images/florence/hurricane-florence_00000357_pre_disaster.png,59,70,1,470,529,927,997,826,38.92755239369192,28.203374278609157
10967,/media/marda/TWOTB1/xBD/hurricanes/images/florence/hurricane-florence_00000357_pre_disaster.png,44,66,1,251,295,929,995,632,35.45472798187933,23.79395169257651
10968,/media/marda/TWOTB1/xBD/hurricanes/images/florence/hurricane-florence_00000357_pre_disaster.png,34,76,1,129,163,938,1014,755,41.52067772543718,25.147962542706768
10969,/media/marda/TWOTB1/xBD/hurricanes/images/florence/hurricane-florence_00000357_pre_disaster.png,50,86,1,180,230,938,1024,1185,51.871555700069,31.246147492310378
10970,/media/marda/TWOTB1/xBD/hurricanes/images/florence/hurricane-florence_00000357_pre_disaster.png,41,80,1,31,72,945,1025,1080,46.95681646364342,31.873727964831975
10971,/media/marda/TWOTB1/xBD/hurricanes/images/florence/hurricane-florence_00000357_pre_disaster.png,12,49,1,86,98,960,1009,89,11.46055452563566,10.432423747424703
10972,/media/marda/TWOTB1/xBD/hurricanes/images/florence/hurricane-florence_00000357_pre_disaster.png,38,57,1,419,457,987,1044,260,20.831179453001425,16.68605194348731
10973,/media/marda/TWOTB1/xBD/hurricanes/images/florence/hurricane-florence_00000357_pre_disaster.png,41,51,1,273,314,993,1044,186,28.321428345670565,9.68282123841571
10974,/media/marda/TWOTB1/xBD/hurricanes/images/florence/hurricane-florence_00000470_pre_disaster.png,35,19,1,453,488,47,66,278,21.02041434957985,17.586267396273794
10975,/media/marda/TWOTB1/xBD/hurricanes/images/florence/hurricane-florence_00000470_pre_disaster.png,28,13,1,448,476,98,111,105,12.932784078318434,11.018650991829187
10976,/media/marda/TWOTB1/xBD/hurricanes/images/florence/hurricane-florence_00000470_pre_disaster.png,53,23,1,483,536,110,133,366,37.98331737307649,12.906602597517148
10977,/media/marda/TWOTB1/xBD/hurricanes/images/florence/hurricane-florence_00000470_pre_disaster.png,66,33,1,603,669,341,374,478,46.25253142524176,15.446444879743106
10978,/media/marda/TWOTB1/xBD/hurricanes/images/florence/hurricane-florence_00000470_pre_disaster.png,45,28,1,633,678,388,416,194,20.264843538978045,12.728997187379882
10979,/media/marda/TWOTB1/xBD/hurricanes/images/florence/hurricane-florence_00000470_pre_disaster.png,43,47,1,272,315,410,457,723,32.62726345196027,29.161038124075716
10980,/media/marda/TWOTB1/xBD/hurricanes/images/florence/hurricane-florence_00000470_pre_disaster.png,81,41,1,644,725,412,453,810,59.889466807410024,19.957287242222126
10981,/media/marda/TWOTB1/xBD/hurricanes/images/florence/hurricane-florence_00000470_pre_disaster.png,19,29,1,252,271,421,450,103,13.024524259021891,10.543331695143763
10982,/media/marda/TWOTB1/xBD/hurricanes/images/florence/hurricane-florence_00000470_pre_disaster.png,49,63,1,697,746,423,486,487,53.42981957780735,12.148605439349325
10983,/media/marda/TWOTB1/xBD/hurricanes/images/florence/hurricane-florence_00000470_pre_disaster.png,62,46,1,209,271,446,492,883,55.74383192068757,23.84859912998971
10984,/media/marda/TWOTB1/xBD/hurricanes/images/florence/hurricane-florence_00000470_pre_disaster.png,90,136,1,637,727,613,749,4434,120.30613904173089,49.16458160901806
10985,/media/marda/TWOTB1/xBD/hurricanes/images/florence/hurricane-florence_00000470_pre_disaster.png,76,66,1,505,581,648,714,1553,59.34281237666569,34.71666068013401
10986,/media/marda/TWOTB1/xBD/hurricanes/images/florence/hurricane-florence_00000470_pre_disaster.png,49,53,1,421,470,665,718,659,33.94382590058685,25.715422782532816
10987,/media/marda/TWOTB1/xBD/hurricanes/images/florence/hurricane-florence_00000470_pre_disaster.png,40,47,1,545,585,689,736,226,18.312119310840657,16.50081530757081
10988,/media/marda/TWOTB1/xBD/hurricanes/images/florence/hurricane-florence_00000470_pre_disaster.png,62,51,1,353,415,695,746,537,53.94702405987711,13.334449245550857
10989,/media/marda/TWOTB1/xBD/hurricanes/images/florence/hurricane-florence_00000470_pre_disaster.png,42,61,1,463,505,700,761,608,33.47838637073061,23.972092151213296
10990,/media/marda/TWOTB1/xBD/hurricanes/images/florence/hurricane-florence_00000470_pre_disaster.png,37,47,1,474,511,738,785,230,18.01319877166472,17.100954020890036
10991,/media/marda/TWOTB1/xBD/hurricanes/images/florence/hurricane-florence_00000470_pre_disaster.png,57,67,1,355,412,873,940,1034,41.59364110963238,32.59071686258947
10992,/media/marda/TWOTB1/xBD/hurricanes/images/florence/hurricane-florence_00000424_post_disaster.png,65,56,1,849,914,618,674,493,37.65131424079412,17.20795241729779
10993,/media/marda/TWOTB1/xBD/hurricanes/images/florence/hurricane-florence_00000424_post_disaster.png,61,69,1,700,761,812,881,480,45.11794815388455,14.156807508327237
10994,/media/marda/TWOTB1/xBD/hurricanes/images/florence/hurricane-florence_00000424_post_disaster.png,58,82,1,622,680,905,987,589,53.29399439043431,14.687131652709486
10995,/media/marda/TWOTB1/xBD/hurricanes/images/florence/hurricane-florence_00000424_post_disaster.png,40,50,1,726,766,949,999,90,12.65857162026289,9.566586480054102
10996,/media/marda/TWOTB1/xBD/hurricanes/images/florence/hurricane-florence_00000424_post_disaster.png,42,54,1,742,784,989,1043,117,14.273492592362926,11.039719907872655
10997,/media/marda/TWOTB1/xBD/hurricanes/images/florence/hurricane-florence_00000395_post_disaster.png,55,24,1,127,182,1,25,597,56.37727074337616,14.154894179068354
10998,/media/marda/TWOTB1/xBD/hurricanes/images/florence/hurricane-florence_00000395_post_disaster.png,16,15,1,0,16,38,53,165,16.301021410831364,13.742593876517413
10999,/media/marda/TWOTB1/xBD/hurricanes/images/florence/hurricane-florence_00000395_post_disaster.png,74,39,1,814,888,76,115,1156,44.69190505744348,34.2090743809288
11000,/media/marda/TWOTB1/xBD/hurricanes/images/florence/hurricane-florence_00000395_post_disaster.png,96,75,1,602,698,143,218,3696,72.66916525965249,67.75724274756698
11001,/media/marda/TWOTB1/xBD/hurricanes/images/florence/hurricane-florence_00000395_post_disaster.png,52,59,1,145,197,185,244,1605,62.04128481666582,37.18812543266331
11002,/media/marda/TWOTB1/xBD/hurricanes/images/florence/hurricane-florence_00000395_post_disaster.png,70,39,1,806,876,189,228,746,46.415554267508234,23.989584545660563
11003,/media/marda/TWOTB1/xBD/hurricanes/images/florence/hurricane-florence_00000395_post_disaster.png,42,26,1,560,602,193,219,369,22.733955665718057,21.209987454882132
11004,/media/marda/TWOTB1/xBD/hurricanes/images/florence/hurricane-florence_00000395_post_disaster.png,40,21,1,540,580,197,218,248,20.49221560135793,15.990954286666039
11005,/media/marda/TWOTB1/xBD/hurricanes/images/florence/hurricane-florence_00000395_post_disaster.png,55,59,1,330,385,198,257,1341,52.6186495240165,35.45398240182038
11006,/media/marda/TWOTB1/xBD/hurricanes/images/florence/hurricane-florence_00000395_post_disaster.png,64,39,1,896,960,209,248,653,30.46985406103482,28.440283256478867
11007,/media/marda/TWOTB1/xBD/hurricanes/images/florence/hurricane-florence_00000395_post_disaster.png,55,24,1,952,1007,230,254,181,17.748262017343876,13.700591028840982
11008,/media/marda/TWOTB1/xBD/hurricanes/images/florence/hurricane-florence_00000395_post_disaster.png,36,32,1,280,316,242,274,450,27.775723092960092,21.432998021603687
11009,/media/marda/TWOTB1/xBD/hurricanes/images/florence/hurricane-florence_00000395_post_disaster.png,48,30,1,333,381,255,285,514,38.70653418164042,17.516115728342555
11010,/media/marda/TWOTB1/xBD/hurricanes/images/florence/hurricane-florence_00000395_post_disaster.png,27,26,1,11,38,264,290,293,27.420837263677804,14.300737999424683
11011,/media/marda/TWOTB1/xBD/hurricanes/images/florence/hurricane-florence_00000395_post_disaster.png,37,38,1,280,317,265,303,638,31.792752917070132,26.810907799065568
11012,/media/marda/TWOTB1/xBD/hurricanes/images/florence/hurricane-florence_00000395_post_disaster.png,39,51,1,70,109,290,341,1108,42.06250686081947,34.803797039471405
11013,/media/marda/TWOTB1/xBD/hurricanes/images/florence/hurricane-florence_00000395_post_disaster.png,60,60,1,713,773,524,584,904,38.91006412551568,30.412469427868462
11014,/media/marda/TWOTB1/xBD/hurricanes/images/florence/hurricane-florence_00000395_post_disaster.png,63,58,1,672,735,526,584,1095,41.66352443427491,34.87101727848831
11015,/media/marda/TWOTB1/xBD/hurricanes/images/florence/hurricane-florence_00000395_post_disaster.png,61,72,1,746,807,561,633,1246,56.313623509180054,29.537092902068483
11016,/media/marda/TWOTB1/xBD/hurricanes/images/florence/hurricane-florence_00000348_post_disaster.png,33,52,1,20,53,0,52,1382,56.22820322444203,32.39124121125055
11017,/media/marda/TWOTB1/xBD/hurricanes/images/florence/hurricane-florence_00000348_post_disaster.png,94,42,1,947,1041,22,64,1310,54.70123501849123,31.69031655886696
11018,/media/marda/TWOTB1/xBD/hurricanes/images/florence/hurricane-florence_00000348_post_disaster.png,45,23,1,519,564,29,52,415,24.931724345405943,21.935852174936553
11019,/media/marda/TWOTB1/xBD/hurricanes/images/florence/hurricane-florence_00000348_post_disaster.png,31,13,1,555,586,61,74,108,13.226211267664585,11.005304094805908
11020,/media/marda/TWOTB1/xBD/hurricanes/images/florence/hurricane-florence_00000348_post_disaster.png,72,47,1,496,568,98,145,1580,58.73603535534686,36.77914645941301
11021,/media/marda/TWOTB1/xBD/hurricanes/images/florence/hurricane-florence_00000348_post_disaster.png,61,65,1,709,770,189,254,1313,62.27484438353218,29.09045886335479
11022,/media/marda/TWOTB1/xBD/hurricanes/images/florence/hurricane-florence_00000348_post_disaster.png,64,34,1,892,956,268,302,633,31.274266233930145,26.708232790486132
11023,/media/marda/TWOTB1/xBD/hurricanes/images/florence/hurricane-florence_00000348_post_disaster.png,39,33,1,322,361,273,306,331,26.003751276115878,17.00927669208861
11024,/media/marda/TWOTB1/xBD/hurricanes/images/florence/hurricane-florence_00000348_post_disaster.png,22,26,1,125,147,293,319,170,17.79545091570938,12.830612832928749
11025,/media/marda/TWOTB1/xBD/hurricanes/images/florence/hurricane-florence_00000348_post_disaster.png,87,68,1,340,427,293,361,2021,77.24026466726896,36.09855196634888
11026,/media/marda/TWOTB1/xBD/hurricanes/images/florence/hurricane-florence_00000348_post_disaster.png,59,60,1,153,212,300,360,1267,52.46874493237729,33.03760745364678
11027,/media/marda/TWOTB1/xBD/hurricanes/images/florence/hurricane-florence_00000348_post_disaster.png,60,51,1,802,862,390,441,943,42.5955905729983,29.799975044969774
11028,/media/marda/TWOTB1/xBD/hurricanes/images/florence/hurricane-florence_00000348_post_disaster.png,61,42,1,865,926,391,433,611,34.076243112234096,25.529099437024605
11029,/media/marda/TWOTB1/xBD/hurricanes/images/florence/hurricane-florence_00000348_post_disaster.png,62,44,1,968,1030,395,439,533,28.99962089767175,24.250457375741
11030,/media/marda/TWOTB1/xBD/hurricanes/images/florence/hurricane-florence_00000348_post_disaster.png,56,53,1,688,744,404,457,721,35.85302425352085,27.30730052883113
11031,/media/marda/TWOTB1/xBD/hurricanes/images/florence/hurricane-florence_00000348_post_disaster.png,60,40,1,737,797,419,459,702,35.319501429606895,26.232831064806074
11032,/media/marda/TWOTB1/xBD/hurricanes/images/florence/hurricane-florence_00000348_post_disaster.png,55,61,1,617,672,428,489,1005,45.898890497706105,28.77620262930955
11033,/media/marda/TWOTB1/xBD/hurricanes/images/florence/hurricane-florence_00000348_post_disaster.png,17,30,1,139,156,429,459,98,11.824453731990346,11.127777936096674
11034,/media/marda/TWOTB1/xBD/hurricanes/images/florence/hurricane-florence_00000348_post_disaster.png,42,24,1,819,861,433,457,80,11.489125293076057,9.16515138991168
11035,/media/marda/TWOTB1/xBD/hurricanes/images/florence/hurricane-florence_00000348_post_disaster.png,39,45,1,234,273,435,480,467,32.2435916751106,19.16016602750544
11036,/media/marda/TWOTB1/xBD/hurricanes/images/florence/hurricane-florence_00000348_post_disaster.png,65,89,1,266,331,442,531,2009,68.68269217871651,48.440842946268496
11037,/media/marda/TWOTB1/xBD/hurricanes/images/florence/hurricane-florence_00000348_post_disaster.png,31,43,1,125,156,453,496,385,25.476428809959927,20.190498595861083
11038,/media/marda/TWOTB1/xBD/hurricanes/images/florence/hurricane-florence_00000348_post_disaster.png,89,32,1,806,895,454,486,631,63.78424855824149,13.46568843642969
11039,/media/marda/TWOTB1/xBD/hurricanes/images/florence/hurricane-florence_00000348_post_disaster.png,46,43,1,558,604,459,502,374,23.849792414263145,20.94292177635763
11040,/media/marda/TWOTB1/xBD/hurricanes/images/florence/hurricane-florence_00000348_post_disaster.png,60,65,1,496,556,467,532,815,49.46812860184689,28.56290688151769
11041,/media/marda/TWOTB1/xBD/hurricanes/images/florence/hurricane-florence_00000348_post_disaster.png,85,41,1,806,891,476,517,561,58.928609828393625,12.71278970660346
11042,/media/marda/TWOTB1/xBD/hurricanes/images/florence/hurricane-florence_00000348_post_disaster.png,44,26,1,854,898,476,502,94,13.482054406759584,9.433462098423908
11043,/media/marda/TWOTB1/xBD/hurricanes/images/florence/hurricane-florence_00000348_post_disaster.png,40,54,1,180,220,483,537,699,33.75700993188425,27.383100625781484
11044,/media/marda/TWOTB1/xBD/hurricanes/images/florence/hurricane-florence_00000348_post_disaster.png,55,40,1,989,1044,483,523,298,24.589822639665723,16.25705788417449
11045,/media/marda/TWOTB1/xBD/hurricanes/images/florence/hurricane-florence_00000348_post_disaster.png,56,68,1,515,571,511,579,924,50.465965784043675,25.805387986572946
11046,/media/marda/TWOTB1/xBD/hurricanes/images/florence/hurricane-florence_00000348_post_disaster.png,55,60,1,184,239,512,572,1101,47.221602762335344,30.524987833558374
11047,/media/marda/TWOTB1/xBD/hurricanes/images/florence/hurricane-florence_00000348_post_disaster.png,49,50,1,626,675,513,563,720,34.74073654613587,27.611855380711255
11048,/media/marda/TWOTB1/xBD/hurricanes/images/florence/hurricane-florence_00000348_post_disaster.png,58,50,1,856,914,520,570,588,30.611902479583712,25.654955324515875
11049,/media/marda/TWOTB1/xBD/hurricanes/images/florence/hurricane-florence_00000348_post_disaster.png,53,56,1,409,462,521,577,673,39.72431168981196,22.383508521420524
11050,/media/marda/TWOTB1/xBD/hurricanes/images/florence/hurricane-florence_00000348_post_disaster.png,50,31,1,910,960,521,552,104,14.623058444740824,9.637461219798197
11051,/media/marda/TWOTB1/xBD/hurricanes/images/florence/hurricane-florence_00000348_post_disaster.png,57,36,1,881,938,530,566,290,25.659572146747358,15.147555123233067
11052,/media/marda/TWOTB1/xBD/hurricanes/images/florence/hurricane-florence_00000348_post_disaster.png,46,34,1,998,1044,541,575,72,15.211449542427133,6.3649852620485055
11053,/media/marda/TWOTB1/xBD/hurricanes/images/florence/hurricane-florence_00000348_post_disaster.png,30,32,1,576,606,550,582,120,13.808210118138652,11.489125293076057
11054,/media/marda/TWOTB1/xBD/hurricanes/images/florence/hurricane-florence_00000348_post_disaster.png,29,33,1,430,459,561,594,85,11.236294413237108,10.209735463746327
11055,/media/marda/TWOTB1/xBD/hurricanes/images/florence/hurricane-florence_00000348_post_disaster.png,43,55,1,106,149,570,625,681,35.4837093452227,25.61746930768522
11056,/media/marda/TWOTB1/xBD/hurricanes/images/florence/hurricane-florence_00000348_post_disaster.png,56,68,1,327,383,570,638,1215,43.95342437027613,36.34128849428283
11057,/media/marda/TWOTB1/xBD/hurricanes/images/florence/hurricane-florence_00000348_post_disaster.png,46,39,1,438,484,570,609,305,35.51732243394795,13.944451960339906
11058,/media/marda/TWOTB1/xBD/hurricanes/images/florence/hurricane-florence_00000348_post_disaster.png,45,50,1,530,575,574,624,641,34.131876525499905,24.951663241046834
11059,/media/marda/TWOTB1/xBD/hurricanes/images/florence/hurricane-florence_00000348_post_disaster.png,39,56,1,447,486,590,646,699,35.832514924158296,26.016283996720638
11060,/media/marda/TWOTB1/xBD/hurricanes/images/florence/hurricane-florence_00000348_post_disaster.png,40,41,1,558,598,604,645,313,22.5895101732457,18.332539476992288
11061,/media/marda/TWOTB1/xBD/hurricanes/images/florence/hurricane-florence_00000348_post_disaster.png,35,103,1,0,35,627,730,1997,89.84302912875667,33.33239744505222
11062,/media/marda/TWOTB1/xBD/hurricanes/images/florence/hurricane-florence_00000348_post_disaster.png,34,48,1,342,376,628,676,300,21.259953581464977,18.87729195334257
11063,/media/marda/TWOTB1/xBD/hurricanes/images/florence/hurricane-florence_00000348_post_disaster.png,45,60,1,536,581,631,691,814,39.462055678350204,27.312626250962378
11064,/media/marda/TWOTB1/xBD/hurricanes/images/florence/hurricane-florence_00000348_post_disaster.png,76,41,1,631,707,631,672,572,59.27837421997887,12.888068973438813
11065,/media/marda/TWOTB1/xBD/hurricanes/images/florence/hurricane-florence_00000348_post_disaster.png,45,71,1,444,489,646,717,1095,52.26304474023521,28.446980001985594
11066,/media/marda/TWOTB1/xBD/hurricanes/images/florence/hurricane-florence_00000348_post_disaster.png,44,44,1,742,786,657,701,194,19.815239087731502,13.148462765354509
11067,/media/marda/TWOTB1/xBD/hurricanes/images/florence/hurricane-florence_00000348_post_disaster.png,47,63,1,771,818,661,724,483,42.62584903667602,15.148800681955192
11068,/media/marda/TWOTB1/xBD/hurricanes/images/florence/hurricane-florence_00000348_post_disaster.png,25,45,1,60,85,665,710,296,21.527836124167788,18.189084978401663
11069,/media/marda/TWOTB1/xBD/hurricanes/images/florence/hurricane-florence_00000348_post_disaster.png,38,77,1,363,401,665,742,1249,60.07355915077332,27.75697032594268
11070,/media/marda/TWOTB1/xBD/hurricanes/images/florence/hurricane-florence_00000348_post_disaster.png,40,39,1,565,605,677,716,269,22.482319453674254,15.8550919431563
11071,/media/marda/TWOTB1/xBD/hurricanes/images/florence/hurricane-florence_00000348_post_disaster.png,57,77,1,178,235,681,758,1379,50.02193414247906,40.39437291545943
11072,/media/marda/TWOTB1/xBD/hurricanes/images/florence/hurricane-florence_00000348_post_disaster.png,52,71,1,634,686,692,763,704,44.53903227280632,24.538689447925954
11073,/media/marda/TWOTB1/xBD/hurricanes/images/florence/hurricane-florence_00000348_post_disaster.png,49,66,1,541,590,700,766,895,44.22288812646372,28.404075936721927
11074,/media/marda/TWOTB1/xBD/hurricanes/images/florence/hurricane-florence_00000348_post_disaster.png,55,48,1,680,735,705,753,336,30.063926820398372,14.940144684217431
11075,/media/marda/TWOTB1/xBD/hurricanes/images/florence/hurricane-florence_00000348_post_disaster.png,39,67,1,453,492,711,778,817,42.83864213403642,25.45976388973908
11076,/media/marda/TWOTB1/xBD/hurricanes/images/florence/hurricane-florence_00000348_post_disaster.png,51,75,1,365,416,738,813,1276,48.881125122181444,38.549306178129754
11077,/media/marda/TWOTB1/xBD/hurricanes/images/florence/hurricane-florence_00000348_post_disaster.png,33,67,1,455,488,762,829,572,44.02431111118195,17.338852754515337
11078,/media/marda/TWOTB1/xBD/hurricanes/images/florence/hurricane-florence_00000348_post_disaster.png,44,56,1,540,584,763,819,597,31.507379378057248,25.180329483306082
11079,/media/marda/TWOTB1/xBD/hurricanes/images/florence/hurricane-florence_00000348_post_disaster.png,53,66,1,241,294,772,838,1264,51.73830875775841,34.10871467794403
11080,/media/marda/TWOTB1/xBD/hurricanes/images/florence/hurricane-florence_00000348_post_disaster.png,47,81,1,55,102,781,862,1309,48.95997740350739,37.47707274119167
11081,/media/marda/TWOTB1/xBD/hurricanes/images/florence/hurricane-florence_00000348_post_disaster.png,55,56,1,634,689,785,841,782,34.94773934735613,29.508252464003533
11082,/media/marda/TWOTB1/xBD/hurricanes/images/florence/hurricane-florence_00000348_post_disaster.png,59,55,1,439,498,813,868,918,48.226578116502324,25.272752281671725
11083,/media/marda/TWOTB1/xBD/hurricanes/images/florence/hurricane-florence_00000348_post_disaster.png,35,51,1,238,273,815,866,503,30.592950346055574,21.898823949544433
11084,/media/marda/TWOTB1/xBD/hurricanes/images/florence/hurricane-florence_00000348_post_disaster.png,40,67,1,0,40,830,897,824,36.17782668183325,29.948999464071623
11085,/media/marda/TWOTB1/xBD/hurricanes/images/florence/hurricane-florence_00000348_post_disaster.png,34,66,1,92,126,840,906,545,32.25550308671372,22.566062202560815
11086,/media/marda/TWOTB1/xBD/hurricanes/images/florence/hurricane-florence_00000348_post_disaster.png,32,70,1,267,299,849,919,912,43.86342439892262,27.688746209726915
11087,/media/marda/TWOTB1/xBD/hurricanes/images/florence/hurricane-florence_00000348_post_disaster.png,43,51,1,571,614,851,902,209,22.01815858867432,12.460926263486488
11088,/media/marda/TWOTB1/xBD/hurricanes/images/florence/hurricane-florence_00000348_post_disaster.png,18,48,1,33,51,873,921,145,16.39585956659624,11.864897347741975
11089,/media/marda/TWOTB1/xBD/hurricanes/images/florence/hurricane-florence_00000348_post_disaster.png,42,68,1,62,104,878,946,1014,44.961662724469214,31.610807671248974
11090,/media/marda/TWOTB1/xBD/hurricanes/images/florence/hurricane-florence_00000348_post_disaster.png,53,85,1,429,482,902,987,1385,52.773232774327305,35.471089421310786
11091,/media/marda/TWOTB1/xBD/hurricanes/images/florence/hurricane-florence_00000348_post_disaster.png,27,52,1,29,56,903,955,373,30.74795186362586,16.22688945580455
11092,/media/marda/TWOTB1/xBD/hurricanes/images/florence/hurricane-florence_00000348_post_disaster.png,7,48,1,0,7,904,952,50,11.134002490572739,6.367573206482988
11093,/media/marda/TWOTB1/xBD/hurricanes/images/florence/hurricane-florence_00000348_post_disaster.png,14,49,1,13,27,907,956,97,13.012735514599916,10.065963406717616
11094,/media/marda/TWOTB1/xBD/hurricanes/images/florence/hurricane-florence_00000348_post_disaster.png,52,67,1,377,429,908,975,842,42.306719633314664,26.420289170613184
11095,/media/marda/TWOTB1/xBD/hurricanes/images/florence/hurricane-florence_00000348_post_disaster.png,36,64,1,56,92,917,981,902,39.331177837549106,30.426232343573602
11096,/media/marda/TWOTB1/xBD/hurricanes/images/florence/hurricane-florence_00000348_post_disaster.png,31,48,1,481,512,923,971,144,15.055363438919823,12.75201197850026
11097,/media/marda/TWOTB1/xBD/hurricanes/images/florence/hurricane-florence_00000348_post_disaster.png,24,57,1,27,51,926,983,476,26.264977589830856,23.960190240201214
11098,/media/marda/TWOTB1/xBD/hurricanes/images/florence/hurricane-florence_00000348_post_disaster.png,16,54,1,4,20,930,984,145,17.852449251196578,10.888175352697823
11099,/media/marda/TWOTB1/xBD/hurricanes/images/florence/hurricane-florence_00000348_post_disaster.png,69,56,1,648,717,939,995,724,46.54848455801176,20.41643115964439
11100,/media/marda/TWOTB1/xBD/hurricanes/images/florence/hurricane-florence_00000348_post_disaster.png,30,79,1,155,185,947,1026,892,45.42619544827298,26.215716651106565
11101,/media/marda/TWOTB1/xBD/hurricanes/images/florence/hurricane-florence_00000348_post_disaster.png,38,75,1,60,98,956,1031,1390,43.52668216014324,42.61445149451917
11102,/media/marda/TWOTB1/xBD/hurricanes/images/florence/hurricane-florence_00000348_post_disaster.png,79,82,1,510,589,907,989,1128,64.90135212091312,23.195548783563712
11103,/media/marda/TWOTB1/xBD/hurricanes/images/florence/hurricane-florence_00000154_post_disaster.png,54,25,1,944,998,454,479,109,19.498058465864748,7.702999089811469
11104,/media/marda/TWOTB1/xBD/hurricanes/images/florence/hurricane-florence_00000103_post_disaster.png,54,37,1,384,438,100,137,1045,42.66481727622366,32.45627662023398
11105,/media/marda/TWOTB1/xBD/hurricanes/images/florence/hurricane-florence_00000103_post_disaster.png,35,19,1,347,382,113,132,284,25.325920452152708,14.713600393117945
11106,/media/marda/TWOTB1/xBD/hurricanes/images/florence/hurricane-florence_00000103_post_disaster.png,245,312,1,798,1043,138,450,29913,347.8658131352864,122.09185777729455
11107,/media/marda/TWOTB1/xBD/hurricanes/images/florence/hurricane-florence_00000103_post_disaster.png,36,27,1,295,331,143,170,427,24.64540669985407,22.900692006919382
11108,/media/marda/TWOTB1/xBD/hurricanes/images/florence/hurricane-florence_00000103_post_disaster.png,41,39,1,355,396,150,189,774,37.759751699421486,27.32388841172862
11109,/media/marda/TWOTB1/xBD/hurricanes/images/florence/hurricane-florence_00000103_post_disaster.png,29,21,1,104,133,214,235,259,26.676187250496998,12.839030993269827
11110,/media/marda/TWOTB1/xBD/hurricanes/images/florence/hurricane-florence_00000103_post_disaster.png,123,117,1,626,749,224,341,5746,113.77584664362675,67.07028035960253
11111,/media/marda/TWOTB1/xBD/hurricanes/images/florence/hurricane-florence_00000103_post_disaster.png,49,42,1,89,138,232,274,1259,51.51094060214409,32.53869322631981
11112,/media/marda/TWOTB1/xBD/hurricanes/images/florence/hurricane-florence_00000103_post_disaster.png,21,19,1,175,196,245,264,143,18.67197603603715,10.097663952191345
11113,/media/marda/TWOTB1/xBD/hurricanes/images/florence/hurricane-florence_00000103_post_disaster.png,71,38,1,252,323,261,299,1196,67.77976847418253,23.551347384575763
11114,/media/marda/TWOTB1/xBD/hurricanes/images/florence/hurricane-florence_00000103_post_disaster.png,46,39,1,164,210,264,303,880,40.42848618511728,30.355912610224983
11115,/media/marda/TWOTB1/xBD/hurricanes/images/florence/hurricane-florence_00000103_post_disaster.png,44,41,1,453,497,281,322,656,33.18919560460779,26.067243851618404
11116,/media/marda/TWOTB1/xBD/hurricanes/images/florence/hurricane-florence_00000103_post_disaster.png,34,52,1,362,396,300,352,494,44.97607785993902,14.520356793176152
11117,/media/marda/TWOTB1/xBD/hurricanes/images/florence/hurricane-florence_00000103_post_disaster.png,13,35,1,0,13,302,337,227,23.4208162912688,13.102502660792487
11118,/media/marda/TWOTB1/xBD/hurricanes/images/florence/hurricane-florence_00000103_post_disaster.png,26,46,1,39,65,302,348,647,37.33677388660972,22.944161062579656
11119,/media/marda/TWOTB1/xBD/hurricanes/images/florence/hurricane-florence_00000103_post_disaster.png,38,42,1,446,484,339,381,530,30.59103491167466,22.97385120078212
11120,/media/marda/TWOTB1/xBD/hurricanes/images/florence/hurricane-florence_00000103_post_disaster.png,61,46,1,234,295,369,415,1155,55.80535164171138,27.470868053326434
11121,/media/marda/TWOTB1/xBD/hurricanes/images/florence/hurricane-florence_00000103_post_disaster.png,73,54,1,306,379,377,431,1769,63.2694795598716,36.91690090302253
11122,/media/marda/TWOTB1/xBD/hurricanes/images/florence/hurricane-florence_00000103_post_disaster.png,38,41,1,436,474,381,422,513,31.005206282664126,21.99770889434823
11123,/media/marda/TWOTB1/xBD/hurricanes/images/florence/hurricane-florence_00000103_post_disaster.png,27,36,1,268,295,401,437,222,17.57588203651483,16.937080252980827
11124,/media/marda/TWOTB1/xBD/hurricanes/images/florence/hurricane-florence_00000103_post_disaster.png,42,54,1,429,471,420,474,710,39.604001521060724,23.91151745853637
11125,/media/marda/TWOTB1/xBD/hurricanes/images/florence/hurricane-florence_00000103_post_disaster.png,47,53,1,0,47,428,481,1110,53.81391447270668,29.204263996044087
11126,/media/marda/TWOTB1/xBD/hurricanes/images/florence/hurricane-florence_00000103_post_disaster.png,46,44,1,324,370,440,484,662,34.83479844127209,25.60682378970055
11127,/media/marda/TWOTB1/xBD/hurricanes/images/florence/hurricane-florence_00000103_post_disaster.png,25,40,1,67,92,441,481,460,26.193311457551992,23.491571913257072
11128,/media/marda/TWOTB1/xBD/hurricanes/images/florence/hurricane-florence_00000103_post_disaster.png,93,60,1,93,186,445,505,2023,99.6698668102189,27.907506592512366
11129,/media/marda/TWOTB1/xBD/hurricanes/images/florence/hurricane-florence_00000103_post_disaster.png,114,162,1,521,635,445,607,5203,164.3461278819057,69.40530071403116
11130,/media/marda/TWOTB1/xBD/hurricanes/images/florence/hurricane-florence_00000103_post_disaster.png,62,53,1,981,1043,461,514,467,34.01329733451169,19.422540503304266
11131,/media/marda/TWOTB1/xBD/hurricanes/images/florence/hurricane-florence_00000103_post_disaster.png,59,49,1,420,479,471,520,885,44.3333087371345,27.19620629245917
11132,/media/marda/TWOTB1/xBD/hurricanes/images/florence/hurricane-florence_00000103_post_disaster.png,40,94,1,180,220,480,574,1682,86.37372753173355,26.758357416116358
11133,/media/marda/TWOTB1/xBD/hurricanes/images/florence/hurricane-florence_00000103_post_disaster.png,28,28,1,471,499,481,509,127,13.436815602821452,12.671532688956072
11134,/media/marda/TWOTB1/xBD/hurricanes/images/florence/hurricane-florence_00000103_post_disaster.png,84,61,1,27,111,509,570,1912,92.20853454055919,28.25804228732041
11135,/media/marda/TWOTB1/xBD/hurricanes/images/florence/hurricane-florence_00000103_post_disaster.png,43,63,1,413,456,521,584,792,44.825375580517075,23.607167791591856
11136,/media/marda/TWOTB1/xBD/hurricanes/images/florence/hurricane-florence_00000103_post_disaster.png,43,97,1,0,43,541,638,1857,82.1976058408365,30.379837990291573
11137,/media/marda/TWOTB1/xBD/hurricanes/images/florence/hurricane-florence_00000103_post_disaster.png,30,31,1,458,488,548,579,120,15.388075147362175,10.482070879640208
11138,/media/marda/TWOTB1/xBD/hurricanes/images/florence/hurricane-florence_00000103_post_disaster.png,82,57,1,113,195,554,611,1893,86.2242409841718,29.821417078373486
11139,/media/marda/TWOTB1/xBD/hurricanes/images/florence/hurricane-florence_00000103_post_disaster.png,96,85,1,882,978,563,648,1968,71.28377497929166,36.12928654855386
11140,/media/marda/TWOTB1/xBD/hurricanes/images/florence/hurricane-florence_00000103_post_disaster.png,49,53,1,402,451,571,624,785,33.75515439371219,30.8336943935749
11141,/media/marda/TWOTB1/xBD/hurricanes/images/florence/hurricane-florence_00000103_post_disaster.png,43,43,1,561,604,577,620,265,19.605892793560933,18.091331035007677
11142,/media/marda/TWOTB1/xBD/hurricanes/images/florence/hurricane-florence_00000103_post_disaster.png,98,95,1,611,709,597,692,2110,84.09958428351752,38.38078899797153
11143,/media/marda/TWOTB1/xBD/hurricanes/images/florence/hurricane-florence_00000103_post_disaster.png,37,39,1,548,585,618,657,126,13.917232623667957,12.16137103687514
11144,/media/marda/TWOTB1/xBD/hurricanes/images/florence/hurricane-florence_00000103_post_disaster.png,47,50,1,581,628,623,673,350,21.843882061827593,21.33484301964859
11145,/media/marda/TWOTB1/xBD/hurricanes/images/florence/hurricane-florence_00000103_post_disaster.png,85,103,1,408,493,630,733,3025,89.24089472700801,54.227224782256926
11146,/media/marda/TWOTB1/xBD/hurricanes/images/florence/hurricane-florence_00000103_post_disaster.png,36,39,1,516,552,640,679,119,13.706185177375373,11.654542592206512
11147,/media/marda/TWOTB1/xBD/hurricanes/images/florence/hurricane-florence_00000103_post_disaster.png,64,74,1,544,608,686,760,935,48.20827234378287,25.8616800147302
11148,/media/marda/TWOTB1/xBD/hurricanes/images/florence/hurricane-florence_00000103_post_disaster.png,59,70,1,984,1043,714,784,626,44.513939853058794,19.023938462074256
11149,/media/marda/TWOTB1/xBD/hurricanes/images/florence/hurricane-florence_00000103_post_disaster.png,118,113,1,703,821,730,843,3867,72.16168230684332,71.28338511942077
11150,/media/marda/TWOTB1/xBD/hurricanes/images/florence/hurricane-florence_00000103_post_disaster.png,96,91,1,689,785,857,948,1880,69.60765804398973,36.76899143474705
11151,/media/marda/TWOTB1/xBD/hurricanes/images/florence/hurricane-florence_00000103_post_disaster.png,94,97,1,871,965,867,964,1416,78.11081647544533,24.18798453556057
11152,/media/marda/TWOTB1/xBD/hurricanes/images/florence/hurricane-florence_00000103_post_disaster.png,43,78,1,360,403,886,964,935,43.346352436647535,29.320129618555164
11153,/media/marda/TWOTB1/xBD/hurricanes/images/florence/hurricane-florence_00000103_post_disaster.png,72,74,1,855,927,918,992,477,48.807094570066795,13.769121816875998
11154,/media/marda/TWOTB1/xBD/hurricanes/images/florence/hurricane-florence_00000103_post_disaster.png,59,62,1,821,880,950,1012,358,24.19401079409812,19.760988410383828
11155,/media/marda/TWOTB1/xBD/hurricanes/images/florence/hurricane-florence_00000103_post_disaster.png,124,90,1,900,1024,951,1041,2539,79.17001815922696,47.79762073097341
11156,/media/marda/TWOTB1/xBD/hurricanes/images/florence/hurricane-florence_00000103_post_disaster.png,40,77,1,347,387,952,1029,814,42.3561287266664,25.67444317816335
11157,/media/marda/TWOTB1/xBD/hurricanes/images/florence/hurricane-florence_00000103_post_disaster.png,63,67,1,864,927,974,1041,259,42.01781511316447,8.255694879940723
11158,/media/marda/TWOTB1/xBD/hurricanes/images/florence/hurricane-florence_00000103_post_disaster.png,42,65,1,152,194,976,1041,719,39.32677260569058,26.984016940818048
11159,/media/marda/TWOTB1/xBD/hurricanes/images/florence/hurricane-florence_00000103_post_disaster.png,64,61,1,569,633,980,1041,566,36.257004127043736,22.629399956266766
11160,/media/marda/TWOTB1/xBD/hurricanes/images/florence/hurricane-florence_00000230_post_disaster.png,29,10,1,294,323,0,10,113,16.448257307668243,9.378997804010545
11161,/media/marda/TWOTB1/xBD/hurricanes/images/florence/hurricane-florence_00000230_post_disaster.png,94,49,1,830,924,0,49,1606,52.86341036860413,40.34589601565213
11162,/media/marda/TWOTB1/xBD/hurricanes/images/florence/hurricane-florence_00000230_post_disaster.png,59,27,1,785,844,8,35,370,27.52020505621466,17.777460705484465
11163,/media/marda/TWOTB1/xBD/hurricanes/images/florence/hurricane-florence_00000230_post_disaster.png,63,31,1,754,817,24,55,555,31.705691013754503,23.18072303855217
11164,/media/marda/TWOTB1/xBD/hurricanes/images/florence/hurricane-florence_00000230_post_disaster.png,39,44,1,308,347,28,72,618,47.80809133455072,17.189600626078946
11165,/media/marda/TWOTB1/xBD/hurricanes/images/florence/hurricane-florence_00000230_post_disaster.png,102,62,1,737,839,59,121,1956,79.68182218783822,32.59859577128824
11166,/media/marda/TWOTB1/xBD/hurricanes/images/florence/hurricane-florence_00000230_post_disaster.png,52,24,1,665,717,69,93,284,26.733521230358097,14.205063524381922
11167,/media/marda/TWOTB1/xBD/hurricanes/images/florence/hurricane-florence_00000230_post_disaster.png,74,58,1,579,653,86,144,1291,63.036466996883206,34.94823687344096
11168,/media/marda/TWOTB1/xBD/hurricanes/images/florence/hurricane-florence_00000230_post_disaster.png,57,36,1,645,702,112,148,541,33.28515754048099,23.380507008154165
11169,/media/marda/TWOTB1/xBD/hurricanes/images/florence/hurricane-florence_00000230_post_disaster.png,82,65,1,433,515,150,215,1437,80.50877310327851,24.276831461729504
11170,/media/marda/TWOTB1/xBD/hurricanes/images/florence/hurricane-florence_00000230_post_disaster.png,45,20,1,692,737,154,174,159,15.628497918076102,13.369780914795284
11171,/media/marda/TWOTB1/xBD/hurricanes/images/florence/hurricane-florence_00000230_post_disaster.png,89,70,1,633,722,156,226,1968,68.85403081441524,37.90412831017282
11172,/media/marda/TWOTB1/xBD/hurricanes/images/florence/hurricane-florence_00000230_post_disaster.png,70,63,1,591,661,199,262,1256,58.11012573566989,28.15280287977731
11173,/media/marda/TWOTB1/xBD/hurricanes/images/florence/hurricane-florence_00000230_post_disaster.png,59,46,1,502,561,216,262,920,36.87069506855041,33.02539654276061
11174,/media/marda/TWOTB1/xBD/hurricanes/images/florence/hurricane-florence_00000230_post_disaster.png,46,21,1,848,894,224,245,91,11.870224183311464,10.324178445840506
11175,/media/marda/TWOTB1/xBD/hurricanes/images/florence/hurricane-florence_00000230_post_disaster.png,51,35,1,831,882,269,304,329,30.85806635337849,15.034045164282716
11176,/media/marda/TWOTB1/xBD/hurricanes/images/florence/hurricane-florence_00000230_post_disaster.png,40,27,1,494,534,275,302,208,18.01621424524283,15.119738187197264
11177,/media/marda/TWOTB1/xBD/hurricanes/images/florence/hurricane-florence_00000230_post_disaster.png,80,53,1,488,568,294,347,1176,58.04977558508438,31.502086098468258
11178,/media/marda/TWOTB1/xBD/hurricanes/images/florence/hurricane-florence_00000230_post_disaster.png,75,48,1,621,696,326,374,905,52.29504139990996,27.777964417348894
11179,/media/marda/TWOTB1/xBD/hurricanes/images/florence/hurricane-florence_00000230_post_disaster.png,66,47,1,569,635,348,395,892,43.51310823057217,27.137575745724146
11180,/media/marda/TWOTB1/xBD/hurricanes/images/florence/hurricane-florence_00000230_post_disaster.png,90,105,1,705,795,403,508,2269,104.68466512865417,36.518991768903014
11181,/media/marda/TWOTB1/xBD/hurricanes/images/florence/hurricane-florence_00000230_post_disaster.png,72,57,1,620,692,414,471,1216,48.10376125440424,34.96246268200759
11182,/media/marda/TWOTB1/xBD/hurricanes/images/florence/hurricane-florence_00000230_post_disaster.png,30,30,1,159,189,441,471,269,28.55516186833057,12.521195636168807
11183,/media/marda/TWOTB1/xBD/hurricanes/images/florence/hurricane-florence_00000230_post_disaster.png,46,63,1,278,324,441,504,868,45.9366600597693,27.901011229408773
11184,/media/marda/TWOTB1/xBD/hurricanes/images/florence/hurricane-florence_00000230_post_disaster.png,17,25,1,161,178,459,484,87,14.283701543962087,8.211220741466162
11185,/media/marda/TWOTB1/xBD/hurricanes/images/florence/hurricane-florence_00000230_post_disaster.png,37,39,1,208,245,468,507,461,29.93547619805757,20.135968447459312
11186,/media/marda/TWOTB1/xBD/hurricanes/images/florence/hurricane-florence_00000230_post_disaster.png,26,43,1,111,137,471,514,461,27.28156327096278,22.18218043998926
11187,/media/marda/TWOTB1/xBD/hurricanes/images/florence/hurricane-florence_00000230_post_disaster.png,51,37,1,644,695,473,510,325,28.00745285869146,15.526061914386357
11188,/media/marda/TWOTB1/xBD/hurricanes/images/florence/hurricane-florence_00000230_post_disaster.png,64,44,1,145,209,474,518,1018,64.18621625023889,21.471980434631437
11189,/media/marda/TWOTB1/xBD/hurricanes/images/florence/hurricane-florence_00000230_post_disaster.png,31,59,1,84,115,497,556,871,42.09280286003973,27.385844177615144
11190,/media/marda/TWOTB1/xBD/hurricanes/images/florence/hurricane-florence_00000230_post_disaster.png,35,38,1,496,531,506,544,166,17.90105903349425,12.492658996177889
11191,/media/marda/TWOTB1/xBD/hurricanes/images/florence/hurricane-florence_00000230_post_disaster.png,95,69,1,426,521,508,577,2058,85.5674521304959,32.4487276189557
11192,/media/marda/TWOTB1/xBD/hurricanes/images/florence/hurricane-florence_00000230_post_disaster.png,73,61,1,265,338,529,590,1580,68.36470593821159,30.342340881085804
11193,/media/marda/TWOTB1/xBD/hurricanes/images/florence/hurricane-florence_00000230_post_disaster.png,63,54,1,436,499,548,602,1069,49.52100547538117,28.11791503000337
11194,/media/marda/TWOTB1/xBD/hurricanes/images/florence/hurricane-florence_00000230_post_disaster.png,57,57,1,203,260,553,610,1071,54.22024770299353,27.3769300206838
11195,/media/marda/TWOTB1/xBD/hurricanes/images/florence/hurricane-florence_00000230_post_disaster.png,74,89,1,273,347,556,645,2802,64.55543211518192,59.70637882479753
11196,/media/marda/TWOTB1/xBD/hurricanes/images/florence/hurricane-florence_00000230_post_disaster.png,117,128,1,752,869,593,721,3970,107.75796443442877,60.26006346133256
11197,/media/marda/TWOTB1/xBD/hurricanes/images/florence/hurricane-florence_00000230_post_disaster.png,93,65,1,446,539,596,661,1820,76.6763109477082,34.15262933961155
11198,/media/marda/TWOTB1/xBD/hurricanes/images/florence/hurricane-florence_00000230_post_disaster.png,49,56,1,298,347,619,675,730,35.00976091812299,27.4313128684651
11199,/media/marda/TWOTB1/xBD/hurricanes/images/florence/hurricane-florence_00000230_post_disaster.png,57,72,1,326,383,637,709,991,57.74585866769263,25.692952399283904
11200,/media/marda/TWOTB1/xBD/hurricanes/images/florence/hurricane-florence_00000230_post_disaster.png,59,92,1,380,439,646,738,1693,74.81623784366957,30.10310621840029
11201,/media/marda/TWOTB1/xBD/hurricanes/images/florence/hurricane-florence_00000230_post_disaster.png,84,127,1,677,761,652,779,3126,103.16107230527497,42.77585854444556
11202,/media/marda/TWOTB1/xBD/hurricanes/images/florence/hurricane-florence_00000230_post_disaster.png,35,54,1,305,340,661,715,392,28.757555310637695,18.433565250404254
11203,/media/marda/TWOTB1/xBD/hurricanes/images/florence/hurricane-florence_00000230_post_disaster.png,84,80,1,485,569,684,764,2515,66.3955917028803,50.91005696001082
11204,/media/marda/TWOTB1/xBD/hurricanes/images/florence/hurricane-florence_00000230_post_disaster.png,59,45,1,984,1043,693,738,214,18.119577966195624,15.723988857390166
11205,/media/marda/TWOTB1/xBD/hurricanes/images/florence/hurricane-florence_00000230_post_disaster.png,69,66,1,931,1000,707,773,745,38.095727985956415,25.807718607485377
11206,/media/marda/TWOTB1/xBD/hurricanes/images/florence/hurricane-florence_00000230_post_disaster.png,74,71,1,795,869,774,845,1239,42.54870078729756,38.98402741831538
11207,/media/marda/TWOTB1/xBD/hurricanes/images/florence/hurricane-florence_00000230_post_disaster.png,48,63,1,22,70,785,848,936,49.98626942958844,24.988917401901368
11208,/media/marda/TWOTB1/xBD/hurricanes/images/florence/hurricane-florence_00000230_post_disaster.png,62,76,1,982,1044,794,870,512,38.02407308278404,20.148675429570847
11209,/media/marda/TWOTB1/xBD/hurricanes/images/florence/hurricane-florence_00000230_post_disaster.png,65,58,1,360,425,805,863,672,57.238153123757606,15.683886736767555
11210,/media/marda/TWOTB1/xBD/hurricanes/images/florence/hurricane-florence_00000230_post_disaster.png,75,73,1,381,456,850,923,1627,61.72079518977029,34.61572669281755
11211,/media/marda/TWOTB1/xBD/hurricanes/images/florence/hurricane-florence_00000230_post_disaster.png,30,51,1,440,470,894,945,123,13.453337017993492,12.298896788616576
11212,/media/marda/TWOTB1/xBD/hurricanes/images/florence/hurricane-florence_00000230_post_disaster.png,77,82,1,566,643,913,995,1518,54.66494120647433,37.17502744970908
11213,/media/marda/TWOTB1/xBD/hurricanes/images/florence/hurricane-florence_00000230_post_disaster.png,47,57,1,614,661,946,1003,287,21.91350349500884,17.565222473183297
11214,/media/marda/TWOTB1/xBD/hurricanes/images/florence/hurricane-florence_00000230_post_disaster.png,46,50,1,998,1044,986,1036,32,8.66677295088283,5.72790726337689
11215,/media/marda/TWOTB1/xBD/hurricanes/images/florence/hurricane-florence_00000333_post_disaster.png,94,51,1,942,1036,170,221,1308,54.83725205121367,31.70800221741335
11216,/media/marda/TWOTB1/xBD/hurricanes/images/florence/hurricane-florence_00000421_pre_disaster.png,107,44,1,408,515,55,99,2581,98.29684239917509,34.870935312264166
11217,/media/marda/TWOTB1/xBD/hurricanes/images/florence/hurricane-florence_00000421_pre_disaster.png,170,42,1,789,959,78,120,3759,153.45383148641915,32.72357083098303
11218,/media/marda/TWOTB1/xBD/hurricanes/images/florence/hurricane-florence_00000421_pre_disaster.png,104,49,1,395,499,130,179,2635,98.03005929906071,35.68541284676709
11219,/media/marda/TWOTB1/xBD/hurricanes/images/florence/hurricane-florence_00000421_pre_disaster.png,128,75,1,363,491,158,233,3539,136.14590549024817,42.121867775639714
11220,/media/marda/TWOTB1/xBD/hurricanes/images/florence/hurricane-florence_00000421_pre_disaster.png,56,59,1,527,583,195,254,1825,60.24969265007197,40.27350569681469
11221,/media/marda/TWOTB1/xBD/hurricanes/images/florence/hurricane-florence_00000421_pre_disaster.png,122,58,1,377,499,238,296,3067,122.46108043346696,33.4088249282876
11222,/media/marda/TWOTB1/xBD/hurricanes/images/florence/hurricane-florence_00000421_pre_disaster.png,31,18,1,600,631,312,330,37,7.424365877053523,6.36617392414642
11223,/media/marda/TWOTB1/xBD/hurricanes/images/florence/hurricane-florence_00000421_pre_disaster.png,33,22,1,601,634,325,347,69,9.957750617574623,8.969720678405217
11224,/media/marda/TWOTB1/xBD/hurricanes/images/florence/hurricane-florence_00000421_pre_disaster.png,34,21,1,611,645,325,346,74,10.355589381103238,9.154100781578054
11225,/media/marda/TWOTB1/xBD/hurricanes/images/florence/hurricane-florence_00000421_pre_disaster.png,63,78,1,681,744,348,426,1893,70.15001005870242,36.102095071017004
11226,/media/marda/TWOTB1/xBD/hurricanes/images/florence/hurricane-florence_00000421_pre_disaster.png,99,76,1,435,534,378,454,2696,92.82683980522324,42.44441840282924
11227,/media/marda/TWOTB1/xBD/hurricanes/images/florence/hurricane-florence_00000421_pre_disaster.png,135,91,1,424,559,422,513,3591,141.04368428306796,39.67285858153395
11228,/media/marda/TWOTB1/xBD/hurricanes/images/florence/hurricane-florence_00000421_pre_disaster.png,107,72,1,631,738,447,519,3208,82.61017580239401,52.95249768012126
11229,/media/marda/TWOTB1/xBD/hurricanes/images/florence/hurricane-florence_00000421_pre_disaster.png,93,68,1,426,519,468,536,2351,80.09862682423258,40.109719846410414
11230,/media/marda/TWOTB1/xBD/hurricanes/images/florence/hurricane-florence_00000421_pre_disaster.png,50,50,1,568,618,491,541,645,32.6674498474757,27.072931461974754
11231,/media/marda/TWOTB1/xBD/hurricanes/images/florence/hurricane-florence_00000421_pre_disaster.png,63,46,1,507,570,495,541,857,45.91589095332728,24.720247816318757
11232,/media/marda/TWOTB1/xBD/hurricanes/images/florence/hurricane-florence_00000421_pre_disaster.png,40,36,1,508,548,535,571,253,22.237057046041247,15.132714685281462
11233,/media/marda/TWOTB1/xBD/hurricanes/images/florence/hurricane-florence_00000421_pre_disaster.png,96,87,1,491,587,624,711,2662,78.74896199043886,45.157396726349745
11234,/media/marda/TWOTB1/xBD/hurricanes/images/florence/hurricane-florence_00000421_pre_disaster.png,69,89,1,568,637,644,733,2534,71.06573500628635,47.44449311203083
11235,/media/marda/TWOTB1/xBD/hurricanes/images/florence/hurricane-florence_00000421_pre_disaster.png,64,69,1,771,835,788,857,710,32.15939623641115,29.232845708662456
11236,/media/marda/TWOTB1/xBD/hurricanes/images/florence/hurricane-florence_00000421_pre_disaster.png,70,75,1,792,862,809,884,897,42.21033657415504,28.285419931598643
11237,/media/marda/TWOTB1/xBD/hurricanes/images/florence/hurricane-florence_00000421_pre_disaster.png,97,78,1,762,859,876,954,1653,70.69413923304512,35.59661077900847
11238,/media/marda/TWOTB1/xBD/hurricanes/images/florence/hurricane-florence_00000018_post_disaster.png,65,53,1,403,468,98,151,1345,47.83864271354518,37.42090232512065
11239,/media/marda/TWOTB1/xBD/hurricanes/images/florence/hurricane-florence_00000018_post_disaster.png,69,48,1,602,671,114,162,1079,42.17832846606157,34.05236939712167
11240,/media/marda/TWOTB1/xBD/hurricanes/images/florence/hurricane-florence_00000018_post_disaster.png,58,50,1,392,450,152,202,918,52.02482039182227,23.41845286594732
11241,/media/marda/TWOTB1/xBD/hurricanes/images/florence/hurricane-florence_00000018_post_disaster.png,57,43,1,460,517,152,195,711,40.04286399727664,23.69626844453166
11242,/media/marda/TWOTB1/xBD/hurricanes/images/florence/hurricane-florence_00000018_post_disaster.png,52,30,1,656,708,173,203,353,25.87953374818254,18.235836885327178
11243,/media/marda/TWOTB1/xBD/hurricanes/images/florence/hurricane-florence_00000018_post_disaster.png,37,24,1,430,467,184,208,259,19.383646675356225,17.906656763365877
11244,/media/marda/TWOTB1/xBD/hurricanes/images/florence/hurricane-florence_00000018_post_disaster.png,31,14,1,569,600,184,198,54,9.208793051854947,7.949725185697178
11245,/media/marda/TWOTB1/xBD/hurricanes/images/florence/hurricane-florence_00000018_post_disaster.png,54,38,1,628,682,227,265,406,33.35005701579282,16.282953196977857
11246,/media/marda/TWOTB1/xBD/hurricanes/images/florence/hurricane-florence_00000018_post_disaster.png,85,74,1,237,322,241,315,2376,67.49830427619068,49.05587054771685
11247,/media/marda/TWOTB1/xBD/hurricanes/images/florence/hurricane-florence_00000018_post_disaster.png,22,25,1,248,270,309,334,131,14.13075593425988,12.043259931661462
11248,/media/marda/TWOTB1/xBD/hurricanes/images/florence/hurricane-florence_00000018_post_disaster.png,62,55,1,340,402,315,370,1168,42.42969123705715,36.20811928564565
11249,/media/marda/TWOTB1/xBD/hurricanes/images/florence/hurricane-florence_00000018_post_disaster.png,30,32,1,286,316,371,403,186,21.29450617608943,11.69348344607311
11250,/media/marda/TWOTB1/xBD/hurricanes/images/florence/hurricane-florence_00000018_post_disaster.png,105,119,1,369,474,382,501,3059,129.4332241886801,60.908843083245685
11251,/media/marda/TWOTB1/xBD/hurricanes/images/florence/hurricane-florence_00000018_post_disaster.png,52,65,1,314,366,440,505,850,53.505893728336204,21.193546073168648
11252,/media/marda/TWOTB1/xBD/hurricanes/images/florence/hurricane-florence_00000018_post_disaster.png,29,44,1,53,82,458,502,422,24.43233495713518,22.8640128088072
11253,/media/marda/TWOTB1/xBD/hurricanes/images/florence/hurricane-florence_00000018_post_disaster.png,10,35,1,0,10,459,494,97,16.548042195973657,9.038956769701173
11254,/media/marda/TWOTB1/xBD/hurricanes/images/florence/hurricane-florence_00000018_post_disaster.png,22,34,1,257,279,463,497,145,17.69189659569606,11.002513196119741
11255,/media/marda/TWOTB1/xBD/hurricanes/images/florence/hurricane-florence_00000018_post_disaster.png,46,42,1,392,438,467,509,361,32.70867515135926,14.747012362498435
11256,/media/marda/TWOTB1/xBD/hurricanes/images/florence/hurricane-florence_00000018_post_disaster.png,30,40,1,278,308,473,513,241,23.496549564380196,13.711036761881331
11257,/media/marda/TWOTB1/xBD/hurricanes/images/florence/hurricane-florence_00000018_post_disaster.png,56,61,1,323,379,488,549,1136,40.198209613964224,38.407648482860225
11258,/media/marda/TWOTB1/xBD/hurricanes/images/florence/hurricane-florence_00000018_post_disaster.png,34,58,1,0,34,499,557,644,41.842517865678374,20.692602350139094
11259,/media/marda/TWOTB1/xBD/hurricanes/images/florence/hurricane-florence_00000018_post_disaster.png,67,79,1,196,263,531,610,1937,72.86663420129067,40.36538110521835
11260,/media/marda/TWOTB1/xBD/hurricanes/images/florence/hurricane-florence_00000018_post_disaster.png,21,68,1,0,21,663,731,469,45.21571064331727,13.901070386187834
11261,/media/marda/TWOTB1/xBD/hurricanes/images/florence/hurricane-florence_00000018_post_disaster.png,34,70,1,37,71,683,753,641,50.798915796718134,18.453753116248294
11262,/media/marda/TWOTB1/xBD/hurricanes/images/florence/hurricane-florence_00000018_post_disaster.png,35,75,1,91,126,708,783,633,52.73060302762472,16.0207702399282
11263,/media/marda/TWOTB1/xBD/hurricanes/images/florence/hurricane-florence_00000018_post_disaster.png,28,71,1,139,167,729,800,559,45.90633784094953,16.282838039201106
11264,/media/marda/TWOTB1/xBD/hurricanes/images/florence/hurricane-florence_00000018_post_disaster.png,45,61,1,185,230,761,822,481,45.909318378163725,13.978650799881908
11265,/media/marda/TWOTB1/xBD/hurricanes/images/florence/hurricane-florence_00000018_post_disaster.png,47,78,1,244,291,794,872,700,55.99126450152841,16.513225297438595
11266,/media/marda/TWOTB1/xBD/hurricanes/images/florence/hurricane-florence_00000018_post_disaster.png,45,72,1,324,369,848,920,528,45.684545869051334,15.43553050827466
11267,/media/marda/TWOTB1/xBD/hurricanes/images/florence/hurricane-florence_00000018_post_disaster.png,41,53,1,390,431,868,921,250,30.221050129714094,11.020568454363323
11268,/media/marda/TWOTB1/xBD/hurricanes/images/florence/hurricane-florence_00000018_post_disaster.png,32,43,1,443,475,880,923,110,17.239598611323817,8.579403072231411
11269,/media/marda/TWOTB1/xBD/hurricanes/images/florence/hurricane-florence_00000018_post_disaster.png,52,53,1,417,469,893,946,301,41.435466321613276,10.571848358254725
11270,/media/marda/TWOTB1/xBD/hurricanes/images/florence/hurricane-florence_00000018_post_disaster.png,27,52,1,350,377,894,946,130,13.544564419881048,12.996619250935945
11271,/media/marda/TWOTB1/xBD/hurricanes/images/florence/hurricane-florence_00000018_post_disaster.png,71,85,1,718,789,908,993,1088,49.79984723071808,30.020685037743164
11272,/media/marda/TWOTB1/xBD/hurricanes/images/florence/hurricane-florence_00000018_post_disaster.png,62,60,1,893,955,912,972,430,27.432627411193558,21.824189752391213
11273,/media/marda/TWOTB1/xBD/hurricanes/images/florence/hurricane-florence_00000018_post_disaster.png,103,76,1,800,903,914,990,1621,70.6974871939443,33.65331272693204
11274,/media/marda/TWOTB1/xBD/hurricanes/images/florence/hurricane-florence_00000018_post_disaster.png,60,53,1,969,1029,927,980,249,21.499056197223062,15.410668918957118
11275,/media/marda/TWOTB1/xBD/hurricanes/images/florence/hurricane-florence_00000272_post_disaster.png,24,24,1,0,24,0,24,303,27.12590815232815,15.118919039028242
11276,/media/marda/TWOTB1/xBD/hurricanes/images/florence/hurricane-florence_00000272_post_disaster.png,20,13,1,23,43,0,13,155,17.684735121340253,12.103158233020366
11277,/media/marda/TWOTB1/xBD/hurricanes/images/florence/hurricane-florence_00000272_post_disaster.png,22,6,1,120,142,0,6,57,16.606545682910102,5.18537134639757
11278,/media/marda/TWOTB1/xBD/hurricanes/images/florence/hurricane-florence_00000272_post_disaster.png,43,52,1,10,53,44,96,1036,54.601368422976996,25.676522725465624
11279,/media/marda/TWOTB1/xBD/hurricanes/images/florence/hurricane-florence_00000272_post_disaster.png,18,17,1,63,81,53,70,168,15.632535961621809,14.16233261908467
11280,/media/marda/TWOTB1/xBD/hurricanes/images/florence/hurricane-florence_00000272_post_disaster.png,85,50,1,535,620,176,226,1684,60.661987312459246,38.491243718073434
11281,/media/marda/TWOTB1/xBD/hurricanes/images/florence/hurricane-florence_00000272_post_disaster.png,63,71,1,756,819,180,251,1477,73.91809825455735,26.369169437582485
11282,/media/marda/TWOTB1/xBD/hurricanes/images/florence/hurricane-florence_00000272_post_disaster.png,55,31,1,689,744,206,237,337,26.452124303413967,17.026779865740323
11283,/media/marda/TWOTB1/xBD/hurricanes/images/florence/hurricane-florence_00000272_post_disaster.png,44,38,1,381,425,242,280,466,27.230988701796417,22.638808648409814
11284,/media/marda/TWOTB1/xBD/hurricanes/images/florence/hurricane-florence_00000272_post_disaster.png,37,37,1,159,196,243,280,513,30.433679536861455,22.726851254010914
11285,/media/marda/TWOTB1/xBD/hurricanes/images/florence/hurricane-florence_00000272_post_disaster.png,50,46,1,198,248,260,306,898,37.20751278477994,31.988286578622546
11286,/media/marda/TWOTB1/xBD/hurricanes/images/florence/hurricane-florence_00000272_post_disaster.png,59,51,1,320,379,260,311,799,53.58836473199373,19.900356833573955
11287,/media/marda/TWOTB1/xBD/hurricanes/images/florence/hurricane-florence_00000272_post_disaster.png,60,75,1,212,272,310,385,1866,56.67632010616684,43.40100596340562
11288,/media/marda/TWOTB1/xBD/hurricanes/images/florence/hurricane-florence_00000272_post_disaster.png,38,49,1,46,84,353,402,773,34.81473114762794,29.256718234934095
11289,/media/marda/TWOTB1/xBD/hurricanes/images/florence/hurricane-florence_00000272_post_disaster.png,43,47,1,322,365,416,463,479,26.530533446942275,24.118956778476953
11290,/media/marda/TWOTB1/xBD/hurricanes/images/florence/hurricane-florence_00000272_post_disaster.png,35,32,1,504,539,445,477,117,13.238784560118821,12.083885435594215
11291,/media/marda/TWOTB1/xBD/hurricanes/images/florence/hurricane-florence_00000272_post_disaster.png,44,59,1,223,267,543,602,686,38.4520205208557,23.683591547783564
11292,/media/marda/TWOTB1/xBD/hurricanes/images/florence/hurricane-florence_00000272_post_disaster.png,37,49,1,258,295,687,736,455,29.187100748174753,20.438565598067335
11293,/media/marda/TWOTB1/xBD/hurricanes/images/florence/hurricane-florence_00000272_post_disaster.png,53,64,1,192,245,704,768,939,50.22887997199569,24.620313519608747
11294,/media/marda/TWOTB1/xBD/hurricanes/images/florence/hurricane-florence_00000272_post_disaster.png,36,59,1,101,137,759,818,528,35.362105322644204,19.711745245677143
11295,/media/marda/TWOTB1/xBD/hurricanes/images/florence/hurricane-florence_00000272_post_disaster.png,27,43,1,305,332,779,822,118,13.029907512805224,12.405773287807243
11296,/media/marda/TWOTB1/xBD/hurricanes/images/florence/hurricane-florence_00000272_post_disaster.png,65,86,1,377,442,796,882,1143,62.77030821281353,24.199650885493412
11297,/media/marda/TWOTB1/xBD/hurricanes/images/florence/hurricane-florence_00000272_post_disaster.png,35,63,1,226,261,809,872,445,32.573571279456765,18.429834796405267
11298,/media/marda/TWOTB1/xBD/hurricanes/images/florence/hurricane-florence_00000272_post_disaster.png,47,75,1,346,393,857,932,761,37.71553564367984,27.841183201314088
11299,/media/marda/TWOTB1/xBD/hurricanes/images/florence/hurricane-florence_00000272_post_disaster.png,52,91,1,82,134,926,1017,1280,59.46821213284992,28.416236171320026
11300,/media/marda/TWOTB1/xBD/hurricanes/images/florence/hurricane-florence_00000523_pre_disaster.png,299,83,1,560,859,708,791,10350,315.0132596762856,44.541138612267105
11301,/media/marda/TWOTB1/xBD/hurricanes/images/florence/hurricane-florence_00000398_pre_disaster.png,66,57,1,250,316,0,57,2017,57.87762013849171,47.6280909023847
11302,/media/marda/TWOTB1/xBD/hurricanes/images/florence/hurricane-florence_00000398_pre_disaster.png,37,12,1,335,372,0,12,206,23.82605937789958,12.03922310668966
11303,/media/marda/TWOTB1/xBD/hurricanes/images/florence/hurricane-florence_00000398_pre_disaster.png,102,63,1,541,643,107,170,2678,70.48599587339679,53.10396239446077
11304,/media/marda/TWOTB1/xBD/hurricanes/images/florence/hurricane-florence_00000398_pre_disaster.png,108,58,1,882,990,182,240,1974,71.04560476834978,39.30564035768599
11305,/media/marda/TWOTB1/xBD/hurricanes/images/florence/hurricane-florence_00000398_pre_disaster.png,73,74,1,430,503,196,270,2327,65.45941565901339,48.09476629883784
11306,/media/marda/TWOTB1/xBD/hurricanes/images/florence/hurricane-florence_00000398_pre_disaster.png,59,55,1,25,84,203,258,1607,58.59596052676739,36.95675413559045
11307,/media/marda/TWOTB1/xBD/hurricanes/images/florence/hurricane-florence_00000398_pre_disaster.png,79,65,1,778,857,275,340,1507,53.920873966694266,38.356525769064284
11308,/media/marda/TWOTB1/xBD/hurricanes/images/florence/hurricane-florence_00000398_pre_disaster.png,55,60,1,292,347,317,377,1494,52.24325651828817,37.54066714508285
11309,/media/marda/TWOTB1/xBD/hurricanes/images/florence/hurricane-florence_00000398_pre_disaster.png,95,69,1,837,932,363,432,1775,60.038267178994516,41.013943671786144
11310,/media/marda/TWOTB1/xBD/hurricanes/images/florence/hurricane-florence_00000398_pre_disaster.png,61,48,1,611,672,383,431,684,32.56572915413277,27.82606656347798
11311,/media/marda/TWOTB1/xBD/hurricanes/images/florence/hurricane-florence_00000398_pre_disaster.png,113,107,1,536,649,410,517,3845,95.16807920013719,53.822490774836716
11312,/media/marda/TWOTB1/xBD/hurricanes/images/florence/hurricane-florence_00000398_pre_disaster.png,89,82,1,926,1015,433,515,1761,59.61159293110227,41.822789013029215
11313,/media/marda/TWOTB1/xBD/hurricanes/images/florence/hurricane-florence_00000398_pre_disaster.png,51,39,1,691,742,455,494,252,22.985349764665596,14.664526919103702
11314,/media/marda/TWOTB1/xBD/hurricanes/images/florence/hurricane-florence_00000398_pre_disaster.png,97,69,1,947,1044,471,540,1731,56.724910822014806,42.06580352158855
11315,/media/marda/TWOTB1/xBD/hurricanes/images/florence/hurricane-florence_00000398_pre_disaster.png,88,80,1,612,700,473,553,2008,63.68440863116159,41.91556294325193
11316,/media/marda/TWOTB1/xBD/hurricanes/images/florence/hurricane-florence_00000398_pre_disaster.png,11,45,1,0,11,486,531,169,27.540855997954225,9.40119793239704
11317,/media/marda/TWOTB1/xBD/hurricanes/images/florence/hurricane-florence_00000398_pre_disaster.png,40,31,1,753,793,525,556,66,9.893238061249852,9.04599320676632
11318,/media/marda/TWOTB1/xBD/hurricanes/images/florence/hurricane-florence_00000398_pre_disaster.png,82,70,1,783,865,547,617,1333,48.51543355261498,36.61428227870283
11319,/media/marda/TWOTB1/xBD/hurricanes/images/florence/hurricane-florence_00000398_pre_disaster.png,89,73,1,844,933,556,629,1661,49.69546088449661,46.818184673145865
11320,/media/marda/TWOTB1/xBD/hurricanes/images/florence/hurricane-florence_00000398_pre_disaster.png,42,37,1,681,723,565,602,133,15.689956301915473,11.37989044064125
11321,/media/marda/TWOTB1/xBD/hurricanes/images/florence/hurricane-florence_00000398_pre_disaster.png,62,66,1,982,1044,637,703,791,44.38140353584105,23.848773269181017
11322,/media/marda/TWOTB1/xBD/hurricanes/images/florence/hurricane-florence_00000398_pre_disaster.png,72,75,1,352,424,743,818,1833,62.060271808995374,41.45405652629337
11323,/media/marda/TWOTB1/xBD/hurricanes/images/florence/hurricane-florence_00000398_pre_disaster.png,79,93,1,674,753,746,839,1814,60.41108188550812,43.34302098733512
11324,/media/marda/TWOTB1/xBD/hurricanes/images/florence/hurricane-florence_00000398_pre_disaster.png,68,91,1,430,498,778,869,1859,60.04023083305501,43.23154179880133
11325,/media/marda/TWOTB1/xBD/hurricanes/images/florence/hurricane-florence_00000398_pre_disaster.png,77,82,1,919,996,838,920,1015,47.24764825169141,32.782449086429246
11326,/media/marda/TWOTB1/xBD/hurricanes/images/florence/hurricane-florence_00000000_pre_disaster.png,53,46,1,76,129,0,46,1243,56.28680808824067,29.590512824986057
11327,/media/marda/TWOTB1/xBD/hurricanes/images/florence/hurricane-florence_00000000_pre_disaster.png,33,9,1,287,320,0,9,107,20.501474954000585,8.004678999023062
11328,/media/marda/TWOTB1/xBD/hurricanes/images/florence/hurricane-florence_00000000_pre_disaster.png,88,38,1,844,932,0,38,1614,54.26935349866437,41.72576432583845
11329,/media/marda/TWOTB1/xBD/hurricanes/images/florence/hurricane-florence_00000000_pre_disaster.png,80,37,1,940,1020,0,37,1223,47.65977787375216,35.29135980001713
11330,/media/marda/TWOTB1/xBD/hurricanes/images/florence/hurricane-florence_00000000_pre_disaster.png,60,8,1,984,1044,0,8,153,22.119012661553473,9.065738500579767
11331,/media/marda/TWOTB1/xBD/hurricanes/images/florence/hurricane-florence_00000000_pre_disaster.png,31,21,1,196,227,3,24,242,22.85742229419172,14.149072804529846
11332,/media/marda/TWOTB1/xBD/hurricanes/images/florence/hurricane-florence_00000000_pre_disaster.png,94,44,1,830,924,39,83,1808,59.15344158216963,44.93457267425698
11333,/media/marda/TWOTB1/xBD/hurricanes/images/florence/hurricane-florence_00000000_pre_disaster.png,95,66,1,196,291,50,116,2311,96.82638063670221,32.86487366546616
11334,/media/marda/TWOTB1/xBD/hurricanes/images/florence/hurricane-florence_00000000_pre_disaster.png,36,63,1,57,93,55,118,1319,65.56631652620047,27.806278522899806
11335,/media/marda/TWOTB1/xBD/hurricanes/images/florence/hurricane-florence_00000000_pre_disaster.png,93,42,1,831,924,85,127,1583,58.426626812145095,38.457454201348426
11336,/media/marda/TWOTB1/xBD/hurricanes/images/florence/hurricane-florence_00000000_pre_disaster.png,78,46,1,932,1010,86,132,1495,52.04434138452571,39.538057544294574
11337,/media/marda/TWOTB1/xBD/hurricanes/images/florence/hurricane-florence_00000000_pre_disaster.png,68,54,1,976,1044,99,153,1216,53.50052264710795,30.358238754600123
11338,/media/marda/TWOTB1/xBD/hurricanes/images/florence/hurricane-florence_00000000_pre_disaster.png,40,31,1,202,242,118,149,392,36.81068209962591,14.081230602779149
11339,/media/marda/TWOTB1/xBD/hurricanes/images/florence/hurricane-florence_00000000_pre_disaster.png,76,51,1,88,164,120,171,1493,71.76227861749979,33.469309374804695
11340,/media/marda/TWOTB1/xBD/hurricanes/images/florence/hurricane-florence_00000000_pre_disaster.png,80,47,1,840,920,133,180,1511,50.205837141946844,42.46303247184912
11341,/media/marda/TWOTB1/xBD/hurricanes/images/florence/hurricane-florence_00000000_pre_disaster.png,89,50,1,796,885,169,219,1520,54.665186908752595,38.412963002842375
11342,/media/marda/TWOTB1/xBD/hurricanes/images/florence/hurricane-florence_00000000_pre_disaster.png,28,34,1,161,189,171,205,304,33.03673527915549,12.299655770276757
11343,/media/marda/TWOTB1/xBD/hurricanes/images/florence/hurricane-florence_00000000_pre_disaster.png,56,50,1,175,231,175,225,1153,48.93364727643555,34.12154857403795
11344,/media/marda/TWOTB1/xBD/hurricanes/images/florence/hurricane-florence_00000000_pre_disaster.png,87,47,1,927,1014,175,222,1890,56.482832159149496,44.79878489565828
11345,/media/marda/TWOTB1/xBD/hurricanes/images/florence/hurricane-florence_00000000_pre_disaster.png,19,19,1,139,158,176,195,113,12.320211468131099,12.320211468131099
11346,/media/marda/TWOTB1/xBD/hurricanes/images/florence/hurricane-florence_00000000_pre_disaster.png,93,52,1,756,849,216,268,1921,60.9177834430747,43.236692391105095
11347,/media/marda/TWOTB1/xBD/hurricanes/images/florence/hurricane-florence_00000000_pre_disaster.png,78,58,1,920,998,238,296,1405,51.276191287778616,38.33135640780579
11348,/media/marda/TWOTB1/xBD/hurricanes/images/florence/hurricane-florence_00000000_pre_disaster.png,34,31,1,99,133,242,273,247,33.78594406590345,9.794468331311919
11349,/media/marda/TWOTB1/xBD/hurricanes/images/florence/hurricane-florence_00000000_pre_disaster.png,71,64,1,973,1044,245,309,1118,54.372880863318514,29.209799322734188
11350,/media/marda/TWOTB1/xBD/hurricanes/images/florence/hurricane-florence_00000000_pre_disaster.png,139,122,1,302,441,246,368,6524,123.30092926605603,92.31606725151947
11351,/media/marda/TWOTB1/xBD/hurricanes/images/florence/hurricane-florence_00000000_pre_disaster.png,81,61,1,781,862,254,315,1554,53.73769297224632,39.382962688668535
11352,/media/marda/TWOTB1/xBD/hurricanes/images/florence/hurricane-florence_00000000_pre_disaster.png,29,28,1,132,161,275,303,148,30.644744503392616,6.479252688610709
11353,/media/marda/TWOTB1/xBD/hurricanes/images/florence/hurricane-florence_00000000_pre_disaster.png,99,71,1,804,903,281,352,2090,70.34238455976947,41.130553223801975
11354,/media/marda/TWOTB1/xBD/hurricanes/images/florence/hurricane-florence_00000000_pre_disaster.png,85,76,1,659,744,302,378,1791,71.63892161981619,32.975919763387516
11355,/media/marda/TWOTB1/xBD/hurricanes/images/florence/hurricane-florence_00000000_pre_disaster.png,50,31,1,994,1044,302,333,128,20.064247793466155,8.97284224660105
11356,/media/marda/TWOTB1/xBD/hurricanes/images/florence/hurricane-florence_00000000_pre_disaster.png,90,74,1,445,535,305,379,2263,63.90857878075711,49.3790381093213
11357,/media/marda/TWOTB1/xBD/hurricanes/images/florence/hurricane-florence_00000000_pre_disaster.png,8,20,1,63,71,329,349,45,7.853950298295041,7.33376483719105
11358,/media/marda/TWOTB1/xBD/hurricanes/images/florence/hurricane-florence_00000000_pre_disaster.png,50,59,1,64,114,339,398,1140,45.839430277381865,33.418639719797454
11359,/media/marda/TWOTB1/xBD/hurricanes/images/florence/hurricane-florence_00000000_pre_disaster.png,97,66,1,796,893,339,405,1986,61.74049982285901,43.72698280762563
11360,/media/marda/TWOTB1/xBD/hurricanes/images/florence/hurricane-florence_00000000_pre_disaster.png,53,35,1,991,1044,345,380,170,20.726894428922186,12.113980010391963
11361,/media/marda/TWOTB1/xBD/hurricanes/images/florence/hurricane-florence_00000000_pre_disaster.png,59,42,1,985,1044,364,406,337,28.584730210166857,16.009272807349394
11362,/media/marda/TWOTB1/xBD/hurricanes/images/florence/hurricane-florence_00000000_pre_disaster.png,103,65,1,926,1029,367,432,1747,62.181789733382324,39.864382205690966
11363,/media/marda/TWOTB1/xBD/hurricanes/images/florence/hurricane-florence_00000000_pre_disaster.png,89,57,1,779,868,389,446,1437,52.615662975032905,36.99248898597855
11364,/media/marda/TWOTB1/xBD/hurricanes/images/florence/hurricane-florence_00000000_pre_disaster.png,81,67,1,895,976,392,459,1494,52.5219399773742,39.101311405482626
11365,/media/marda/TWOTB1/xBD/hurricanes/images/florence/hurricane-florence_00000000_pre_disaster.png,85,63,1,588,673,396,459,1389,63.54205317865002,29.475997437551527
11366,/media/marda/TWOTB1/xBD/hurricanes/images/florence/hurricane-florence_00000000_pre_disaster.png,61,57,1,511,572,406,463,672,48.371170866066194,19.165126467794444
11367,/media/marda/TWOTB1/xBD/hurricanes/images/florence/hurricane-florence_00000000_pre_disaster.png,92,66,1,752,844,419,485,1651,53.41733000802122,42.676145097741916
11368,/media/marda/TWOTB1/xBD/hurricanes/images/florence/hurricane-florence_00000000_pre_disaster.png,49,46,1,519,568,445,491,414,30.309214642301914,18.234617249094576
11369,/media/marda/TWOTB1/xBD/hurricanes/images/florence/hurricane-florence_00000000_pre_disaster.png,95,66,1,855,950,446,512,1646,53.03507402418286,42.51420975017325
11370,/media/marda/TWOTB1/xBD/hurricanes/images/florence/hurricane-florence_00000000_pre_disaster.png,32,25,1,564,596,454,479,95,13.728033565991018,9.167873432551843
11371,/media/marda/TWOTB1/xBD/hurricanes/images/florence/hurricane-florence_00000000_pre_disaster.png,92,68,1,724,816,461,529,1751,54.618484894767164,44.979754575176806
11372,/media/marda/TWOTB1/xBD/hurricanes/images/florence/hurricane-florence_00000000_pre_disaster.png,90,74,1,837,927,477,551,1708,54.72577746182739,44.17671177542711
11373,/media/marda/TWOTB1/xBD/hurricanes/images/florence/hurricane-florence_00000000_pre_disaster.png,81,71,1,705,786,504,575,1548,49.37026283576375,43.621565926520695
11374,/media/marda/TWOTB1/xBD/hurricanes/images/florence/hurricane-florence_00000000_pre_disaster.png,85,73,1,815,900,515,588,1701,55.05343746374975,42.90230516390338
11375,/media/marda/TWOTB1/xBD/hurricanes/images/florence/hurricane-florence_00000000_pre_disaster.png,56,61,1,988,1044,531,592,533,45.041743109240365,15.939696566620311
11376,/media/marda/TWOTB1/xBD/hurricanes/images/florence/hurricane-florence_00000000_pre_disaster.png,85,76,1,793,878,556,632,1734,53.688801129343666,45.5931832437089
11377,/media/marda/TWOTB1/xBD/hurricanes/images/florence/hurricane-florence_00000000_pre_disaster.png,84,65,1,686,770,557,622,1554,53.842494014219355,39.881105365881645
11378,/media/marda/TWOTB1/xBD/hurricanes/images/florence/hurricane-florence_00000000_pre_disaster.png,93,74,1,947,1040,571,645,1715,57.528655017009456,41.25096063819041
11379,/media/marda/TWOTB1/xBD/hurricanes/images/florence/hurricane-florence_00000000_pre_disaster.png,55,62,1,182,237,583,645,1105,44.20910747658626,34.608086834395095
11380,/media/marda/TWOTB1/xBD/hurricanes/images/florence/hurricane-florence_00000000_pre_disaster.png,85,69,1,676,761,600,669,1733,56.82653980212536,44.04071549063293
11381,/media/marda/TWOTB1/xBD/hurricanes/images/florence/hurricane-florence_00000000_pre_disaster.png,72,80,1,207,279,601,681,2003,62.697043425496986,43.18237006584026
11382,/media/marda/TWOTB1/xBD/hurricanes/images/florence/hurricane-florence_00000000_pre_disaster.png,101,75,1,930,1031,608,683,1823,57.26599733110981,44.02521685443428
11383,/media/marda/TWOTB1/xBD/hurricanes/images/florence/hurricane-florence_00000000_pre_disaster.png,78,73,1,779,857,609,682,1568,53.80155532200992,40.188941518148994
11384,/media/marda/TWOTB1/xBD/hurricanes/images/florence/hurricane-florence_00000000_pre_disaster.png,58,71,1,355,413,613,684,1287,51.16484247669216,35.170773669838354
11385,/media/marda/TWOTB1/xBD/hurricanes/images/florence/hurricane-florence_00000000_pre_disaster.png,54,47,1,510,564,636,683,517,36.457736441775225,18.894832311664953
11386,/media/marda/TWOTB1/xBD/hurricanes/images/florence/hurricane-florence_00000000_pre_disaster.png,83,69,1,669,752,643,712,1719,55.304594262300355,42.354408637934554
11387,/media/marda/TWOTB1/xBD/hurricanes/images/florence/hurricane-florence_00000000_pre_disaster.png,71,71,1,246,317,644,715,1539,58.42223964176893,37.27928840527829
11388,/media/marda/TWOTB1/xBD/hurricanes/images/florence/hurricane-florence_00000000_pre_disaster.png,79,68,1,769,848,656,724,1456,51.54040688528789,39.457089737663914
11389,/media/marda/TWOTB1/xBD/hurricanes/images/florence/hurricane-florence_00000000_pre_disaster.png,65,81,1,373,438,661,742,1482,50.510498265714766,41.865732019234024
11390,/media/marda/TWOTB1/xBD/hurricanes/images/florence/hurricane-florence_00000000_pre_disaster.png,91,68,1,920,1011,661,729,1557,51.090347477306494,41.50469309074306
11391,/media/marda/TWOTB1/xBD/hurricanes/images/florence/hurricane-florence_00000000_pre_disaster.png,82,72,1,660,742,687,759,1738,55.599332271878104,42.824700795903034
11392,/media/marda/TWOTB1/xBD/hurricanes/images/florence/hurricane-florence_00000000_pre_disaster.png,63,87,1,425,488,688,775,1623,54.96061562009949,41.22763412720288
11393,/media/marda/TWOTB1/xBD/hurricanes/images/florence/hurricane-florence_00000000_pre_disaster.png,67,74,1,269,336,692,766,1347,52.797800215710694,37.03526185642854
11394,/media/marda/TWOTB1/xBD/hurricanes/images/florence/hurricane-florence_00000000_pre_disaster.png,40,74,1,73,113,696,770,717,52.41591306416925,19.42937639985086
11395,/media/marda/TWOTB1/xBD/hurricanes/images/florence/hurricane-florence_00000000_pre_disaster.png,83,76,1,760,843,697,773,1725,57.54845862964356,42.3104808762782
11396,/media/marda/TWOTB1/xBD/hurricanes/images/florence/hurricane-florence_00000000_pre_disaster.png,65,82,1,468,533,710,792,1470,51.599928063270205,39.874410517400065
11397,/media/marda/TWOTB1/xBD/hurricanes/images/florence/hurricane-florence_00000000_pre_disaster.png,90,71,1,911,1001,710,781,1404,52.65440957466388,36.551629876009365
11398,/media/marda/TWOTB1/xBD/hurricanes/images/florence/hurricane-florence_00000000_pre_disaster.png,67,76,1,294,361,729,805,1411,51.89411041520879,37.26428622941942
11399,/media/marda/TWOTB1/xBD/hurricanes/images/florence/hurricane-florence_00000000_pre_disaster.png,81,74,1,650,731,733,807,1640,51.20134923750951,46.28960363162339
11400,/media/marda/TWOTB1/xBD/hurricanes/images/florence/hurricane-florence_00000000_pre_disaster.png,37,62,1,54,91,743,805,632,36.80767645122357,22.868526616766545
11401,/media/marda/TWOTB1/xBD/hurricanes/images/florence/hurricane-florence_00000000_pre_disaster.png,75,73,1,750,825,745,818,1548,49.90969135137225,43.37812197675115
11402,/media/marda/TWOTB1/xBD/hurricanes/images/florence/hurricane-florence_00000000_pre_disaster.png,100,72,1,890,990,752,824,1747,61.62368976455926,41.19369236268396
11403,/media/marda/TWOTB1/xBD/hurricanes/images/florence/hurricane-florence_00000000_pre_disaster.png,71,80,1,325,396,766,846,1620,54.496629224023245,42.57455836225677
11404,/media/marda/TWOTB1/xBD/hurricanes/images/florence/hurricane-florence_00000000_pre_disaster.png,86,81,1,616,702,776,857,1735,52.50940498882464,45.22430025564072
11405,/media/marda/TWOTB1/xBD/hurricanes/images/florence/hurricane-florence_00000000_pre_disaster.png,70,87,1,370,440,784,871,1977,59.37078301420751,47.01390355577223
11406,/media/marda/TWOTB1/xBD/hurricanes/images/florence/hurricane-florence_00000000_pre_disaster.png,51,51,1,993,1044,789,840,163,18.759055838875362,11.466044447426478
11407,/media/marda/TWOTB1/xBD/hurricanes/images/florence/hurricane-florence_00000000_pre_disaster.png,86,78,1,724,810,794,872,1762,57.03604024636372,43.12471644430702
11408,/media/marda/TWOTB1/xBD/hurricanes/images/florence/hurricane-florence_00000000_pre_disaster.png,91,76,1,891,982,798,874,1459,54.39197037283987,37.95199081548048
11409,/media/marda/TWOTB1/xBD/hurricanes/images/florence/hurricane-florence_00000000_pre_disaster.png,67,87,1,413,480,799,886,1502,48.487678410507996,42.74826464524523
11410,/media/marda/TWOTB1/xBD/hurricanes/images/florence/hurricane-florence_00000000_pre_disaster.png,60,74,1,984,1044,835,909,567,47.993550594332504,18.945112696065053
11411,/media/marda/TWOTB1/xBD/hurricanes/images/florence/hurricane-florence_00000000_pre_disaster.png,78,79,1,710,788,836,915,1535,52.42639131473799,40.67980593988527
11412,/media/marda/TWOTB1/xBD/hurricanes/images/florence/hurricane-florence_00000000_pre_disaster.png,101,87,1,869,970,839,926,2009,58.55379942056755,46.50781136066058
11413,/media/marda/TWOTB1/xBD/hurricanes/images/florence/hurricane-florence_00000000_pre_disaster.png,75,74,1,569,644,858,932,1192,47.573731546652745,35.07762211875245
11414,/media/marda/TWOTB1/xBD/hurricanes/images/florence/hurricane-florence_00000000_pre_disaster.png,55,81,1,334,389,862,943,961,53.741787258346136,23.735140563061588
11415,/media/marda/TWOTB1/xBD/hurricanes/images/florence/hurricane-florence_00000000_pre_disaster.png,72,85,1,972,1044,880,965,1245,51.48740693168752,33.80051198177517
11416,/media/marda/TWOTB1/xBD/hurricanes/images/florence/hurricane-florence_00000000_pre_disaster.png,94,89,1,846,940,887,976,1669,52.04085276680314,43.95159083646157
11417,/media/marda/TWOTB1/xBD/hurricanes/images/florence/hurricane-florence_00000000_pre_disaster.png,76,86,1,601,677,888,974,1364,47.74669343087945,40.08636253900536
11418,/media/marda/TWOTB1/xBD/hurricanes/images/florence/hurricane-florence_00000000_pre_disaster.png,74,88,1,722,796,890,978,1434,51.248986206334145,38.37809557889668
11419,/media/marda/TWOTB1/xBD/hurricanes/images/florence/hurricane-florence_00000000_pre_disaster.png,82,91,1,944,1026,924,1015,1489,52.08188380289371,39.24970095174807
11420,/media/marda/TWOTB1/xBD/hurricanes/images/florence/hurricane-florence_00000000_pre_disaster.png,89,87,1,811,900,926,1013,1629,56.286165304575746,40.0985946557966
11421,/media/marda/TWOTB1/xBD/hurricanes/images/florence/hurricane-florence_00000000_pre_disaster.png,78,82,1,626,704,934,1016,1444,52.09734144920226,37.92863020748994
11422,/media/marda/TWOTB1/xBD/hurricanes/images/florence/hurricane-florence_00000000_pre_disaster.png,81,90,1,756,837,939,1029,1515,49.278776826395685,42.17876534788307
11423,/media/marda/TWOTB1/xBD/hurricanes/images/florence/hurricane-florence_00000000_pre_disaster.png,25,61,1,33,58,956,1017,314,21.654951655251505,19.39691305954243
11424,/media/marda/TWOTB1/xBD/hurricanes/images/florence/hurricane-florence_00000000_pre_disaster.png,72,86,1,380,452,956,1042,1559,50.21497018224718,42.371738298501725
11425,/media/marda/TWOTB1/xBD/hurricanes/images/florence/hurricane-florence_00000000_pre_disaster.png,81,75,1,918,999,967,1042,1099,45.701398583701575,34.16791860154471
11426,/media/marda/TWOTB1/xBD/hurricanes/images/florence/hurricane-florence_00000000_pre_disaster.png,85,65,1,650,735,977,1042,1128,58.787042105669826,27.17243664786161
11427,/media/marda/TWOTB1/xBD/hurricanes/images/florence/hurricane-florence_00000000_pre_disaster.png,24,55,1,268,292,983,1038,119,13.652046121732107,11.70035219340214
11428,/media/marda/TWOTB1/xBD/hurricanes/images/florence/hurricane-florence_00000000_pre_disaster.png,67,60,1,425,492,984,1044,594,51.434065244593036,18.402458556374146
11429,/media/marda/TWOTB1/xBD/hurricanes/images/florence/hurricane-florence_00000477_pre_disaster.png,21,28,1,201,222,491,519,110,13.269975230507708,11.178387738087915
11430,/media/marda/TWOTB1/xBD/hurricanes/images/florence/hurricane-florence_00000477_pre_disaster.png,34,50,1,196,230,515,565,546,27.97155619601539,26.201572854856717
11431,/media/marda/TWOTB1/xBD/hurricanes/images/florence/hurricane-florence_00000477_pre_disaster.png,62,49,1,497,559,518,567,836,46.76852078712188,23.64261745623322
11432,/media/marda/TWOTB1/xBD/hurricanes/images/florence/hurricane-florence_00000477_pre_disaster.png,33,44,1,110,143,536,580,555,30.99914366049652,23.797939055494552
11433,/media/marda/TWOTB1/xBD/hurricanes/images/florence/hurricane-florence_00000477_pre_disaster.png,40,62,1,438,478,558,620,507,46.201635041698395,14.677252798541662
11434,/media/marda/TWOTB1/xBD/hurricanes/images/florence/hurricane-florence_00000477_pre_disaster.png,48,50,1,300,348,653,703,667,37.85998042554561,24.21037944160782
11435,/media/marda/TWOTB1/xBD/hurricanes/images/florence/hurricane-florence_00000477_pre_disaster.png,70,49,1,398,468,671,720,1300,62.23715054071371,27.85069753035944
11436,/media/marda/TWOTB1/xBD/hurricanes/images/florence/hurricane-florence_00000477_pre_disaster.png,31,49,1,170,201,676,725,533,29.034707041067378,24.226061872224285
11437,/media/marda/TWOTB1/xBD/hurricanes/images/florence/hurricane-florence_00000477_pre_disaster.png,56,63,1,520,576,708,771,667,30.508222075193913,29.19626357252773
11438,/media/marda/TWOTB1/xBD/hurricanes/images/florence/hurricane-florence_00000477_pre_disaster.png,34,85,1,282,316,837,922,747,58.98904257928013,16.841074949995456
11439,/media/marda/TWOTB1/xBD/hurricanes/images/florence/hurricane-florence_00000477_pre_disaster.png,34,65,1,0,34,878,943,883,37.04470840769764,31.87874356572243
11440,/media/marda/TWOTB1/xBD/hurricanes/images/florence/hurricane-florence_00000477_pre_disaster.png,60,57,1,253,313,935,992,930,54.2199720430654,22.62243345038835
11441,/media/marda/TWOTB1/xBD/hurricanes/images/florence/hurricane-florence_00000435_post_disaster.png,46,25,1,470,516,80,105,258,32.818491407786716,10.509543172089924
11442,/media/marda/TWOTB1/xBD/hurricanes/images/florence/hurricane-florence_00000435_post_disaster.png,36,19,1,499,535,106,125,119,13.378625617002482,12.00676628506171
11443,/media/marda/TWOTB1/xBD/hurricanes/images/florence/hurricane-florence_00000435_post_disaster.png,43,31,1,336,379,127,158,428,28.627630587521956,19.78569439637211
11444,/media/marda/TWOTB1/xBD/hurricanes/images/florence/hurricane-florence_00000435_post_disaster.png,37,21,1,564,601,166,187,145,13.904105074798395,13.904105074798395
11445,/media/marda/TWOTB1/xBD/hurricanes/images/florence/hurricane-florence_00000435_post_disaster.png,42,32,1,344,386,185,217,415,27.579480878184164,20.057289856377572
11446,/media/marda/TWOTB1/xBD/hurricanes/images/florence/hurricane-florence_00000435_post_disaster.png,61,61,1,342,403,219,280,1216,58.274239372736666,29.432326291522557
11447,/media/marda/TWOTB1/xBD/hurricanes/images/florence/hurricane-florence_00000435_post_disaster.png,49,43,1,299,348,246,289,627,36.857048383263454,22.64761736387479
11448,/media/marda/TWOTB1/xBD/hurricanes/images/florence/hurricane-florence_00000435_post_disaster.png,65,66,1,836,901,727,793,549,40.90034907007873,17.94128456116457
11449,/media/marda/TWOTB1/xBD/hurricanes/images/florence/hurricane-florence_00000435_post_disaster.png,86,58,1,773,859,846,904,693,62.82915850806358,16.272419813034958
11450,/media/marda/TWOTB1/xBD/hurricanes/images/florence/hurricane-florence_00000435_post_disaster.png,62,53,1,292,354,134,187,1045,58.56390568574005,24.122353483367917
11451,/media/marda/TWOTB1/xBD/hurricanes/images/florence/hurricane-florence_00000361_pre_disaster.png,44,71,1,162,206,322,393,1946,63.440644437056086,40.520699078210214
11452,/media/marda/TWOTB1/xBD/hurricanes/images/florence/hurricane-florence_00000361_pre_disaster.png,24,23,1,210,234,357,380,122,17.34438301058642,9.370174289256942
11453,/media/marda/TWOTB1/xBD/hurricanes/images/florence/hurricane-florence_00000361_pre_disaster.png,51,89,1,43,94,390,479,3127,83.1444183605305,49.79956961902166
11454,/media/marda/TWOTB1/xBD/hurricanes/images/florence/hurricane-florence_00000361_pre_disaster.png,61,79,1,159,220,435,514,2880,66.03273994889743,57.875313622555744
11455,/media/marda/TWOTB1/xBD/hurricanes/images/florence/hurricane-florence_00000361_pre_disaster.png,30,37,1,118,148,526,563,385,28.73336298769329,17.745810511187
11456,/media/marda/TWOTB1/xBD/hurricanes/images/florence/hurricane-florence_00000294_post_disaster.png,31,22,1,272,303,0,22,238,28.49106127376182,11.064051255860097
11457,/media/marda/TWOTB1/xBD/hurricanes/images/florence/hurricane-florence_00000294_post_disaster.png,47,50,1,217,264,2,52,911,55.073098550868814,23.21315848126019
11458,/media/marda/TWOTB1/xBD/hurricanes/images/florence/hurricane-florence_00000294_post_disaster.png,53,13,1,962,1015,22,35,137,17.766712212556534,10.381921350647772
11459,/media/marda/TWOTB1/xBD/hurricanes/images/florence/hurricane-florence_00000294_post_disaster.png,63,29,1,720,783,79,108,913,39.20697043679077,30.964332058762892
11460,/media/marda/TWOTB1/xBD/hurricanes/images/florence/hurricane-florence_00000294_post_disaster.png,41,18,1,681,722,94,112,234,19.85185043983834,15.65131678394534
11461,/media/marda/TWOTB1/xBD/hurricanes/images/florence/hurricane-florence_00000294_post_disaster.png,65,34,1,864,929,135,169,531,31.963406850716076,21.849888224269186
11462,/media/marda/TWOTB1/xBD/hurricanes/images/florence/hurricane-florence_00000294_post_disaster.png,73,66,1,716,789,150,216,2214,67.17054038863958,44.07791294053362
11463,/media/marda/TWOTB1/xBD/hurricanes/images/florence/hurricane-florence_00000294_post_disaster.png,25,35,1,33,58,204,239,355,27.11408305018846,17.34365252564476
11464,/media/marda/TWOTB1/xBD/hurricanes/images/florence/hurricane-florence_00000294_post_disaster.png,86,45,1,941,1027,212,257,697,55.82942099428986,16.521874604021892
11465,/media/marda/TWOTB1/xBD/hurricanes/images/florence/hurricane-florence_00000294_post_disaster.png,52,56,1,90,142,218,274,1258,50.67108668226565,32.58833439889927
11466,/media/marda/TWOTB1/xBD/hurricanes/images/florence/hurricane-florence_00000294_post_disaster.png,18,28,1,50,68,226,254,227,17.530087624011035,16.840877673385698
11467,/media/marda/TWOTB1/xBD/hurricanes/images/florence/hurricane-florence_00000294_post_disaster.png,55,33,1,989,1044,243,276,195,25.290008834742796,10.585437263853008
11468,/media/marda/TWOTB1/xBD/hurricanes/images/florence/hurricane-florence_00000294_post_disaster.png,23,30,1,72,95,258,288,265,20.95819446012303,16.863574474809074
11469,/media/marda/TWOTB1/xBD/hurricanes/images/florence/hurricane-florence_00000294_post_disaster.png,55,32,1,887,942,315,347,193,20.592254748767306,12.388862640001605
11470,/media/marda/TWOTB1/xBD/hurricanes/images/florence/hurricane-florence_00000294_post_disaster.png,49,61,1,121,170,317,378,1153,55.111033289407494,27.557253923852535
11471,/media/marda/TWOTB1/xBD/hurricanes/images/florence/hurricane-florence_00000294_post_disaster.png,50,36,1,994,1044,323,359,127,21.459952511993038,9.047619961126863
11472,/media/marda/TWOTB1/xBD/hurricanes/images/florence/hurricane-florence_00000294_post_disaster.png,37,32,1,476,513,328,360,197,18.99084519200091,13.779840881508091
11473,/media/marda/TWOTB1/xBD/hurricanes/images/florence/hurricane-florence_00000294_post_disaster.png,83,60,1,850,933,347,407,1147,50.242571187911174,38.12701797457104
11474,/media/marda/TWOTB1/xBD/hurricanes/images/florence/hurricane-florence_00000294_post_disaster.png,92,45,1,928,1020,348,393,732,62.0497691650544,15.641453751665512
11475,/media/marda/TWOTB1/xBD/hurricanes/images/florence/hurricane-florence_00000294_post_disaster.png,26,35,1,117,143,362,397,260,20.063661687524437,17.616419530796083
11476,/media/marda/TWOTB1/xBD/hurricanes/images/florence/hurricane-florence_00000294_post_disaster.png,39,33,1,449,488,362,395,258,19.38161167390472,17.682706506411396
11477,/media/marda/TWOTB1/xBD/hurricanes/images/florence/hurricane-florence_00000294_post_disaster.png,45,38,1,491,536,364,402,389,24.456801501766126,20.89292023292292
11478,/media/marda/TWOTB1/xBD/hurricanes/images/florence/hurricane-florence_00000294_post_disaster.png,34,45,1,92,126,366,411,570,28.287748070248835,26.810246839292926
11479,/media/marda/TWOTB1/xBD/hurricanes/images/florence/hurricane-florence_00000294_post_disaster.png,40,34,1,514,554,379,413,247,20.736098297522823,15.727934680316539
11480,/media/marda/TWOTB1/xBD/hurricanes/images/florence/hurricane-florence_00000294_post_disaster.png,65,63,1,424,489,389,452,1351,54.37920929115945,32.80916865467131
11481,/media/marda/TWOTB1/xBD/hurricanes/images/florence/hurricane-florence_00000294_post_disaster.png,79,54,1,726,805,392,446,1309,53.55757287749493,32.00444939342088
11482,/media/marda/TWOTB1/xBD/hurricanes/images/florence/hurricane-florence_00000294_post_disaster.png,47,59,1,184,231,448,507,933,40.038667263215885,32.580026799897446
11483,/media/marda/TWOTB1/xBD/hurricanes/images/florence/hurricane-florence_00000294_post_disaster.png,36,45,1,130,166,457,502,475,29.22918613429309,21.63750439598812
11484,/media/marda/TWOTB1/xBD/hurricanes/images/florence/hurricane-florence_00000294_post_disaster.png,40,40,1,562,602,486,526,251,22.66738652222228,14.73306032197434
11485,/media/marda/TWOTB1/xBD/hurricanes/images/florence/hurricane-florence_00000294_post_disaster.png,46,40,1,528,574,496,536,245,28.434101335130414,11.351140334177527
11486,/media/marda/TWOTB1/xBD/hurricanes/images/florence/hurricane-florence_00000294_post_disaster.png,73,57,1,509,582,519,576,1041,56.65118686577545,24.725941931124765
11487,/media/marda/TWOTB1/xBD/hurricanes/images/florence/hurricane-florence_00000294_post_disaster.png,42,67,1,239,281,520,587,712,50.82613838768109,20.781096815078726
11488,/media/marda/TWOTB1/xBD/hurricanes/images/florence/hurricane-florence_00000294_post_disaster.png,58,66,1,179,237,567,633,1246,49.155413930004634,33.57247411227418
11489,/media/marda/TWOTB1/xBD/hurricanes/images/florence/hurricane-florence_00000294_post_disaster.png,71,77,1,973,1044,665,742,1237,52.907792511851454,30.94446368157168
11490,/media/marda/TWOTB1/xBD/hurricanes/images/florence/hurricane-florence_00000294_post_disaster.png,39,69,1,125,164,668,737,759,50.42385504820143,20.71087413546893
11491,/media/marda/TWOTB1/xBD/hurricanes/images/florence/hurricane-florence_00000294_post_disaster.png,67,72,1,613,680,676,748,1154,46.79110610342229,32.74504215119385
11492,/media/marda/TWOTB1/xBD/hurricanes/images/florence/hurricane-florence_00000294_post_disaster.png,38,39,1,646,684,685,724,112,12.399578587160951,12.018923932427258
11493,/media/marda/TWOTB1/xBD/hurricanes/images/florence/hurricane-florence_00000294_post_disaster.png,47,51,1,660,707,697,748,291,19.976358003991628,19.25902756023573
11494,/media/marda/TWOTB1/xBD/hurricanes/images/florence/hurricane-florence_00000294_post_disaster.png,46,59,1,446,492,721,780,544,29.240672270762282,24.631512434086385
11495,/media/marda/TWOTB1/xBD/hurricanes/images/florence/hurricane-florence_00000294_post_disaster.png,35,68,1,4,39,752,820,813,38.26807043220735,28.331035382486753
11496,/media/marda/TWOTB1/xBD/hurricanes/images/florence/hurricane-florence_00000294_post_disaster.png,58,67,1,698,756,780,847,653,38.14931422070843,22.43399079418065
11497,/media/marda/TWOTB1/xBD/hurricanes/images/florence/hurricane-florence_00000294_post_disaster.png,51,48,1,843,894,795,843,176,17.43125536730445,13.34661847621231
11498,/media/marda/TWOTB1/xBD/hurricanes/images/florence/hurricane-florence_00000294_post_disaster.png,55,55,1,858,913,812,867,291,21.165750326920215,18.16165104460058
11499,/media/marda/TWOTB1/xBD/hurricanes/images/florence/hurricane-florence_00000294_post_disaster.png,77,83,1,814,891,817,900,1413,50.21215827351289,37.402088729054356
11500,/media/marda/TWOTB1/xBD/hurricanes/images/florence/hurricane-florence_00000294_post_disaster.png,18,50,1,164,182,837,887,149,15.499469965208178,12.652953280072753
11501,/media/marda/TWOTB1/xBD/hurricanes/images/florence/hurricane-florence_00000294_post_disaster.png,46,60,1,413,459,865,925,466,26.382073103006203,23.31602719434802
11502,/media/marda/TWOTB1/xBD/hurricanes/images/florence/hurricane-florence_00000294_post_disaster.png,48,70,1,537,585,867,937,560,37.49937965144293,20.47219605883144
11503,/media/marda/TWOTB1/xBD/hurricanes/images/florence/hurricane-florence_00000294_post_disaster.png,31,59,1,131,162,869,928,350,30.954293523211714,15.00921751584796
11504,/media/marda/TWOTB1/xBD/hurricanes/images/florence/hurricane-florence_00000294_post_disaster.png,46,65,1,505,551,900,965,399,31.091308559119742,16.957684268397617
11505,/media/marda/TWOTB1/xBD/hurricanes/images/florence/hurricane-florence_00000294_post_disaster.png,83,97,1,570,653,944,1041,1613,75.8599357732162,28.681304823833166
11506,/media/marda/TWOTB1/xBD/hurricanes/images/florence/hurricane-florence_00000294_post_disaster.png,63,76,1,435,498,961,1037,744,56.35045728709168,17.550501791924034
11507,/media/marda/TWOTB1/xBD/hurricanes/images/florence/hurricane-florence_00000294_post_disaster.png,62,71,1,542,604,970,1041,842,43.276610237731774,25.882440613177792
11508,/media/marda/TWOTB1/xBD/hurricanes/images/florence/hurricane-florence_00000294_post_disaster.png,31,51,1,52,83,992,1043,206,27.312647561363566,10.86944510836857
11509,/media/marda/TWOTB1/xBD/hurricanes/images/florence/hurricane-florence_00000031_pre_disaster.png,54,44,1,407,461,0,44,1296,47.40870369008179,36.40278331357407
11510,/media/marda/TWOTB1/xBD/hurricanes/images/florence/hurricane-florence_00000031_pre_disaster.png,75,61,1,862,937,83,144,1881,62.43872416941272,40.87296752356686
11511,/media/marda/TWOTB1/xBD/hurricanes/images/florence/hurricane-florence_00000031_pre_disaster.png,62,65,1,555,617,145,210,1925,65.52570964307569,39.91486484480519
11512,/media/marda/TWOTB1/xBD/hurricanes/images/florence/hurricane-florence_00000031_pre_disaster.png,31,32,1,371,402,337,369,261,19.454362513901962,17.890282573429165
11513,/media/marda/TWOTB1/xBD/hurricanes/images/florence/hurricane-florence_00000031_pre_disaster.png,45,59,1,251,296,359,418,1158,47.55067216854152,32.8160759385976
11514,/media/marda/TWOTB1/xBD/hurricanes/images/florence/hurricane-florence_00000031_pre_disaster.png,27,25,1,330,357,366,391,109,12.571131342685746,11.4349687057993
11515,/media/marda/TWOTB1/xBD/hurricanes/images/florence/hurricane-florence_00000031_pre_disaster.png,47,36,1,332,379,397,433,395,38.8105390430015,13.533462308418237
11516,/media/marda/TWOTB1/xBD/hurricanes/images/florence/hurricane-florence_00000031_pre_disaster.png,23,39,1,122,145,570,609,246,19.709861993292165,16.702856516827985
11517,/media/marda/TWOTB1/xBD/hurricanes/images/florence/hurricane-florence_00000031_pre_disaster.png,39,39,1,66,105,571,610,415,40.97158378144253,13.480936590994466
11518,/media/marda/TWOTB1/xBD/hurricanes/images/florence/hurricane-florence_00000031_pre_disaster.png,48,51,1,9,57,580,631,995,53.18850785686782,24.51264053354367
11519,/media/marda/TWOTB1/xBD/hurricanes/images/florence/hurricane-florence_00000031_pre_disaster.png,34,57,1,0,34,932,989,523,38.113557204692654,18.261967247314967
11520,/media/marda/TWOTB1/xBD/hurricanes/images/florence/hurricane-florence_00000420_pre_disaster.png,40,25,1,6,46,0,25,652,40.04204921433622,21.903012097967963
11521,/media/marda/TWOTB1/xBD/hurricanes/images/florence/hurricane-florence_00000420_pre_disaster.png,36,43,1,31,67,110,153,724,41.289402572682505,23.234472442645973
11522,/media/marda/TWOTB1/xBD/hurricanes/images/florence/hurricane-florence_00000420_pre_disaster.png,22,28,1,49,71,206,234,220,18.315998320767815,16.07828700302514
11523,/media/marda/TWOTB1/xBD/hurricanes/images/florence/hurricane-florence_00000420_pre_disaster.png,42,39,1,189,231,241,280,515,36.64650675388312,18.76931505825344
11524,/media/marda/TWOTB1/xBD/hurricanes/images/florence/hurricane-florence_00000420_pre_disaster.png,10,40,1,0,10,517,557,114,16.95788856307949,10.20119426893973
11525,/media/marda/TWOTB1/xBD/hurricanes/images/florence/hurricane-florence_00000420_pre_disaster.png,49,71,1,0,49,560,631,1540,51.275179187246145,42.85178411980683
11526,/media/marda/TWOTB1/xBD/hurricanes/images/florence/hurricane-florence_00000420_pre_disaster.png,75,76,1,294,369,735,811,1969,71.67343085974775,38.449514019565896
11527,/media/marda/TWOTB1/xBD/hurricanes/images/florence/hurricane-florence_00000420_pre_disaster.png,62,76,1,132,194,837,913,1793,62.382674661487634,41.35440905127428
11528,/media/marda/TWOTB1/xBD/hurricanes/images/florence/hurricane-florence_00000302_pre_disaster.png,75,45,1,787,862,58,103,915,45.97636010868128,26.54933534632693
11529,/media/marda/TWOTB1/xBD/hurricanes/images/florence/hurricane-florence_00000302_pre_disaster.png,58,44,1,986,1044,280,324,375,33.088630310518575,16.565911617818887
11530,/media/marda/TWOTB1/xBD/hurricanes/images/florence/hurricane-florence_00000302_pre_disaster.png,89,78,1,687,776,310,388,1803,70.91490538955254,33.855013221847486
11531,/media/marda/TWOTB1/xBD/hurricanes/images/florence/hurricane-florence_00000302_pre_disaster.png,56,41,1,650,706,340,381,463,28.262111285592386,21.88849783278559
11532,/media/marda/TWOTB1/xBD/hurricanes/images/florence/hurricane-florence_00000302_pre_disaster.png,57,38,1,980,1037,502,540,201,18.764910234880446,14.235246182439257
11533,/media/marda/TWOTB1/xBD/hurricanes/images/florence/hurricane-florence_00000302_pre_disaster.png,81,73,1,930,1011,508,581,1290,56.63843896479948,30.120785413621434
11534,/media/marda/TWOTB1/xBD/hurricanes/images/florence/hurricane-florence_00000302_pre_disaster.png,57,45,1,987,1044,570,615,280,23.197619408265286,16.40041825976997
11535,/media/marda/TWOTB1/xBD/hurricanes/images/florence/hurricane-florence_00000302_pre_disaster.png,59,60,1,711,770,804,864,439,32.06859839776743,18.086690983275293
11536,/media/marda/TWOTB1/xBD/hurricanes/images/florence/hurricane-florence_00000302_pre_disaster.png,79,80,1,690,769,914,994,1192,46.740223132928975,34.547624645609986
11537,/media/marda/TWOTB1/xBD/hurricanes/images/florence/hurricane-florence_00000302_pre_disaster.png,85,98,1,487,572,935,1033,1842,74.8728450733214,34.697956483327964
11538,/media/marda/TWOTB1/xBD/hurricanes/images/florence/hurricane-florence_00000302_pre_disaster.png,65,74,1,759,824,957,1031,659,34.13556719733166,25.766740347777016
11539,/media/marda/TWOTB1/xBD/hurricanes/images/florence/hurricane-florence_00000156_pre_disaster.png,47,45,1,196,243,318,363,804,40.76075595688809,26.09953085468151
11540,/media/marda/TWOTB1/xBD/hurricanes/images/florence/hurricane-florence_00000156_pre_disaster.png,21,27,1,272,293,361,388,126,15.460675566990657,10.997606776095687
11541,/media/marda/TWOTB1/xBD/hurricanes/images/florence/hurricane-florence_00000156_pre_disaster.png,20,24,1,269,289,376,400,82,11.165219909949816,9.912854968713752
11542,/media/marda/TWOTB1/xBD/hurricanes/images/florence/hurricane-florence_00000156_pre_disaster.png,21,26,1,328,349,420,446,78,10.57674055686882,9.8413991769168
11543,/media/marda/TWOTB1/xBD/hurricanes/images/florence/hurricane-florence_00000156_pre_disaster.png,52,38,1,341,393,460,498,732,44.37260311876328,21.86010187543345
11544,/media/marda/TWOTB1/xBD/hurricanes/images/florence/hurricane-florence_00000175_pre_disaster.png,64,9,1,540,604,0,9,205,41.10957224955031,7.664777624851214
11545,/media/marda/TWOTB1/xBD/hurricanes/images/florence/hurricane-florence_00000175_pre_disaster.png,98,61,1,696,794,0,61,3019,68.15642440315538,59.160100153604155
11546,/media/marda/TWOTB1/xBD/hurricanes/images/florence/hurricane-florence_00000175_pre_disaster.png,32,24,1,516,548,348,372,144,13.808210118138652,13.808210118138652
11547,/media/marda/TWOTB1/xBD/hurricanes/images/florence/hurricane-florence_00000175_pre_disaster.png,55,68,1,197,252,758,826,1235,46.57963301741336,35.44402998413383
11548,/media/marda/TWOTB1/xBD/hurricanes/images/florence/hurricane-florence_00000175_pre_disaster.png,64,84,1,158,222,875,959,1569,51.79289592356359,42.703998782679754
11549,/media/marda/TWOTB1/xBD/hurricanes/images/florence/hurricane-florence_00000488_pre_disaster.png,40,23,1,148,188,0,23,532,35.21691819310722,20.864551996383398
11550,/media/marda/TWOTB1/xBD/hurricanes/images/florence/hurricane-florence_00000488_pre_disaster.png,70,42,1,550,620,5,47,1191,44.52176331928544,36.01936799638872
11551,/media/marda/TWOTB1/xBD/hurricanes/images/florence/hurricane-florence_00000488_pre_disaster.png,35,31,1,51,86,32,63,459,41.801282587315924,14.63517433470607
11552,/media/marda/TWOTB1/xBD/hurricanes/images/florence/hurricane-florence_00000488_pre_disaster.png,31,46,1,112,143,45,91,567,51.81949567232047,14.541813751229089
11553,/media/marda/TWOTB1/xBD/hurricanes/images/florence/hurricane-florence_00000488_pre_disaster.png,85,59,1,687,772,56,115,1862,58.8087265035997,42.76400341598098
11554,/media/marda/TWOTB1/xBD/hurricanes/images/florence/hurricane-florence_00000488_pre_disaster.png,36,18,1,547,583,99,117,166,16.38348598139491,13.597153816763035
11555,/media/marda/TWOTB1/xBD/hurricanes/images/florence/hurricane-florence_00000488_pre_disaster.png,49,29,1,13,62,116,145,518,55.02428815266253,12.585668829019827
11556,/media/marda/TWOTB1/xBD/hurricanes/images/florence/hurricane-florence_00000488_pre_disaster.png,46,32,1,80,126,133,165,535,48.18373768365272,16.33415439742671
11557,/media/marda/TWOTB1/xBD/hurricanes/images/florence/hurricane-florence_00000488_pre_disaster.png,32,21,1,141,173,159,180,221,30.998677380465757,9.55199653854317
11558,/media/marda/TWOTB1/xBD/hurricanes/images/florence/hurricane-florence_00000488_pre_disaster.png,21,19,1,99,120,165,184,147,18.248409003721406,10.814562058001654
11559,/media/marda/TWOTB1/xBD/hurricanes/images/florence/hurricane-florence_00000488_pre_disaster.png,28,57,1,94,122,207,264,702,54.01349238135316,20.80256663786779
11560,/media/marda/TWOTB1/xBD/hurricanes/images/florence/hurricane-florence_00000488_pre_disaster.png,27,39,1,47,74,209,248,573,32.650606750102305,23.35507632837524
11561,/media/marda/TWOTB1/xBD/hurricanes/images/florence/hurricane-florence_00000488_pre_disaster.png,13,19,1,117,130,209,228,57,10.927764526083145,7.135527791323865
11562,/media/marda/TWOTB1/xBD/hurricanes/images/florence/hurricane-florence_00000488_pre_disaster.png,37,52,1,146,183,230,282,638,47.908220506837964,23.98194229714391
11563,/media/marda/TWOTB1/xBD/hurricanes/images/florence/hurricane-florence_00000488_pre_disaster.png,32,51,1,209,241,244,295,585,45.7009855285346,20.27365551829953
11564,/media/marda/TWOTB1/xBD/hurricanes/images/florence/hurricane-florence_00000488_pre_disaster.png,66,36,1,295,361,272,308,627,62.94935990960231,13.331075290982033
11565,/media/marda/TWOTB1/xBD/hurricanes/images/florence/hurricane-florence_00000488_pre_disaster.png,32,59,1,132,164,329,388,672,50.495226538129806,19.16830507440106
11566,/media/marda/TWOTB1/xBD/hurricanes/images/florence/hurricane-florence_00000488_pre_disaster.png,27,47,1,187,214,351,398,484,34.67270587755416,19.57610784893384
11567,/media/marda/TWOTB1/xBD/hurricanes/images/florence/hurricane-florence_00000488_pre_disaster.png,21,31,1,93,114,370,401,203,17.873205320170825,15.215175839303551
11568,/media/marda/TWOTB1/xBD/hurricanes/images/florence/hurricane-florence_00000488_pre_disaster.png,34,46,1,247,281,373,419,410,35.943557668761436,18.49903084444715
11569,/media/marda/TWOTB1/xBD/hurricanes/images/florence/hurricane-florence_00000488_pre_disaster.png,21,32,1,195,216,404,436,148,14.304836024489811,13.896592200456798
11570,/media/marda/TWOTB1/xBD/hurricanes/images/florence/hurricane-florence_00000488_pre_disaster.png,13,42,1,0,13,536,578,159,18.4116733674945,13.035065706618239
11571,/media/marda/TWOTB1/xBD/hurricanes/images/florence/hurricane-florence_00000488_pre_disaster.png,35,78,1,0,35,958,1036,880,39.91572853920806,29.85478884261524
11572,/media/marda/TWOTB1/xBD/hurricanes/images/florence/hurricane-florence_00000050_pre_disaster.png,43,36,1,482,525,47,83,553,37.97877264226038,19.470210824079405
11573,/media/marda/TWOTB1/xBD/hurricanes/images/florence/hurricane-florence_00000050_pre_disaster.png,78,80,1,511,589,102,182,3152,81.00369075526456,54.28635579349613
11574,/media/marda/TWOTB1/xBD/hurricanes/images/florence/hurricane-florence_00000050_pre_disaster.png,43,68,1,367,410,137,205,1336,71.70623927643669,24.871769690892286
11575,/media/marda/TWOTB1/xBD/hurricanes/images/florence/hurricane-florence_00000050_pre_disaster.png,61,55,1,422,483,159,214,1765,51.36357199437959,46.48054693532784
11576,/media/marda/TWOTB1/xBD/hurricanes/images/florence/hurricane-florence_00000050_pre_disaster.png,50,42,1,467,517,259,301,766,32.8022309557462,31.040324279349566
11577,/media/marda/TWOTB1/xBD/hurricanes/images/florence/hurricane-florence_00000050_pre_disaster.png,62,58,1,438,500,316,374,1034,47.56652998274081,28.812348924949255
11578,/media/marda/TWOTB1/xBD/hurricanes/images/florence/hurricane-florence_00000050_pre_disaster.png,47,59,1,319,366,320,379,916,45.93676542072459,26.85312624252511
11579,/media/marda/TWOTB1/xBD/hurricanes/images/florence/hurricane-florence_00000126_post_disaster.png,179,179,1,162,341,393,572,20000,167.19978174733728,159.4367621594304
11580,/media/marda/TWOTB1/xBD/hurricanes/images/florence/hurricane-florence_00000354_pre_disaster.png,55,46,1,652,707,67,113,1110,49.0414755205836,30.221768650852002
11581,/media/marda/TWOTB1/xBD/hurricanes/images/florence/hurricane-florence_00000354_pre_disaster.png,27,17,1,463,490,98,115,110,17.78882022894103,8.323750177124419
11582,/media/marda/TWOTB1/xBD/hurricanes/images/florence/hurricane-florence_00000354_pre_disaster.png,74,76,1,415,489,105,181,2616,71.5742648991559,49.0934631937197
11583,/media/marda/TWOTB1/xBD/hurricanes/images/florence/hurricane-florence_00000354_pre_disaster.png,55,54,1,490,545,127,181,979,53.878813326141035,24.262445103605096
11584,/media/marda/TWOTB1/xBD/hurricanes/images/florence/hurricane-florence_00000354_pre_disaster.png,92,50,1,700,792,127,177,1607,66.43059111441839,32.84649348491289
11585,/media/marda/TWOTB1/xBD/hurricanes/images/florence/hurricane-florence_00000354_pre_disaster.png,42,38,1,376,418,151,189,544,33.11644441260726,21.590788788387407
11586,/media/marda/TWOTB1/xBD/hurricanes/images/florence/hurricane-florence_00000354_pre_disaster.png,65,65,1,824,889,222,287,1450,63.13216596221621,30.626209722872034
11587,/media/marda/TWOTB1/xBD/hurricanes/images/florence/hurricane-florence_00000354_pre_disaster.png,50,44,1,554,604,316,360,615,32.63476978803599,25.129904357876786
11588,/media/marda/TWOTB1/xBD/hurricanes/images/florence/hurricane-florence_00000354_pre_disaster.png,47,58,1,514,561,334,392,553,51.34516625469444,14.38969191911458
11589,/media/marda/TWOTB1/xBD/hurricanes/images/florence/hurricane-florence_00000354_pre_disaster.png,72,51,1,459,531,362,413,1114,58.4425172401629,25.390071064031773
11590,/media/marda/TWOTB1/xBD/hurricanes/images/florence/hurricane-florence_00000354_pre_disaster.png,65,37,1,972,1037,416,453,329,24.495430167142462,17.968962967906883
11591,/media/marda/TWOTB1/xBD/hurricanes/images/florence/hurricane-florence_00000354_pre_disaster.png,43,43,1,339,382,435,478,535,32.21589391004943,21.854947695016655
11592,/media/marda/TWOTB1/xBD/hurricanes/images/florence/hurricane-florence_00000354_pre_disaster.png,90,61,1,813,903,451,512,1708,57.64854496756732,39.57125505659439
11593,/media/marda/TWOTB1/xBD/hurricanes/images/florence/hurricane-florence_00000354_pre_disaster.png,62,73,1,648,710,492,565,1239,54.50248379864893,33.3212309183076
11594,/media/marda/TWOTB1/xBD/hurricanes/images/florence/hurricane-florence_00000354_pre_disaster.png,48,35,1,917,965,494,529,110,14.796361977892275,10.030922577528646
11595,/media/marda/TWOTB1/xBD/hurricanes/images/florence/hurricane-florence_00000354_pre_disaster.png,62,42,1,878,940,503,545,367,29.213168377040297,16.57186197194253
11596,/media/marda/TWOTB1/xBD/hurricanes/images/florence/hurricane-florence_00000354_pre_disaster.png,38,38,1,625,663,507,545,180,19.21730738399348,12.618574810272474
11597,/media/marda/TWOTB1/xBD/hurricanes/images/florence/hurricane-florence_00000354_pre_disaster.png,48,50,1,550,598,528,578,545,27.547198632186007,26.13855434528987
11598,/media/marda/TWOTB1/xBD/hurricanes/images/florence/hurricane-florence_00000354_pre_disaster.png,77,63,1,653,730,614,677,1261,50.213693423190605,33.20162835303411
11599,/media/marda/TWOTB1/xBD/hurricanes/images/florence/hurricane-florence_00000354_pre_disaster.png,37,40,1,639,676,641,681,134,15.213541377857398,11.856014887736269
11600,/media/marda/TWOTB1/xBD/hurricanes/images/florence/hurricane-florence_00000354_pre_disaster.png,53,45,1,681,734,657,702,353,27.529956560816277,17.15047405571271
11601,/media/marda/TWOTB1/xBD/hurricanes/images/florence/hurricane-florence_00000354_pre_disaster.png,58,80,1,665,723,686,766,989,53.20190520588389,25.17085219247453
11602,/media/marda/TWOTB1/xBD/hurricanes/images/florence/hurricane-florence_00000354_pre_disaster.png,47,58,1,555,602,723,781,448,27.109345454230283,22.494582029365574
11603,/media/marda/TWOTB1/xBD/hurricanes/images/florence/hurricane-florence_00000354_pre_disaster.png,70,69,1,904,974,756,825,764,37.6756730838041,29.259604460158027
11604,/media/marda/TWOTB1/xBD/hurricanes/images/florence/hurricane-florence_00000354_pre_disaster.png,79,82,1,702,781,761,843,1760,50.23202417326068,46.04118358925982
11605,/media/marda/TWOTB1/xBD/hurricanes/images/florence/hurricane-florence_00000354_pre_disaster.png,47,44,1,960,1007,832,876,75,12.63613232281595,8.02261137371238
11606,/media/marda/TWOTB1/xBD/hurricanes/images/florence/hurricane-florence_00000354_pre_disaster.png,96,111,1,948,1044,868,979,2033,93.87667066772246,37.857984700394844
11607,/media/marda/TWOTB1/xBD/hurricanes/images/florence/hurricane-florence_00000354_pre_disaster.png,37,37,1,960,997,883,920,1,0.0,0.0
11608,/media/marda/TWOTB1/xBD/hurricanes/images/florence/hurricane-florence_00000354_pre_disaster.png,59,82,1,557,616,899,981,1058,41.55650116826294,33.86916861029391
11609,/media/marda/TWOTB1/xBD/hurricanes/images/florence/hurricane-florence_00000354_pre_disaster.png,42,56,1,504,546,953,1009,246,21.199646875637523,15.548696544025514
11610,/media/marda/TWOTB1/xBD/hurricanes/images/florence/hurricane-florence_00000354_pre_disaster.png,68,61,1,966,1034,957,1018,477,29.8510442780721,21.35981287845884
11611,/media/marda/TWOTB1/xBD/hurricanes/images/florence/hurricane-florence_00000354_pre_disaster.png,69,63,1,799,868,979,1042,677,37.74295716992027,23.714319936088756
11612,/media/marda/TWOTB1/xBD/hurricanes/images/florence/hurricane-florence_00000037_pre_disaster.png,30,10,1,357,387,0,10,110,16.201375017224727,9.347722201753955
11613,/media/marda/TWOTB1/xBD/hurricanes/images/florence/hurricane-florence_00000037_pre_disaster.png,77,35,1,946,1023,24,59,799,41.65092730887514,25.74179885314124
11614,/media/marda/TWOTB1/xBD/hurricanes/images/florence/hurricane-florence_00000037_pre_disaster.png,50,33,1,312,362,38,71,631,32.858898975484024,25.680071014621802
11615,/media/marda/TWOTB1/xBD/hurricanes/images/florence/hurricane-florence_00000037_pre_disaster.png,33,31,1,329,362,146,177,256,27.559617693571422,12.91765884687257
11616,/media/marda/TWOTB1/xBD/hurricanes/images/florence/hurricane-florence_00000037_pre_disaster.png,32,27,1,333,365,197,224,170,22.070755132384566,10.197759255732478
11617,/media/marda/TWOTB1/xBD/hurricanes/images/florence/hurricane-florence_00000037_pre_disaster.png,66,65,1,336,402,212,277,1265,66.9229517541858,25.23672504400234
11618,/media/marda/TWOTB1/xBD/hurricanes/images/florence/hurricane-florence_00000037_pre_disaster.png,54,58,1,360,414,480,538,818,39.37292747343489,27.79254194796892
11619,/media/marda/TWOTB1/xBD/hurricanes/images/florence/hurricane-florence_00000037_pre_disaster.png,40,60,1,155,195,557,617,746,43.55185997235543,22.41225272355794
11620,/media/marda/TWOTB1/xBD/hurricanes/images/florence/hurricane-florence_00000037_pre_disaster.png,53,65,1,299,352,564,629,885,44.45364413802018,26.578990308609225
11621,/media/marda/TWOTB1/xBD/hurricanes/images/florence/hurricane-florence_00000037_pre_disaster.png,49,59,1,263,312,647,706,728,39.89196054117549,23.81647281928337
11622,/media/marda/TWOTB1/xBD/hurricanes/images/florence/hurricane-florence_00000037_pre_disaster.png,30,59,1,53,83,654,713,536,33.81409214829306,20.997169323834814
11623,/media/marda/TWOTB1/xBD/hurricanes/images/florence/hurricane-florence_00000037_pre_disaster.png,46,84,1,136,182,859,943,764,61.260598836215834,16.651791069511113
11624,/media/marda/TWOTB1/xBD/hurricanes/images/florence/hurricane-florence_00000037_pre_disaster.png,38,84,1,45,83,921,1005,690,54.263849226264526,16.990994626659443
11625,/media/marda/TWOTB1/xBD/hurricanes/images/florence/hurricane-florence_00000340_pre_disaster.png,55,12,1,775,830,0,12,204,26.28269891043499,10.773908322251648
11626,/media/marda/TWOTB1/xBD/hurricanes/images/florence/hurricane-florence_00000340_pre_disaster.png,65,49,1,743,808,45,94,1034,50.207583071884436,27.40850566363514
11627,/media/marda/TWOTB1/xBD/hurricanes/images/florence/hurricane-florence_00000340_pre_disaster.png,68,52,1,718,786,119,171,1088,48.87776953051086,29.708113032582418
11628,/media/marda/TWOTB1/xBD/hurricanes/images/florence/hurricane-florence_00000340_pre_disaster.png,39,27,1,471,510,165,192,340,22.00202640436992,20.68833406249376
11629,/media/marda/TWOTB1/xBD/hurricanes/images/florence/hurricane-florence_00000340_pre_disaster.png,50,43,1,491,541,195,238,706,39.1130069584459,24.13328469084986
11630,/media/marda/TWOTB1/xBD/hurricanes/images/florence/hurricane-florence_00000340_pre_disaster.png,60,55,1,677,737,269,324,990,46.504097190542055,28.15714307506342
11631,/media/marda/TWOTB1/xBD/hurricanes/images/florence/hurricane-florence_00000340_pre_disaster.png,49,53,1,449,498,271,324,857,46.06473535995674,24.841682051252903
11632,/media/marda/TWOTB1/xBD/hurricanes/images/florence/hurricane-florence_00000340_pre_disaster.png,51,53,1,566,617,301,354,754,40.853681981536276,24.65407569935144
11633,/media/marda/TWOTB1/xBD/hurricanes/images/florence/hurricane-florence_00000340_pre_disaster.png,60,57,1,627,687,345,402,1031,47.85433706865039,28.643045785837565
11634,/media/marda/TWOTB1/xBD/hurricanes/images/florence/hurricane-florence_00000340_pre_disaster.png,71,59,1,423,494,423,482,1480,52.695533647689395,37.394131779073675
11635,/media/marda/TWOTB1/xBD/hurricanes/images/florence/hurricane-florence_00000340_pre_disaster.png,69,76,1,613,682,439,515,1522,60.220822065965244,38.036082070306854
11636,/media/marda/TWOTB1/xBD/hurricanes/images/florence/hurricane-florence_00000340_pre_disaster.png,64,52,1,509,573,446,498,954,45.54542827404187,27.914518974011678
11637,/media/marda/TWOTB1/xBD/hurricanes/images/florence/hurricane-florence_00000340_pre_disaster.png,32,30,1,574,606,482,512,113,12.829987601049009,11.867124712846678
11638,/media/marda/TWOTB1/xBD/hurricanes/images/florence/hurricane-florence_00000340_pre_disaster.png,51,39,1,422,473,491,530,793,39.82792734204361,26.527989771590633
11639,/media/marda/TWOTB1/xBD/hurricanes/images/florence/hurricane-florence_00000340_pre_disaster.png,56,43,1,490,546,491,534,759,39.548514572790964,25.649139650682354
11640,/media/marda/TWOTB1/xBD/hurricanes/images/florence/hurricane-florence_00000340_pre_disaster.png,31,31,1,571,602,496,527,74,10.477126781232585,9.627716560555156
11641,/media/marda/TWOTB1/xBD/hurricanes/images/florence/hurricane-florence_00000340_pre_disaster.png,44,46,1,414,458,763,809,460,31.27233615361998,19.638100217506715
11642,/media/marda/TWOTB1/xBD/hurricanes/images/florence/hurricane-florence_00000340_pre_disaster.png,42,77,1,451,493,795,872,937,47.65150993617855,26.56437197727702
11643,/media/marda/TWOTB1/xBD/hurricanes/images/florence/hurricane-florence_00000340_pre_disaster.png,44,73,1,416,460,800,873,994,47.03779817477743,28.968722167802643
11644,/media/marda/TWOTB1/xBD/hurricanes/images/florence/hurricane-florence_00000340_pre_disaster.png,50,90,1,487,537,862,952,1028,62.40482645683889,21.98877893361066
11645,/media/marda/TWOTB1/xBD/hurricanes/images/florence/hurricane-florence_00000340_pre_disaster.png,46,83,1,217,263,883,966,1100,51.919681362153874,28.766435497283176
11646,/media/marda/TWOTB1/xBD/hurricanes/images/florence/hurricane-florence_00000340_pre_disaster.png,29,47,1,316,345,921,968,166,19.148321585414486,11.572987037652394
11647,/media/marda/TWOTB1/xBD/hurricanes/images/florence/hurricane-florence_00000456_post_disaster.png,43,22,1,392,435,100,122,298,30.97916585884332,13.496213381576494
11648,/media/marda/TWOTB1/xBD/hurricanes/images/florence/hurricane-florence_00000456_post_disaster.png,57,35,1,353,410,171,206,690,46.202683358458145,19.950787343672296
11649,/media/marda/TWOTB1/xBD/hurricanes/images/florence/hurricane-florence_00000456_post_disaster.png,66,47,1,277,343,116,163,1372,57.27114750616543,31.530946215996956
11650,/media/marda/TWOTB1/xBD/hurricanes/images/florence/hurricane-florence_00000456_post_disaster.png,31,29,1,319,350,174,203,348,23.77579884614406,18.891679689995012
11651,/media/marda/TWOTB1/xBD/hurricanes/images/florence/hurricane-florence_00000456_post_disaster.png,90,55,1,336,426,242,297,1532,85.07045518349575,24.031551693459342
11652,/media/marda/TWOTB1/xBD/hurricanes/images/florence/hurricane-florence_00000456_post_disaster.png,41,19,1,499,540,65,84,213,18.26261771608995,15.632244613561317
11653,/media/marda/TWOTB1/xBD/hurricanes/images/florence/hurricane-florence_00000478_pre_disaster.png,77,17,1,519,596,55,72,740,65.43615628873896,15.099430793000185
11654,/media/marda/TWOTB1/xBD/hurricanes/images/florence/hurricane-florence_00000478_pre_disaster.png,53,18,1,586,639,229,247,202,35.459569605410564,7.669297200935851
11655,/media/marda/TWOTB1/xBD/hurricanes/images/florence/hurricane-florence_00000478_pre_disaster.png,50,17,1,585,635,245,262,221,31.877219856790827,9.223150127334593
11656,/media/marda/TWOTB1/xBD/hurricanes/images/florence/hurricane-florence_00000478_pre_disaster.png,53,17,1,579,632,258,275,219,36.072835020670716,8.105011587954603
11657,/media/marda/TWOTB1/xBD/hurricanes/images/florence/hurricane-florence_00000478_pre_disaster.png,34,41,1,289,323,361,402,491,29.775475275103645,21.96617523766172
11658,/media/marda/TWOTB1/xBD/hurricanes/images/florence/hurricane-florence_00000478_pre_disaster.png,23,27,1,235,258,365,392,119,13.464478805633526,11.936185168427915
11659,/media/marda/TWOTB1/xBD/hurricanes/images/florence/hurricane-florence_00000478_pre_disaster.png,58,57,1,274,332,401,458,1280,47.275458876755366,36.67601544723694
11660,/media/marda/TWOTB1/xBD/hurricanes/images/florence/hurricane-florence_00000478_pre_disaster.png,36,29,1,652,688,401,430,132,14.561702286111437,12.152421340498078
11661,/media/marda/TWOTB1/xBD/hurricanes/images/florence/hurricane-florence_00000478_pre_disaster.png,23,31,1,144,167,403,434,162,20.60655766054585,10.516671834439189
11662,/media/marda/TWOTB1/xBD/hurricanes/images/florence/hurricane-florence_00000478_pre_disaster.png,54,35,1,133,187,442,477,552,56.67673424365566,13.008699642297215
11663,/media/marda/TWOTB1/xBD/hurricanes/images/florence/hurricane-florence_00000478_pre_disaster.png,39,32,1,404,443,449,481,212,24.00554188036055,11.855960176675897
11664,/media/marda/TWOTB1/xBD/hurricanes/images/florence/hurricane-florence_00000478_pre_disaster.png,49,30,1,3,52,455,485,568,56.560203665949345,13.388633302718178
11665,/media/marda/TWOTB1/xBD/hurricanes/images/florence/hurricane-florence_00000478_pre_disaster.png,36,33,1,456,492,457,490,208,20.559219304209073,13.545196482712358
11666,/media/marda/TWOTB1/xBD/hurricanes/images/florence/hurricane-florence_00000478_pre_disaster.png,54,54,1,482,536,459,513,909,37.46263787458515,32.39322632248315
11667,/media/marda/TWOTB1/xBD/hurricanes/images/florence/hurricane-florence_00000478_pre_disaster.png,43,50,1,405,448,465,515,586,33.81902828059649,23.138023010967718
11668,/media/marda/TWOTB1/xBD/hurricanes/images/florence/hurricane-florence_00000478_pre_disaster.png,59,47,1,368,427,487,534,802,47.00115424566531,22.784407157959315
11669,/media/marda/TWOTB1/xBD/hurricanes/images/florence/hurricane-florence_00000478_pre_disaster.png,66,56,1,450,516,511,567,977,49.40086485267948,26.925957758808835
11670,/media/marda/TWOTB1/xBD/hurricanes/images/florence/hurricane-florence_00000478_pre_disaster.png,61,41,1,718,779,539,580,290,36.330454607589566,10.658405669075826
11671,/media/marda/TWOTB1/xBD/hurricanes/images/florence/hurricane-florence_00000478_pre_disaster.png,53,39,1,22,75,544,583,810,61.268315921324344,18.44783596492096
11672,/media/marda/TWOTB1/xBD/hurricanes/images/florence/hurricane-florence_00000478_pre_disaster.png,36,54,1,134,170,554,608,713,32.67627622127245,29.139996520842836
11673,/media/marda/TWOTB1/xBD/hurricanes/images/florence/hurricane-florence_00000478_pre_disaster.png,51,50,1,626,677,569,619,448,29.633544095387098,20.098487652765847
11674,/media/marda/TWOTB1/xBD/hurricanes/images/florence/hurricane-florence_00000478_pre_disaster.png,22,50,1,53,75,589,639,258,29.40979674433934,11.547353065442474
11675,/media/marda/TWOTB1/xBD/hurricanes/images/florence/hurricane-florence_00000478_pre_disaster.png,20,34,1,228,248,593,627,70,11.289032502847839,8.40035168400414
11676,/media/marda/TWOTB1/xBD/hurricanes/images/florence/hurricane-florence_00000478_pre_disaster.png,53,42,1,278,331,594,636,494,48.96359185968521,13.504307028405034
11677,/media/marda/TWOTB1/xBD/hurricanes/images/florence/hurricane-florence_00000478_pre_disaster.png,28,42,1,178,206,597,639,287,23.7213022942947,15.999989629204928
11678,/media/marda/TWOTB1/xBD/hurricanes/images/florence/hurricane-florence_00000478_pre_disaster.png,76,69,1,563,639,597,666,1392,50.66138865541508,38.00739350223961
11679,/media/marda/TWOTB1/xBD/hurricanes/images/florence/hurricane-florence_00000478_pre_disaster.png,17,35,1,154,171,619,654,98,13.098624402236698,10.11724107068797
11680,/media/marda/TWOTB1/xBD/hurricanes/images/florence/hurricane-florence_00000478_pre_disaster.png,55,71,1,690,745,782,853,586,43.93418768076866,17.824995052391564
11681,/media/marda/TWOTB1/xBD/hurricanes/images/florence/hurricane-florence_00000478_pre_disaster.png,74,73,1,598,672,786,859,1169,50.208720015866746,30.832550340220777
11682,/media/marda/TWOTB1/xBD/hurricanes/images/florence/hurricane-florence_00000478_pre_disaster.png,81,68,1,883,964,877,945,933,51.59929239796501,23.672892308643114
11683,/media/marda/TWOTB1/xBD/hurricanes/images/florence/hurricane-florence_00000478_pre_disaster.png,55,55,1,928,983,905,960,209,17.079925155674907,16.382033643583192
11684,/media/marda/TWOTB1/xBD/hurricanes/images/florence/hurricane-florence_00000150_post_disaster.png,47,51,1,542,589,691,742,315,26.580065827034286,15.847866897820126
11685,/media/marda/TWOTB1/xBD/hurricanes/images/florence/hurricane-florence_00000150_post_disaster.png,62,67,1,605,667,707,774,670,42.67019248028093,20.894374329976923
11686,/media/marda/TWOTB1/xBD/hurricanes/images/florence/hurricane-florence_00000150_post_disaster.png,61,66,1,560,621,740,806,877,35.008930452683224,33.582764099834925
11687,/media/marda/TWOTB1/xBD/hurricanes/images/florence/hurricane-florence_00000150_post_disaster.png,54,59,1,41,95,757,816,1124,59.18442302320697,25.352724455365923
11688,/media/marda/TWOTB1/xBD/hurricanes/images/florence/hurricane-florence_00000150_post_disaster.png,55,62,1,531,586,797,859,609,35.9264712855036,22.3787261770335
11689,/media/marda/TWOTB1/xBD/hurricanes/images/florence/hurricane-florence_00000150_post_disaster.png,73,67,1,566,639,813,880,1257,55.41027857996539,30.770647532266032
11690,/media/marda/TWOTB1/xBD/hurricanes/images/florence/hurricane-florence_00000150_post_disaster.png,44,59,1,337,381,852,911,481,33.89249697412015,18.832945627865907
11691,/media/marda/TWOTB1/xBD/hurricanes/images/florence/hurricane-florence_00000512_pre_disaster.png,37,42,1,338,375,661,703,348,27.117424743606172,16.999856568198723
11692,/media/marda/TWOTB1/xBD/hurricanes/images/florence/hurricane-florence_00000512_pre_disaster.png,49,53,1,342,391,697,750,695,40.752862125181814,22.786579438790625
11693,/media/marda/TWOTB1/xBD/hurricanes/images/florence/hurricane-florence_00000512_pre_disaster.png,59,63,1,807,866,797,860,772,35.50314165687545,28.70555202809615
11694,/media/marda/TWOTB1/xBD/hurricanes/images/florence/hurricane-florence_00000512_pre_disaster.png,71,69,1,587,658,804,873,1112,48.60170868917905,32.946301284795226
11695,/media/marda/TWOTB1/xBD/hurricanes/images/florence/hurricane-florence_00000512_pre_disaster.png,66,54,1,347,413,832,886,440,58.85809410597084,10.001667523668328
11696,/media/marda/TWOTB1/xBD/hurricanes/images/florence/hurricane-florence_00000512_pre_disaster.png,69,54,1,572,641,871,925,793,53.14015717844191,19.949216892888696
11697,/media/marda/TWOTB1/xBD/hurricanes/images/florence/hurricane-florence_00000022_post_disaster.png,62,13,1,981,1043,0,13,233,25.49832259535553,13.112411831766892
11698,/media/marda/TWOTB1/xBD/hurricanes/images/florence/hurricane-florence_00000022_post_disaster.png,70,72,1,695,765,869,941,974,39.23786751285541,32.724015478297545
11699,/media/marda/TWOTB1/xBD/hurricanes/images/florence/hurricane-florence_00000022_post_disaster.png,77,114,1,529,606,882,996,1996,86.76525922190174,44.59153667568051
11700,/media/marda/TWOTB1/xBD/hurricanes/images/florence/hurricane-florence_00000022_post_disaster.png,48,59,1,532,580,972,1031,350,27.51531603835722,16.997611946410313
11701,/media/marda/TWOTB1/xBD/hurricanes/images/florence/hurricane-florence_00000351_post_disaster.png,50,27,1,334,384,0,27,607,35.30713484279084,22.90947241062968
11702,/media/marda/TWOTB1/xBD/hurricanes/images/florence/hurricane-florence_00000351_post_disaster.png,32,18,1,317,349,19,37,189,20.94129124259933,12.013545973403078
11703,/media/marda/TWOTB1/xBD/hurricanes/images/florence/hurricane-florence_00000351_post_disaster.png,50,38,1,294,344,47,85,704,36.84299137671041,25.523465520982178
11704,/media/marda/TWOTB1/xBD/hurricanes/images/florence/hurricane-florence_00000351_post_disaster.png,20,22,1,66,86,231,253,250,22.377225253183948,14.697169726456401
11705,/media/marda/TWOTB1/xBD/hurricanes/images/florence/hurricane-florence_00000351_post_disaster.png,45,67,1,28,73,247,314,1885,63.199573719995385,43.50766632160182
11706,/media/marda/TWOTB1/xBD/hurricanes/images/florence/hurricane-florence_00000351_post_disaster.png,27,30,1,103,130,252,282,463,25.85297377183837,23.90018723393609
11707,/media/marda/TWOTB1/xBD/hurricanes/images/florence/hurricane-florence_00000351_post_disaster.png,31,33,1,136,167,268,301,651,30.56562637426931,28.355326089843807
11708,/media/marda/TWOTB1/xBD/hurricanes/images/florence/hurricane-florence_00000351_post_disaster.png,15,22,1,87,102,271,293,175,16.226068626250505,14.33176531123117
11709,/media/marda/TWOTB1/xBD/hurricanes/images/florence/hurricane-florence_00000351_post_disaster.png,81,53,1,25,106,326,379,2445,87.71620368981108,38.158281918708894
11710,/media/marda/TWOTB1/xBD/hurricanes/images/florence/hurricane-florence_00000351_post_disaster.png,55,52,1,114,169,333,385,1361,50.11955007342131,36.0522467843197
11711,/media/marda/TWOTB1/xBD/hurricanes/images/florence/hurricane-florence_00000351_post_disaster.png,33,25,1,538,571,346,371,104,13.542446165676482,10.106390755273372
11712,/media/marda/TWOTB1/xBD/hurricanes/images/florence/hurricane-florence_00000351_post_disaster.png,68,52,1,573,641,359,411,899,48.894647539129615,24.429565951795826
11713,/media/marda/TWOTB1/xBD/hurricanes/images/florence/hurricane-florence_00000351_post_disaster.png,15,24,1,55,70,369,393,163,17.099355343461053,12.658807864670228
11714,/media/marda/TWOTB1/xBD/hurricanes/images/florence/hurricane-florence_00000351_post_disaster.png,29,63,1,17,46,379,442,1253,57.189281435176575,29.318674249774435
11715,/media/marda/TWOTB1/xBD/hurricanes/images/florence/hurricane-florence_00000351_post_disaster.png,47,46,1,455,502,387,433,511,36.96160315012289,18.431890436732363
11716,/media/marda/TWOTB1/xBD/hurricanes/images/florence/hurricane-florence_00000351_post_disaster.png,72,76,1,486,558,396,472,1748,58.376804842390726,40.81759175160195
11717,/media/marda/TWOTB1/xBD/hurricanes/images/florence/hurricane-florence_00000351_post_disaster.png,46,43,1,373,419,437,480,386,33.49717021624314,15.384165456017037
11718,/media/marda/TWOTB1/xBD/hurricanes/images/florence/hurricane-florence_00000351_post_disaster.png,67,56,1,409,476,462,518,1270,50.29991510838439,33.269997828039514
11719,/media/marda/TWOTB1/xBD/hurricanes/images/florence/hurricane-florence_00000351_post_disaster.png,25,37,1,53,78,490,527,480,27.90402425463748,22.97154368529665
11720,/media/marda/TWOTB1/xBD/hurricanes/images/florence/hurricane-florence_00000351_post_disaster.png,24,60,1,17,41,494,554,960,46.17358552246078,27.688746209726915
11721,/media/marda/TWOTB1/xBD/hurricanes/images/florence/hurricane-florence_00000351_post_disaster.png,55,57,1,354,409,500,557,828,42.621671092694754,25.801083584300205
11722,/media/marda/TWOTB1/xBD/hurricanes/images/florence/hurricane-florence_00000351_post_disaster.png,47,55,1,307,354,532,587,659,35.29824438693598,24.6979881045811
11723,/media/marda/TWOTB1/xBD/hurricanes/images/florence/hurricane-florence_00000351_post_disaster.png,49,73,1,19,68,569,642,1838,56.6247209897064,46.49390284514353
11724,/media/marda/TWOTB1/xBD/hurricanes/images/florence/hurricane-florence_00000351_post_disaster.png,39,51,1,245,284,578,629,525,28.832223948245783,24.08162675164322
11725,/media/marda/TWOTB1/xBD/hurricanes/images/florence/hurricane-florence_00000351_post_disaster.png,71,84,1,144,215,601,685,1932,58.28898876285536,46.58412586267567
11726,/media/marda/TWOTB1/xBD/hurricanes/images/florence/hurricane-florence_00000351_post_disaster.png,26,41,1,111,137,617,658,190,21.43365017340607,11.869440862721145
11727,/media/marda/TWOTB1/xBD/hurricanes/images/florence/hurricane-florence_00000351_post_disaster.png,16,40,1,34,50,661,701,136,13.503812097939996,13.503812097939996
11728,/media/marda/TWOTB1/xBD/hurricanes/images/florence/hurricane-florence_00000351_post_disaster.png,49,73,1,15,64,708,781,1043,50.83470422607489,27.381645159173665
11729,/media/marda/TWOTB1/xBD/hurricanes/images/florence/hurricane-florence_00000351_post_disaster.png,94,152,1,47,141,889,1041,6168,132.79937716999402,62.0542286085893
11730,/media/marda/TWOTB1/xBD/hurricanes/images/florence/hurricane-florence_00000351_post_disaster.png,22,59,1,140,162,936,995,226,23.43651334030477,12.733493468794775
11731,/media/marda/TWOTB1/xBD/hurricanes/images/florence/hurricane-florence_00000351_post_disaster.png,95,97,1,148,243,944,1041,3513,87.08128223394165,53.25413134968706
11732,/media/marda/TWOTB1/xBD/hurricanes/images/florence/hurricane-florence_00000351_post_disaster.png,13,58,1,0,13,965,1023,189,20.85748165003202,12.509139648787086
11733,/media/marda/TWOTB1/xBD/hurricanes/images/florence/hurricane-florence_00000351_post_disaster.png,41,58,1,0,41,985,1043,509,45.58195381818346,17.470627858095234
11734,/media/marda/TWOTB1/xBD/hurricanes/images/florence/hurricane-florence_00000508_post_disaster.png,263,164,1,0,263,153,317,10628,322.24021662259963,43.99375857678582
11735,/media/marda/TWOTB1/xBD/hurricanes/images/florence/hurricane-florence_00000508_post_disaster.png,317,179,1,36,353,260,439,12713,375.66152021772444,45.05668879085901
11736,/media/marda/TWOTB1/xBD/hurricanes/images/florence/hurricane-florence_00000508_post_disaster.png,320,178,1,115,435,371,549,12242,374.3037569390986,43.555404618283795
11737,/media/marda/TWOTB1/xBD/hurricanes/images/florence/hurricane-florence_00000508_post_disaster.png,323,184,1,187,510,466,650,12274,375.49689812949987,43.52674817701451
11738,/media/marda/TWOTB1/xBD/hurricanes/images/florence/hurricane-florence_00000508_post_disaster.png,293,173,1,280,573,567,740,10859,339.3005468988197,42.57304145932961
11739,/media/marda/TWOTB1/xBD/hurricanes/images/florence/hurricane-florence_00000508_post_disaster.png,65,73,1,626,691,596,669,951,51.400642087910384,24.51625182283772
11740,/media/marda/TWOTB1/xBD/hurricanes/images/florence/hurricane-florence_00000508_post_disaster.png,131,102,1,386,517,677,779,4238,127.42070520055343,44.11519787447954
11741,/media/marda/TWOTB1/xBD/hurricanes/images/florence/hurricane-florence_00000508_post_disaster.png,42,56,1,471,513,791,847,323,23.669175981040347,18.2684659512283
11742,/media/marda/TWOTB1/xBD/hurricanes/images/florence/hurricane-florence_00000508_post_disaster.png,57,89,1,539,596,902,991,1346,52.62465280043518,33.83925703953371
11743,/media/marda/TWOTB1/xBD/hurricanes/images/florence/hurricane-florence_00000508_post_disaster.png,42,50,1,502,544,993,1043,115,20.179102225491828,8.725300310548434
11744,/media/marda/TWOTB1/xBD/hurricanes/images/florence/hurricane-florence_00000354_post_disaster.png,55,46,1,652,707,67,113,1110,49.0414755205836,30.221768650852002
11745,/media/marda/TWOTB1/xBD/hurricanes/images/florence/hurricane-florence_00000354_post_disaster.png,27,17,1,463,490,98,115,110,17.78882022894103,8.323750177124419
11746,/media/marda/TWOTB1/xBD/hurricanes/images/florence/hurricane-florence_00000354_post_disaster.png,74,76,1,415,489,105,181,2616,71.5742648991559,49.0934631937197
11747,/media/marda/TWOTB1/xBD/hurricanes/images/florence/hurricane-florence_00000354_post_disaster.png,55,54,1,490,545,127,181,979,53.878813326141035,24.262445103605096
11748,/media/marda/TWOTB1/xBD/hurricanes/images/florence/hurricane-florence_00000354_post_disaster.png,92,50,1,700,792,127,177,1607,66.43059111441839,32.84649348491289
11749,/media/marda/TWOTB1/xBD/hurricanes/images/florence/hurricane-florence_00000354_post_disaster.png,42,38,1,376,418,151,189,544,33.11644441260726,21.590788788387407
11750,/media/marda/TWOTB1/xBD/hurricanes/images/florence/hurricane-florence_00000354_post_disaster.png,65,65,1,824,889,222,287,1450,63.13216596221621,30.626209722872034
11751,/media/marda/TWOTB1/xBD/hurricanes/images/florence/hurricane-florence_00000354_post_disaster.png,50,44,1,554,604,316,360,615,32.63476978803599,25.129904357876786
11752,/media/marda/TWOTB1/xBD/hurricanes/images/florence/hurricane-florence_00000354_post_disaster.png,47,58,1,514,561,334,392,553,51.34516625469444,14.38969191911458
11753,/media/marda/TWOTB1/xBD/hurricanes/images/florence/hurricane-florence_00000354_post_disaster.png,72,51,1,459,531,362,413,1114,58.4425172401629,25.390071064031773
11754,/media/marda/TWOTB1/xBD/hurricanes/images/florence/hurricane-florence_00000354_post_disaster.png,65,37,1,972,1037,416,453,329,24.495430167142462,17.968962967906883
11755,/media/marda/TWOTB1/xBD/hurricanes/images/florence/hurricane-florence_00000354_post_disaster.png,43,43,1,339,382,435,478,535,32.21589391004943,21.854947695016655
11756,/media/marda/TWOTB1/xBD/hurricanes/images/florence/hurricane-florence_00000354_post_disaster.png,90,61,1,813,903,451,512,1708,57.64854496756732,39.57125505659439
11757,/media/marda/TWOTB1/xBD/hurricanes/images/florence/hurricane-florence_00000354_post_disaster.png,62,73,1,648,710,492,565,1239,54.50248379864893,33.3212309183076
11758,/media/marda/TWOTB1/xBD/hurricanes/images/florence/hurricane-florence_00000354_post_disaster.png,48,35,1,917,965,494,529,110,14.796361977892275,10.030922577528646
11759,/media/marda/TWOTB1/xBD/hurricanes/images/florence/hurricane-florence_00000354_post_disaster.png,62,42,1,878,940,503,545,367,29.213168377040297,16.57186197194253
11760,/media/marda/TWOTB1/xBD/hurricanes/images/florence/hurricane-florence_00000354_post_disaster.png,38,38,1,625,663,507,545,180,19.21730738399348,12.618574810272474
11761,/media/marda/TWOTB1/xBD/hurricanes/images/florence/hurricane-florence_00000354_post_disaster.png,48,50,1,550,598,528,578,545,27.547198632186007,26.13855434528987
11762,/media/marda/TWOTB1/xBD/hurricanes/images/florence/hurricane-florence_00000354_post_disaster.png,77,63,1,653,730,614,677,1261,50.213693423190605,33.20162835303411
11763,/media/marda/TWOTB1/xBD/hurricanes/images/florence/hurricane-florence_00000354_post_disaster.png,37,40,1,639,676,641,681,134,15.213541377857398,11.856014887736269
11764,/media/marda/TWOTB1/xBD/hurricanes/images/florence/hurricane-florence_00000354_post_disaster.png,53,45,1,681,734,657,702,353,27.529956560816277,17.15047405571271
11765,/media/marda/TWOTB1/xBD/hurricanes/images/florence/hurricane-florence_00000354_post_disaster.png,58,80,1,665,723,686,766,989,53.20190520588389,25.17085219247453
11766,/media/marda/TWOTB1/xBD/hurricanes/images/florence/hurricane-florence_00000354_post_disaster.png,47,58,1,555,602,723,781,448,27.109345454230283,22.494582029365574
11767,/media/marda/TWOTB1/xBD/hurricanes/images/florence/hurricane-florence_00000354_post_disaster.png,70,69,1,904,974,756,825,764,37.6756730838041,29.259604460158027
11768,/media/marda/TWOTB1/xBD/hurricanes/images/florence/hurricane-florence_00000354_post_disaster.png,79,82,1,702,781,761,843,1760,50.23202417326068,46.04118358925982
11769,/media/marda/TWOTB1/xBD/hurricanes/images/florence/hurricane-florence_00000354_post_disaster.png,47,44,1,960,1007,832,876,75,12.63613232281595,8.02261137371238
11770,/media/marda/TWOTB1/xBD/hurricanes/images/florence/hurricane-florence_00000354_post_disaster.png,96,112,1,948,1044,867,979,2038,94.23097860144084,37.80483370808265
11771,/media/marda/TWOTB1/xBD/hurricanes/images/florence/hurricane-florence_00000354_post_disaster.png,37,37,1,960,997,883,920,1,0.0,0.0
11772,/media/marda/TWOTB1/xBD/hurricanes/images/florence/hurricane-florence_00000354_post_disaster.png,68,61,1,966,1034,957,1018,477,29.8510442780721,21.35981287845884
11773,/media/marda/TWOTB1/xBD/hurricanes/images/florence/hurricane-florence_00000354_post_disaster.png,69,62,1,799,868,979,1041,648,37.687148090441774,22.85349190830748
11774,/media/marda/TWOTB1/xBD/hurricanes/images/florence/hurricane-florence_00000354_post_disaster.png,59,82,1,557,616,899,981,1058,41.55650116826294,33.86916861029391
11775,/media/marda/TWOTB1/xBD/hurricanes/images/florence/hurricane-florence_00000354_post_disaster.png,42,56,1,504,546,953,1009,246,21.199646875637523,15.548696544025514
11776,/media/marda/TWOTB1/xBD/hurricanes/images/florence/hurricane-florence_00000163_post_disaster.png,55,46,1,889,944,701,747,180,16.147806746822514,14.807036748359655
11777,/media/marda/TWOTB1/xBD/hurricanes/images/florence/hurricane-florence_00000199_pre_disaster.png,36,12,1,530,566,0,12,141,16.443728732872284,11.606609646765936
11778,/media/marda/TWOTB1/xBD/hurricanes/images/florence/hurricane-florence_00000199_pre_disaster.png,59,14,1,646,705,0,14,450,39.963162626372714,14.997451415072819
11779,/media/marda/TWOTB1/xBD/hurricanes/images/florence/hurricane-florence_00000199_pre_disaster.png,91,40,1,411,502,13,53,1665,82.55259815677911,27.711768377891588
11780,/media/marda/TWOTB1/xBD/hurricanes/images/florence/hurricane-florence_00000199_pre_disaster.png,54,46,1,537,591,13,59,1018,47.81022924383942,28.127410216585695
11781,/media/marda/TWOTB1/xBD/hurricanes/images/florence/hurricane-florence_00000199_pre_disaster.png,65,27,1,946,1011,21,48,529,30.711471216473306,23.17776321220108
11782,/media/marda/TWOTB1/xBD/hurricanes/images/florence/hurricane-florence_00000199_pre_disaster.png,94,44,1,876,970,26,70,1679,60.57170150438904,38.85813065971688
11783,/media/marda/TWOTB1/xBD/hurricanes/images/florence/hurricane-florence_00000199_pre_disaster.png,89,63,1,196,285,48,111,2905,85.22464331920857,46.90109235720638
11784,/media/marda/TWOTB1/xBD/hurricanes/images/florence/hurricane-florence_00000199_pre_disaster.png,63,40,1,815,878,50,90,829,39.727796778616316,27.457712892001236
11785,/media/marda/TWOTB1/xBD/hurricanes/images/florence/hurricane-florence_00000199_pre_disaster.png,51,14,1,930,981,63,77,134,14.978023567401127,11.887461436207161
11786,/media/marda/TWOTB1/xBD/hurricanes/images/florence/hurricane-florence_00000199_pre_disaster.png,67,47,1,774,841,74,121,1114,45.02701753056169,32.89611515084843
11787,/media/marda/TWOTB1/xBD/hurricanes/images/florence/hurricane-florence_00000199_pre_disaster.png,73,49,1,970,1043,86,135,954,53.61504162154777,24.165332713077884
11788,/media/marda/TWOTB1/xBD/hurricanes/images/florence/hurricane-florence_00000199_pre_disaster.png,103,46,1,689,792,87,133,2101,76.83099578740928,40.41793463850394
11789,/media/marda/TWOTB1/xBD/hurricanes/images/florence/hurricane-florence_00000199_pre_disaster.png,43,12,1,835,878,97,109,87,11.44474565249455,10.258668695675262
11790,/media/marda/TWOTB1/xBD/hurricanes/images/florence/hurricane-florence_00000199_pre_disaster.png,62,21,1,970,1032,148,169,219,26.208248440034783,11.17866999848357
11791,/media/marda/TWOTB1/xBD/hurricanes/images/florence/hurricane-florence_00000199_pre_disaster.png,42,13,1,785,827,149,162,85,11.147372866272212,10.118968209588605
11792,/media/marda/TWOTB1/xBD/hurricanes/images/florence/hurricane-florence_00000199_pre_disaster.png,67,33,1,715,782,179,212,781,40.59708525328074,25.44449150749619
11793,/media/marda/TWOTB1/xBD/hurricanes/images/florence/hurricane-florence_00000199_pre_disaster.png,40,20,1,768,808,180,200,156,16.49991016876714,12.728290328202958
11794,/media/marda/TWOTB1/xBD/hurricanes/images/florence/hurricane-florence_00000199_pre_disaster.png,68,43,1,328,396,197,240,1309,60.33339421950097,28.659706589279985
11795,/media/marda/TWOTB1/xBD/hurricanes/images/florence/hurricane-florence_00000199_pre_disaster.png,46,29,1,699,745,233,262,251,19.755029206905643,16.940967752005964
11796,/media/marda/TWOTB1/xBD/hurricanes/images/florence/hurricane-florence_00000199_pre_disaster.png,52,23,1,919,971,235,258,171,16.304083919397367,13.82967766221902
11797,/media/marda/TWOTB1/xBD/hurricanes/images/florence/hurricane-florence_00000199_pre_disaster.png,50,40,1,378,428,241,281,880,39.29417153445503,30.069953990779577
11798,/media/marda/TWOTB1/xBD/hurricanes/images/florence/hurricane-florence_00000199_pre_disaster.png,38,62,1,147,185,242,304,1352,58.56612992157638,30.51020317279423
11799,/media/marda/TWOTB1/xBD/hurricanes/images/florence/hurricane-florence_00000199_pre_disaster.png,45,18,1,962,1007,253,271,56,8.91227083456127,8.48528137423857
11800,/media/marda/TWOTB1/xBD/hurricanes/images/florence/hurricane-florence_00000199_pre_disaster.png,87,69,1,892,979,264,333,1906,58.23048001344161,45.20642618835663
11801,/media/marda/TWOTB1/xBD/hurricanes/images/florence/hurricane-florence_00000199_pre_disaster.png,72,53,1,964,1036,266,319,1008,45.659273998014505,29.23795042559206
11802,/media/marda/TWOTB1/xBD/hurricanes/images/florence/hurricane-florence_00000199_pre_disaster.png,50,50,1,429,479,290,340,1156,44.278598503075735,34.842018716438304
11803,/media/marda/TWOTB1/xBD/hurricanes/images/florence/hurricane-florence_00000199_pre_disaster.png,79,103,1,693,772,294,397,2986,93.53182796445948,43.208937785308876
11804,/media/marda/TWOTB1/xBD/hurricanes/images/florence/hurricane-florence_00000199_pre_disaster.png,82,47,1,807,889,306,353,992,50.46977517672826,25.909947931848624
11805,/media/marda/TWOTB1/xBD/hurricanes/images/florence/hurricane-florence_00000199_pre_disaster.png,35,60,1,323,358,309,369,682,53.12681664034999,17.087220900290987
11806,/media/marda/TWOTB1/xBD/hurricanes/images/florence/hurricane-florence_00000199_pre_disaster.png,60,35,1,428,488,361,396,509,50.073291618634435,13.593842224447222
11807,/media/marda/TWOTB1/xBD/hurricanes/images/florence/hurricane-florence_00000199_pre_disaster.png,27,64,1,353,380,365,429,673,57.743719269905114,15.501655126201214
11808,/media/marda/TWOTB1/xBD/hurricanes/images/florence/hurricane-florence_00000199_pre_disaster.png,85,75,1,900,985,385,460,1979,65.11572078266015,42.760654669259374
11809,/media/marda/TWOTB1/xBD/hurricanes/images/florence/hurricane-florence_00000199_pre_disaster.png,63,31,1,434,497,395,426,607,53.89279590936224,15.021088272197444
11810,/media/marda/TWOTB1/xBD/hurricanes/images/florence/hurricane-florence_00000199_pre_disaster.png,63,51,1,981,1044,402,453,526,31.597059098255393,24.03800923844384
11811,/media/marda/TWOTB1/xBD/hurricanes/images/florence/hurricane-florence_00000199_pre_disaster.png,70,50,1,830,900,411,461,887,37.074255673424375,32.05061152238293
11812,/media/marda/TWOTB1/xBD/hurricanes/images/florence/hurricane-florence_00000199_pre_disaster.png,64,52,1,782,846,427,479,888,37.30499954579172,31.697833055998988
11813,/media/marda/TWOTB1/xBD/hurricanes/images/florence/hurricane-florence_00000199_pre_disaster.png,81,65,1,935,1016,455,520,1348,49.80014856660059,39.87626916968022
11814,/media/marda/TWOTB1/xBD/hurricanes/images/florence/hurricane-florence_00000199_pre_disaster.png,43,30,1,846,889,456,486,110,13.15336227355618,11.270467650717878
11815,/media/marda/TWOTB1/xBD/hurricanes/images/florence/hurricane-florence_00000199_pre_disaster.png,49,28,1,995,1044,458,486,70,11.227069914063952,8.279027050313465
11816,/media/marda/TWOTB1/xBD/hurricanes/images/florence/hurricane-florence_00000199_pre_disaster.png,52,47,1,227,279,468,515,876,46.26320941868732,24.84387349311328
11817,/media/marda/TWOTB1/xBD/hurricanes/images/florence/hurricane-florence_00000199_pre_disaster.png,54,29,1,982,1036,485,514,128,14.336308039451044,11.908856273188931
11818,/media/marda/TWOTB1/xBD/hurricanes/images/florence/hurricane-florence_00000199_pre_disaster.png,61,72,1,606,667,486,558,1323,57.42830013277692,30.82274800789759
11819,/media/marda/TWOTB1/xBD/hurricanes/images/florence/hurricane-florence_00000199_pre_disaster.png,73,62,1,966,1039,502,564,939,41.61282291784129,29.959925161383527
11820,/media/marda/TWOTB1/xBD/hurricanes/images/florence/hurricane-florence_00000199_pre_disaster.png,37,34,1,591,628,520,554,116,12.774769437493985,12.226033535902392
11821,/media/marda/TWOTB1/xBD/hurricanes/images/florence/hurricane-florence_00000199_pre_disaster.png,52,53,1,414,466,521,574,815,38.093238758035305,28.239871603313176
11822,/media/marda/TWOTB1/xBD/hurricanes/images/florence/hurricane-florence_00000199_pre_disaster.png,45,37,1,210,255,535,572,299,41.57960512341385,9.597772250853312
11823,/media/marda/TWOTB1/xBD/hurricanes/images/florence/hurricane-florence_00000199_pre_disaster.png,72,63,1,842,914,535,598,1072,42.13264397762545,34.674851258280995
11824,/media/marda/TWOTB1/xBD/hurricanes/images/florence/hurricane-florence_00000199_pre_disaster.png,52,49,1,500,552,539,588,607,32.78377517741265,24.456581041785814
11825,/media/marda/TWOTB1/xBD/hurricanes/images/florence/hurricane-florence_00000199_pre_disaster.png,41,62,1,342,383,546,608,747,42.68663030895957,23.304093420972
11826,/media/marda/TWOTB1/xBD/hurricanes/images/florence/hurricane-florence_00000199_pre_disaster.png,48,41,1,511,559,573,614,370,28.888904879452667,16.946050225798075
11827,/media/marda/TWOTB1/xBD/hurricanes/images/florence/hurricane-florence_00000199_pre_disaster.png,81,95,1,645,726,626,721,2217,75.5178868465811,44.37885211031361
11828,/media/marda/TWOTB1/xBD/hurricanes/images/florence/hurricane-florence_00000199_pre_disaster.png,49,38,1,890,939,632,670,132,14.821268044644658,11.920550610763035
11829,/media/marda/TWOTB1/xBD/hurricanes/images/florence/hurricane-florence_00000199_pre_disaster.png,40,41,1,628,668,641,682,176,16.98877311065698,13.593526555963182
11830,/media/marda/TWOTB1/xBD/hurricanes/images/florence/hurricane-florence_00000199_pre_disaster.png,70,54,1,895,965,662,716,766,35.85395081120009,27.6715771911503
11831,/media/marda/TWOTB1/xBD/hurricanes/images/florence/hurricane-florence_00000199_pre_disaster.png,129,77,1,342,471,665,742,2664,131.79328955011712,26.773023029875695
11832,/media/marda/TWOTB1/xBD/hurricanes/images/florence/hurricane-florence_00000199_pre_disaster.png,67,103,1,684,751,693,796,1795,77.60567100827365,32.36847565544264
11833,/media/marda/TWOTB1/xBD/hurricanes/images/florence/hurricane-florence_00000199_pre_disaster.png,61,68,1,765,826,704,772,917,39.992755578846236,29.873077541577562
11834,/media/marda/TWOTB1/xBD/hurricanes/images/florence/hurricane-florence_00000199_pre_disaster.png,72,132,1,444,516,706,838,2756,115.90366126669676,31.63396119867853
11835,/media/marda/TWOTB1/xBD/hurricanes/images/florence/hurricane-florence_00000199_pre_disaster.png,54,62,1,654,708,724,786,686,33.52142858199897,26.925316468911998
11836,/media/marda/TWOTB1/xBD/hurricanes/images/florence/hurricane-florence_00000199_pre_disaster.png,68,131,1,347,415,734,865,2710,114.8723318075518,31.446641751893267
11837,/media/marda/TWOTB1/xBD/hurricanes/images/florence/hurricane-florence_00000199_pre_disaster.png,62,60,1,952,1014,740,800,600,32.23253856148788,24.621124446160213
11838,/media/marda/TWOTB1/xBD/hurricanes/images/florence/hurricane-florence_00000199_pre_disaster.png,96,71,1,183,279,743,814,1829,103.46323617784239,25.047226984031326
11839,/media/marda/TWOTB1/xBD/hurricanes/images/florence/hurricane-florence_00000199_pre_disaster.png,64,53,1,892,956,782,835,483,27.989189963393848,22.628241144263736
11840,/media/marda/TWOTB1/xBD/hurricanes/images/florence/hurricane-florence_00000199_pre_disaster.png,38,110,1,187,225,798,908,2089,87.92084688664193,31.667496047408356
11841,/media/marda/TWOTB1/xBD/hurricanes/images/florence/hurricane-florence_00000199_pre_disaster.png,77,61,1,843,920,802,863,874,45.24776186631598,25.42323271954509
11842,/media/marda/TWOTB1/xBD/hurricanes/images/florence/hurricane-florence_00000199_pre_disaster.png,77,66,1,787,864,811,877,989,49.55719871319085,26.36238483101912
11843,/media/marda/TWOTB1/xBD/hurricanes/images/florence/hurricane-florence_00000199_pre_disaster.png,54,49,1,980,1034,814,863,181,16.581296687479956,14.641153257087543
11844,/media/marda/TWOTB1/xBD/hurricanes/images/florence/hurricane-florence_00000199_pre_disaster.png,30,64,1,271,301,825,889,642,35.67449731670299,23.833044452116106
11845,/media/marda/TWOTB1/xBD/hurricanes/images/florence/hurricane-florence_00000199_pre_disaster.png,40,42,1,727,767,829,871,71,12.67150428105662,7.586905062798292
11846,/media/marda/TWOTB1/xBD/hurricanes/images/florence/hurricane-florence_00000199_pre_disaster.png,67,80,1,696,763,836,916,1117,48.555009993206504,32.20855044022041
11847,/media/marda/TWOTB1/xBD/hurricanes/images/florence/hurricane-florence_00000199_pre_disaster.png,44,52,1,682,726,854,906,251,19.007637879017896,17.432550313963905
11848,/media/marda/TWOTB1/xBD/hurricanes/images/florence/hurricane-florence_00000199_pre_disaster.png,47,47,1,854,901,855,902,136,13.928567445217674,13.151309692965388
11849,/media/marda/TWOTB1/xBD/hurricanes/images/florence/hurricane-florence_00000199_pre_disaster.png,42,81,1,565,607,865,946,558,54.59688801633846,13.571329632026757
11850,/media/marda/TWOTB1/xBD/hurricanes/images/florence/hurricane-florence_00000199_pre_disaster.png,105,72,1,937,1042,876,948,1676,72.76589229263308,31.606203257328495
11851,/media/marda/TWOTB1/xBD/hurricanes/images/florence/hurricane-florence_00000199_pre_disaster.png,47,87,1,493,540,883,970,745,60.819964974171704,16.289483492698892
11852,/media/marda/TWOTB1/xBD/hurricanes/images/florence/hurricane-florence_00000199_pre_disaster.png,39,81,1,454,493,896,977,612,48.8445750666332,16.607232297702474
11853,/media/marda/TWOTB1/xBD/hurricanes/images/florence/hurricane-florence_00000199_pre_disaster.png,63,53,1,821,884,896,949,288,33.777439314636815,11.329098915399923
11854,/media/marda/TWOTB1/xBD/hurricanes/images/florence/hurricane-florence_00000199_pre_disaster.png,51,55,1,918,969,898,953,196,19.241539561276763,13.585941846994709
11855,/media/marda/TWOTB1/xBD/hurricanes/images/florence/hurricane-florence_00000199_pre_disaster.png,69,57,1,621,690,900,957,496,50.55857891736146,13.051971736991264
11856,/media/marda/TWOTB1/xBD/hurricanes/images/florence/hurricane-florence_00000199_pre_disaster.png,49,59,1,883,932,907,966,203,24.043657600712873,11.246931494957126
11857,/media/marda/TWOTB1/xBD/hurricanes/images/florence/hurricane-florence_00000199_pre_disaster.png,41,81,1,400,441,911,992,641,49.27639407751323,17.281097971956868
11858,/media/marda/TWOTB1/xBD/hurricanes/images/florence/hurricane-florence_00000199_pre_disaster.png,41,90,1,358,399,919,1009,843,60.13669415821699,18.596760109593543
11859,/media/marda/TWOTB1/xBD/hurricanes/images/florence/hurricane-florence_00000199_pre_disaster.png,30,46,1,494,524,926,972,62,9.724764784040628,8.688697602294345
11860,/media/marda/TWOTB1/xBD/hurricanes/images/florence/hurricane-florence_00000199_pre_disaster.png,36,84,1,311,347,936,1020,625,52.800960902689894,15.673615222807177
11861,/media/marda/TWOTB1/xBD/hurricanes/images/florence/hurricane-florence_00000199_pre_disaster.png,46,85,1,523,569,937,1022,699,54.61959268564464,17.01537538324842
11862,/media/marda/TWOTB1/xBD/hurricanes/images/florence/hurricane-florence_00000199_pre_disaster.png,29,79,1,271,300,950,1029,529,46.9181673553088,15.023943088464419
11863,/media/marda/TWOTB1/xBD/hurricanes/images/florence/hurricane-florence_00000199_pre_disaster.png,41,78,1,485,526,953,1031,539,46.73672553933706,15.343654146805646
11864,/media/marda/TWOTB1/xBD/hurricanes/images/florence/hurricane-florence_00000199_pre_disaster.png,39,78,1,437,476,964,1042,585,48.50438214117422,16.040593583802327
11865,/media/marda/TWOTB1/xBD/hurricanes/images/florence/hurricane-florence_00000199_pre_disaster.png,34,62,1,384,418,982,1044,285,24.835673490754026,15.222423037571021
11866,/media/marda/TWOTB1/xBD/hurricanes/images/florence/hurricane-florence_00000225_post_disaster.png,64,48,1,513,577,134,182,1496,45.50719698650026,43.86995216162109
11867,/media/marda/TWOTB1/xBD/hurricanes/images/florence/hurricane-florence_00000225_post_disaster.png,55,34,1,544,599,356,390,525,38.41399922685535,18.602949206549734
11868,/media/marda/TWOTB1/xBD/hurricanes/images/florence/hurricane-florence_00000225_post_disaster.png,42,29,1,610,652,361,390,228,18.791530207568808,16.154331255491144
11869,/media/marda/TWOTB1/xBD/hurricanes/images/florence/hurricane-florence_00000225_post_disaster.png,46,42,1,633,679,370,412,484,30.16725957869737,21.2888432235267
11870,/media/marda/TWOTB1/xBD/hurricanes/images/florence/hurricane-florence_00000225_post_disaster.png,38,33,1,494,532,372,405,270,21.283445243537713,17.53150347968085
11871,/media/marda/TWOTB1/xBD/hurricanes/images/florence/hurricane-florence_00000225_post_disaster.png,56,51,1,494,550,387,438,1118,40.019463919873814,37.39590633549541
11872,/media/marda/TWOTB1/xBD/hurricanes/images/florence/hurricane-florence_00000225_post_disaster.png,34,23,1,562,596,392,415,86,13.7906726627086,8.446832911432315
11873,/media/marda/TWOTB1/xBD/hurricanes/images/florence/hurricane-florence_00000225_post_disaster.png,63,57,1,564,627,403,460,1068,38.46853923647004,36.99870249497796
11874,/media/marda/TWOTB1/xBD/hurricanes/images/florence/hurricane-florence_00000225_post_disaster.png,37,31,1,664,701,439,470,109,14.113897291605856,10.282958628063724
11875,/media/marda/TWOTB1/xBD/hurricanes/images/florence/hurricane-florence_00000225_post_disaster.png,57,71,1,647,704,453,524,1163,57.33862627305426,26.71220824836699
11876,/media/marda/TWOTB1/xBD/hurricanes/images/florence/hurricane-florence_00000225_post_disaster.png,37,33,1,198,235,472,505,408,31.574718614562027,16.965975773698194
11877,/media/marda/TWOTB1/xBD/hurricanes/images/florence/hurricane-florence_00000225_post_disaster.png,62,36,1,964,1026,475,511,343,25.29559440817448,18.066293927613703
11878,/media/marda/TWOTB1/xBD/hurricanes/images/florence/hurricane-florence_00000225_post_disaster.png,23,38,1,232,255,478,516,206,22.92428263763094,11.95227774033936
11879,/media/marda/TWOTB1/xBD/hurricanes/images/florence/hurricane-florence_00000225_post_disaster.png,25,53,1,287,312,478,531,552,42.505013793669306,17.21379441535129
11880,/media/marda/TWOTB1/xBD/hurricanes/images/florence/hurricane-florence_00000225_post_disaster.png,71,54,1,579,650,481,535,1264,52.49843445738341,34.3987321803317
11881,/media/marda/TWOTB1/xBD/hurricanes/images/florence/hurricane-florence_00000225_post_disaster.png,39,47,1,187,226,491,538,621,37.656033545750795,24.388742937440515
11882,/media/marda/TWOTB1/xBD/hurricanes/images/florence/hurricane-florence_00000225_post_disaster.png,47,37,1,92,139,503,540,617,51.00591235539424,16.09404333482276
11883,/media/marda/TWOTB1/xBD/hurricanes/images/florence/hurricane-florence_00000225_post_disaster.png,66,59,1,972,1038,517,576,688,38.44880372315705,23.537638967837562
11884,/media/marda/TWOTB1/xBD/hurricanes/images/florence/hurricane-florence_00000225_post_disaster.png,32,34,1,328,360,541,575,277,22.87728510942136,15.99221499962756
11885,/media/marda/TWOTB1/xBD/hurricanes/images/florence/hurricane-florence_00000225_post_disaster.png,68,61,1,114,182,626,687,1636,73.0442690887662,30.78055666669566
11886,/media/marda/TWOTB1/xBD/hurricanes/images/florence/hurricane-florence_00000225_post_disaster.png,55,54,1,218,273,637,691,1153,51.53266827043654,30.10988275811118
11887,/media/marda/TWOTB1/xBD/hurricanes/images/florence/hurricane-florence_00000225_post_disaster.png,60,56,1,287,347,645,701,1249,56.74563705674492,31.265520857828044
11888,/media/marda/TWOTB1/xBD/hurricanes/images/florence/hurricane-florence_00000225_post_disaster.png,52,56,1,370,422,647,703,897,40.183083438946134,29.80374410908516
11889,/media/marda/TWOTB1/xBD/hurricanes/images/florence/hurricane-florence_00000225_post_disaster.png,72,58,1,820,892,659,717,910,40.067298980221594,30.796387124606483
11890,/media/marda/TWOTB1/xBD/hurricanes/images/florence/hurricane-florence_00000225_post_disaster.png,38,58,1,156,194,682,740,1082,39.016135688965115,36.393895886980836
11891,/media/marda/TWOTB1/xBD/hurricanes/images/florence/hurricane-florence_00000225_post_disaster.png,31,55,1,328,359,683,738,586,35.62249835320967,21.820111690938305
11892,/media/marda/TWOTB1/xBD/hurricanes/images/florence/hurricane-florence_00000225_post_disaster.png,43,49,1,384,427,694,743,567,32.80103833502301,23.00335687453707
11893,/media/marda/TWOTB1/xBD/hurricanes/images/florence/hurricane-florence_00000225_post_disaster.png,32,53,1,211,243,702,755,529,27.645753749286943,25.286914367196115
11894,/media/marda/TWOTB1/xBD/hurricanes/images/florence/hurricane-florence_00000225_post_disaster.png,81,52,1,922,1003,705,757,817,49.098359562321214,22.082278164648155
11895,/media/marda/TWOTB1/xBD/hurricanes/images/florence/hurricane-florence_00000225_post_disaster.png,45,37,1,829,874,733,770,114,14.718374362133243,10.142222904147909
11896,/media/marda/TWOTB1/xBD/hurricanes/images/florence/hurricane-florence_00000225_post_disaster.png,35,52,1,324,359,735,787,519,26.758123465922193,25.867296361626522
11897,/media/marda/TWOTB1/xBD/hurricanes/images/florence/hurricane-florence_00000225_post_disaster.png,67,42,1,977,1044,741,783,263,33.39272677005654,10.549636819022679
11898,/media/marda/TWOTB1/xBD/hurricanes/images/florence/hurricane-florence_00000225_post_disaster.png,53,43,1,972,1025,761,804,114,13.82727709369943,11.091993681949786
11899,/media/marda/TWOTB1/xBD/hurricanes/images/florence/hurricane-florence_00000225_post_disaster.png,46,64,1,356,402,772,836,1109,38.92596962461688,38.03511282555622
11900,/media/marda/TWOTB1/xBD/hurricanes/images/florence/hurricane-florence_00000225_post_disaster.png,46,38,1,951,997,780,818,65,10.255349617167536,8.596895997841836
11901,/media/marda/TWOTB1/xBD/hurricanes/images/florence/hurricane-florence_00000225_post_disaster.png,45,38,1,939,984,783,821,58,9.19321378667686,8.569692874779994
11902,/media/marda/TWOTB1/xBD/hurricanes/images/florence/hurricane-florence_00000226_post_disaster.png,45,42,1,573,618,465,507,343,23.158942526275762,19.449711198487236
11903,/media/marda/TWOTB1/xBD/hurricanes/images/florence/hurricane-florence_00000226_post_disaster.png,48,62,1,582,630,512,574,507,47.5804793836878,14.21311055093115
11904,/media/marda/TWOTB1/xBD/hurricanes/images/florence/hurricane-florence_00000226_post_disaster.png,45,52,1,390,435,643,695,556,32.73729160694425,22.40959225853783
11905,/media/marda/TWOTB1/xBD/hurricanes/images/florence/hurricane-florence_00000226_post_disaster.png,54,47,1,655,709,650,697,284,33.01386643417504,11.508728003109162
11906,/media/marda/TWOTB1/xBD/hurricanes/images/florence/hurricane-florence_00000226_post_disaster.png,59,78,1,736,795,693,771,706,54.97384025894015,17.149446524005228
11907,/media/marda/TWOTB1/xBD/hurricanes/images/florence/hurricane-florence_00000226_post_disaster.png,76,44,1,509,585,700,744,581,62.71117276129184,12.39220853667968
11908,/media/marda/TWOTB1/xBD/hurricanes/images/florence/hurricane-florence_00000226_post_disaster.png,76,85,1,879,955,728,813,1071,62.16947956210443,23.001102382508765
11909,/media/marda/TWOTB1/xBD/hurricanes/images/florence/hurricane-florence_00000226_post_disaster.png,72,85,1,814,886,806,891,1283,49.70829349293716,34.94380256576115
11910,/media/marda/TWOTB1/xBD/hurricanes/images/florence/hurricane-florence_00000226_post_disaster.png,50,75,1,384,434,817,892,632,51.85734714234109,16.1145521324283
11911,/media/marda/TWOTB1/xBD/hurricanes/images/florence/hurricane-florence_00000226_post_disaster.png,62,55,1,565,627,836,891,771,44.64050041863423,22.933164877855134
11912,/media/marda/TWOTB1/xBD/hurricanes/images/florence/hurricane-florence_00000226_post_disaster.png,50,48,1,462,512,849,897,320,36.25252079404969,11.821790730553253
11913,/media/marda/TWOTB1/xBD/hurricanes/images/florence/hurricane-florence_00000226_post_disaster.png,87,72,1,838,925,893,965,1159,55.469630870071164,27.63050136565512
11914,/media/marda/TWOTB1/xBD/hurricanes/images/florence/hurricane-florence_00000226_post_disaster.png,54,72,1,685,739,911,983,920,39.415850391023454,31.17174513039325
11915,/media/marda/TWOTB1/xBD/hurricanes/images/florence/hurricane-florence_00000226_post_disaster.png,66,71,1,605,671,929,1000,1111,47.63530004125515,32.80354991928641
11916,/media/marda/TWOTB1/xBD/hurricanes/images/florence/hurricane-florence_00000226_post_disaster.png,66,59,1,477,543,932,991,923,53.66335077577613,22.660625117115824
11917,/media/marda/TWOTB1/xBD/hurricanes/images/florence/hurricane-florence_00000226_post_disaster.png,52,59,1,406,458,949,1008,793,41.601390799196224,25.41333738108961
11918,/media/marda/TWOTB1/xBD/hurricanes/images/florence/hurricane-florence_00000226_post_disaster.png,33,49,1,560,593,981,1030,169,14.966629547095765,14.966629547095765
11919,/media/marda/TWOTB1/xBD/hurricanes/images/florence/hurricane-florence_00000535_post_disaster.png,17,43,1,9,26,683,726,298,20.890233637553298,19.049422910845475
11920,/media/marda/TWOTB1/xBD/hurricanes/images/florence/hurricane-florence_00000535_post_disaster.png,11,41,1,16,27,701,742,113,13.1325679529402,11.573363323054615
11921,/media/marda/TWOTB1/xBD/hurricanes/images/florence/hurricane-florence_00000535_post_disaster.png,34,61,1,2,36,736,797,995,37.75707988661667,35.201375301755235
11922,/media/marda/TWOTB1/xBD/hurricanes/images/florence/hurricane-florence_00000535_post_disaster.png,23,46,1,37,60,778,824,261,23.633244322677495,14.65687552303179
11923,/media/marda/TWOTB1/xBD/hurricanes/images/florence/hurricane-florence_00000535_post_disaster.png,94,79,1,608,702,809,888,2053,70.17845385357556,38.190816612224
11924,/media/marda/TWOTB1/xBD/hurricanes/images/florence/hurricane-florence_00000535_post_disaster.png,56,70,1,62,118,817,887,1399,55.726151925788116,33.47894684231792
11925,/media/marda/TWOTB1/xBD/hurricanes/images/florence/hurricane-florence_00000535_post_disaster.png,64,78,1,714,778,846,924,1483,50.380620160847805,39.29519489379324
11926,/media/marda/TWOTB1/xBD/hurricanes/images/florence/hurricane-florence_00000535_post_disaster.png,41,52,1,700,741,873,925,239,22.004202980073288,14.4900849767989
11927,/media/marda/TWOTB1/xBD/hurricanes/images/florence/hurricane-florence_00000535_post_disaster.png,60,67,1,597,657,880,947,860,36.00133450011335,33.73746296701245
11928,/media/marda/TWOTB1/xBD/hurricanes/images/florence/hurricane-florence_00000535_post_disaster.png,78,75,1,366,444,909,984,1312,69.98737590673846,25.31761560801026
11929,/media/marda/TWOTB1/xBD/hurricanes/images/florence/hurricane-florence_00000535_post_disaster.png,49,46,1,747,796,914,960,124,21.857052320362776,7.587900616718068
11930,/media/marda/TWOTB1/xBD/hurricanes/images/florence/hurricane-florence_00000535_post_disaster.png,43,52,1,590,633,943,995,235,20.52799774246739,15.210204380166319
11931,/media/marda/TWOTB1/xBD/hurricanes/images/florence/hurricane-florence_00000535_post_disaster.png,69,70,1,701,770,971,1041,1137,42.82103389047922,35.24223052714582
11932,/media/marda/TWOTB1/xBD/hurricanes/images/florence/hurricane-florence_00000535_post_disaster.png,67,62,1,555,622,974,1036,903,51.45335824822454,23.73675156076047
11933,/media/marda/TWOTB1/xBD/hurricanes/images/florence/hurricane-florence_00000535_post_disaster.png,44,53,1,643,687,976,1029,244,21.14877148288163,15.441320629973319
11934,/media/marda/TWOTB1/xBD/hurricanes/images/florence/hurricane-florence_00000535_post_disaster.png,209,58,1,40,249,623,681,6296,234.36216261083095,35.76802579017676
11935,/media/marda/TWOTB1/xBD/hurricanes/images/florence/hurricane-florence_00000232_pre_disaster.png,57,31,1,648,705,0,31,569,32.231889889071184,23.17489154164518
11936,/media/marda/TWOTB1/xBD/hurricanes/images/florence/hurricane-florence_00000232_pre_disaster.png,46,17,1,740,786,29,46,144,17.925833122560253,10.749576538218173
11937,/media/marda/TWOTB1/xBD/hurricanes/images/florence/hurricane-florence_00000232_pre_disaster.png,73,41,1,707,780,72,113,875,50.352854406080056,23.2429944033374
11938,/media/marda/TWOTB1/xBD/hurricanes/images/florence/hurricane-florence_00000232_pre_disaster.png,54,34,1,143,197,107,141,1258,54.518484030640224,30.81941021909745
11939,/media/marda/TWOTB1/xBD/hurricanes/images/florence/hurricane-florence_00000232_pre_disaster.png,76,16,1,560,636,111,127,635,61.124730755803014,13.76177984379851
11940,/media/marda/TWOTB1/xBD/hurricanes/images/florence/hurricane-florence_00000232_pre_disaster.png,76,45,1,792,868,118,163,828,46.90274972963176,23.45737474459426
11941,/media/marda/TWOTB1/xBD/hurricanes/images/florence/hurricane-florence_00000232_pre_disaster.png,60,29,1,853,913,184,213,377,23.76928739704339,20.888711277244056
11942,/media/marda/TWOTB1/xBD/hurricanes/images/florence/hurricane-florence_00000232_pre_disaster.png,66,32,1,412,478,186,218,1279,56.38897519473075,30.084932483036592
11943,/media/marda/TWOTB1/xBD/hurricanes/images/florence/hurricane-florence_00000232_pre_disaster.png,47,34,1,582,629,194,228,664,31.71082557611858,28.020609589164824
11944,/media/marda/TWOTB1/xBD/hurricanes/images/florence/hurricane-florence_00000232_pre_disaster.png,38,30,1,466,504,227,257,473,25.614496455915674,24.58933238950996
11945,/media/marda/TWOTB1/xBD/hurricanes/images/florence/hurricane-florence_00000232_pre_disaster.png,63,46,1,456,519,264,310,1152,46.41359738681662,37.20860754832781
11946,/media/marda/TWOTB1/xBD/hurricanes/images/florence/hurricane-florence_00000232_pre_disaster.png,69,48,1,547,616,269,317,1262,54.799382317209684,33.32432272029009
11947,/media/marda/TWOTB1/xBD/hurricanes/images/florence/hurricane-florence_00000232_pre_disaster.png,75,36,1,761,836,295,331,719,49.106863491222974,19.565922314414333
11948,/media/marda/TWOTB1/xBD/hurricanes/images/florence/hurricane-florence_00000232_pre_disaster.png,83,58,1,832,915,431,489,935,56.38800807332621,22.136040746564156
11949,/media/marda/TWOTB1/xBD/hurricanes/images/florence/hurricane-florence_00000232_pre_disaster.png,46,37,1,391,437,449,486,420,35.75109335152262,17.09508435792959
11950,/media/marda/TWOTB1/xBD/hurricanes/images/florence/hurricane-florence_00000232_pre_disaster.png,81,51,1,899,980,474,525,798,48.0591592852151,22.03694823484221
11951,/media/marda/TWOTB1/xBD/hurricanes/images/florence/hurricane-florence_00000232_pre_disaster.png,56,59,1,375,431,476,535,1274,44.49749604469408,41.32546985264629
11952,/media/marda/TWOTB1/xBD/hurricanes/images/florence/hurricane-florence_00000232_pre_disaster.png,29,26,1,337,366,483,509,113,18.486116830834696,8.253551262922695
11953,/media/marda/TWOTB1/xBD/hurricanes/images/florence/hurricane-florence_00000232_pre_disaster.png,19,29,1,328,347,505,534,58,10.423361364603895,7.382236395603707
11954,/media/marda/TWOTB1/xBD/hurricanes/images/florence/hurricane-florence_00000232_pre_disaster.png,25,32,1,366,391,511,543,82,11.014576906480427,10.019836353771252
11955,/media/marda/TWOTB1/xBD/hurricanes/images/florence/hurricane-florence_00000232_pre_disaster.png,24,36,1,314,338,521,557,159,17.629722161180705,12.0735153304368
11956,/media/marda/TWOTB1/xBD/hurricanes/images/florence/hurricane-florence_00000232_pre_disaster.png,21,36,1,326,347,522,558,121,17.544059413821902,9.230734390811268
11957,/media/marda/TWOTB1/xBD/hurricanes/images/florence/hurricane-florence_00000232_pre_disaster.png,20,35,1,336,356,524,559,94,15.353352734956113,8.23705213538934
11958,/media/marda/TWOTB1/xBD/hurricanes/images/florence/hurricane-florence_00000232_pre_disaster.png,21,35,1,344,365,525,560,113,16.39954773721334,9.226720193899611
11959,/media/marda/TWOTB1/xBD/hurricanes/images/florence/hurricane-florence_00000232_pre_disaster.png,21,28,1,356,377,542,570,50,9.531164280244877,7.213661169127931
11960,/media/marda/TWOTB1/xBD/hurricanes/images/florence/hurricane-florence_00000232_pre_disaster.png,21,28,1,373,394,544,572,64,10.454829124972864,8.159138923171927
11961,/media/marda/TWOTB1/xBD/hurricanes/images/florence/hurricane-florence_00000232_pre_disaster.png,22,29,1,387,409,545,574,58,9.529758218520893,8.225962978109198
11962,/media/marda/TWOTB1/xBD/hurricanes/images/florence/hurricane-florence_00000232_pre_disaster.png,44,60,1,537,581,574,634,695,41.72579188067925,22.236469375335275
11963,/media/marda/TWOTB1/xBD/hurricanes/images/florence/hurricane-florence_00000232_pre_disaster.png,40,73,1,348,388,650,723,1051,52.43499197276822,27.170730653643158
11964,/media/marda/TWOTB1/xBD/hurricanes/images/florence/hurricane-florence_00000232_pre_disaster.png,52,79,1,573,625,771,850,957,51.434504918318325,24.593229118099114
11965,/media/marda/TWOTB1/xBD/hurricanes/images/florence/hurricane-florence_00000232_pre_disaster.png,15,47,1,9,24,784,831,170,17.40165094441971,13.076214616594285
11966,/media/marda/TWOTB1/xBD/hurricanes/images/florence/hurricane-florence_00000232_pre_disaster.png,59,84,1,65,124,823,907,1496,62.73320071617218,32.43810786775073
11967,/media/marda/TWOTB1/xBD/hurricanes/images/florence/hurricane-florence_00000232_pre_disaster.png,38,85,1,375,413,840,925,1151,59.00867866768853,26.036416737790123
11968,/media/marda/TWOTB1/xBD/hurricanes/images/florence/hurricane-florence_00000232_pre_disaster.png,37,45,1,633,670,841,886,112,13.578885937313276,11.422725271133991
11969,/media/marda/TWOTB1/xBD/hurricanes/images/florence/hurricane-florence_00000232_pre_disaster.png,40,50,1,305,345,856,906,442,30.267568226674925,19.112576559996757
11970,/media/marda/TWOTB1/xBD/hurricanes/images/florence/hurricane-florence_00000232_pre_disaster.png,18,52,1,54,72,882,934,141,19.60920673108717,9.447304273181244
11971,/media/marda/TWOTB1/xBD/hurricanes/images/florence/hurricane-florence_00000232_pre_disaster.png,43,80,1,385,428,927,1007,991,48.008545542374726,27.197740474941938
11972,/media/marda/TWOTB1/xBD/hurricanes/images/florence/hurricane-florence_00000232_pre_disaster.png,32,46,1,324,356,934,980,181,23.174021324697605,10.403577079790706
11973,/media/marda/TWOTB1/xBD/hurricanes/images/florence/hurricane-florence_00000232_pre_disaster.png,55,68,1,565,620,962,1030,619,29.965732713291636,27.64338768554156
11974,/media/marda/TWOTB1/xBD/hurricanes/images/florence/hurricane-florence_00000232_pre_disaster.png,66,63,1,509,575,979,1042,736,42.76088911913657,23.81349733775917
11975,/media/marda/TWOTB1/xBD/hurricanes/images/florence/hurricane-florence_00000016_post_disaster.png,57,19,1,166,223,0,19,511,45.384712642991644,17.151776199691678
11976,/media/marda/TWOTB1/xBD/hurricanes/images/florence/hurricane-florence_00000016_post_disaster.png,65,33,1,282,347,0,33,1040,49.60552205945454,28.848878704565685
11977,/media/marda/TWOTB1/xBD/hurricanes/images/florence/hurricane-florence_00000016_post_disaster.png,21,5,1,335,356,0,5,25,8.0,4.664761515876241
11978,/media/marda/TWOTB1/xBD/hurricanes/images/florence/hurricane-florence_00000016_post_disaster.png,42,6,1,637,679,0,6,57,17.608244416750697,4.890385668709081
11979,/media/marda/TWOTB1/xBD/hurricanes/images/florence/hurricane-florence_00000016_post_disaster.png,75,37,1,748,823,0,37,1087,41.39495336198456,35.872679853880406
11980,/media/marda/TWOTB1/xBD/hurricanes/images/florence/hurricane-florence_00000016_post_disaster.png,73,15,1,785,858,0,15,426,40.79325655451991,14.251720055237456
11981,/media/marda/TWOTB1/xBD/hurricanes/images/florence/hurricane-florence_00000016_post_disaster.png,47,7,1,829,876,0,7,54,13.67488330208856,6.122573549276759
11982,/media/marda/TWOTB1/xBD/hurricanes/images/florence/hurricane-florence_00000016_post_disaster.png,56,41,1,143,199,13,54,1217,47.57722982131329,34.11537076554896
11983,/media/marda/TWOTB1/xBD/hurricanes/images/florence/hurricane-florence_00000016_post_disaster.png,76,36,1,647,723,14,50,1367,53.213823891045294,33.863544352582615
11984,/media/marda/TWOTB1/xBD/hurricanes/images/florence/hurricane-florence_00000016_post_disaster.png,63,48,1,259,322,20,68,1472,52.264909988079495,36.70470409224017
11985,/media/marda/TWOTB1/xBD/hurricanes/images/florence/hurricane-florence_00000016_post_disaster.png,58,44,1,126,184,42,86,1360,51.01579291568901,36.16860934912038
11986,/media/marda/TWOTB1/xBD/hurricanes/images/florence/hurricane-florence_00000016_post_disaster.png,54,45,1,231,285,55,100,1144,40.58689839404615,38.06354830490356
11987,/media/marda/TWOTB1/xBD/hurricanes/images/florence/hurricane-florence_00000016_post_disaster.png,88,53,1,826,914,64,117,1542,51.20732575806376,39.79198201051299
11988,/media/marda/TWOTB1/xBD/hurricanes/images/florence/hurricane-florence_00000016_post_disaster.png,87,37,1,636,723,66,103,1553,59.01879517967915,34.44213573145118
11989,/media/marda/TWOTB1/xBD/hurricanes/images/florence/hurricane-florence_00000016_post_disaster.png,61,41,1,104,165,81,122,1329,51.634713319418054,34.40452314980073
11990,/media/marda/TWOTB1/xBD/hurricanes/images/florence/hurricane-florence_00000016_post_disaster.png,118,68,1,756,874,81,149,2899,87.45865504632967,47.92649861699798
11991,/media/marda/TWOTB1/xBD/hurricanes/images/florence/hurricane-florence_00000016_post_disaster.png,62,48,1,213,275,94,142,1571,52.780432291492474,38.83780891646185
11992,/media/marda/TWOTB1/xBD/hurricanes/images/florence/hurricane-florence_00000016_post_disaster.png,80,52,1,620,700,108,160,1519,53.27959283995604,37.100683558006516
11993,/media/marda/TWOTB1/xBD/hurricanes/images/florence/hurricane-florence_00000016_post_disaster.png,60,45,1,93,153,114,159,1500,55.15767701755218,35.63853967928316
11994,/media/marda/TWOTB1/xBD/hurricanes/images/florence/hurricane-florence_00000016_post_disaster.png,83,53,1,734,817,127,180,1291,52.962870462047164,32.30308052880317
11995,/media/marda/TWOTB1/xBD/hurricanes/images/florence/hurricane-florence_00000016_post_disaster.png,60,45,1,197,257,133,178,1292,49.354399025638564,35.19728855552105
11996,/media/marda/TWOTB1/xBD/hurricanes/images/florence/hurricane-florence_00000016_post_disaster.png,76,52,1,590,666,143,195,1276,51.4651272040553,32.68635113339101
11997,/media/marda/TWOTB1/xBD/hurricanes/images/florence/hurricane-florence_00000016_post_disaster.png,47,42,1,92,139,154,196,1114,42.486429266038115,34.76043018629972
11998,/media/marda/TWOTB1/xBD/hurricanes/images/florence/hurricane-florence_00000016_post_disaster.png,82,52,1,713,795,156,208,1310,46.470201575586266,37.956365349919004
11999,/media/marda/TWOTB1/xBD/hurricanes/images/florence/hurricane-florence_00000016_post_disaster.png,74,54,1,567,641,174,228,1283,51.369234543954,33.08277581039633
12000,/media/marda/TWOTB1/xBD/hurricanes/images/florence/hurricane-florence_00000016_post_disaster.png,50,43,1,186,236,175,218,1176,43.95100533224987,35.380896790028565
12001,/media/marda/TWOTB1/xBD/hurricanes/images/florence/hurricane-florence_00000016_post_disaster.png,82,56,1,690,772,185,241,1409,51.398337230261355,36.294993947267955
12002,/media/marda/TWOTB1/xBD/hurricanes/images/florence/hurricane-florence_00000016_post_disaster.png,48,39,1,82,130,193,232,1176,44.81880120560199,34.59572583236779
12003,/media/marda/TWOTB1/xBD/hurricanes/images/florence/hurricane-florence_00000016_post_disaster.png,76,57,1,538,614,200,257,1404,52.06304615870673,35.43503753869977
12004,/media/marda/TWOTB1/xBD/hurricanes/images/florence/hurricane-florence_00000016_post_disaster.png,76,59,1,667,743,213,272,1261,47.23661674883892,36.52653644507806
12005,/media/marda/TWOTB1/xBD/hurricanes/images/florence/hurricane-florence_00000016_post_disaster.png,57,39,1,177,234,221,260,1152,50.1678692802101,31.090195309948744
12006,/media/marda/TWOTB1/xBD/hurricanes/images/florence/hurricane-florence_00000016_post_disaster.png,48,40,1,75,123,231,271,1149,47.177101369793455,32.60767746937949
12007,/media/marda/TWOTB1/xBD/hurricanes/images/florence/hurricane-florence_00000016_post_disaster.png,74,54,1,509,583,235,289,1280,48.3952597799066,35.46929284793015
12008,/media/marda/TWOTB1/xBD/hurricanes/images/florence/hurricane-florence_00000016_post_disaster.png,77,62,1,645,722,237,299,1324,53.13194612039334,33.26274037926696
12009,/media/marda/TWOTB1/xBD/hurricanes/images/florence/hurricane-florence_00000016_post_disaster.png,69,58,1,486,555,259,317,1350,48.41379104719494,37.60258888738757
12010,/media/marda/TWOTB1/xBD/hurricanes/images/florence/hurricane-florence_00000016_post_disaster.png,102,86,1,592,694,265,351,2746,82.25045808709292,48.409678408547435
12011,/media/marda/TWOTB1/xBD/hurricanes/images/florence/hurricane-florence_00000016_post_disaster.png,51,41,1,73,124,269,310,1282,50.41632568032248,34.920751282291306
12012,/media/marda/TWOTB1/xBD/hurricanes/images/florence/hurricane-florence_00000016_post_disaster.png,73,53,1,452,525,293,346,1333,49.339707127751005,35.9267120036641
12013,/media/marda/TWOTB1/xBD/hurricanes/images/florence/hurricane-florence_00000016_post_disaster.png,51,61,1,204,255,312,373,1051,45.35691928373287,32.37589254148208
12014,/media/marda/TWOTB1/xBD/hurricanes/images/florence/hurricane-florence_00000016_post_disaster.png,66,56,1,571,637,317,373,952,37.0171922468103,34.872066941450434
12015,/media/marda/TWOTB1/xBD/hurricanes/images/florence/hurricane-florence_00000016_post_disaster.png,67,60,1,428,495,319,379,1289,47.44275729140375,36.454431416521665
12016,/media/marda/TWOTB1/xBD/hurricanes/images/florence/hurricane-florence_00000016_post_disaster.png,52,44,1,96,148,341,385,1289,52.0820116089053,33.59270536345987
12017,/media/marda/TWOTB1/xBD/hurricanes/images/florence/hurricane-florence_00000016_post_disaster.png,76,68,1,543,619,342,410,1593,52.63272303430202,39.7352028514125
12018,/media/marda/TWOTB1/xBD/hurricanes/images/florence/hurricane-florence_00000016_post_disaster.png,61,64,1,390,451,347,411,1441,49.77714158402592,37.72915610849246
12019,/media/marda/TWOTB1/xBD/hurricanes/images/florence/hurricane-florence_00000016_post_disaster.png,53,56,1,242,295,354,410,1122,41.430787824181266,35.50726594188028
12020,/media/marda/TWOTB1/xBD/hurricanes/images/florence/hurricane-florence_00000016_post_disaster.png,50,60,1,296,346,368,428,1288,48.19877046514446,35.60994304684612
12021,/media/marda/TWOTB1/xBD/hurricanes/images/florence/hurricane-florence_00000016_post_disaster.png,92,94,1,492,584,370,464,2767,83.70933072914308,46.85362522482552
12022,/media/marda/TWOTB1/xBD/hurricanes/images/florence/hurricane-florence_00000016_post_disaster.png,66,62,1,469,535,421,483,1213,43.42019103426754,37.151454100426726
12023,/media/marda/TWOTB1/xBD/hurricanes/images/florence/hurricane-florence_00000016_post_disaster.png,54,64,1,175,229,424,488,1228,48.14023110762288,34.83871345111824
12024,/media/marda/TWOTB1/xBD/hurricanes/images/florence/hurricane-florence_00000016_post_disaster.png,70,65,1,436,506,442,507,1355,48.78216052213478,37.4238691979628
12025,/media/marda/TWOTB1/xBD/hurricanes/images/florence/hurricane-florence_00000016_post_disaster.png,51,58,1,213,264,445,503,1097,43.53470780807894,34.18268838219396
12026,/media/marda/TWOTB1/xBD/hurricanes/images/florence/hurricane-florence_00000016_post_disaster.png,51,49,1,77,128,451,500,1278,50.453553634003335,33.9875971921018
12027,/media/marda/TWOTB1/xBD/hurricanes/images/florence/hurricane-florence_00000016_post_disaster.png,61,59,1,400,461,460,519,1005,40.80900713380799,32.68875202257046
12028,/media/marda/TWOTB1/xBD/hurricanes/images/florence/hurricane-florence_00000016_post_disaster.png,55,68,1,253,308,461,529,1472,50.6261597373197,38.46274259419333
12029,/media/marda/TWOTB1/xBD/hurricanes/images/florence/hurricane-florence_00000016_post_disaster.png,51,63,1,294,345,470,533,1216,47.057992392354556,34.99140956275945
12030,/media/marda/TWOTB1/xBD/hurricanes/images/florence/hurricane-florence_00000016_post_disaster.png,49,51,1,82,131,491,542,1216,49.326724017414506,33.35697939779624
12031,/media/marda/TWOTB1/xBD/hurricanes/images/florence/hurricane-florence_00000016_post_disaster.png,68,66,1,387,455,495,561,1254,47.22936107224701,35.706797240047635
12032,/media/marda/TWOTB1/xBD/hurricanes/images/florence/hurricane-florence_00000016_post_disaster.png,47,52,1,84,131,527,579,1156,46.410049857265115,33.72542724736915
12033,/media/marda/TWOTB1/xBD/hurricanes/images/florence/hurricane-florence_00000016_post_disaster.png,67,73,1,367,434,527,600,1542,53.50016500597483,37.556365955846665
12034,/media/marda/TWOTB1/xBD/hurricanes/images/florence/hurricane-florence_00000016_post_disaster.png,53,59,1,81,134,567,626,1290,54.7062207690136,31.81939883248258
12035,/media/marda/TWOTB1/xBD/hurricanes/images/florence/hurricane-florence_00000016_post_disaster.png,60,68,1,289,349,611,679,1247,43.67877121297409,37.5321915886965
12036,/media/marda/TWOTB1/xBD/hurricanes/images/florence/hurricane-florence_00000016_post_disaster.png,50,68,1,136,186,631,699,1119,41.57956536210587,35.50050113696872
12037,/media/marda/TWOTB1/xBD/hurricanes/images/florence/hurricane-florence_00000016_post_disaster.png,49,74,1,176,225,651,725,1379,52.900328456576425,34.84258989147521
12038,/media/marda/TWOTB1/xBD/hurricanes/images/florence/hurricane-florence_00000509_post_disaster.png,65,61,1,0,65,491,552,1954,74.16325162444535,35.175509986396065
12039,/media/marda/TWOTB1/xBD/hurricanes/images/florence/hurricane-florence_00000509_post_disaster.png,36,38,1,731,767,830,868,37,7.670168369232968,6.087006124297144
12040,/media/marda/TWOTB1/xBD/hurricanes/images/florence/hurricane-florence_00000509_post_disaster.png,140,98,1,703,843,883,981,2990,119.85833406043159,33.61841677133411
12041,/media/marda/TWOTB1/xBD/hurricanes/images/florence/hurricane-florence_00000509_post_disaster.png,47,63,1,647,694,917,980,293,28.676023072421405,13.640317513706234
12042,/media/marda/TWOTB1/xBD/hurricanes/images/florence/hurricane-florence_00000509_post_disaster.png,54,78,1,614,668,931,1009,470,47.559122463878424,13.194598189935022
12043,/media/marda/TWOTB1/xBD/hurricanes/images/florence/hurricane-florence_00000509_post_disaster.png,132,79,1,677,809,962,1041,1987,99.28584695619665,30.560000902759906
12044,/media/marda/TWOTB1/xBD/hurricanes/images/florence/hurricane-florence_00000509_post_disaster.png,33,45,1,605,638,974,1019,67,9.475813673564893,8.957611621975428
12045,/media/marda/TWOTB1/xBD/hurricanes/images/florence/hurricane-florence_00000509_post_disaster.png,134,94,1,724,858,836,930,3044,117.58417993681958,34.39194167733409
12046,/media/marda/TWOTB1/xBD/hurricanes/images/florence/hurricane-florence_00000053_post_disaster.png,67,30,1,432,499,0,30,1071,52.58834266051001,27.351289906523757
12047,/media/marda/TWOTB1/xBD/hurricanes/images/florence/hurricane-florence_00000053_post_disaster.png,51,17,1,546,597,0,17,294,27.111148766244305,16.211502527635137
12048,/media/marda/TWOTB1/xBD/hurricanes/images/florence/hurricane-florence_00000053_post_disaster.png,63,37,1,959,1022,4,41,504,38.78382441826097,18.506204757840212
12049,/media/marda/TWOTB1/xBD/hurricanes/images/florence/hurricane-florence_00000053_post_disaster.png,43,12,1,868,911,25,37,84,11.207824819146573,10.127714641833366
12050,/media/marda/TWOTB1/xBD/hurricanes/images/florence/hurricane-florence_00000053_post_disaster.png,92,125,1,283,375,35,160,6461,129.24671576908224,65.8494567525645
12051,/media/marda/TWOTB1/xBD/hurricanes/images/florence/hurricane-florence_00000053_post_disaster.png,45,22,1,470,515,58,80,399,27.543585756465344,19.129059182859205
12052,/media/marda/TWOTB1/xBD/hurricanes/images/florence/hurricane-florence_00000210_pre_disaster.png,81,36,1,772,853,0,36,1177,47.353063987220125,32.64705238233509
12053,/media/marda/TWOTB1/xBD/hurricanes/images/florence/hurricane-florence_00000210_pre_disaster.png,29,23,1,352,381,127,150,181,16.418195067752173,14.787336824090996
12054,/media/marda/TWOTB1/xBD/hurricanes/images/florence/hurricane-florence_00000210_pre_disaster.png,49,31,1,809,858,488,519,127,15.194929923763347,11.181705077704782
12055,/media/marda/TWOTB1/xBD/hurricanes/images/florence/hurricane-florence_00000430_post_disaster.png,29,7,1,103,132,0,7,115,28.125140785796784,5.7280104898913065
12056,/media/marda/TWOTB1/xBD/hurricanes/images/florence/hurricane-florence_00000430_post_disaster.png,37,46,1,43,80,24,70,1224,43.66621739233201,36.91377851875059
12057,/media/marda/TWOTB1/xBD/hurricanes/images/florence/hurricane-florence_00000430_post_disaster.png,58,42,1,33,91,91,133,1384,66.27889008734752,31.217240181208012
12058,/media/marda/TWOTB1/xBD/hurricanes/images/florence/hurricane-florence_00000430_post_disaster.png,49,53,1,25,74,159,212,1620,55.81149320462119,42.13441877823573
12059,/media/marda/TWOTB1/xBD/hurricanes/images/florence/hurricane-florence_00000430_post_disaster.png,22,17,1,98,120,166,183,182,19.822087009413767,12.341328547617891
12060,/media/marda/TWOTB1/xBD/hurricanes/images/florence/hurricane-florence_00000430_post_disaster.png,54,28,1,554,608,184,212,642,35.73903604185602,23.04510301455765
12061,/media/marda/TWOTB1/xBD/hurricanes/images/florence/hurricane-florence_00000430_post_disaster.png,33,31,1,72,105,196,227,551,33.73022462334187,21.701255435185818
12062,/media/marda/TWOTB1/xBD/hurricanes/images/florence/hurricane-florence_00000430_post_disaster.png,566,818,1,242,808,209,1027,232451,789.8436445382208,444.74293662641657
12063,/media/marda/TWOTB1/xBD/hurricanes/images/florence/hurricane-florence_00000430_post_disaster.png,38,24,1,564,602,210,234,210,18.68871416642843,14.396761697897071
12064,/media/marda/TWOTB1/xBD/hurricanes/images/florence/hurricane-florence_00000430_post_disaster.png,21,26,1,164,185,232,258,155,15.279327510028542,13.59567656988036
12065,/media/marda/TWOTB1/xBD/hurricanes/images/florence/hurricane-florence_00000430_post_disaster.png,72,64,1,807,879,242,306,1385,56.86015240301273,32.18424039667841
12066,/media/marda/TWOTB1/xBD/hurricanes/images/florence/hurricane-florence_00000430_post_disaster.png,60,53,1,929,989,402,455,518,38.644502448298994,17.928863024885654
12067,/media/marda/TWOTB1/xBD/hurricanes/images/florence/hurricane-florence_00000430_post_disaster.png,8,40,1,0,8,432,472,104,22.794957878604396,6.988533426596971
12068,/media/marda/TWOTB1/xBD/hurricanes/images/florence/hurricane-florence_00000430_post_disaster.png,17,28,1,89,106,437,465,129,15.891855356004536,10.687158351548472
12069,/media/marda/TWOTB1/xBD/hurricanes/images/florence/hurricane-florence_00000430_post_disaster.png,46,72,1,79,125,452,524,1386,55.48760235636246,35.283864118706845
12070,/media/marda/TWOTB1/xBD/hurricanes/images/florence/hurricane-florence_00000430_post_disaster.png,44,48,1,118,162,528,576,727,43.047216963790106,22.45273564317786
12071,/media/marda/TWOTB1/xBD/hurricanes/images/florence/hurricane-florence_00000430_post_disaster.png,38,44,1,135,173,567,611,462,35.14710054448293,18.322731666097972
12072,/media/marda/TWOTB1/xBD/hurricanes/images/florence/hurricane-florence_00000430_post_disaster.png,52,57,1,128,180,597,654,875,50.965599007313756,24.63056939752119
12073,/media/marda/TWOTB1/xBD/hurricanes/images/florence/hurricane-florence_00000430_post_disaster.png,19,49,1,46,65,627,676,289,25.665885478370562,14.896644454562335
12074,/media/marda/TWOTB1/xBD/hurricanes/images/florence/hurricane-florence_00000430_post_disaster.png,42,62,1,1,43,630,692,1098,43.52722143093421,33.70467022074068
12075,/media/marda/TWOTB1/xBD/hurricanes/images/florence/hurricane-florence_00000430_post_disaster.png,40,57,1,164,204,673,730,633,39.302760460775744,22.132638555086576
12076,/media/marda/TWOTB1/xBD/hurricanes/images/florence/hurricane-florence_00000430_post_disaster.png,38,75,1,95,133,697,772,1076,46.32958334813304,31.08903320174412
12077,/media/marda/TWOTB1/xBD/hurricanes/images/florence/hurricane-florence_00000430_post_disaster.png,39,58,1,48,87,703,761,776,40.23792391051051,25.76452800926723
12078,/media/marda/TWOTB1/xBD/hurricanes/images/florence/hurricane-florence_00000430_post_disaster.png,23,62,1,25,48,717,779,544,35.687649125110056,20.5646883225928
12079,/media/marda/TWOTB1/xBD/hurricanes/images/florence/hurricane-florence_00000430_post_disaster.png,46,77,1,178,224,723,800,1051,52.29797415857055,32.740259860416444
12080,/media/marda/TWOTB1/xBD/hurricanes/images/florence/hurricane-florence_00000430_post_disaster.png,21,44,1,117,138,748,792,189,17.014035390767116,14.926076707242533
12081,/media/marda/TWOTB1/xBD/hurricanes/images/florence/hurricane-florence_00000430_post_disaster.png,90,55,1,625,715,770,825,1144,65.11732950464948,23.751946685797556
12082,/media/marda/TWOTB1/xBD/hurricanes/images/florence/hurricane-florence_00000430_post_disaster.png,31,116,1,0,31,779,895,1550,91.05036121375825,23.294340267646955
12083,/media/marda/TWOTB1/xBD/hurricanes/images/florence/hurricane-florence_00000430_post_disaster.png,48,78,1,174,222,788,866,1238,48.93010760732416,34.72311914510857
12084,/media/marda/TWOTB1/xBD/hurricanes/images/florence/hurricane-florence_00000430_post_disaster.png,72,80,1,833,905,788,868,1184,52.14311382861527,31.366683933015015
12085,/media/marda/TWOTB1/xBD/hurricanes/images/florence/hurricane-florence_00000430_post_disaster.png,59,58,1,113,172,805,863,853,60.29657995164621,18.931644968289422
12086,/media/marda/TWOTB1/xBD/hurricanes/images/florence/hurricane-florence_00000430_post_disaster.png,51,54,1,751,802,833,887,383,23.1850841396091,21.113818635024227
12087,/media/marda/TWOTB1/xBD/hurricanes/images/florence/hurricane-florence_00000430_post_disaster.png,54,96,1,221,275,837,933,1466,72.910031476365,28.652024640551943
12088,/media/marda/TWOTB1/xBD/hurricanes/images/florence/hurricane-florence_00000430_post_disaster.png,42,60,1,186,228,847,907,631,36.47333644145937,23.110140393945695
12089,/media/marda/TWOTB1/xBD/hurricanes/images/florence/hurricane-florence_00000430_post_disaster.png,40,49,1,687,727,861,910,140,16.743599635265586,11.27306858559668
12090,/media/marda/TWOTB1/xBD/hurricanes/images/florence/hurricane-florence_00000430_post_disaster.png,27,60,1,112,139,865,925,426,27.796535108930787,20.30170598781749
12091,/media/marda/TWOTB1/xBD/hurricanes/images/florence/hurricane-florence_00000430_post_disaster.png,43,63,1,191,234,883,946,728,37.43316018766969,25.843104567487288
12092,/media/marda/TWOTB1/xBD/hurricanes/images/florence/hurricane-florence_00000430_post_disaster.png,30,51,1,343,373,886,937,164,17.938668543754506,12.315339439555002
12093,/media/marda/TWOTB1/xBD/hurricanes/images/florence/hurricane-florence_00000430_post_disaster.png,34,109,1,16,50,888,997,1455,80.85642786539788,24.0205102443411
12094,/media/marda/TWOTB1/xBD/hurricanes/images/florence/hurricane-florence_00000430_post_disaster.png,41,72,1,152,193,890,962,873,38.31002603279344,30.14593071663333
12095,/media/marda/TWOTB1/xBD/hurricanes/images/florence/hurricane-florence_00000430_post_disaster.png,42,67,1,111,153,908,975,778,38.11516728988885,26.754871597097313
12096,/media/marda/TWOTB1/xBD/hurricanes/images/florence/hurricane-florence_00000430_post_disaster.png,40,74,1,71,111,915,989,826,40.95502908813872,28.04069157386002
12097,/media/marda/TWOTB1/xBD/hurricanes/images/florence/hurricane-florence_00000430_post_disaster.png,32,52,1,352,384,916,968,191,19.34017197798771,13.246603676806414
12098,/media/marda/TWOTB1/xBD/hurricanes/images/florence/hurricane-florence_00000430_post_disaster.png,63,65,1,770,833,939,1004,674,31.277898648219413,28.502677038628143
12099,/media/marda/TWOTB1/xBD/hurricanes/images/florence/hurricane-florence_00000430_post_disaster.png,65,61,1,783,848,982,1043,499,35.795954466356456,18.58831416395469
12100,/media/marda/TWOTB1/xBD/hurricanes/images/florence/hurricane-florence_00000008_post_disaster.png,123,106,1,701,824,320,426,2478,128.36061609235497,25.67475255551223
12101,/media/marda/TWOTB1/xBD/hurricanes/images/florence/hurricane-florence_00000008_post_disaster.png,125,105,1,734,859,354,459,2456,131.0313331527255,24.886388384734516
12102,/media/marda/TWOTB1/xBD/hurricanes/images/florence/hurricane-florence_00000008_post_disaster.png,70,79,1,603,673,777,856,1208,45.140158823872255,36.46780763953298
12103,/media/marda/TWOTB1/xBD/hurricanes/images/florence/hurricane-florence_00000008_post_disaster.png,66,81,1,349,415,802,883,1383,45.014277028915146,41.037948879623464
12104,/media/marda/TWOTB1/xBD/hurricanes/images/florence/hurricane-florence_00000008_post_disaster.png,73,83,1,305,378,835,918,1547,57.11566728148511,36.68012978787658
12105,/media/marda/TWOTB1/xBD/hurricanes/images/florence/hurricane-florence_00000008_post_disaster.png,80,89,1,526,606,851,940,1716,58.335034049082445,39.859909528806185
12106,/media/marda/TWOTB1/xBD/hurricanes/images/florence/hurricane-florence_00000008_post_disaster.png,80,91,1,696,776,854,945,1471,57.45974000933623,34.91877927216238
12107,/media/marda/TWOTB1/xBD/hurricanes/images/florence/hurricane-florence_00000008_post_disaster.png,74,88,1,277,351,859,947,1743,58.17701921927584,40.26248959905367
12108,/media/marda/TWOTB1/xBD/hurricanes/images/florence/hurricane-florence_00000008_post_disaster.png,69,90,1,422,491,869,959,1563,54.98031147576919,38.168112755685016
12109,/media/marda/TWOTB1/xBD/hurricanes/images/florence/hurricane-florence_00000008_post_disaster.png,76,90,1,566,642,881,971,1519,58.30664275077116,35.81843733799448
12110,/media/marda/TWOTB1/xBD/hurricanes/images/florence/hurricane-florence_00000008_post_disaster.png,64,85,1,400,464,894,979,1171,42.05535196096286,40.429033310005984
12111,/media/marda/TWOTB1/xBD/hurricanes/images/florence/hurricane-florence_00000008_post_disaster.png,70,89,1,244,314,899,988,1624,57.401693310303,37.98574267577208
12112,/media/marda/TWOTB1/xBD/hurricanes/images/florence/hurricane-florence_00000008_post_disaster.png,72,85,1,599,671,904,989,1253,43.01708129292268,39.033633406107946
12113,/media/marda/TWOTB1/xBD/hurricanes/images/florence/hurricane-florence_00000008_post_disaster.png,59,84,1,369,428,926,1010,1116,45.0027054036245,34.676584916034116
12114,/media/marda/TWOTB1/xBD/hurricanes/images/florence/hurricane-florence_00000008_post_disaster.png,69,89,1,213,282,932,1021,1617,57.03600315395329,38.394856786518176
12115,/media/marda/TWOTB1/xBD/hurricanes/images/florence/hurricane-florence_00000008_post_disaster.png,68,85,1,187,255,956,1041,1616,58.34376431480278,36.774213097004676
12116,/media/marda/TWOTB1/xBD/hurricanes/images/florence/hurricane-florence_00000008_post_disaster.png,87,81,1,672,759,960,1041,1668,59.51072629730585,36.966910105351324
12117,/media/marda/TWOTB1/xBD/hurricanes/images/florence/hurricane-florence_00000008_post_disaster.png,65,77,1,335,400,964,1041,1228,50.07089104529844,31.894352557107485
12118,/media/marda/TWOTB1/xBD/hurricanes/images/florence/hurricane-florence_00000008_post_disaster.png,83,74,1,518,601,967,1041,1394,57.4572536515936,31.984729700301106
12119,/media/marda/TWOTB1/xBD/hurricanes/images/florence/hurricane-florence_00000008_post_disaster.png,40,57,1,164,204,986,1043,297,28.744503874569638,15.8976615162094
12120,/media/marda/TWOTB1/xBD/hurricanes/images/florence/hurricane-florence_00000008_post_disaster.png,37,53,1,314,351,990,1043,171,21.742531101628913,11.929558135137444
12121,/media/marda/TWOTB1/xBD/hurricanes/images/florence/hurricane-florence_00000008_post_disaster.png,52,52,1,651,703,991,1043,174,24.171637512355275,11.032201953234388
12122,/media/marda/TWOTB1/xBD/hurricanes/images/florence/hurricane-florence_00000173_post_disaster.png,73,45,1,832,905,22,67,1200,44.05483481894841,36.06535974476916
12123,/media/marda/TWOTB1/xBD/hurricanes/images/florence/hurricane-florence_00000173_post_disaster.png,38,56,1,209,247,167,223,1027,52.02236777369153,26.39312937392838
12124,/media/marda/TWOTB1/xBD/hurricanes/images/florence/hurricane-florence_00000173_post_disaster.png,29,28,1,207,236,216,244,266,19.742275241343865,18.029142040622325
12125,/media/marda/TWOTB1/xBD/hurricanes/images/florence/hurricane-florence_00000173_post_disaster.png,61,53,1,628,689,230,283,1217,48.760467459318264,32.89665232648906
12126,/media/marda/TWOTB1/xBD/hurricanes/images/florence/hurricane-florence_00000173_post_disaster.png,54,20,1,952,1006,238,258,124,19.22670279325634,8.688796810972702
12127,/media/marda/TWOTB1/xBD/hurricanes/images/florence/hurricane-florence_00000173_post_disaster.png,61,52,1,220,281,250,302,1533,55.04749936359137,36.721905051269665
12128,/media/marda/TWOTB1/xBD/hurricanes/images/florence/hurricane-florence_00000173_post_disaster.png,49,23,1,879,928,255,278,124,13.219871722978668,12.639680632338397
12129,/media/marda/TWOTB1/xBD/hurricanes/images/florence/hurricane-florence_00000173_post_disaster.png,48,61,1,292,340,300,361,1184,49.23831840791067,31.981663733920207
12130,/media/marda/TWOTB1/xBD/hurricanes/images/florence/hurricane-florence_00000173_post_disaster.png,93,55,1,945,1038,313,368,1545,55.40913598761613,37.94939633389697
12131,/media/marda/TWOTB1/xBD/hurricanes/images/florence/hurricane-florence_00000173_post_disaster.png,73,60,1,631,704,318,378,1421,52.53324212641853,37.34197449616481
12132,/media/marda/TWOTB1/xBD/hurricanes/images/florence/hurricane-florence_00000173_post_disaster.png,89,56,1,864,953,335,391,1566,53.08922317346076,39.50664924800215
12133,/media/marda/TWOTB1/xBD/hurricanes/images/florence/hurricane-florence_00000173_post_disaster.png,37,31,1,377,414,336,367,259,23.067194631831523,15.009298757494312
12134,/media/marda/TWOTB1/xBD/hurricanes/images/florence/hurricane-florence_00000173_post_disaster.png,78,55,1,795,873,354,409,1278,45.005368296078046,37.656981581247805
12135,/media/marda/TWOTB1/xBD/hurricanes/images/florence/hurricane-florence_00000173_post_disaster.png,39,24,1,770,809,377,401,86,12.02927007545204,9.473298760880185
12136,/media/marda/TWOTB1/xBD/hurricanes/images/florence/hurricane-florence_00000173_post_disaster.png,64,63,1,690,754,398,461,1114,49.1183648279686,29.799970935171597
12137,/media/marda/TWOTB1/xBD/hurricanes/images/florence/hurricane-florence_00000173_post_disaster.png,83,70,1,908,991,486,556,1741,51.640937258785286,44.86749906793322
12138,/media/marda/TWOTB1/xBD/hurricanes/images/florence/hurricane-florence_00000173_post_disaster.png,72,72,1,690,762,519,591,1422,55.45208433279799,33.819641479460124
12139,/media/marda/TWOTB1/xBD/hurricanes/images/florence/hurricane-florence_00000173_post_disaster.png,90,82,1,940,1030,590,672,1943,59.555769711703874,45.547138802897514
12140,/media/marda/TWOTB1/xBD/hurricanes/images/florence/hurricane-florence_00000173_post_disaster.png,74,82,1,722,796,602,684,1582,55.8506896389769,40.165363489945705
12141,/media/marda/TWOTB1/xBD/hurricanes/images/florence/hurricane-florence_00000173_post_disaster.png,76,92,1,596,672,623,715,1993,69.449739109247,38.314353832151426
12142,/media/marda/TWOTB1/xBD/hurricanes/images/florence/hurricane-florence_00000173_post_disaster.png,46,40,1,852,898,627,667,147,15.250872275316727,12.948203655689698
12143,/media/marda/TWOTB1/xBD/hurricanes/images/florence/hurricane-florence_00000173_post_disaster.png,46,38,1,882,928,649,687,98,14.432596847019893,9.188843350985067
12144,/media/marda/TWOTB1/xBD/hurricanes/images/florence/hurricane-florence_00000173_post_disaster.png,59,42,1,884,943,661,703,244,24.25759635468701,13.485699872838952
12145,/media/marda/TWOTB1/xBD/hurricanes/images/florence/hurricane-florence_00000173_post_disaster.png,82,73,1,756,838,683,756,1517,56.833197421486474,36.70038698551816
12146,/media/marda/TWOTB1/xBD/hurricanes/images/florence/hurricane-florence_00000173_post_disaster.png,73,71,1,970,1043,686,757,1145,45.18166391496353,33.02420199622073
12147,/media/marda/TWOTB1/xBD/hurricanes/images/florence/hurricane-florence_00000173_post_disaster.png,91,91,1,348,439,696,787,3303,78.65647711559393,56.365114456708774
12148,/media/marda/TWOTB1/xBD/hurricanes/images/florence/hurricane-florence_00000173_post_disaster.png,54,47,1,869,923,727,774,258,20.7496407928064,16.433518901919978
12149,/media/marda/TWOTB1/xBD/hurricanes/images/florence/hurricane-florence_00000173_post_disaster.png,43,47,1,496,539,734,781,232,22.37292388768931,13.903474989620564
12150,/media/marda/TWOTB1/xBD/hurricanes/images/florence/hurricane-florence_00000173_post_disaster.png,67,76,1,240,307,738,814,1930,60.103212335691445,42.972711220220866
12151,/media/marda/TWOTB1/xBD/hurricanes/images/florence/hurricane-florence_00000173_post_disaster.png,57,44,1,983,1040,747,791,143,14.654442933593698,13.066399574155817
12152,/media/marda/TWOTB1/xBD/hurricanes/images/florence/hurricane-florence_00000173_post_disaster.png,83,79,1,775,858,759,838,1431,54.32492123249246,37.258874732769705
12153,/media/marda/TWOTB1/xBD/hurricanes/images/florence/hurricane-florence_00000173_post_disaster.png,52,83,1,488,540,814,897,1103,52.532058189961845,28.231555461791782
12154,/media/marda/TWOTB1/xBD/hurricanes/images/florence/hurricane-florence_00000173_post_disaster.png,79,99,1,879,958,830,929,1686,71.5450054216464,31.874750598065408
12155,/media/marda/TWOTB1/xBD/hurricanes/images/florence/hurricane-florence_00000173_post_disaster.png,68,62,1,681,749,875,937,806,40.012179809297486,27.06799468025899
12156,/media/marda/TWOTB1/xBD/hurricanes/images/florence/hurricane-florence_00000173_post_disaster.png,54,44,1,972,1026,879,923,96,15.149158953706758,8.472147812147867
12157,/media/marda/TWOTB1/xBD/hurricanes/images/florence/hurricane-florence_00000173_post_disaster.png,52,48,1,959,1011,892,940,103,16.280692671140336,8.509908618008398
12158,/media/marda/TWOTB1/xBD/hurricanes/images/florence/hurricane-florence_00000173_post_disaster.png,81,77,1,962,1043,953,1030,1109,48.60123742916963,30.470357556958284
12159,/media/marda/TWOTB1/xBD/hurricanes/images/florence/hurricane-florence_00000024_pre_disaster.png,59,43,1,621,680,40,83,946,45.46847243748545,29.250190793147926
12160,/media/marda/TWOTB1/xBD/hurricanes/images/florence/hurricane-florence_00000024_pre_disaster.png,68,51,1,905,973,277,328,903,52.57200189567766,27.955638244261706
12161,/media/marda/TWOTB1/xBD/hurricanes/images/florence/hurricane-florence_00000024_pre_disaster.png,63,52,1,721,784,300,352,1027,41.83009083656471,34.22848039117684
12162,/media/marda/TWOTB1/xBD/hurricanes/images/florence/hurricane-florence_00000024_pre_disaster.png,66,37,1,782,848,308,345,724,37.64428828594994,26.292479008193155
12163,/media/marda/TWOTB1/xBD/hurricanes/images/florence/hurricane-florence_00000024_pre_disaster.png,40,24,1,773,813,344,368,138,14.05059836167152,13.037378964587367
12164,/media/marda/TWOTB1/xBD/hurricanes/images/florence/hurricane-florence_00000024_pre_disaster.png,52,28,1,960,1012,353,381,126,15.14081174597413,11.210640936836306
12165,/media/marda/TWOTB1/xBD/hurricanes/images/florence/hurricane-florence_00000024_pre_disaster.png,62,55,1,710,772,392,447,1034,47.47926032334975,28.895511190089863
12166,/media/marda/TWOTB1/xBD/hurricanes/images/florence/hurricane-florence_00000024_pre_disaster.png,53,39,1,788,841,394,433,373,25.233559153479487,19.78726551258566
12167,/media/marda/TWOTB1/xBD/hurricanes/images/florence/hurricane-florence_00000024_pre_disaster.png,38,24,1,779,817,411,435,53,8.772461452899979,8.161906748191695
12168,/media/marda/TWOTB1/xBD/hurricanes/images/florence/hurricane-florence_00000024_pre_disaster.png,85,58,1,852,937,462,520,1502,53.05593072418598,37.82151569397514
12169,/media/marda/TWOTB1/xBD/hurricanes/images/florence/hurricane-florence_00000024_pre_disaster.png,57,57,1,696,753,486,543,825,41.748025803199006,26.151803031037478
12170,/media/marda/TWOTB1/xBD/hurricanes/images/florence/hurricane-florence_00000024_pre_disaster.png,48,36,1,750,798,491,527,230,20.193635184081142,15.254640427554472
12171,/media/marda/TWOTB1/xBD/hurricanes/images/florence/hurricane-florence_00000024_pre_disaster.png,48,41,1,783,831,494,535,303,23.72086978787783,17.073369571562395
12172,/media/marda/TWOTB1/xBD/hurricanes/images/florence/hurricane-florence_00000303_post_disaster.png,79,67,1,761,840,501,568,1058,54.71056109872383,25.857964515357708
12173,/media/marda/TWOTB1/xBD/hurricanes/images/florence/hurricane-florence_00000303_post_disaster.png,64,53,1,714,778,530,583,581,38.69121766109131,20.14138880636168
12174,/media/marda/TWOTB1/xBD/hurricanes/images/florence/hurricane-florence_00000303_post_disaster.png,79,76,1,874,953,584,660,1194,49.60028051718581,35.50392810620324
12175,/media/marda/TWOTB1/xBD/hurricanes/images/florence/hurricane-florence_00000303_post_disaster.png,48,33,1,938,986,625,658,59,10.319468574007749,7.62567456059103
12176,/media/marda/TWOTB1/xBD/hurricanes/images/florence/hurricane-florence_00000303_post_disaster.png,55,44,1,961,1016,631,675,176,20.340856841866895,11.602291984875794
12177,/media/marda/TWOTB1/xBD/hurricanes/images/florence/hurricane-florence_00000303_post_disaster.png,46,57,1,511,557,808,865,319,25.468163909657946,16.740508686422622
12178,/media/marda/TWOTB1/xBD/hurricanes/images/florence/hurricane-florence_00000303_post_disaster.png,54,66,1,545,599,823,889,564,32.19761999985825,23.39157409312968
12179,/media/marda/TWOTB1/xBD/hurricanes/images/florence/hurricane-florence_00000303_post_disaster.png,60,69,1,502,562,870,939,821,37.4441882262443,28.848282346015992
12180,/media/marda/TWOTB1/xBD/hurricanes/images/florence/hurricane-florence_00000026_post_disaster.png,72,15,1,937,1009,0,15,325,42.02076568373016,12.154004643237483
12181,/media/marda/TWOTB1/xBD/hurricanes/images/florence/hurricane-florence_00000026_post_disaster.png,62,56,1,950,1012,78,134,827,61.08370598746097,18.417968893850215
12182,/media/marda/TWOTB1/xBD/hurricanes/images/florence/hurricane-florence_00000026_post_disaster.png,47,24,1,741,788,119,143,274,19.38975346203623,18.940039173400258
12183,/media/marda/TWOTB1/xBD/hurricanes/images/florence/hurricane-florence_00000026_post_disaster.png,81,26,1,767,848,120,146,660,57.39011786791823,16.114468005349543
12184,/media/marda/TWOTB1/xBD/hurricanes/images/florence/hurricane-florence_00000026_post_disaster.png,65,54,1,434,499,159,213,805,64.11692795564436,16.751288804421666
12185,/media/marda/TWOTB1/xBD/hurricanes/images/florence/hurricane-florence_00000026_post_disaster.png,54,18,1,932,986,163,181,181,18.79767402815377,13.014502769334179
12186,/media/marda/TWOTB1/xBD/hurricanes/images/florence/hurricane-florence_00000026_post_disaster.png,63,24,1,884,947,165,189,382,28.490294864715185,17.842346100218027
12187,/media/marda/TWOTB1/xBD/hurricanes/images/florence/hurricane-florence_00000026_post_disaster.png,31,39,1,349,380,177,216,511,37.96570809773614,18.005254189500036
12188,/media/marda/TWOTB1/xBD/hurricanes/images/florence/hurricane-florence_00000026_post_disaster.png,67,56,1,592,659,177,233,1212,47.24614113872681,35.23894568710623
12189,/media/marda/TWOTB1/xBD/hurricanes/images/florence/hurricane-florence_00000026_post_disaster.png,58,51,1,242,300,276,327,692,61.36728077899422,15.051800538016835
12190,/media/marda/TWOTB1/xBD/hurricanes/images/florence/hurricane-florence_00000026_post_disaster.png,89,63,1,713,802,346,409,1694,63.92063803908711,38.81852213306648
12191,/media/marda/TWOTB1/xBD/hurricanes/images/florence/hurricane-florence_00000026_post_disaster.png,58,35,1,622,680,382,417,618,37.20510506359476,22.18963873380097
12192,/media/marda/TWOTB1/xBD/hurricanes/images/florence/hurricane-florence_00000026_post_disaster.png,62,60,1,756,818,451,511,1123,48.129566951916466,31.448343889450832
12193,/media/marda/TWOTB1/xBD/hurricanes/images/florence/hurricane-florence_00000026_post_disaster.png,41,29,1,771,812,503,532,112,14.419855277207477,10.306349257078447
12194,/media/marda/TWOTB1/xBD/hurricanes/images/florence/hurricane-florence_00000026_post_disaster.png,25,53,1,255,280,552,605,391,36.05132084610336,15.483067270802803
12195,/media/marda/TWOTB1/xBD/hurricanes/images/florence/hurricane-florence_00000026_post_disaster.png,23,73,1,30,53,888,961,433,40.55487908946226,14.256449585621402
12196,/media/marda/TWOTB1/xBD/hurricanes/images/florence/hurricane-florence_00000026_post_disaster.png,74,111,1,294,368,922,1033,1868,87.60886862700382,34.01385917176033
12197,/media/marda/TWOTB1/xBD/hurricanes/images/florence/hurricane-florence_00000026_post_disaster.png,41,62,1,247,288,928,990,413,33.81342390866452,16.316612085456562
12198,/media/marda/TWOTB1/xBD/hurricanes/images/florence/hurricane-florence_00000026_post_disaster.png,47,42,1,989,1036,931,973,36,8.160260731786414,5.8754792060202
12199,/media/marda/TWOTB1/xBD/hurricanes/images/florence/hurricane-florence_00000026_post_disaster.png,80,96,1,953,1033,941,1037,1791,64.14922774454175,40.463129393711704
12200,/media/marda/TWOTB1/xBD/hurricanes/images/florence/hurricane-florence_00000026_post_disaster.png,39,59,1,249,288,948,1007,361,32.831480094013216,14.64343617037318
12201,/media/marda/TWOTB1/xBD/hurricanes/images/florence/hurricane-florence_00000026_post_disaster.png,66,79,1,820,886,962,1041,838,43.68194324698143,30.822377346519886
12202,/media/marda/TWOTB1/xBD/hurricanes/images/florence/hurricane-florence_00000026_post_disaster.png,61,68,1,747,808,973,1041,788,40.546333917216415,26.88618030254569
12203,/media/marda/TWOTB1/xBD/hurricanes/images/florence/hurricane-florence_00000026_post_disaster.png,43,54,1,666,709,989,1043,208,19.861136603620785,14.14148608003981
12204,/media/marda/TWOTB1/xBD/hurricanes/images/florence/hurricane-florence_00000513_pre_disaster.png,59,49,1,781,840,683,732,533,30.2340006025149,22.939943105064238
12205,/media/marda/TWOTB1/xBD/hurricanes/images/florence/hurricane-florence_00000513_pre_disaster.png,99,73,1,810,909,697,770,1918,71.24441690040848,36.61172060345938
12206,/media/marda/TWOTB1/xBD/hurricanes/images/florence/hurricane-florence_00000513_pre_disaster.png,70,92,1,974,1044,779,871,1389,72.11139237558959,31.26889642197268
12207,/media/marda/TWOTB1/xBD/hurricanes/images/florence/hurricane-florence_00000513_pre_disaster.png,66,51,1,932,998,785,836,414,31.310104112292127,17.69640328860022
12208,/media/marda/TWOTB1/xBD/hurricanes/images/florence/hurricane-florence_00000200_pre_disaster.png,47,30,1,469,516,175,205,392,24.292622238626844,21.313618100089876
12209,/media/marda/TWOTB1/xBD/hurricanes/images/florence/hurricane-florence_00000200_pre_disaster.png,63,59,1,426,489,230,289,1181,49.28417307968176,31.68776080071416
12210,/media/marda/TWOTB1/xBD/hurricanes/images/florence/hurricane-florence_00000200_pre_disaster.png,49,44,1,603,652,291,335,418,38.556491214092965,14.495180140880999
12211,/media/marda/TWOTB1/xBD/hurricanes/images/florence/hurricane-florence_00000200_pre_disaster.png,61,58,1,555,616,363,421,924,45.47938740381054,27.128754103084606
12212,/media/marda/TWOTB1/xBD/hurricanes/images/florence/hurricane-florence_00000200_pre_disaster.png,61,58,1,298,359,366,424,1016,53.43049173168972,25.70206943297514
12213,/media/marda/TWOTB1/xBD/hurricanes/images/florence/hurricane-florence_00000200_pre_disaster.png,28,37,1,258,286,435,472,215,18.545646260225727,15.36177572807318
12214,/media/marda/TWOTB1/xBD/hurricanes/images/florence/hurricane-florence_00000200_pre_disaster.png,24,30,1,286,310,442,472,95,13.523931473797543,9.43033990548726
12215,/media/marda/TWOTB1/xBD/hurricanes/images/florence/hurricane-florence_00000200_pre_disaster.png,67,87,1,372,439,656,743,1592,63.932064342629005,34.95755034224982
12216,/media/marda/TWOTB1/xBD/hurricanes/images/florence/hurricane-florence_00000200_pre_disaster.png,33,48,1,324,357,668,716,259,20.606851258855695,16.787044763898628
12217,/media/marda/TWOTB1/xBD/hurricanes/images/florence/hurricane-florence_00000200_pre_disaster.png,30,45,1,317,347,688,733,164,15.762587340458781,13.772761758260977
12218,/media/marda/TWOTB1/xBD/hurricanes/images/florence/hurricane-florence_00000200_pre_disaster.png,34,53,1,293,327,725,778,320,24.058558083330475,17.79583435669747
12219,/media/marda/TWOTB1/xBD/hurricanes/images/florence/hurricane-florence_00000200_pre_disaster.png,60,79,1,572,632,736,815,979,48.13408959861522,28.44894885733786
12220,/media/marda/TWOTB1/xBD/hurricanes/images/florence/hurricane-florence_00000200_pre_disaster.png,30,50,1,268,298,745,795,257,18.708483320529417,18.364451522156443
12221,/media/marda/TWOTB1/xBD/hurricanes/images/florence/hurricane-florence_00000200_pre_disaster.png,62,101,1,118,180,748,849,1911,76.2034013579423,35.927291742527615
12222,/media/marda/TWOTB1/xBD/hurricanes/images/florence/hurricane-florence_00000200_pre_disaster.png,67,67,1,614,681,768,835,952,37.67463902523831,33.530005274666486
12223,/media/marda/TWOTB1/xBD/hurricanes/images/florence/hurricane-florence_00000200_pre_disaster.png,50,78,1,342,392,770,848,1021,49.656755857121595,27.29830315270338
12224,/media/marda/TWOTB1/xBD/hurricanes/images/florence/hurricane-florence_00000200_pre_disaster.png,40,62,1,70,110,778,840,665,36.7676659632394,24.068798545683745
12225,/media/marda/TWOTB1/xBD/hurricanes/images/florence/hurricane-florence_00000200_pre_disaster.png,42,51,1,660,702,793,844,181,17.022508111881802,14.295190377871023
12226,/media/marda/TWOTB1/xBD/hurricanes/images/florence/hurricane-florence_00000200_pre_disaster.png,49,71,1,205,254,909,980,796,39.56260702373064,28.072515992007183
12227,/media/marda/TWOTB1/xBD/hurricanes/images/florence/hurricane-florence_00000200_pre_disaster.png,44,75,1,256,300,950,1025,810,35.49524636251168,30.28786804960047
12228,/media/marda/TWOTB1/xBD/hurricanes/images/florence/hurricane-florence_00000498_post_disaster.png,74,61,1,795,869,239,300,1055,56.77085716545838,24.799348327426927
12229,/media/marda/TWOTB1/xBD/hurricanes/images/florence/hurricane-florence_00000498_post_disaster.png,48,19,1,994,1042,245,264,55,10.34577969160451,7.014192195795645
12230,/media/marda/TWOTB1/xBD/hurricanes/images/florence/hurricane-florence_00000498_post_disaster.png,56,20,1,983,1039,255,275,94,15.330061555135417,8.266201723960073
12231,/media/marda/TWOTB1/xBD/hurricanes/images/florence/hurricane-florence_00000498_post_disaster.png,60,27,1,926,986,272,299,202,24.816537841922404,11.058136222005814
12232,/media/marda/TWOTB1/xBD/hurricanes/images/florence/hurricane-florence_00000498_post_disaster.png,58,22,1,923,981,295,317,142,24.592108943853074,7.739782557132333
12233,/media/marda/TWOTB1/xBD/hurricanes/images/florence/hurricane-florence_00000498_post_disaster.png,86,41,1,872,958,306,347,606,60.26226942503595,13.394719349031538
12234,/media/marda/TWOTB1/xBD/hurricanes/images/florence/hurricane-florence_00000498_post_disaster.png,39,36,1,468,507,423,459,170,26.87363905055158,8.472608927322232
12235,/media/marda/TWOTB1/xBD/hurricanes/images/florence/hurricane-florence_00000498_post_disaster.png,52,42,1,458,510,449,491,570,35.997276531743836,22.180538716362882
12236,/media/marda/TWOTB1/xBD/hurricanes/images/florence/hurricane-florence_00000498_post_disaster.png,62,72,1,571,633,645,717,1051,46.5900400179323,31.927278345026416
12237,/media/marda/TWOTB1/xBD/hurricanes/images/florence/hurricane-florence_00000498_post_disaster.png,75,75,1,892,967,659,734,1367,52.00974923090684,35.40067757335397
12238,/media/marda/TWOTB1/xBD/hurricanes/images/florence/hurricane-florence_00000498_post_disaster.png,33,38,1,510,543,679,717,102,11.95837011969403,11.436839845387206
12239,/media/marda/TWOTB1/xBD/hurricanes/images/florence/hurricane-florence_00000498_post_disaster.png,37,46,1,514,551,695,741,175,16.707526070998043,14.0700495747492
12240,/media/marda/TWOTB1/xBD/hurricanes/images/florence/hurricane-florence_00000498_post_disaster.png,39,42,1,559,598,697,739,136,18.73194439589606,9.722449478137724
12241,/media/marda/TWOTB1/xBD/hurricanes/images/florence/hurricane-florence_00000498_post_disaster.png,60,49,1,935,995,704,753,260,22.21040339826109,15.624127671710086
12242,/media/marda/TWOTB1/xBD/hurricanes/images/florence/hurricane-florence_00000498_post_disaster.png,35,40,1,545,580,706,746,92,15.438645073891067,8.032062174900908
12243,/media/marda/TWOTB1/xBD/hurricanes/images/florence/hurricane-florence_00000498_post_disaster.png,63,53,1,906,969,706,759,468,25.864722505958575,23.923438464796345
12244,/media/marda/TWOTB1/xBD/hurricanes/images/florence/hurricane-florence_00000498_post_disaster.png,30,37,1,535,565,713,750,54,8.967361710167031,7.956198941682753
12245,/media/marda/TWOTB1/xBD/hurricanes/images/florence/hurricane-florence_00000498_post_disaster.png,50,72,1,554,604,969,1041,750,33.9697768027044,29.07270749110469
12246,/media/marda/TWOTB1/xBD/hurricanes/images/florence/hurricane-florence_00000498_post_disaster.png,69,60,1,608,677,983,1043,558,42.694114633779904,21.50599046321805
12247,/media/marda/TWOTB1/xBD/hurricanes/images/florence/hurricane-florence_00000438_post_disaster.png,333,117,1,161,494,158,275,11910,373.101931560077,42.566101275807966
12248,/media/marda/TWOTB1/xBD/hurricanes/images/florence/hurricane-florence_00000438_post_disaster.png,333,124,1,162,495,242,366,11924,373.23302172704376,42.55852951018516
12249,/media/marda/TWOTB1/xBD/hurricanes/images/florence/hurricane-florence_00000438_post_disaster.png,281,118,1,214,495,327,445,9984,309.30677389840963,43.0416287200009
12250,/media/marda/TWOTB1/xBD/hurricanes/images/florence/hurricane-florence_00000438_post_disaster.png,280,126,1,215,495,412,538,10283,310.19897109072934,44.19104635941044
12251,/media/marda/TWOTB1/xBD/hurricanes/images/florence/hurricane-florence_00000438_post_disaster.png,40,39,1,435,475,484,523,343,24.52176417137977,18.773891674888425
12252,/media/marda/TWOTB1/xBD/hurricanes/images/florence/hurricane-florence_00000438_post_disaster.png,23,38,1,388,411,699,737,80,11.820834889915222,8.959233365939465
12253,/media/marda/TWOTB1/xBD/hurricanes/images/florence/hurricane-florence_00000438_post_disaster.png,19,36,1,370,389,701,737,56,9.16515138991168,8.0
12254,/media/marda/TWOTB1/xBD/hurricanes/images/florence/hurricane-florence_00000537_pre_disaster.png,13,21,1,0,13,14,35,186,19.720690339740262,13.099189476428805
12255,/media/marda/TWOTB1/xBD/hurricanes/images/florence/hurricane-florence_00000537_pre_disaster.png,17,27,1,36,53,316,343,201,17.82129013535105,14.386535227867764
12256,/media/marda/TWOTB1/xBD/hurricanes/images/florence/hurricane-florence_00000537_pre_disaster.png,39,54,1,33,72,345,399,1007,36.841351016220045,36.07266788735688
12257,/media/marda/TWOTB1/xBD/hurricanes/images/florence/hurricane-florence_00000537_pre_disaster.png,48,55,1,11,59,409,464,1127,49.98383838058339,30.360814167757383
12258,/media/marda/TWOTB1/xBD/hurricanes/images/florence/hurricane-florence_00000537_pre_disaster.png,31,41,1,101,132,412,453,407,25.594587120862517,21.236775842771348
12259,/media/marda/TWOTB1/xBD/hurricanes/images/florence/hurricane-florence_00000537_pre_disaster.png,10,44,1,0,10,481,525,153,25.311482604750598,10.099629739179774
12260,/media/marda/TWOTB1/xBD/hurricanes/images/florence/hurricane-florence_00000537_pre_disaster.png,44,28,1,925,969,504,532,48,8.30772235959311,7.367991907668753
12261,/media/marda/TWOTB1/xBD/hurricanes/images/florence/hurricane-florence_00000537_pre_disaster.png,121,47,1,923,1044,514,561,2212,94.61456869002411,31.047648368929227
12262,/media/marda/TWOTB1/xBD/hurricanes/images/florence/hurricane-florence_00000537_pre_disaster.png,122,48,1,922,1044,564,612,2265,95.15222914265549,31.608528712513973
12263,/media/marda/TWOTB1/xBD/hurricanes/images/florence/hurricane-florence_00000537_pre_disaster.png,46,32,1,922,968,590,622,53,9.604320503904235,7.142985832087935
12264,/media/marda/TWOTB1/xBD/hurricanes/images/florence/hurricane-florence_00000537_pre_disaster.png,48,37,1,933,981,604,641,139,14.043096459631126,13.241611484318698
12265,/media/marda/TWOTB1/xBD/hurricanes/images/florence/hurricane-florence_00000537_pre_disaster.png,28,43,1,46,74,608,651,313,29.765141475640768,14.069928966732785
12266,/media/marda/TWOTB1/xBD/hurricanes/images/florence/hurricane-florence_00000537_pre_disaster.png,9,54,1,0,9,623,677,146,28.921601003568668,7.664404549475006
12267,/media/marda/TWOTB1/xBD/hurricanes/images/florence/hurricane-florence_00000537_pre_disaster.png,143,60,1,899,1042,624,684,3023,120.16515968618998,34.26107501812148
12268,/media/marda/TWOTB1/xBD/hurricanes/images/florence/hurricane-florence_00000537_pre_disaster.png,50,56,1,58,108,731,787,1070,52.59690232399547,27.20615563184259
12269,/media/marda/TWOTB1/xBD/hurricanes/images/florence/hurricane-florence_00000537_pre_disaster.png,146,89,1,866,1012,759,848,2928,127.11863564252796,30.454011842825384
12270,/media/marda/TWOTB1/xBD/hurricanes/images/florence/hurricane-florence_00000537_pre_disaster.png,32,66,1,83,115,785,851,670,32.56284544840528,27.462346937003513
12271,/media/marda/TWOTB1/xBD/hurricanes/images/florence/hurricane-florence_00000537_pre_disaster.png,26,82,1,10,36,794,876,732,54.467085255566005,17.87042755812218
12272,/media/marda/TWOTB1/xBD/hurricanes/images/florence/hurricane-florence_00000537_pre_disaster.png,42,39,1,852,894,795,834,48,9.370221764179126,6.609992408895746
12273,/media/marda/TWOTB1/xBD/hurricanes/images/florence/hurricane-florence_00000537_pre_disaster.png,39,44,1,848,887,803,847,78,13.815841185108308,7.47871719273107
12274,/media/marda/TWOTB1/xBD/hurricanes/images/florence/hurricane-florence_00000092_post_disaster.png,36,12,1,258,294,0,12,291,31.83401361563628,12.20316480785332
12275,/media/marda/TWOTB1/xBD/hurricanes/images/florence/hurricane-florence_00000092_post_disaster.png,58,40,1,965,1023,520,560,366,22.467394581593698,21.653902121348594
12276,/media/marda/TWOTB1/xBD/hurricanes/images/florence/hurricane-florence_00000092_post_disaster.png,44,29,1,927,971,536,565,61,9.420869152462581,8.69969776536743
12277,/media/marda/TWOTB1/xBD/hurricanes/images/florence/hurricane-florence_00000092_post_disaster.png,52,39,1,907,959,547,586,304,21.908902300206645,18.439088914585774
12278,/media/marda/TWOTB1/xBD/hurricanes/images/florence/hurricane-florence_00000092_post_disaster.png,51,32,1,905,956,577,609,161,15.95326936557958,13.335924662636412
12279,/media/marda/TWOTB1/xBD/hurricanes/images/florence/hurricane-florence_00000092_post_disaster.png,53,41,1,990,1043,596,637,155,17.065527683513476,13.56831951790062
12280,/media/marda/TWOTB1/xBD/hurricanes/images/florence/hurricane-florence_00000092_post_disaster.png,52,42,1,903,955,614,656,253,19.451016897299592,17.561900970427033
12281,/media/marda/TWOTB1/xBD/hurricanes/images/florence/hurricane-florence_00000092_post_disaster.png,81,44,1,838,919,621,665,598,53.89021102827632,17.195414900923147
12282,/media/marda/TWOTB1/xBD/hurricanes/images/florence/hurricane-florence_00000092_post_disaster.png,36,58,1,0,36,625,683,1224,41.55317877932646,39.242833740697165
12283,/media/marda/TWOTB1/xBD/hurricanes/images/florence/hurricane-florence_00000092_post_disaster.png,88,36,1,943,1031,680,716,498,57.48656173566268,11.5134720272047
12284,/media/marda/TWOTB1/xBD/hurricanes/images/florence/hurricane-florence_00000092_post_disaster.png,8,50,1,0,8,977,1027,59,12.311310339622096,7.383423807107813
12285,/media/marda/TWOTB1/xBD/hurricanes/images/florence/hurricane-florence_00000383_pre_disaster.png,36,24,1,213,249,0,24,466,26.70917113165714,23.669382298361892
12286,/media/marda/TWOTB1/xBD/hurricanes/images/florence/hurricane-florence_00000383_pre_disaster.png,39,25,1,195,234,31,56,525,35.7884661431138,19.616563884930052
12287,/media/marda/TWOTB1/xBD/hurricanes/images/florence/hurricane-florence_00000383_pre_disaster.png,42,27,1,184,226,79,106,657,37.77067351190625,23.239786078598353
12288,/media/marda/TWOTB1/xBD/hurricanes/images/florence/hurricane-florence_00000383_pre_disaster.png,51,36,1,52,103,127,163,818,53.47014029871801,20.232646181848075
12289,/media/marda/TWOTB1/xBD/hurricanes/images/florence/hurricane-florence_00000383_pre_disaster.png,32,23,1,164,196,140,163,306,30.636720113548616,13.351958717378293
12290,/media/marda/TWOTB1/xBD/hurricanes/images/florence/hurricane-florence_00000383_pre_disaster.png,37,32,1,174,211,173,205,541,28.51135342331551,25.60523132281111
12291,/media/marda/TWOTB1/xBD/hurricanes/images/florence/hurricane-florence_00000383_pre_disaster.png,21,14,1,225,246,176,190,98,14.123883498671557,9.395265667173526
12292,/media/marda/TWOTB1/xBD/hurricanes/images/florence/hurricane-florence_00000383_pre_disaster.png,55,79,1,2,57,197,276,1128,93.19166798921108,34.022345397605854
12293,/media/marda/TWOTB1/xBD/hurricanes/images/florence/hurricane-florence_00000383_pre_disaster.png,40,43,1,33,73,214,257,831,37.632981821581886,31.43142363029845
12294,/media/marda/TWOTB1/xBD/hurricanes/images/florence/hurricane-florence_00000383_pre_disaster.png,30,34,1,149,179,218,252,443,24.966247181817206,23.632133121645037
12295,/media/marda/TWOTB1/xBD/hurricanes/images/florence/hurricane-florence_00000383_pre_disaster.png,32,61,1,250,282,220,281,810,60.53279561372289,17.841635306681848
12296,/media/marda/TWOTB1/xBD/hurricanes/images/florence/hurricane-florence_00000383_pre_disaster.png,59,51,1,317,376,223,274,771,55.48196504174469,19.14063377890875
12297,/media/marda/TWOTB1/xBD/hurricanes/images/florence/hurricane-florence_00000383_pre_disaster.png,34,52,1,145,179,255,307,836,44.2507578191734,25.241142973681384
12298,/media/marda/TWOTB1/xBD/hurricanes/images/florence/hurricane-florence_00000383_pre_disaster.png,26,22,1,194,220,263,285,215,21.05367517412579,13.452232385217862
12299,/media/marda/TWOTB1/xBD/hurricanes/images/florence/hurricane-florence_00000383_pre_disaster.png,20,18,1,208,228,278,296,77,12.088161643913285,8.620881227417849
12300,/media/marda/TWOTB1/xBD/hurricanes/images/florence/hurricane-florence_00000383_pre_disaster.png,22,21,1,199,221,296,317,126,16.1245154965971,10.327955589886445
12301,/media/marda/TWOTB1/xBD/hurricanes/images/florence/hurricane-florence_00000383_pre_disaster.png,23,47,1,0,23,297,344,557,34.11876327657857,21.791973043046227
12302,/media/marda/TWOTB1/xBD/hurricanes/images/florence/hurricane-florence_00000383_pre_disaster.png,20,33,1,108,128,324,357,227,21.696300760598024,14.038627641412205
12303,/media/marda/TWOTB1/xBD/hurricanes/images/florence/hurricane-florence_00000383_pre_disaster.png,16,47,1,0,16,343,390,352,33.89597837376469,14.750670431693935
12304,/media/marda/TWOTB1/xBD/hurricanes/images/florence/hurricane-florence_00000383_pre_disaster.png,36,62,1,98,134,356,418,1020,50.5411166482599,27.2402356376945
12305,/media/marda/TWOTB1/xBD/hurricanes/images/florence/hurricane-florence_00000383_pre_disaster.png,36,48,1,77,113,445,493,754,35.17094275499689,29.130638552427815
12306,/media/marda/TWOTB1/xBD/hurricanes/images/florence/hurricane-florence_00000383_pre_disaster.png,65,50,1,57,122,490,540,1223,61.64716477496829,28.4306979920219
12307,/media/marda/TWOTB1/xBD/hurricanes/images/florence/hurricane-florence_00000383_pre_disaster.png,55,35,1,145,200,496,531,553,57.452212025531836,12.750058087267538
12308,/media/marda/TWOTB1/xBD/hurricanes/images/florence/hurricane-florence_00000383_pre_disaster.png,43,48,1,99,142,516,564,629,43.16100225644366,19.122524736648028
12309,/media/marda/TWOTB1/xBD/hurricanes/images/florence/hurricane-florence_00000383_pre_disaster.png,39,60,1,26,65,576,636,895,38.09047652684486,34.623182623061375
12310,/media/marda/TWOTB1/xBD/hurricanes/images/florence/hurricane-florence_00000383_pre_disaster.png,48,43,1,21,69,629,672,385,52.66557265597693,10.478038470031409
12311,/media/marda/TWOTB1/xBD/hurricanes/images/florence/hurricane-florence_00000383_pre_disaster.png,23,69,1,0,23,676,745,697,45.557511513331455,20.76811398362875
12312,/media/marda/TWOTB1/xBD/hurricanes/images/florence/hurricane-florence_00000383_pre_disaster.png,29,51,1,99,128,712,763,407,27.056073990599785,19.882726661364252
12313,/media/marda/TWOTB1/xBD/hurricanes/images/florence/hurricane-florence_00000383_pre_disaster.png,58,68,1,498,556,798,866,1001,43.59743545986806,33.50460541630235
12314,/media/marda/TWOTB1/xBD/hurricanes/images/florence/hurricane-florence_00000383_pre_disaster.png,47,58,1,68,115,820,878,461,51.74324828555259,11.921576551946774
12315,/media/marda/TWOTB1/xBD/hurricanes/images/florence/hurricane-florence_00000383_pre_disaster.png,26,83,1,0,26,844,927,801,49.284547542299485,23.289277321203542
12316,/media/marda/TWOTB1/xBD/hurricanes/images/florence/hurricane-florence_00000383_pre_disaster.png,65,84,1,491,556,868,952,1528,52.90715301223383,48.709889203769784
12317,/media/marda/TWOTB1/xBD/hurricanes/images/florence/hurricane-florence_00000383_pre_disaster.png,80,71,1,762,842,874,945,591,60.70449328659107,13.004079908835944
12318,/media/marda/TWOTB1/xBD/hurricanes/images/florence/hurricane-florence_00000383_pre_disaster.png,81,55,1,701,782,882,937,1144,60.06101346477551,25.32249030157231
12319,/media/marda/TWOTB1/xBD/hurricanes/images/florence/hurricane-florence_00000383_pre_disaster.png,72,52,1,363,435,892,944,749,66.3667541938229,15.120848535699782
12320,/media/marda/TWOTB1/xBD/hurricanes/images/florence/hurricane-florence_00000383_pre_disaster.png,72,53,1,587,659,894,947,625,57.37844220631439,14.55824989676435
12321,/media/marda/TWOTB1/xBD/hurricanes/images/florence/hurricane-florence_00000383_pre_disaster.png,43,71,1,844,887,904,975,367,40.40132352608264,12.101336727881458
12322,/media/marda/TWOTB1/xBD/hurricanes/images/florence/hurricane-florence_00000383_pre_disaster.png,42,69,1,14,56,966,1035,892,43.444179665521375,27.185503919482546
12323,/media/marda/TWOTB1/xBD/hurricanes/images/florence/hurricane-florence_00000383_pre_disaster.png,50,53,1,129,179,991,1044,378,48.4165934372022,11.144856462049725
12324,/media/marda/TWOTB1/xBD/hurricanes/images/florence/hurricane-florence_00000247_post_disaster.png,49,25,1,337,386,1,26,745,39.980563431856396,24.419731526332296
12325,/media/marda/TWOTB1/xBD/hurricanes/images/florence/hurricane-florence_00000247_post_disaster.png,31,17,1,345,376,37,54,195,17.630079091128174,14.87004882316199
12326,/media/marda/TWOTB1/xBD/hurricanes/images/florence/hurricane-florence_00000247_post_disaster.png,60,44,1,305,365,195,239,1054,51.02366952094545,27.329018752270414
12327,/media/marda/TWOTB1/xBD/hurricanes/images/florence/hurricane-florence_00000247_post_disaster.png,18,26,1,28,46,251,277,164,14.968827263042193,14.697735981056672
12328,/media/marda/TWOTB1/xBD/hurricanes/images/florence/hurricane-florence_00000247_post_disaster.png,47,43,1,99,146,274,317,861,46.22361244763738,24.673948698199872
12329,/media/marda/TWOTB1/xBD/hurricanes/images/florence/hurricane-florence_00000247_post_disaster.png,42,46,1,234,276,327,373,501,43.23890450474649,15.25462128898371
12330,/media/marda/TWOTB1/xBD/hurricanes/images/florence/hurricane-florence_00000247_post_disaster.png,40,46,1,165,205,343,389,574,35.658211423335224,21.971961356860707
12331,/media/marda/TWOTB1/xBD/hurricanes/images/florence/hurricane-florence_00000436_post_disaster.png,348,120,1,341,689,269,389,9982,382.74037487065686,34.8657665376954
12332,/media/marda/TWOTB1/xBD/hurricanes/images/florence/hurricane-florence_00000436_post_disaster.png,72,70,1,740,812,303,373,1449,60.55964990736354,31.919546568836516
12333,/media/marda/TWOTB1/xBD/hurricanes/images/florence/hurricane-florence_00000436_post_disaster.png,54,45,1,676,730,314,359,455,30.30008667419066,21.777721367747905
12334,/media/marda/TWOTB1/xBD/hurricanes/images/florence/hurricane-florence_00000436_post_disaster.png,347,125,1,277,624,353,478,10081,387.00578939401066,34.7178940734078
12335,/media/marda/TWOTB1/xBD/hurricanes/images/florence/hurricane-florence_00000436_post_disaster.png,33,22,1,408,441,387,409,126,17.821805651793902,9.166513331997946
12336,/media/marda/TWOTB1/xBD/hurricanes/images/florence/hurricane-florence_00000436_post_disaster.png,61,37,1,709,770,392,429,532,33.22589779351196,22.394811667772185
12337,/media/marda/TWOTB1/xBD/hurricanes/images/florence/hurricane-florence_00000436_post_disaster.png,347,128,1,294,641,420,548,10245,384.01415357384747,35.63046329080529
12338,/media/marda/TWOTB1/xBD/hurricanes/images/florence/hurricane-florence_00000436_post_disaster.png,75,55,1,681,756,473,528,1662,54.730637587648175,40.3303668080488
12339,/media/marda/TWOTB1/xBD/hurricanes/images/florence/hurricane-florence_00000436_post_disaster.png,349,127,1,309,658,490,617,9815,386.0853799036772,33.86883442992637
12340,/media/marda/TWOTB1/xBD/hurricanes/images/florence/hurricane-florence_00000436_post_disaster.png,30,31,1,445,475,522,553,102,14.587208211063531,9.14368915372104
12341,/media/marda/TWOTB1/xBD/hurricanes/images/florence/hurricane-florence_00000436_post_disaster.png,14,44,1,53,67,840,884,137,15.766208736747712,11.703184055757083
12342,/media/marda/TWOTB1/xBD/hurricanes/images/florence/hurricane-florence_00000436_post_disaster.png,58,82,1,82,140,927,1009,1481,54.43600484395939,37.32089407952749
12343,/media/marda/TWOTB1/xBD/hurricanes/images/florence/hurricane-florence_00000234_post_disaster.png,52,76,1,57,109,798,874,1140,42.77525720086521,35.27889837957801
12344,/media/marda/TWOTB1/xBD/hurricanes/images/florence/hurricane-florence_00000234_post_disaster.png,13,55,1,25,38,848,903,215,24.759237982621777,11.64608506368543
12345,/media/marda/TWOTB1/xBD/hurricanes/images/florence/hurricane-florence_00000234_post_disaster.png,76,42,1,903,979,110,152,835,38.56249698441912,28.908658311717648
12346,/media/marda/TWOTB1/xBD/hurricanes/images/florence/hurricane-florence_00000234_post_disaster.png,67,48,1,716,783,202,250,843,35.423958650282366,31.76712505711734
12347,/media/marda/TWOTB1/xBD/hurricanes/images/florence/hurricane-florence_00000234_post_disaster.png,78,59,1,668,746,226,285,1429,45.18353160851433,42.19189342739854
12348,/media/marda/TWOTB1/xBD/hurricanes/images/florence/hurricane-florence_00000234_post_disaster.png,23,70,1,0,23,651,721,574,40.93044089615149,21.134099909787643
12349,/media/marda/TWOTB1/xBD/hurricanes/images/florence/hurricane-florence_00000140_pre_disaster.png,48,31,1,927,975,526,557,92,12.899791247720342,9.656477602018303
12350,/media/marda/TWOTB1/xBD/hurricanes/images/florence/hurricane-florence_00000079_post_disaster.png,58,39,1,412,470,25,64,1283,44.70667578779399,38.102079445020564
12351,/media/marda/TWOTB1/xBD/hurricanes/images/florence/hurricane-florence_00000079_post_disaster.png,53,27,1,316,369,46,73,825,43.21584422337743,24.827498772465418
12352,/media/marda/TWOTB1/xBD/hurricanes/images/florence/hurricane-florence_00000079_post_disaster.png,69,65,1,85,154,98,163,2739,62.527787740496265,57.294466790161565
12353,/media/marda/TWOTB1/xBD/hurricanes/images/florence/hurricane-florence_00000079_post_disaster.png,42,33,1,322,364,169,202,666,31.24376591074565,28.268225189714123
12354,/media/marda/TWOTB1/xBD/hurricanes/images/florence/hurricane-florence_00000079_post_disaster.png,66,46,1,435,501,582,628,767,53.89829909844355,18.88368820858227
12355,/media/marda/TWOTB1/xBD/hurricanes/images/florence/hurricane-florence_00000079_post_disaster.png,30,52,1,374,404,785,837,271,20.08663563696899,18.080223055752096
12356,/media/marda/TWOTB1/xBD/hurricanes/images/florence/hurricane-florence_00000079_post_disaster.png,48,58,1,323,371,801,859,701,38.46383284617658,23.79911120424483
12357,/media/marda/TWOTB1/xBD/hurricanes/images/florence/hurricane-florence_00000079_post_disaster.png,24,49,1,22,46,320,369,757,40.66606059829744,24.87056099962886
12358,/media/marda/TWOTB1/xBD/hurricanes/images/florence/hurricane-florence_00000161_post_disaster.png,29,31,1,328,357,491,522,116,19.565861898634186,7.893305876011578
12359,/media/marda/TWOTB1/xBD/hurricanes/images/florence/hurricane-florence_00000161_post_disaster.png,157,137,1,295,452,512,649,9448,138.85224472587558,93.99107768103116
12360,/media/marda/TWOTB1/xBD/hurricanes/images/florence/hurricane-florence_00000161_post_disaster.png,42,42,1,423,465,519,561,364,27.12460488536368,17.868112813273516
12361,/media/marda/TWOTB1/xBD/hurricanes/images/florence/hurricane-florence_00000161_post_disaster.png,31,39,1,435,466,615,654,120,13.120898631661767,12.174190239459264
12362,/media/marda/TWOTB1/xBD/hurricanes/images/florence/hurricane-florence_00000161_post_disaster.png,70,88,1,343,413,731,819,1981,56.86926154630223,51.3395317908862
12363,/media/marda/TWOTB1/xBD/hurricanes/images/florence/hurricane-florence_00000161_post_disaster.png,82,73,1,703,785,840,913,1341,55.385096761859025,32.315729232771055
12364,/media/marda/TWOTB1/xBD/hurricanes/images/florence/hurricane-florence_00000161_post_disaster.png,61,68,1,798,859,971,1039,635,30.71594424784082,27.5094491373706
12365,/media/marda/TWOTB1/xBD/hurricanes/images/florence/hurricane-florence_00000161_post_disaster.png,49,56,1,730,779,987,1043,282,21.393418263891153,17.522170199711596
12366,/media/marda/TWOTB1/xBD/hurricanes/images/florence/hurricane-florence_00000371_post_disaster.png,325,242,1,148,473,87,329,42427,318.44074670095,177.2960470339887
12367,/media/marda/TWOTB1/xBD/hurricanes/images/florence/hurricane-florence_00000371_post_disaster.png,31,19,1,378,409,118,137,169,16.20708424828682,13.44575331800368
12368,/media/marda/TWOTB1/xBD/hurricanes/images/florence/hurricane-florence_00000371_post_disaster.png,66,34,1,665,731,295,329,463,42.252091609585726,15.400762134326907
12369,/media/marda/TWOTB1/xBD/hurricanes/images/florence/hurricane-florence_00000371_post_disaster.png,63,47,1,710,773,300,347,675,31.229713567946003,29.049572323744197
12370,/media/marda/TWOTB1/xBD/hurricanes/images/florence/hurricane-florence_00000371_post_disaster.png,84,73,1,631,715,349,422,2099,55.88607557347026,52.224314338888135
12371,/media/marda/TWOTB1/xBD/hurricanes/images/florence/hurricane-florence_00000371_post_disaster.png,57,55,1,124,181,717,772,1016,58.37976805183797,23.980912467555513
12372,/media/marda/TWOTB1/xBD/hurricanes/images/florence/hurricane-florence_00000371_post_disaster.png,45,91,1,41,86,718,809,2035,66.35221387043218,45.00560528167658
12373,/media/marda/TWOTB1/xBD/hurricanes/images/florence/hurricane-florence_00000371_post_disaster.png,60,90,1,203,263,721,811,1689,59.279883761286435,42.91088909270536
12374,/media/marda/TWOTB1/xBD/hurricanes/images/florence/hurricane-florence_00000371_post_disaster.png,14,44,1,95,109,775,819,163,16.708531860628767,12.851503582314109
12375,/media/marda/TWOTB1/xBD/hurricanes/images/florence/hurricane-florence_00000371_post_disaster.png,36,64,1,107,143,784,848,907,36.606290532933706,33.01751402243961
12376,/media/marda/TWOTB1/xBD/hurricanes/images/florence/hurricane-florence_00000371_post_disaster.png,19,45,1,14,33,785,830,240,19.132720476409425,16.073169723155456
12377,/media/marda/TWOTB1/xBD/hurricanes/images/florence/hurricane-florence_00000313_post_disaster.png,35,48,1,426,461,503,551,205,34.21516016481987,8.802167403837663
12378,/media/marda/TWOTB1/xBD/hurricanes/images/florence/hurricane-florence_00000313_post_disaster.png,73,74,1,456,529,526,600,1435,56.80192867760505,34.23115142766797
12379,/media/marda/TWOTB1/xBD/hurricanes/images/florence/hurricane-florence_00000313_post_disaster.png,33,36,1,426,459,588,624,144,14.421733334426877,13.272913901368826
12380,/media/marda/TWOTB1/xBD/hurricanes/images/florence/hurricane-florence_00000313_post_disaster.png,80,75,1,445,525,605,680,1417,66.03687350240023,28.632626474193444
12381,/media/marda/TWOTB1/xBD/hurricanes/images/florence/hurricane-florence_00000313_post_disaster.png,53,57,1,563,616,630,687,499,33.615684757506735,19.739023505567964
12382,/media/marda/TWOTB1/xBD/hurricanes/images/florence/hurricane-florence_00000313_post_disaster.png,55,59,1,578,633,661,720,590,29.995816907654067,27.211462447378942
12383,/media/marda/TWOTB1/xBD/hurricanes/images/florence/hurricane-florence_00000313_post_disaster.png,71,66,1,520,591,672,738,950,55.624242677000794,22.80701828647969
12384,/media/marda/TWOTB1/xBD/hurricanes/images/florence/hurricane-florence_00000313_post_disaster.png,52,52,1,991,1043,697,749,192,23.457662282381676,11.323573786631307
12385,/media/marda/TWOTB1/xBD/hurricanes/images/florence/hurricane-florence_00000313_post_disaster.png,45,42,1,729,774,757,799,137,17.017002962841616,10.846644597873796
12386,/media/marda/TWOTB1/xBD/hurricanes/images/florence/hurricane-florence_00000313_post_disaster.png,45,60,1,562,607,795,855,464,28.326733700843302,21.557400803968907
12387,/media/marda/TWOTB1/xBD/hurricanes/images/florence/hurricane-florence_00000313_post_disaster.png,40,53,1,521,561,818,871,227,24.247926336798983,14.97139893586878
12388,/media/marda/TWOTB1/xBD/hurricanes/images/florence/hurricane-florence_00000313_post_disaster.png,63,66,1,531,594,841,907,971,42.380855986482935,30.109826464310757
12389,/media/marda/TWOTB1/xBD/hurricanes/images/florence/hurricane-florence_00000313_post_disaster.png,109,135,1,862,971,854,989,5013,103.71555429611757,64.83100821812754
12390,/media/marda/TWOTB1/xBD/hurricanes/images/florence/hurricane-florence_00000313_post_disaster.png,61,71,1,337,398,880,951,1206,48.92624811076614,32.98971743997481
12391,/media/marda/TWOTB1/xBD/hurricanes/images/florence/hurricane-florence_00000313_post_disaster.png,28,61,1,109,137,912,973,342,25.140281587787456,18.200935769808652
12392,/media/marda/TWOTB1/xBD/hurricanes/images/florence/hurricane-florence_00000313_post_disaster.png,74,68,1,685,759,925,993,921,50.10222788329909,24.860053200378925
12393,/media/marda/TWOTB1/xBD/hurricanes/images/florence/hurricane-florence_00000313_post_disaster.png,84,79,1,812,896,933,1012,1532,53.93529434853482,37.85763447843117
12394,/media/marda/TWOTB1/xBD/hurricanes/images/florence/hurricane-florence_00000313_post_disaster.png,91,74,1,878,969,967,1041,1377,57.422818054429904,34.936092395764085
12395,/media/marda/TWOTB1/xBD/hurricanes/images/florence/hurricane-florence_00000313_post_disaster.png,65,61,1,504,569,980,1041,753,43.55534937193949,23.788207817458158
12396,/media/marda/TWOTB1/xBD/hurricanes/images/florence/hurricane-florence_00000313_post_disaster.png,72,70,1,367,439,464,534,1628,53.00555364432616,40.85125051934403
12397,/media/marda/TWOTB1/xBD/hurricanes/images/florence/hurricane-florence_00000157_post_disaster.png,58,24,1,852,910,289,313,349,28.94506666075493,15.87815200125437
12398,/media/marda/TWOTB1/xBD/hurricanes/images/florence/hurricane-florence_00000157_post_disaster.png,76,74,1,718,794,589,663,1263,50.392939942448315,33.41854914906073
12399,/media/marda/TWOTB1/xBD/hurricanes/images/florence/hurricane-florence_00000157_post_disaster.png,67,51,1,832,899,616,667,442,36.83491559668609,15.87536529219027
12400,/media/marda/TWOTB1/xBD/hurricanes/images/florence/hurricane-florence_00000157_post_disaster.png,79,79,1,775,854,915,994,1099,44.376369761776004,33.04840866683832
12401,/media/marda/TWOTB1/xBD/hurricanes/images/florence/hurricane-florence_00000157_post_disaster.png,71,69,1,953,1024,965,1034,823,33.67601499813866,32.863544494190585
12402,/media/marda/TWOTB1/xBD/hurricanes/images/florence/hurricane-florence_00000016_pre_disaster.png,57,19,1,166,223,0,19,511,45.384712642991644,17.151776199691678
12403,/media/marda/TWOTB1/xBD/hurricanes/images/florence/hurricane-florence_00000016_pre_disaster.png,65,33,1,282,347,0,33,1040,49.60552205945454,28.848878704565685
12404,/media/marda/TWOTB1/xBD/hurricanes/images/florence/hurricane-florence_00000016_pre_disaster.png,21,5,1,335,356,0,5,25,8.0,4.664761515876241
12405,/media/marda/TWOTB1/xBD/hurricanes/images/florence/hurricane-florence_00000016_pre_disaster.png,42,6,1,637,679,0,6,57,17.608244416750697,4.890385668709081
12406,/media/marda/TWOTB1/xBD/hurricanes/images/florence/hurricane-florence_00000016_pre_disaster.png,75,37,1,748,823,0,37,1087,41.39495336198456,35.872679853880406
12407,/media/marda/TWOTB1/xBD/hurricanes/images/florence/hurricane-florence_00000016_pre_disaster.png,73,15,1,785,858,0,15,426,40.79325655451991,14.251720055237456
12408,/media/marda/TWOTB1/xBD/hurricanes/images/florence/hurricane-florence_00000016_pre_disaster.png,47,7,1,829,876,0,7,54,13.67488330208856,6.122573549276759
12409,/media/marda/TWOTB1/xBD/hurricanes/images/florence/hurricane-florence_00000016_pre_disaster.png,56,41,1,143,199,13,54,1217,47.57722982131329,34.11537076554896
12410,/media/marda/TWOTB1/xBD/hurricanes/images/florence/hurricane-florence_00000016_pre_disaster.png,76,36,1,647,723,14,50,1367,53.213823891045294,33.863544352582615
12411,/media/marda/TWOTB1/xBD/hurricanes/images/florence/hurricane-florence_00000016_pre_disaster.png,63,48,1,259,322,20,68,1472,52.264909988079495,36.70470409224017
12412,/media/marda/TWOTB1/xBD/hurricanes/images/florence/hurricane-florence_00000016_pre_disaster.png,58,44,1,126,184,42,86,1360,51.01579291568901,36.16860934912038
12413,/media/marda/TWOTB1/xBD/hurricanes/images/florence/hurricane-florence_00000016_pre_disaster.png,54,45,1,231,285,55,100,1144,40.58689839404615,38.06354830490356
12414,/media/marda/TWOTB1/xBD/hurricanes/images/florence/hurricane-florence_00000016_pre_disaster.png,88,53,1,826,914,64,117,1542,51.20732575806376,39.79198201051299
12415,/media/marda/TWOTB1/xBD/hurricanes/images/florence/hurricane-florence_00000016_pre_disaster.png,87,37,1,636,723,66,103,1553,59.01879517967915,34.44213573145118
12416,/media/marda/TWOTB1/xBD/hurricanes/images/florence/hurricane-florence_00000016_pre_disaster.png,61,41,1,104,165,81,122,1329,51.634713319418054,34.40452314980073
12417,/media/marda/TWOTB1/xBD/hurricanes/images/florence/hurricane-florence_00000016_pre_disaster.png,118,68,1,756,874,81,149,2899,87.45865504632967,47.92649861699798
12418,/media/marda/TWOTB1/xBD/hurricanes/images/florence/hurricane-florence_00000016_pre_disaster.png,62,48,1,213,275,94,142,1571,52.780432291492474,38.83780891646185
12419,/media/marda/TWOTB1/xBD/hurricanes/images/florence/hurricane-florence_00000016_pre_disaster.png,80,52,1,620,700,108,160,1519,53.27959283995604,37.100683558006516
12420,/media/marda/TWOTB1/xBD/hurricanes/images/florence/hurricane-florence_00000016_pre_disaster.png,60,45,1,93,153,114,159,1500,55.15767701755218,35.63853967928316
12421,/media/marda/TWOTB1/xBD/hurricanes/images/florence/hurricane-florence_00000016_pre_disaster.png,83,53,1,734,817,127,180,1291,52.962870462047164,32.30308052880317
12422,/media/marda/TWOTB1/xBD/hurricanes/images/florence/hurricane-florence_00000016_pre_disaster.png,60,45,1,197,257,133,178,1292,49.354399025638564,35.19728855552105
12423,/media/marda/TWOTB1/xBD/hurricanes/images/florence/hurricane-florence_00000016_pre_disaster.png,76,52,1,590,666,143,195,1276,51.4651272040553,32.68635113339101
12424,/media/marda/TWOTB1/xBD/hurricanes/images/florence/hurricane-florence_00000016_pre_disaster.png,47,42,1,92,139,154,196,1114,42.486429266038115,34.76043018629972
12425,/media/marda/TWOTB1/xBD/hurricanes/images/florence/hurricane-florence_00000016_pre_disaster.png,82,52,1,713,795,156,208,1310,46.470201575586266,37.956365349919004
12426,/media/marda/TWOTB1/xBD/hurricanes/images/florence/hurricane-florence_00000016_pre_disaster.png,74,54,1,567,641,174,228,1283,51.369234543954,33.08277581039633
12427,/media/marda/TWOTB1/xBD/hurricanes/images/florence/hurricane-florence_00000016_pre_disaster.png,50,43,1,186,236,175,218,1176,43.95100533224987,35.380896790028565
12428,/media/marda/TWOTB1/xBD/hurricanes/images/florence/hurricane-florence_00000016_pre_disaster.png,82,56,1,690,772,185,241,1409,51.398337230261355,36.294993947267955
12429,/media/marda/TWOTB1/xBD/hurricanes/images/florence/hurricane-florence_00000016_pre_disaster.png,48,39,1,82,130,193,232,1176,44.81880120560199,34.59572583236779
12430,/media/marda/TWOTB1/xBD/hurricanes/images/florence/hurricane-florence_00000016_pre_disaster.png,76,57,1,538,614,200,257,1404,52.06304615870673,35.43503753869977
12431,/media/marda/TWOTB1/xBD/hurricanes/images/florence/hurricane-florence_00000016_pre_disaster.png,76,59,1,667,743,213,272,1261,47.23661674883892,36.52653644507806
12432,/media/marda/TWOTB1/xBD/hurricanes/images/florence/hurricane-florence_00000016_pre_disaster.png,57,39,1,177,234,221,260,1152,50.1678692802101,31.090195309948744
12433,/media/marda/TWOTB1/xBD/hurricanes/images/florence/hurricane-florence_00000016_pre_disaster.png,48,40,1,75,123,231,271,1149,47.177101369793455,32.60767746937949
12434,/media/marda/TWOTB1/xBD/hurricanes/images/florence/hurricane-florence_00000016_pre_disaster.png,74,54,1,509,583,235,289,1280,48.3952597799066,35.46929284793015
12435,/media/marda/TWOTB1/xBD/hurricanes/images/florence/hurricane-florence_00000016_pre_disaster.png,77,62,1,645,722,237,299,1324,53.13194612039334,33.26274037926696
12436,/media/marda/TWOTB1/xBD/hurricanes/images/florence/hurricane-florence_00000016_pre_disaster.png,69,58,1,486,555,259,317,1350,48.41379104719494,37.60258888738757
12437,/media/marda/TWOTB1/xBD/hurricanes/images/florence/hurricane-florence_00000016_pre_disaster.png,102,86,1,592,694,265,351,2746,82.25045808709292,48.409678408547435
12438,/media/marda/TWOTB1/xBD/hurricanes/images/florence/hurricane-florence_00000016_pre_disaster.png,51,41,1,73,124,269,310,1282,50.41632568032248,34.920751282291306
12439,/media/marda/TWOTB1/xBD/hurricanes/images/florence/hurricane-florence_00000016_pre_disaster.png,73,53,1,452,525,293,346,1333,49.339707127751005,35.9267120036641
12440,/media/marda/TWOTB1/xBD/hurricanes/images/florence/hurricane-florence_00000016_pre_disaster.png,51,61,1,204,255,312,373,1051,45.35691928373287,32.37589254148208
12441,/media/marda/TWOTB1/xBD/hurricanes/images/florence/hurricane-florence_00000016_pre_disaster.png,66,56,1,571,637,317,373,952,37.0171922468103,34.872066941450434
12442,/media/marda/TWOTB1/xBD/hurricanes/images/florence/hurricane-florence_00000016_pre_disaster.png,67,60,1,428,495,319,379,1289,47.44275729140375,36.454431416521665
12443,/media/marda/TWOTB1/xBD/hurricanes/images/florence/hurricane-florence_00000016_pre_disaster.png,52,44,1,96,148,341,385,1289,52.0820116089053,33.59270536345987
12444,/media/marda/TWOTB1/xBD/hurricanes/images/florence/hurricane-florence_00000016_pre_disaster.png,76,68,1,543,619,342,410,1593,52.63272303430202,39.7352028514125
12445,/media/marda/TWOTB1/xBD/hurricanes/images/florence/hurricane-florence_00000016_pre_disaster.png,61,64,1,390,451,347,411,1441,49.77714158402592,37.72915610849246
12446,/media/marda/TWOTB1/xBD/hurricanes/images/florence/hurricane-florence_00000016_pre_disaster.png,53,56,1,242,295,354,410,1122,41.430787824181266,35.50726594188028
12447,/media/marda/TWOTB1/xBD/hurricanes/images/florence/hurricane-florence_00000016_pre_disaster.png,50,60,1,296,346,368,428,1288,48.19877046514446,35.60994304684612
12448,/media/marda/TWOTB1/xBD/hurricanes/images/florence/hurricane-florence_00000016_pre_disaster.png,92,94,1,492,584,370,464,2767,83.70933072914308,46.85362522482552
12449,/media/marda/TWOTB1/xBD/hurricanes/images/florence/hurricane-florence_00000016_pre_disaster.png,66,62,1,469,535,421,483,1213,43.42019103426754,37.151454100426726
12450,/media/marda/TWOTB1/xBD/hurricanes/images/florence/hurricane-florence_00000016_pre_disaster.png,54,64,1,175,229,424,488,1228,48.14023110762288,34.83871345111824
12451,/media/marda/TWOTB1/xBD/hurricanes/images/florence/hurricane-florence_00000016_pre_disaster.png,70,65,1,436,506,442,507,1355,48.78216052213478,37.4238691979628
12452,/media/marda/TWOTB1/xBD/hurricanes/images/florence/hurricane-florence_00000016_pre_disaster.png,51,58,1,213,264,445,503,1097,43.53470780807894,34.18268838219396
12453,/media/marda/TWOTB1/xBD/hurricanes/images/florence/hurricane-florence_00000016_pre_disaster.png,51,49,1,77,128,451,500,1278,50.453553634003335,33.9875971921018
12454,/media/marda/TWOTB1/xBD/hurricanes/images/florence/hurricane-florence_00000016_pre_disaster.png,61,59,1,400,461,460,519,1005,40.80900713380799,32.68875202257046
12455,/media/marda/TWOTB1/xBD/hurricanes/images/florence/hurricane-florence_00000016_pre_disaster.png,55,68,1,253,308,461,529,1472,50.6261597373197,38.46274259419333
12456,/media/marda/TWOTB1/xBD/hurricanes/images/florence/hurricane-florence_00000016_pre_disaster.png,51,63,1,294,345,470,533,1216,47.057992392354556,34.99140956275945
12457,/media/marda/TWOTB1/xBD/hurricanes/images/florence/hurricane-florence_00000016_pre_disaster.png,49,51,1,82,131,491,542,1216,49.326724017414506,33.35697939779624
12458,/media/marda/TWOTB1/xBD/hurricanes/images/florence/hurricane-florence_00000016_pre_disaster.png,68,66,1,387,455,495,561,1254,47.22936107224701,35.706797240047635
12459,/media/marda/TWOTB1/xBD/hurricanes/images/florence/hurricane-florence_00000016_pre_disaster.png,47,52,1,84,131,527,579,1156,46.410049857265115,33.72542724736915
12460,/media/marda/TWOTB1/xBD/hurricanes/images/florence/hurricane-florence_00000016_pre_disaster.png,67,73,1,367,434,527,600,1542,53.50016500597483,37.556365955846665
12461,/media/marda/TWOTB1/xBD/hurricanes/images/florence/hurricane-florence_00000016_pre_disaster.png,53,59,1,81,134,567,626,1290,54.7062207690136,31.81939883248258
12462,/media/marda/TWOTB1/xBD/hurricanes/images/florence/hurricane-florence_00000016_pre_disaster.png,60,68,1,289,349,611,679,1247,43.67877121297409,37.5321915886965
12463,/media/marda/TWOTB1/xBD/hurricanes/images/florence/hurricane-florence_00000016_pre_disaster.png,50,68,1,136,186,631,699,1119,41.57956536210587,35.50050113696872
12464,/media/marda/TWOTB1/xBD/hurricanes/images/florence/hurricane-florence_00000016_pre_disaster.png,49,74,1,176,225,651,725,1379,52.900328456576425,34.84258989147521
12465,/media/marda/TWOTB1/xBD/hurricanes/images/florence/hurricane-florence_00000098_post_disaster.png,43,33,1,126,169,529,562,428,44.889448127299985,12.67197302035036
12466,/media/marda/TWOTB1/xBD/hurricanes/images/florence/hurricane-florence_00000098_post_disaster.png,27,51,1,168,195,561,612,544,31.200212254737956,23.728477528704477
12467,/media/marda/TWOTB1/xBD/hurricanes/images/florence/hurricane-florence_00000098_post_disaster.png,21,40,1,161,182,604,644,214,18.22211397513578,15.755101777836218
12468,/media/marda/TWOTB1/xBD/hurricanes/images/florence/hurricane-florence_00000230_pre_disaster.png,29,10,1,294,323,0,10,113,16.448257307668243,9.378997804010545
12469,/media/marda/TWOTB1/xBD/hurricanes/images/florence/hurricane-florence_00000230_pre_disaster.png,94,49,1,830,924,0,49,1606,52.86341036860413,40.34589601565213
12470,/media/marda/TWOTB1/xBD/hurricanes/images/florence/hurricane-florence_00000230_pre_disaster.png,59,27,1,785,844,8,35,370,27.52020505621466,17.777460705484465
12471,/media/marda/TWOTB1/xBD/hurricanes/images/florence/hurricane-florence_00000230_pre_disaster.png,63,31,1,754,817,24,55,555,31.705691013754503,23.18072303855217
12472,/media/marda/TWOTB1/xBD/hurricanes/images/florence/hurricane-florence_00000230_pre_disaster.png,39,44,1,308,347,28,72,618,47.80809133455072,17.189600626078946
12473,/media/marda/TWOTB1/xBD/hurricanes/images/florence/hurricane-florence_00000230_pre_disaster.png,102,62,1,737,839,59,121,1956,79.68182218783822,32.59859577128824
12474,/media/marda/TWOTB1/xBD/hurricanes/images/florence/hurricane-florence_00000230_pre_disaster.png,52,24,1,665,717,69,93,284,26.733521230358097,14.205063524381922
12475,/media/marda/TWOTB1/xBD/hurricanes/images/florence/hurricane-florence_00000230_pre_disaster.png,74,58,1,579,653,86,144,1291,63.036466996883206,34.94823687344096
12476,/media/marda/TWOTB1/xBD/hurricanes/images/florence/hurricane-florence_00000230_pre_disaster.png,57,36,1,645,702,112,148,541,33.28515754048099,23.380507008154165
12477,/media/marda/TWOTB1/xBD/hurricanes/images/florence/hurricane-florence_00000230_pre_disaster.png,82,65,1,433,515,150,215,1437,80.50877310327851,24.276831461729504
12478,/media/marda/TWOTB1/xBD/hurricanes/images/florence/hurricane-florence_00000230_pre_disaster.png,45,20,1,692,737,154,174,159,15.628497918076102,13.369780914795284
12479,/media/marda/TWOTB1/xBD/hurricanes/images/florence/hurricane-florence_00000230_pre_disaster.png,89,70,1,633,722,156,226,1968,68.85403081441524,37.90412831017282
12480,/media/marda/TWOTB1/xBD/hurricanes/images/florence/hurricane-florence_00000230_pre_disaster.png,70,63,1,591,661,199,262,1256,58.11012573566989,28.15280287977731
12481,/media/marda/TWOTB1/xBD/hurricanes/images/florence/hurricane-florence_00000230_pre_disaster.png,59,46,1,502,561,216,262,920,36.87069506855041,33.02539654276061
12482,/media/marda/TWOTB1/xBD/hurricanes/images/florence/hurricane-florence_00000230_pre_disaster.png,46,21,1,848,894,224,245,91,11.870224183311464,10.324178445840506
12483,/media/marda/TWOTB1/xBD/hurricanes/images/florence/hurricane-florence_00000230_pre_disaster.png,51,35,1,831,882,269,304,329,30.85806635337849,15.034045164282716
12484,/media/marda/TWOTB1/xBD/hurricanes/images/florence/hurricane-florence_00000230_pre_disaster.png,40,27,1,494,534,275,302,208,18.01621424524283,15.119738187197264
12485,/media/marda/TWOTB1/xBD/hurricanes/images/florence/hurricane-florence_00000230_pre_disaster.png,80,53,1,488,568,294,347,1176,58.04977558508438,31.502086098468258
12486,/media/marda/TWOTB1/xBD/hurricanes/images/florence/hurricane-florence_00000230_pre_disaster.png,75,48,1,621,696,326,374,905,52.29504139990996,27.777964417348894
12487,/media/marda/TWOTB1/xBD/hurricanes/images/florence/hurricane-florence_00000230_pre_disaster.png,66,47,1,569,635,348,395,892,43.51310823057217,27.137575745724146
12488,/media/marda/TWOTB1/xBD/hurricanes/images/florence/hurricane-florence_00000230_pre_disaster.png,90,105,1,705,795,403,508,2269,104.68466512865417,36.518991768903014
12489,/media/marda/TWOTB1/xBD/hurricanes/images/florence/hurricane-florence_00000230_pre_disaster.png,72,57,1,620,692,414,471,1216,48.10376125440424,34.96246268200759
12490,/media/marda/TWOTB1/xBD/hurricanes/images/florence/hurricane-florence_00000230_pre_disaster.png,30,30,1,159,189,441,471,269,28.55516186833057,12.521195636168807
12491,/media/marda/TWOTB1/xBD/hurricanes/images/florence/hurricane-florence_00000230_pre_disaster.png,46,63,1,278,324,441,504,868,45.9366600597693,27.901011229408773
12492,/media/marda/TWOTB1/xBD/hurricanes/images/florence/hurricane-florence_00000230_pre_disaster.png,17,25,1,161,178,459,484,87,14.283701543962087,8.211220741466162
12493,/media/marda/TWOTB1/xBD/hurricanes/images/florence/hurricane-florence_00000230_pre_disaster.png,37,39,1,208,245,468,507,461,29.93547619805757,20.135968447459312
12494,/media/marda/TWOTB1/xBD/hurricanes/images/florence/hurricane-florence_00000230_pre_disaster.png,26,43,1,111,137,471,514,461,27.28156327096278,22.18218043998926
12495,/media/marda/TWOTB1/xBD/hurricanes/images/florence/hurricane-florence_00000230_pre_disaster.png,51,37,1,644,695,473,510,325,28.00745285869146,15.526061914386357
12496,/media/marda/TWOTB1/xBD/hurricanes/images/florence/hurricane-florence_00000230_pre_disaster.png,64,44,1,145,209,474,518,1018,64.18621625023889,21.471980434631437
12497,/media/marda/TWOTB1/xBD/hurricanes/images/florence/hurricane-florence_00000230_pre_disaster.png,31,59,1,84,115,497,556,871,42.09280286003973,27.385844177615144
12498,/media/marda/TWOTB1/xBD/hurricanes/images/florence/hurricane-florence_00000230_pre_disaster.png,35,38,1,496,531,506,544,166,17.90105903349425,12.492658996177889
12499,/media/marda/TWOTB1/xBD/hurricanes/images/florence/hurricane-florence_00000230_pre_disaster.png,95,69,1,426,521,508,577,2058,85.5674521304959,32.4487276189557
12500,/media/marda/TWOTB1/xBD/hurricanes/images/florence/hurricane-florence_00000230_pre_disaster.png,73,61,1,265,338,529,590,1580,68.36470593821159,30.342340881085804
12501,/media/marda/TWOTB1/xBD/hurricanes/images/florence/hurricane-florence_00000230_pre_disaster.png,63,54,1,436,499,548,602,1069,49.52100547538117,28.11791503000337
12502,/media/marda/TWOTB1/xBD/hurricanes/images/florence/hurricane-florence_00000230_pre_disaster.png,57,57,1,203,260,553,610,1071,54.22024770299353,27.3769300206838
12503,/media/marda/TWOTB1/xBD/hurricanes/images/florence/hurricane-florence_00000230_pre_disaster.png,74,89,1,273,347,556,645,2802,64.55543211518192,59.70637882479753
12504,/media/marda/TWOTB1/xBD/hurricanes/images/florence/hurricane-florence_00000230_pre_disaster.png,117,128,1,752,869,593,721,3970,107.75796443442877,60.26006346133256
12505,/media/marda/TWOTB1/xBD/hurricanes/images/florence/hurricane-florence_00000230_pre_disaster.png,93,65,1,446,539,596,661,1820,76.6763109477082,34.15262933961155
12506,/media/marda/TWOTB1/xBD/hurricanes/images/florence/hurricane-florence_00000230_pre_disaster.png,49,56,1,298,347,619,675,730,35.00976091812299,27.4313128684651
12507,/media/marda/TWOTB1/xBD/hurricanes/images/florence/hurricane-florence_00000230_pre_disaster.png,57,72,1,326,383,637,709,991,57.74585866769263,25.692952399283904
12508,/media/marda/TWOTB1/xBD/hurricanes/images/florence/hurricane-florence_00000230_pre_disaster.png,59,92,1,380,439,646,738,1693,74.81623784366957,30.10310621840029
12509,/media/marda/TWOTB1/xBD/hurricanes/images/florence/hurricane-florence_00000230_pre_disaster.png,84,127,1,677,761,652,779,3126,103.16107230527497,42.77585854444556
12510,/media/marda/TWOTB1/xBD/hurricanes/images/florence/hurricane-florence_00000230_pre_disaster.png,35,54,1,305,340,661,715,392,28.757555310637695,18.433565250404254
12511,/media/marda/TWOTB1/xBD/hurricanes/images/florence/hurricane-florence_00000230_pre_disaster.png,84,80,1,485,569,684,764,2515,66.3955917028803,50.91005696001082
12512,/media/marda/TWOTB1/xBD/hurricanes/images/florence/hurricane-florence_00000230_pre_disaster.png,59,45,1,984,1043,693,738,214,18.119577966195624,15.723988857390166
12513,/media/marda/TWOTB1/xBD/hurricanes/images/florence/hurricane-florence_00000230_pre_disaster.png,69,66,1,931,1000,707,773,745,38.095727985956415,25.807718607485377
12514,/media/marda/TWOTB1/xBD/hurricanes/images/florence/hurricane-florence_00000230_pre_disaster.png,74,71,1,795,869,774,845,1239,42.54870078729756,38.98402741831538
12515,/media/marda/TWOTB1/xBD/hurricanes/images/florence/hurricane-florence_00000230_pre_disaster.png,48,63,1,22,70,785,848,936,49.98626942958844,24.988917401901368
12516,/media/marda/TWOTB1/xBD/hurricanes/images/florence/hurricane-florence_00000230_pre_disaster.png,62,76,1,982,1044,794,870,510,37.90969337448312,20.22035016477983
12517,/media/marda/TWOTB1/xBD/hurricanes/images/florence/hurricane-florence_00000230_pre_disaster.png,65,58,1,360,425,805,863,672,57.238153123757606,15.683886736767555
12518,/media/marda/TWOTB1/xBD/hurricanes/images/florence/hurricane-florence_00000230_pre_disaster.png,75,73,1,381,456,850,923,1627,61.72079518977029,34.61572669281755
12519,/media/marda/TWOTB1/xBD/hurricanes/images/florence/hurricane-florence_00000230_pre_disaster.png,30,51,1,440,470,894,945,123,13.453337017993492,12.298896788616576
12520,/media/marda/TWOTB1/xBD/hurricanes/images/florence/hurricane-florence_00000230_pre_disaster.png,77,82,1,566,643,913,995,1518,54.66494120647433,37.17502744970908
12521,/media/marda/TWOTB1/xBD/hurricanes/images/florence/hurricane-florence_00000230_pre_disaster.png,47,57,1,614,661,946,1003,287,21.91350349500884,17.565222473183297
12522,/media/marda/TWOTB1/xBD/hurricanes/images/florence/hurricane-florence_00000230_pre_disaster.png,46,48,1,998,1044,987,1035,26,6.861262498762388,5.764613536983137
12523,/media/marda/TWOTB1/xBD/hurricanes/images/florence/hurricane-florence_00000132_pre_disaster.png,59,52,1,384,443,21,73,1148,49.89760054268539,31.784383388250074
12524,/media/marda/TWOTB1/xBD/hurricanes/images/florence/hurricane-florence_00000132_pre_disaster.png,56,37,1,569,625,171,208,566,33.41346977481009,22.433585151751153
12525,/media/marda/TWOTB1/xBD/hurricanes/images/florence/hurricane-florence_00000132_pre_disaster.png,64,62,1,549,613,425,487,1015,42.267143597762484,32.722931960367276
12526,/media/marda/TWOTB1/xBD/hurricanes/images/florence/hurricane-florence_00000132_pre_disaster.png,77,54,1,895,972,426,480,849,38.10317588259493,29.42840895525524
12527,/media/marda/TWOTB1/xBD/hurricanes/images/florence/hurricane-florence_00000132_pre_disaster.png,78,64,1,759,837,585,649,1024,43.70887101870924,31.286164418412394
12528,/media/marda/TWOTB1/xBD/hurricanes/images/florence/hurricane-florence_00000132_pre_disaster.png,61,51,1,810,871,612,663,373,27.925284778438943,17.853038365102826
12529,/media/marda/TWOTB1/xBD/hurricanes/images/florence/hurricane-florence_00000501_pre_disaster.png,60,40,1,68,128,0,40,1155,61.12659904580952,24.953239806682696
12530,/media/marda/TWOTB1/xBD/hurricanes/images/florence/hurricane-florence_00000501_pre_disaster.png,35,15,1,526,561,25,40,143,14.430056202431553,13.165987881928304
12531,/media/marda/TWOTB1/xBD/hurricanes/images/florence/hurricane-florence_00000501_pre_disaster.png,50,36,1,731,781,311,347,281,20.885066472169207,17.980235773123955
12532,/media/marda/TWOTB1/xBD/hurricanes/images/florence/hurricane-florence_00000030_pre_disaster.png,62,36,1,849,911,35,71,727,35.81931994403313,26.982776059011055
12533,/media/marda/TWOTB1/xBD/hurricanes/images/florence/hurricane-florence_00000030_pre_disaster.png,43,12,1,832,875,64,76,76,10.476137305484787,9.8375232119728
12534,/media/marda/TWOTB1/xBD/hurricanes/images/florence/hurricane-florence_00000030_pre_disaster.png,68,46,1,889,957,341,387,774,35.62903602251698,28.897295390426557
12535,/media/marda/TWOTB1/xBD/hurricanes/images/florence/hurricane-florence_00000030_pre_disaster.png,53,31,1,862,915,355,386,316,21.395080820149122,19.628926113809424
12536,/media/marda/TWOTB1/xBD/hurricanes/images/florence/hurricane-florence_00000030_pre_disaster.png,65,68,1,933,998,827,895,723,34.631198216921895,27.912400868270154
12537,/media/marda/TWOTB1/xBD/hurricanes/images/florence/hurricane-florence_00000030_pre_disaster.png,101,76,1,875,976,872,948,1847,70.34657107144439,34.88617107937151
12538,/media/marda/TWOTB1/xBD/hurricanes/images/florence/hurricane-florence_00000030_pre_disaster.png,61,50,1,973,1034,994,1044,185,24.48596646931897,9.997568136032227
12539,/media/marda/TWOTB1/xBD/hurricanes/images/florence/hurricane-florence_00000068_pre_disaster.png,59,23,1,915,974,28,51,494,26.215056764382357,25.034296875228655
12540,/media/marda/TWOTB1/xBD/hurricanes/images/florence/hurricane-florence_00000068_pre_disaster.png,75,36,1,948,1023,192,228,937,38.31101002742288,32.16805852217779
12541,/media/marda/TWOTB1/xBD/hurricanes/images/florence/hurricane-florence_00000068_pre_disaster.png,60,41,1,984,1044,431,472,466,28.297155693159386,21.964077839758957
12542,/media/marda/TWOTB1/xBD/hurricanes/images/florence/hurricane-florence_00000068_pre_disaster.png,65,43,1,974,1039,508,551,533,29.595102458754102,23.981592466881587
12543,/media/marda/TWOTB1/xBD/hurricanes/images/florence/hurricane-florence_00000068_pre_disaster.png,68,46,1,976,1044,840,886,420,34.62176579359676,16.1245154965971
12544,/media/marda/TWOTB1/xBD/hurricanes/images/florence/hurricane-florence_00000068_pre_disaster.png,54,53,1,845,899,868,921,238,18.99568658630941,16.76592498268608
12545,/media/marda/TWOTB1/xBD/hurricanes/images/florence/hurricane-florence_00000068_pre_disaster.png,70,59,1,974,1044,881,940,780,36.003982530443814,29.012269741105495
12546,/media/marda/TWOTB1/xBD/hurricanes/images/florence/hurricane-florence_00000068_pre_disaster.png,57,55,1,944,1001,885,940,217,19.68960647919039,14.73619169400157
12547,/media/marda/TWOTB1/xBD/hurricanes/images/florence/hurricane-florence_00000068_pre_disaster.png,61,54,1,959,1020,905,959,252,22.730382247607263,14.828953977434193
12548,/media/marda/TWOTB1/xBD/hurricanes/images/florence/hurricane-florence_00000068_pre_disaster.png,60,71,1,983,1043,940,1011,528,38.520778404197486,18.260043484824404
12549,/media/marda/TWOTB1/xBD/hurricanes/images/florence/hurricane-florence_00000068_pre_disaster.png,63,60,1,981,1044,984,1044,448,28.126704647593584,21.62034935136804
12550,/media/marda/TWOTB1/xBD/hurricanes/images/florence/hurricane-florence_00000487_post_disaster.png,232,168,1,124,356,34,202,9029,284.7495917536514,42.24739827523777
12551,/media/marda/TWOTB1/xBD/hurricanes/images/florence/hurricane-florence_00000487_post_disaster.png,167,92,1,180,347,0,92,5108,166.71009365697677,41.3055231608389
12552,/media/marda/TWOTB1/xBD/hurricanes/images/florence/hurricane-florence_00000486_post_disaster.png,266,23,1,674,940,0,23,2720,225.5278466531921,18.54056816042332
12553,/media/marda/TWOTB1/xBD/hurricanes/images/florence/hurricane-florence_00000329_post_disaster.png,47,77,1,10,57,620,697,1325,49.59519206067914,36.01941529783811
12554,/media/marda/TWOTB1/xBD/hurricanes/images/florence/hurricane-florence_00000329_post_disaster.png,35,57,1,99,134,648,705,678,32.416478078807955,27.53263536746614
12555,/media/marda/TWOTB1/xBD/hurricanes/images/florence/hurricane-florence_00000329_post_disaster.png,26,50,1,57,83,667,717,374,22.587596240403293,22.126533932982667
12556,/media/marda/TWOTB1/xBD/hurricanes/images/florence/hurricane-florence_00000329_post_disaster.png,37,58,1,318,355,792,850,326,26.098914315785716,16.684384041965526
12557,/media/marda/TWOTB1/xBD/hurricanes/images/florence/hurricane-florence_00000329_post_disaster.png,76,89,1,233,309,832,921,2040,65.20571940179352,41.25837914558154
12558,/media/marda/TWOTB1/xBD/hurricanes/images/florence/hurricane-florence_00000408_post_disaster.png,19,7,1,39,58,0,7,67,17.706908584689273,5.832425022741497
12559,/media/marda/TWOTB1/xBD/hurricanes/images/florence/hurricane-florence_00000408_post_disaster.png,73,40,1,575,648,3,43,907,57.02635954653032,23.311226933628316
12560,/media/marda/TWOTB1/xBD/hurricanes/images/florence/hurricane-florence_00000408_post_disaster.png,48,36,1,0,48,21,57,921,50.25019127429639,24.372527529886074
12561,/media/marda/TWOTB1/xBD/hurricanes/images/florence/hurricane-florence_00000408_post_disaster.png,77,39,1,592,669,40,79,686,62.9373401893537,14.5490806219741
12562,/media/marda/TWOTB1/xBD/hurricanes/images/florence/hurricane-florence_00000408_post_disaster.png,67,37,1,504,571,52,89,693,54.52951503613812,17.118411790092214
12563,/media/marda/TWOTB1/xBD/hurricanes/images/florence/hurricane-florence_00000408_post_disaster.png,11,15,1,0,11,57,72,103,13.425694180565035,10.46596337946035
12564,/media/marda/TWOTB1/xBD/hurricanes/images/florence/hurricane-florence_00000408_post_disaster.png,73,35,1,614,687,70,105,728,55.17132306175679,18.641829787072076
12565,/media/marda/TWOTB1/xBD/hurricanes/images/florence/hurricane-florence_00000408_post_disaster.png,70,40,1,441,511,91,131,827,59.52880751164192,19.809818870799546
12566,/media/marda/TWOTB1/xBD/hurricanes/images/florence/hurricane-florence_00000408_post_disaster.png,45,22,1,682,727,112,134,185,16.156208762144516,15.374315744568861
12567,/media/marda/TWOTB1/xBD/hurricanes/images/florence/hurricane-florence_00000408_post_disaster.png,70,40,1,630,700,114,154,758,49.81182413587743,21.848437642351666
12568,/media/marda/TWOTB1/xBD/hurricanes/images/florence/hurricane-florence_00000408_post_disaster.png,66,45,1,386,452,127,172,673,62.95387018981622,14.273766469780556
12569,/media/marda/TWOTB1/xBD/hurricanes/images/florence/hurricane-florence_00000408_post_disaster.png,82,42,1,520,602,131,173,926,67.40407344358913,25.167977108738096
12570,/media/marda/TWOTB1/xBD/hurricanes/images/florence/hurricane-florence_00000408_post_disaster.png,76,50,1,546,622,159,209,995,56.667338772139075,34.97798850626123
12571,/media/marda/TWOTB1/xBD/hurricanes/images/florence/hurricane-florence_00000408_post_disaster.png,59,38,1,337,396,163,201,718,55.01297070233282,19.401348531453184
12572,/media/marda/TWOTB1/xBD/hurricanes/images/florence/hurricane-florence_00000408_post_disaster.png,66,39,1,476,542,170,209,571,56.19185447993129,13.571964872404171
12573,/media/marda/TWOTB1/xBD/hurricanes/images/florence/hurricane-florence_00000408_post_disaster.png,59,44,1,286,345,191,235,854,54.17688417555406,23.745404429040267
12574,/media/marda/TWOTB1/xBD/hurricanes/images/florence/hurricane-florence_00000408_post_disaster.png,74,49,1,489,563,193,242,1355,58.4689287343935,32.95909471494429
12575,/media/marda/TWOTB1/xBD/hurricanes/images/florence/hurricane-florence_00000408_post_disaster.png,72,45,1,607,679,208,253,768,54.11165064482149,20.288995085204277
12576,/media/marda/TWOTB1/xBD/hurricanes/images/florence/hurricane-florence_00000408_post_disaster.png,55,36,1,421,476,209,245,509,41.37136352263062,17.086005627011527
12577,/media/marda/TWOTB1/xBD/hurricanes/images/florence/hurricane-florence_00000408_post_disaster.png,61,49,1,233,294,226,275,899,60.44860406689822,21.328616878737634
12578,/media/marda/TWOTB1/xBD/hurricanes/images/florence/hurricane-florence_00000408_post_disaster.png,64,48,1,437,501,234,282,853,50.51596480251852,24.817587552830105
12579,/media/marda/TWOTB1/xBD/hurricanes/images/florence/hurricane-florence_00000408_post_disaster.png,62,48,1,359,421,241,289,775,54.05508016284254,21.1675476722636
12580,/media/marda/TWOTB1/xBD/hurricanes/images/florence/hurricane-florence_00000408_post_disaster.png,53,41,1,554,607,249,290,575,33.577670459284086,23.469622944544742
12581,/media/marda/TWOTB1/xBD/hurricanes/images/florence/hurricane-florence_00000408_post_disaster.png,43,56,1,218,261,269,325,909,50.93340122045457,25.666648238222486
12582,/media/marda/TWOTB1/xBD/hurricanes/images/florence/hurricane-florence_00000408_post_disaster.png,68,49,1,377,445,269,318,858,61.33237932643553,19.33848159456321
12583,/media/marda/TWOTB1/xBD/hurricanes/images/florence/hurricane-florence_00000408_post_disaster.png,65,57,1,306,371,273,330,1021,62.109613133833406,26.284615830969877
12584,/media/marda/TWOTB1/xBD/hurricanes/images/florence/hurricane-florence_00000408_post_disaster.png,70,47,1,495,565,277,324,682,59.64460837642761,15.27908671969339
12585,/media/marda/TWOTB1/xBD/hurricanes/images/florence/hurricane-florence_00000408_post_disaster.png,57,83,1,19,76,286,369,2022,82.04498153603872,32.95429987631662
12586,/media/marda/TWOTB1/xBD/hurricanes/images/florence/hurricane-florence_00000408_post_disaster.png,63,46,1,442,505,314,360,586,54.74387755800961,14.28913500501589
12587,/media/marda/TWOTB1/xBD/hurricanes/images/florence/hurricane-florence_00000408_post_disaster.png,62,51,1,385,447,347,398,654,58.44283779008114,14.947196137148648
12588,/media/marda/TWOTB1/xBD/hurricanes/images/florence/hurricane-florence_00000408_post_disaster.png,56,47,1,337,393,382,429,616,49.81296282701826,16.47587730626397
12589,/media/marda/TWOTB1/xBD/hurricanes/images/florence/hurricane-florence_00000408_post_disaster.png,73,45,1,956,1029,416,461,418,39.99366836297249,13.974503160310395
12590,/media/marda/TWOTB1/xBD/hurricanes/images/florence/hurricane-florence_00000408_post_disaster.png,77,47,1,865,942,460,507,478,48.35920542577672,13.209218367630925
12591,/media/marda/TWOTB1/xBD/hurricanes/images/florence/hurricane-florence_00000408_post_disaster.png,82,52,1,830,912,477,529,690,54.475610429818786,18.403045902848735
12592,/media/marda/TWOTB1/xBD/hurricanes/images/florence/hurricane-florence_00000408_post_disaster.png,82,53,1,796,878,494,547,533,56.056775781916066,12.73576952964375
12593,/media/marda/TWOTB1/xBD/hurricanes/images/florence/hurricane-florence_00000408_post_disaster.png,75,54,1,766,841,511,565,546,50.71682058931091,15.912066183179139
12594,/media/marda/TWOTB1/xBD/hurricanes/images/florence/hurricane-florence_00000408_post_disaster.png,56,67,1,912,968,516,583,690,52.08766745795036,17.93962308059177
12595,/media/marda/TWOTB1/xBD/hurricanes/images/florence/hurricane-florence_00000408_post_disaster.png,81,65,1,730,811,523,588,1050,52.57036382533763,30.080916184076678
12596,/media/marda/TWOTB1/xBD/hurricanes/images/florence/hurricane-florence_00000408_post_disaster.png,57,68,1,881,938,539,607,802,55.08137666607077,21.292599874505765
12597,/media/marda/TWOTB1/xBD/hurricanes/images/florence/hurricane-florence_00000408_post_disaster.png,52,36,1,932,984,545,581,207,17.220392919402606,15.516657597600144
12598,/media/marda/TWOTB1/xBD/hurricanes/images/florence/hurricane-florence_00000408_post_disaster.png,48,66,1,846,894,557,623,690,53.13527838673803,17.300545003858034
12599,/media/marda/TWOTB1/xBD/hurricanes/images/florence/hurricane-florence_00000408_post_disaster.png,76,60,1,662,738,564,624,805,52.12906042244408,23.219199440577672
12600,/media/marda/TWOTB1/xBD/hurricanes/images/florence/hurricane-florence_00000408_post_disaster.png,47,34,1,829,876,564,598,189,16.831463562631072,15.025339239120672
12601,/media/marda/TWOTB1/xBD/hurricanes/images/florence/hurricane-florence_00000408_post_disaster.png,65,68,1,801,866,566,634,941,46.77573030446922,29.52535679344398
12602,/media/marda/TWOTB1/xBD/hurricanes/images/florence/hurricane-florence_00000408_post_disaster.png,81,78,1,963,1044,573,651,1526,51.465172327567714,39.715291165196035
12603,/media/marda/TWOTB1/xBD/hurricanes/images/florence/hurricane-florence_00000408_post_disaster.png,39,64,1,159,198,579,643,754,45.029639160194435,22.272692206065674
12604,/media/marda/TWOTB1/xBD/hurricanes/images/florence/hurricane-florence_00000408_post_disaster.png,73,59,1,629,702,580,639,656,57.29705836479417,16.38708352240151
12605,/media/marda/TWOTB1/xBD/hurricanes/images/florence/hurricane-florence_00000408_post_disaster.png,44,63,1,779,823,592,655,458,44.03690473131297,13.881524161043604
12606,/media/marda/TWOTB1/xBD/hurricanes/images/florence/hurricane-florence_00000408_post_disaster.png,82,56,1,585,667,598,654,1305,60.201182940915615,30.844009037208266
12607,/media/marda/TWOTB1/xBD/hurricanes/images/florence/hurricane-florence_00000408_post_disaster.png,44,79,1,712,756,622,701,698,62.037344193391114,15.019194918604981
12608,/media/marda/TWOTB1/xBD/hurricanes/images/florence/hurricane-florence_00000408_post_disaster.png,41,40,1,605,646,629,669,249,19.203960320761375,17.293913913787307
12609,/media/marda/TWOTB1/xBD/hurricanes/images/florence/hurricane-florence_00000408_post_disaster.png,75,72,1,884,959,638,710,854,51.300526931357965,22.20625504813696
12610,/media/marda/TWOTB1/xBD/hurricanes/images/florence/hurricane-florence_00000408_post_disaster.png,32,104,1,0,32,649,753,1304,71.24894715450107,28.17817061320264
12611,/media/marda/TWOTB1/xBD/hurricanes/images/florence/hurricane-florence_00000408_post_disaster.png,57,65,1,645,702,662,727,563,49.123594562440296,18.449815313127853
12612,/media/marda/TWOTB1/xBD/hurricanes/images/florence/hurricane-florence_00000408_post_disaster.png,58,130,1,0,58,831,961,2889,107.02242866846521,46.33296549044413
12613,/media/marda/TWOTB1/xBD/hurricanes/images/florence/hurricane-florence_00000408_post_disaster.png,36,64,1,36,72,875,939,673,39.88847928823287,22.321217247194145
12614,/media/marda/TWOTB1/xBD/hurricanes/images/florence/hurricane-florence_00000408_post_disaster.png,6,48,1,0,6,939,987,50,12.069417645052921,5.586229292580571
12615,/media/marda/TWOTB1/xBD/hurricanes/images/florence/hurricane-florence_00000408_post_disaster.png,81,89,1,77,158,798,887,2417,85.48606128882807,37.329698481602996
12616,/media/marda/TWOTB1/xBD/hurricanes/images/florence/hurricane-florence_00000408_post_disaster.png,77,64,1,603,680,872,936,597,61.50209851750768,13.097413539690628
12617,/media/marda/TWOTB1/xBD/hurricanes/images/florence/hurricane-florence_00000408_post_disaster.png,72,97,1,159,231,887,984,1433,83.42918388597549,22.76905202671115
12618,/media/marda/TWOTB1/xBD/hurricanes/images/florence/hurricane-florence_00000408_post_disaster.png,71,74,1,72,143,903,977,722,81.81768276442021,11.786378268598376
12619,/media/marda/TWOTB1/xBD/hurricanes/images/florence/hurricane-florence_00000408_post_disaster.png,51,77,1,646,697,906,983,522,46.99948084899983,14.739442835800466
12620,/media/marda/TWOTB1/xBD/hurricanes/images/florence/hurricane-florence_00000408_post_disaster.png,115,123,1,143,258,918,1041,2316,142.3593435054162,21.600901496133073
12621,/media/marda/TWOTB1/xBD/hurricanes/images/florence/hurricane-florence_00000408_post_disaster.png,30,70,1,67,97,944,1014,335,41.7487339238432,10.751429477290573
12622,/media/marda/TWOTB1/xBD/hurricanes/images/florence/hurricane-florence_00000408_post_disaster.png,74,68,1,532,606,973,1041,915,47.143801097196494,26.832005352286235
12623,/media/marda/TWOTB1/xBD/hurricanes/images/florence/hurricane-florence_00000408_post_disaster.png,37,53,1,232,269,990,1043,195,24.731051918644997,12.094828117174906
12624,/media/marda/TWOTB1/xBD/hurricanes/images/florence/hurricane-florence_00000418_post_disaster.png,34,18,1,72,106,0,18,377,30.975020065996087,16.814700295428356
12625,/media/marda/TWOTB1/xBD/hurricanes/images/florence/hurricane-florence_00000418_post_disaster.png,166,76,1,197,363,0,76,6142,169.3166615270342,62.525827553121836
12626,/media/marda/TWOTB1/xBD/hurricanes/images/florence/hurricane-florence_00000418_post_disaster.png,54,16,1,338,392,0,16,473,42.5627169037018,15.071170972228632
12627,/media/marda/TWOTB1/xBD/hurricanes/images/florence/hurricane-florence_00000418_post_disaster.png,64,33,1,556,620,0,33,886,38.70359315311805,31.88327104667671
12628,/media/marda/TWOTB1/xBD/hurricanes/images/florence/hurricane-florence_00000418_post_disaster.png,50,20,1,607,657,0,20,359,24.75529264777595,19.570110796625347
12629,/media/marda/TWOTB1/xBD/hurricanes/images/florence/hurricane-florence_00000418_post_disaster.png,73,39,1,505,578,8,47,1261,53.958910821745974,31.181267126307382
12630,/media/marda/TWOTB1/xBD/hurricanes/images/florence/hurricane-florence_00000418_post_disaster.png,76,51,1,853,929,27,78,1265,47.54376471014656,36.01142820498112
12631,/media/marda/TWOTB1/xBD/hurricanes/images/florence/hurricane-florence_00000418_post_disaster.png,55,36,1,81,136,31,67,1025,58.88354414563867,23.01588721521958
12632,/media/marda/TWOTB1/xBD/hurricanes/images/florence/hurricane-florence_00000418_post_disaster.png,73,53,1,724,797,50,103,1376,52.3136439335101,37.899486488918555
12633,/media/marda/TWOTB1/xBD/hurricanes/images/florence/hurricane-florence_00000418_post_disaster.png,75,43,1,777,852,58,101,1218,44.37572486482547,36.49254523571339
12634,/media/marda/TWOTB1/xBD/hurricanes/images/florence/hurricane-florence_00000418_post_disaster.png,47,33,1,99,146,63,96,800,46.98084698692702,23.501561467080236
12635,/media/marda/TWOTB1/xBD/hurricanes/images/florence/hurricane-florence_00000418_post_disaster.png,12,13,1,59,71,66,79,96,11.997049873108564,10.797358339886829
12636,/media/marda/TWOTB1/xBD/hurricanes/images/florence/hurricane-florence_00000418_post_disaster.png,77,52,1,664,741,68,120,1654,48.90404051998931,44.80764831832164
12637,/media/marda/TWOTB1/xBD/hurricanes/images/florence/hurricane-florence_00000418_post_disaster.png,57,23,1,891,948,82,105,294,20.8572917732427,18.872128615057363
12638,/media/marda/TWOTB1/xBD/hurricanes/images/florence/hurricane-florence_00000418_post_disaster.png,86,90,1,455,541,139,229,3694,84.73593400594935,57.67834532633442
12639,/media/marda/TWOTB1/xBD/hurricanes/images/florence/hurricane-florence_00000418_post_disaster.png,98,49,1,613,711,165,214,1887,81.6855977359906,33.616667713725214
12640,/media/marda/TWOTB1/xBD/hurricanes/images/florence/hurricane-florence_00000418_post_disaster.png,57,44,1,571,628,166,210,898,38.814097874105954,30.682132697982432
12641,/media/marda/TWOTB1/xBD/hurricanes/images/florence/hurricane-florence_00000418_post_disaster.png,94,63,1,327,421,183,246,2907,76.76612917509752,51.38434118467794
12642,/media/marda/TWOTB1/xBD/hurricanes/images/florence/hurricane-florence_00000418_post_disaster.png,54,50,1,243,297,207,257,1188,43.98239621541436,36.37500167528393
12643,/media/marda/TWOTB1/xBD/hurricanes/images/florence/hurricane-florence_00000418_post_disaster.png,65,56,1,831,896,210,266,923,49.12228868804863,24.84752055776706
12644,/media/marda/TWOTB1/xBD/hurricanes/images/florence/hurricane-florence_00000418_post_disaster.png,70,50,1,764,834,220,270,1133,41.255007151523785,36.09152855763292
12645,/media/marda/TWOTB1/xBD/hurricanes/images/florence/hurricane-florence_00000418_post_disaster.png,60,53,1,163,223,230,283,1651,53.68197214004921,40.59805437160248
12646,/media/marda/TWOTB1/xBD/hurricanes/images/florence/hurricane-florence_00000418_post_disaster.png,68,46,1,600,668,272,318,1058,42.73879068492541,32.995585124976635
12647,/media/marda/TWOTB1/xBD/hurricanes/images/florence/hurricane-florence_00000418_post_disaster.png,33,36,1,312,345,276,312,417,27.311543705152303,20.175164158916076
12648,/media/marda/TWOTB1/xBD/hurricanes/images/florence/hurricane-florence_00000418_post_disaster.png,38,57,1,27,65,285,342,1188,50.590246334834546,31.351032944398824
12649,/media/marda/TWOTB1/xBD/hurricanes/images/florence/hurricane-florence_00000418_post_disaster.png,59,32,1,862,921,286,318,356,25.053711447849977,18.82592813003266
12650,/media/marda/TWOTB1/xBD/hurricanes/images/florence/hurricane-florence_00000418_post_disaster.png,52,26,1,795,847,291,317,226,20.131691593813574,14.902517585276323
12651,/media/marda/TWOTB1/xBD/hurricanes/images/florence/hurricane-florence_00000418_post_disaster.png,59,54,1,527,586,294,348,1158,42.81052244979198,35.30272969281261
12652,/media/marda/TWOTB1/xBD/hurricanes/images/florence/hurricane-florence_00000418_post_disaster.png,87,50,1,957,1044,294,344,1106,48.38720067382769,32.00472055696369
12653,/media/marda/TWOTB1/xBD/hurricanes/images/florence/hurricane-florence_00000418_post_disaster.png,44,30,1,646,690,305,335,227,18.913685321383227,15.846948433563153
12654,/media/marda/TWOTB1/xBD/hurricanes/images/florence/hurricane-florence_00000418_post_disaster.png,65,53,1,876,941,327,380,730,39.380978293058035,24.788777530319816
12655,/media/marda/TWOTB1/xBD/hurricanes/images/florence/hurricane-florence_00000418_post_disaster.png,33,33,1,166,199,333,366,299,31.495789212443352,12.509979876581186
12656,/media/marda/TWOTB1/xBD/hurricanes/images/florence/hurricane-florence_00000418_post_disaster.png,69,72,1,687,756,341,413,1397,63.3679626570322,29.41963259789274
12657,/media/marda/TWOTB1/xBD/hurricanes/images/florence/hurricane-florence_00000418_post_disaster.png,45,49,1,173,218,343,392,713,41.140552674255964,22.948206243632566
12658,/media/marda/TWOTB1/xBD/hurricanes/images/florence/hurricane-florence_00000418_post_disaster.png,49,46,1,514,563,343,389,628,32.88673584124455,25.33227822718235
12659,/media/marda/TWOTB1/xBD/hurricanes/images/florence/hurricane-florence_00000418_post_disaster.png,63,58,1,981,1044,361,419,839,45.45848372040765,24.571864780025194
12660,/media/marda/TWOTB1/xBD/hurricanes/images/florence/hurricane-florence_00000418_post_disaster.png,46,48,1,328,374,373,421,831,35.59098263236845,31.613337287483244
12661,/media/marda/TWOTB1/xBD/hurricanes/images/florence/hurricane-florence_00000418_post_disaster.png,19,35,1,0,19,376,411,282,20.200629501898074,18.403028342900452
12662,/media/marda/TWOTB1/xBD/hurricanes/images/florence/hurricane-florence_00000418_post_disaster.png,36,29,1,528,564,393,422,147,15.21753851224594,12.974814623551831
12663,/media/marda/TWOTB1/xBD/hurricanes/images/florence/hurricane-florence_00000418_post_disaster.png,89,64,1,710,799,401,465,1684,57.47145239610368,40.12631101101989
12664,/media/marda/TWOTB1/xBD/hurricanes/images/florence/hurricane-florence_00000418_post_disaster.png,55,46,1,856,911,409,455,422,29.015614796034413,20.72089477501371
12665,/media/marda/TWOTB1/xBD/hurricanes/images/florence/hurricane-florence_00000418_post_disaster.png,73,53,1,896,969,410,463,964,37.59644578674079,33.353373443390254
12666,/media/marda/TWOTB1/xBD/hurricanes/images/florence/hurricane-florence_00000418_post_disaster.png,45,63,1,84,129,414,477,1072,45.65658169770026,31.681282461357256
12667,/media/marda/TWOTB1/xBD/hurricanes/images/florence/hurricane-florence_00000418_post_disaster.png,32,28,1,575,607,418,446,73,10.426526937472167,9.446924153109965
12668,/media/marda/TWOTB1/xBD/hurricanes/images/florence/hurricane-florence_00000418_post_disaster.png,47,43,1,384,431,424,467,564,35.58119570548822,20.998763799398088
12669,/media/marda/TWOTB1/xBD/hurricanes/images/florence/hurricane-florence_00000418_post_disaster.png,44,45,1,336,380,426,471,612,29.772264703759728,27.053914226958614
12670,/media/marda/TWOTB1/xBD/hurricanes/images/florence/hurricane-florence_00000418_post_disaster.png,65,49,1,576,641,428,477,874,44.13467680042179,28.01648510585262
12671,/media/marda/TWOTB1/xBD/hurricanes/images/florence/hurricane-florence_00000418_post_disaster.png,55,57,1,219,274,429,486,967,44.76220236210875,29.29593546348778
12672,/media/marda/TWOTB1/xBD/hurricanes/images/florence/hurricane-florence_00000418_post_disaster.png,34,47,1,39,73,446,493,516,30.494419311009,22.617339133678186
12673,/media/marda/TWOTB1/xBD/hurricanes/images/florence/hurricane-florence_00000418_post_disaster.png,49,60,1,177,226,466,526,868,45.77963541845605,25.295016983173788
12674,/media/marda/TWOTB1/xBD/hurricanes/images/florence/hurricane-florence_00000418_post_disaster.png,68,45,1,585,653,477,522,688,50.921904302288475,17.893911957978585
12675,/media/marda/TWOTB1/xBD/hurricanes/images/florence/hurricane-florence_00000418_post_disaster.png,42,51,1,233,275,491,542,476,40.763363177602386,15.588206251817937
12676,/media/marda/TWOTB1/xBD/hurricanes/images/florence/hurricane-florence_00000418_post_disaster.png,43,65,1,25,68,493,558,905,46.2759397836894,26.097962441308052
12677,/media/marda/TWOTB1/xBD/hurricanes/images/florence/hurricane-florence_00000418_post_disaster.png,50,52,1,369,419,498,550,686,33.17384841551344,27.299375418910344
12678,/media/marda/TWOTB1/xBD/hurricanes/images/florence/hurricane-florence_00000418_post_disaster.png,82,57,1,903,985,506,563,1042,48.35803758165687,28.70439579311791
12679,/media/marda/TWOTB1/xBD/hurricanes/images/florence/hurricane-florence_00000418_post_disaster.png,48,60,1,248,296,507,567,941,39.893216740861675,32.442968929778516
12680,/media/marda/TWOTB1/xBD/hurricanes/images/florence/hurricane-florence_00000418_post_disaster.png,41,62,1,147,188,514,576,865,36.96999723817551,31.069793138955465
12681,/media/marda/TWOTB1/xBD/hurricanes/images/florence/hurricane-florence_00000418_post_disaster.png,69,54,1,601,670,518,572,864,48.58178880985089,23.449447386434272
12682,/media/marda/TWOTB1/xBD/hurricanes/images/florence/hurricane-florence_00000418_post_disaster.png,54,40,1,890,944,533,573,220,18.684499617365383,15.747392899765407
12683,/media/marda/TWOTB1/xBD/hurricanes/images/florence/hurricane-florence_00000418_post_disaster.png,109,66,1,798,907,534,600,1839,85.82690724165326,30.674976670503117
12684,/media/marda/TWOTB1/xBD/hurricanes/images/florence/hurricane-florence_00000418_post_disaster.png,32,62,1,0,32,539,601,807,39.739568406113996,26.952720300237175
12685,/media/marda/TWOTB1/xBD/hurricanes/images/florence/hurricane-florence_00000418_post_disaster.png,63,55,1,717,780,545,600,774,32.84684974911381,31.39955849779973
12686,/media/marda/TWOTB1/xBD/hurricanes/images/florence/hurricane-florence_00000418_post_disaster.png,47,59,1,481,528,553,612,718,41.999566581095,24.878149549706542
12687,/media/marda/TWOTB1/xBD/hurricanes/images/florence/hurricane-florence_00000418_post_disaster.png,62,68,1,104,166,555,623,1331,53.84993533695267,35.62483507679595
12688,/media/marda/TWOTB1/xBD/hurricanes/images/florence/hurricane-florence_00000418_post_disaster.png,67,50,1,958,1025,580,630,518,26.75980073226489,25.864158041304954
12689,/media/marda/TWOTB1/xBD/hurricanes/images/florence/hurricane-florence_00000418_post_disaster.png,52,47,1,705,757,584,631,419,26.104699114455414,21.464265897448037
12690,/media/marda/TWOTB1/xBD/hurricanes/images/florence/hurricane-florence_00000418_post_disaster.png,42,67,1,71,113,602,669,795,45.73376082064281,23.040644171811483
12691,/media/marda/TWOTB1/xBD/hurricanes/images/florence/hurricane-florence_00000418_post_disaster.png,55,56,1,591,646,607,663,664,33.4675125609477,26.201363790863454
12692,/media/marda/TWOTB1/xBD/hurricanes/images/florence/hurricane-florence_00000418_post_disaster.png,65,52,1,970,1035,609,661,450,25.12880827260949,23.92987826569074
12693,/media/marda/TWOTB1/xBD/hurricanes/images/florence/hurricane-florence_00000418_post_disaster.png,30,51,1,119,149,623,674,346,24.57597821856563,18.808265591466856
12694,/media/marda/TWOTB1/xBD/hurricanes/images/florence/hurricane-florence_00000418_post_disaster.png,52,62,1,727,779,634,696,576,38.408533210420146,20.18670207888312
12695,/media/marda/TWOTB1/xBD/hurricanes/images/florence/hurricane-florence_00000418_post_disaster.png,77,56,1,967,1044,642,698,700,45.22682511490685,20.550257861858952
12696,/media/marda/TWOTB1/xBD/hurricanes/images/florence/hurricane-florence_00000418_post_disaster.png,88,96,1,502,590,644,740,2156,73.69267015795569,53.00442778149252
12697,/media/marda/TWOTB1/xBD/hurricanes/images/florence/hurricane-florence_00000418_post_disaster.png,47,69,1,23,70,648,717,959,49.08206024607951,26.08773110967473
12698,/media/marda/TWOTB1/xBD/hurricanes/images/florence/hurricane-florence_00000418_post_disaster.png,54,39,1,930,984,666,705,156,18.328881970039713,11.392790504171613
12699,/media/marda/TWOTB1/xBD/hurricanes/images/florence/hurricane-florence_00000418_post_disaster.png,58,75,1,404,462,667,742,1301,51.24494726636551,34.2863284809949
12700,/media/marda/TWOTB1/xBD/hurricanes/images/florence/hurricane-florence_00000418_post_disaster.png,32,52,1,74,106,670,722,434,30.41099268219768,18.75543195262657
12701,/media/marda/TWOTB1/xBD/hurricanes/images/florence/hurricane-florence_00000418_post_disaster.png,75,56,1,756,831,671,727,936,45.131940945389545,27.80709975358244
12702,/media/marda/TWOTB1/xBD/hurricanes/images/florence/hurricane-florence_00000418_post_disaster.png,52,38,1,961,1013,675,713,134,15.78676281263966,11.37563121629298
12703,/media/marda/TWOTB1/xBD/hurricanes/images/florence/hurricane-florence_00000418_post_disaster.png,26,72,1,0,26,687,759,755,41.44728513451023,24.802090843134533
12704,/media/marda/TWOTB1/xBD/hurricanes/images/florence/hurricane-florence_00000418_post_disaster.png,55,45,1,978,1033,687,732,175,17.442997138289904,13.414453590039535
12705,/media/marda/TWOTB1/xBD/hurricanes/images/florence/hurricane-florence_00000418_post_disaster.png,51,52,1,993,1044,712,764,190,23.067174534294796,11.309000497187139
12706,/media/marda/TWOTB1/xBD/hurricanes/images/florence/hurricane-florence_00000418_post_disaster.png,38,47,1,547,585,726,773,221,17.71529816358832,16.729630684133515
12707,/media/marda/TWOTB1/xBD/hurricanes/images/florence/hurricane-florence_00000418_post_disaster.png,34,50,1,413,447,736,786,253,21.350365309841294,16.190072220291636
12708,/media/marda/TWOTB1/xBD/hurricanes/images/florence/hurricane-florence_00000418_post_disaster.png,61,63,1,867,928,738,801,589,36.31979877930284,21.531003409288374
12709,/media/marda/TWOTB1/xBD/hurricanes/images/florence/hurricane-florence_00000418_post_disaster.png,56,58,1,841,897,750,808,433,30.115887632360494,19.214984156734005
12710,/media/marda/TWOTB1/xBD/hurricanes/images/florence/hurricane-florence_00000418_post_disaster.png,10,45,1,0,10,755,800,91,15.084142940461696,9.081609754704589
12711,/media/marda/TWOTB1/xBD/hurricanes/images/florence/hurricane-florence_00000418_post_disaster.png,61,62,1,801,862,764,826,639,30.815027618849346,27.20407315629624
12712,/media/marda/TWOTB1/xBD/hurricanes/images/florence/hurricane-florence_00000418_post_disaster.png,72,84,1,319,391,809,893,1574,60.16962341740016,37.21227295785433
12713,/media/marda/TWOTB1/xBD/hurricanes/images/florence/hurricane-florence_00000418_post_disaster.png,58,63,1,954,1012,814,877,425,31.528163768503894,17.867110283166312
12714,/media/marda/TWOTB1/xBD/hurricanes/images/florence/hurricane-florence_00000418_post_disaster.png,69,72,1,891,960,828,900,800,39.2991590956165,27.18834298697555
12715,/media/marda/TWOTB1/xBD/hurricanes/images/florence/hurricane-florence_00000418_post_disaster.png,62,73,1,864,926,838,911,693,41.18260913370924,22.311072193024724
12716,/media/marda/TWOTB1/xBD/hurricanes/images/florence/hurricane-florence_00000418_post_disaster.png,64,67,1,832,896,848,915,651,34.58063335953051,24.951296559009947
12717,/media/marda/TWOTB1/xBD/hurricanes/images/florence/hurricane-florence_00000418_post_disaster.png,53,47,1,989,1042,853,900,125,14.581119495349938,11.58753443413766
12718,/media/marda/TWOTB1/xBD/hurricanes/images/florence/hurricane-florence_00000418_post_disaster.png,63,77,1,799,862,861,938,838,46.116872052534774,24.216541762145926
12719,/media/marda/TWOTB1/xBD/hurricanes/images/florence/hurricane-florence_00000418_post_disaster.png,53,74,1,249,302,891,965,847,43.451672265567446,25.883813596456015
12720,/media/marda/TWOTB1/xBD/hurricanes/images/florence/hurricane-florence_00000418_post_disaster.png,42,82,1,57,99,899,981,1063,46.532017629101844,29.99156871745203
12721,/media/marda/TWOTB1/xBD/hurricanes/images/florence/hurricane-florence_00000418_post_disaster.png,93,96,1,662,755,901,997,2001,75.4438494021662,42.767594480197744
12722,/media/marda/TWOTB1/xBD/hurricanes/images/florence/hurricane-florence_00000418_post_disaster.png,73,101,1,961,1034,929,1030,920,73.35999688775239,17.298176917868783
12723,/media/marda/TWOTB1/xBD/hurricanes/images/florence/hurricane-florence_00000418_post_disaster.png,57,64,1,831,888,947,1011,456,26.04226190305382,23.177660577616013
12724,/media/marda/TWOTB1/xBD/hurricanes/images/florence/hurricane-florence_00000418_post_disaster.png,13,63,1,0,13,951,1014,193,24.95026475382344,11.693610956586852
12725,/media/marda/TWOTB1/xBD/hurricanes/images/florence/hurricane-florence_00000418_post_disaster.png,50,54,1,935,985,955,1009,150,17.45347345030134,11.56524669802996
12726,/media/marda/TWOTB1/xBD/hurricanes/images/florence/hurricane-florence_00000418_post_disaster.png,78,75,1,893,971,964,1039,1071,40.24648496453051,35.15379982485922
12727,/media/marda/TWOTB1/xBD/hurricanes/images/florence/hurricane-florence_00000072_pre_disaster.png,84,46,1,879,963,78,124,966,57.300180480109134,22.341474180770046
12728,/media/marda/TWOTB1/xBD/hurricanes/images/florence/hurricane-florence_00000072_pre_disaster.png,85,59,1,904,989,126,185,1475,48.20568208152106,40.849218277715906
12729,/media/marda/TWOTB1/xBD/hurricanes/images/florence/hurricane-florence_00000072_pre_disaster.png,70,55,1,809,879,579,634,789,34.183175303944616,30.860191663352882
12730,/media/marda/TWOTB1/xBD/hurricanes/images/florence/hurricane-florence_00000072_pre_disaster.png,96,68,1,905,1001,581,649,1434,63.77438126925974,29.809900185070465
12731,/media/marda/TWOTB1/xBD/hurricanes/images/florence/hurricane-florence_00000072_pre_disaster.png,50,39,1,876,926,638,677,123,14.764628370375927,11.205260707931075
12732,/media/marda/TWOTB1/xBD/hurricanes/images/florence/hurricane-florence_00000310_pre_disaster.png,63,35,1,981,1044,22,57,465,31.588240786092147,20.53019115219366
12733,/media/marda/TWOTB1/xBD/hurricanes/images/florence/hurricane-florence_00000310_pre_disaster.png,64,52,1,738,802,486,538,647,30.99751567630733,27.871614514213086
12734,/media/marda/TWOTB1/xBD/hurricanes/images/florence/hurricane-florence_00000310_pre_disaster.png,74,69,1,791,865,592,661,843,47.98735376595895,23.50896903121388
12735,/media/marda/TWOTB1/xBD/hurricanes/images/florence/hurricane-florence_00000310_pre_disaster.png,91,86,1,422,513,662,748,2342,69.91354706704092,47.69224661953601
12736,/media/marda/TWOTB1/xBD/hurricanes/images/florence/hurricane-florence_00000310_pre_disaster.png,52,49,1,680,732,680,729,349,22.196824207438237,20.7832856773035
12737,/media/marda/TWOTB1/xBD/hurricanes/images/florence/hurricane-florence_00000310_pre_disaster.png,56,60,1,654,710,726,786,515,26.55216218768893,25.90347549939044
12738,/media/marda/TWOTB1/xBD/hurricanes/images/florence/hurricane-florence_00000310_pre_disaster.png,39,44,1,393,432,741,785,241,22.978786000151526,13.757000222508506
12739,/media/marda/TWOTB1/xBD/hurricanes/images/florence/hurricane-florence_00000310_pre_disaster.png,25,42,1,316,341,752,794,170,15.18668147152784,14.922545122772338
12740,/media/marda/TWOTB1/xBD/hurricanes/images/florence/hurricane-florence_00000310_pre_disaster.png,62,67,1,388,450,768,835,1040,47.56110188683371,29.15784407897626
12741,/media/marda/TWOTB1/xBD/hurricanes/images/florence/hurricane-florence_00000310_pre_disaster.png,66,71,1,587,653,778,849,960,36.70933595937245,35.111578603546654
12742,/media/marda/TWOTB1/xBD/hurricanes/images/florence/hurricane-florence_00000310_pre_disaster.png,52,57,1,301,353,790,847,881,45.1823964193989,26.052375614871064
12743,/media/marda/TWOTB1/xBD/hurricanes/images/florence/hurricane-florence_00000310_pre_disaster.png,24,82,1,160,184,804,886,748,55.84768173715697,17.90674064853067
12744,/media/marda/TWOTB1/xBD/hurricanes/images/florence/hurricane-florence_00000310_pre_disaster.png,28,76,1,218,246,810,886,648,50.13358617499247,17.257532843396632
12745,/media/marda/TWOTB1/xBD/hurricanes/images/florence/hurricane-florence_00000310_pre_disaster.png,42,56,1,267,309,811,867,684,35.94583117400709,25.42210034835951
12746,/media/marda/TWOTB1/xBD/hurricanes/images/florence/hurricane-florence_00000310_pre_disaster.png,38,56,1,67,105,827,883,722,40.42212426100043,23.733401117822197
12747,/media/marda/TWOTB1/xBD/hurricanes/images/florence/hurricane-florence_00000310_pre_disaster.png,51,70,1,300,351,918,988,804,38.92828516054195,27.585450792722664
12748,/media/marda/TWOTB1/xBD/hurricanes/images/florence/hurricane-florence_00000310_pre_disaster.png,30,67,1,166,196,975,1042,635,34.82339185227495,24.120087253518978
12749,/media/marda/TWOTB1/xBD/hurricanes/images/florence/hurricane-florence_00000310_pre_disaster.png,24,61,1,0,24,977,1038,530,28.182888475664008,25.1342862309256
12750,/media/marda/TWOTB1/xBD/hurricanes/images/florence/hurricane-florence_00000519_post_disaster.png,114,52,1,250,364,174,226,2929,118.05896264964866,33.664923798299384
12751,/media/marda/TWOTB1/xBD/hurricanes/images/florence/hurricane-florence_00000519_post_disaster.png,115,50,1,247,362,232,282,2871,119.09570243620327,32.070188922054555
12752,/media/marda/TWOTB1/xBD/hurricanes/images/florence/hurricane-florence_00000519_post_disaster.png,15,15,1,247,262,236,251,37,7.294922604986723,6.409192553169349
12753,/media/marda/TWOTB1/xBD/hurricanes/images/florence/hurricane-florence_00000519_post_disaster.png,24,27,1,241,265,336,363,178,16.89947461335583,14.177334898687128
12754,/media/marda/TWOTB1/xBD/hurricanes/images/florence/hurricane-florence_00000519_post_disaster.png,111,49,1,232,343,288,337,2737,115.82097949586002,31.444243489688006
12755,/media/marda/TWOTB1/xBD/hurricanes/images/florence/hurricane-florence_00000451_post_disaster.png,81,65,1,721,802,698,763,1116,59.90691659858688,34.614346083013665
12756,/media/marda/TWOTB1/xBD/hurricanes/images/florence/hurricane-florence_00000451_post_disaster.png,60,44,1,849,909,743,787,397,30.62734801102789,17.134534590576052
12757,/media/marda/TWOTB1/xBD/hurricanes/images/florence/hurricane-florence_00000451_post_disaster.png,120,78,1,907,1027,760,838,1773,91.13551724435108,26.40644915027149
12758,/media/marda/TWOTB1/xBD/hurricanes/images/florence/hurricane-florence_00000451_post_disaster.png,53,67,1,833,886,763,830,757,42.690499503389326,23.631960013098592
12759,/media/marda/TWOTB1/xBD/hurricanes/images/florence/hurricane-florence_00000451_post_disaster.png,56,64,1,987,1043,777,841,350,35.06714067767752,14.339906490677068
12760,/media/marda/TWOTB1/xBD/hurricanes/images/florence/hurricane-florence_00000451_post_disaster.png,59,64,1,887,946,804,868,619,32.867031177251114,25.00336620526306
12761,/media/marda/TWOTB1/xBD/hurricanes/images/florence/hurricane-florence_00000451_post_disaster.png,129,97,1,896,1025,836,933,3145,100.12135851312911,41.81032789342195
12762,/media/marda/TWOTB1/xBD/hurricanes/images/florence/hurricane-florence_00000451_post_disaster.png,29,35,1,238,267,11,46,624,36.86416928411054,22.54837342172346
12763,/media/marda/TWOTB1/xBD/hurricanes/images/florence/hurricane-florence_00000451_post_disaster.png,32,48,1,264,296,112,160,902,47.3204759573995,25.358294201475562
12764,/media/marda/TWOTB1/xBD/hurricanes/images/florence/hurricane-florence_00000451_post_disaster.png,27,27,1,292,319,32,59,354,27.45457323981374,17.282442217422116
12765,/media/marda/TWOTB1/xBD/hurricanes/images/florence/hurricane-florence_00000451_post_disaster.png,23,15,1,342,365,163,178,74,10.477126781232585,9.627716560555156
12766,/media/marda/TWOTB1/xBD/hurricanes/images/florence/hurricane-florence_00000451_post_disaster.png,23,21,1,94,117,198,219,273,24.221202832779934,14.966629547095765
12767,/media/marda/TWOTB1/xBD/hurricanes/images/florence/hurricane-florence_00000451_post_disaster.png,14,50,1,0,14,203,253,470,47.112325291218966,13.532927027759419
12768,/media/marda/TWOTB1/xBD/hurricanes/images/florence/hurricane-florence_00000451_post_disaster.png,29,57,1,45,74,431,488,840,42.49923806853195,26.447252974517028
12769,/media/marda/TWOTB1/xBD/hurricanes/images/florence/hurricane-florence_00000451_post_disaster.png,31,48,1,72,103,491,539,623,31.28921340074359,26.601479403084703
12770,/media/marda/TWOTB1/xBD/hurricanes/images/florence/hurricane-florence_00000451_post_disaster.png,37,58,1,83,120,531,589,1024,40.844125122154985,33.25616851832784
12771,/media/marda/TWOTB1/xBD/hurricanes/images/florence/hurricane-florence_00000005_post_disaster.png,67,65,1,0,67,0,65,3012,65.77331538924561,61.307816511674496
12772,/media/marda/TWOTB1/xBD/hurricanes/images/florence/hurricane-florence_00000005_post_disaster.png,92,109,1,364,456,0,109,4457,124.02639808696759,48.22296445280601
12773,/media/marda/TWOTB1/xBD/hurricanes/images/florence/hurricane-florence_00000005_post_disaster.png,114,31,1,492,606,0,31,1393,85.75428540813512,26.474519990935896
12774,/media/marda/TWOTB1/xBD/hurricanes/images/florence/hurricane-florence_00000005_post_disaster.png,106,32,1,623,729,0,32,1293,67.66997850932108,29.3677904921748
12775,/media/marda/TWOTB1/xBD/hurricanes/images/florence/hurricane-florence_00000005_post_disaster.png,79,80,1,452,531,35,115,2995,84.04331129875439,46.983249429864635
12776,/media/marda/TWOTB1/xBD/hurricanes/images/florence/hurricane-florence_00000005_post_disaster.png,82,106,1,656,738,40,146,4208,119.64724374477044,47.78678870118986
12777,/media/marda/TWOTB1/xBD/hurricanes/images/florence/hurricane-florence_00000005_post_disaster.png,79,94,1,738,817,76,170,3652,103.82969039760532,46.89569441914271
12778,/media/marda/TWOTB1/xBD/hurricanes/images/florence/hurricane-florence_00000005_post_disaster.png,114,88,1,446,560,117,205,3648,104.38173517953369,46.49633857908144
12779,/media/marda/TWOTB1/xBD/hurricanes/images/florence/hurricane-florence_00000005_post_disaster.png,132,70,1,556,688,139,209,3768,122.33416270082125,41.361005455468565
12780,/media/marda/TWOTB1/xBD/hurricanes/images/florence/hurricane-florence_00000005_post_disaster.png,124,78,1,676,800,177,255,3513,107.9693556409003,43.652862429517725
12781,/media/marda/TWOTB1/xBD/hurricanes/images/florence/hurricane-florence_00000005_post_disaster.png,84,74,1,125,209,179,253,2520,85.65796485914922,39.125843539230964
12782,/media/marda/TWOTB1/xBD/hurricanes/images/florence/hurricane-florence_00000005_post_disaster.png,92,42,1,565,657,272,314,2051,76.64766799046699,35.089586068359125
12783,/media/marda/TWOTB1/xBD/hurricanes/images/florence/hurricane-florence_00000005_post_disaster.png,101,77,1,475,576,274,351,2506,94.01792426107168,36.20537208003462
12784,/media/marda/TWOTB1/xBD/hurricanes/images/florence/hurricane-florence_00000005_post_disaster.png,100,58,1,634,734,283,341,2170,80.36449670245842,35.72097948906066
12785,/media/marda/TWOTB1/xBD/hurricanes/images/florence/hurricane-florence_00000005_post_disaster.png,122,57,1,706,828,309,366,2838,103.69475777638733,36.434201905718936
12786,/media/marda/TWOTB1/xBD/hurricanes/images/florence/hurricane-florence_00000005_post_disaster.png,92,87,1,404,496,323,410,2329,92.08636270093854,34.582076696817765
12787,/media/marda/TWOTB1/xBD/hurricanes/images/florence/hurricane-florence_00000005_post_disaster.png,83,31,1,942,1025,363,394,620,49.05290416588084,17.51658710771809
12788,/media/marda/TWOTB1/xBD/hurricanes/images/florence/hurricane-florence_00000005_post_disaster.png,122,62,1,530,652,365,427,2836,110.18825105043065,34.02820088103903
12789,/media/marda/TWOTB1/xBD/hurricanes/images/florence/hurricane-florence_00000005_post_disaster.png,128,66,1,695,823,392,458,3030,110.02248989164782,36.522665865964655
12790,/media/marda/TWOTB1/xBD/hurricanes/images/florence/hurricane-florence_00000005_post_disaster.png,70,82,1,370,440,395,477,2118,72.91771761213744,38.443170086660665
12791,/media/marda/TWOTB1/xBD/hurricanes/images/florence/hurricane-florence_00000005_post_disaster.png,72,120,1,972,1044,406,526,2823,116.89246617278275,32.758411421682005
12792,/media/marda/TWOTB1/xBD/hurricanes/images/florence/hurricane-florence_00000005_post_disaster.png,93,97,1,463,556,407,504,2778,97.51243349789517,38.196994733555286
12793,/media/marda/TWOTB1/xBD/hurricanes/images/florence/hurricane-florence_00000005_post_disaster.png,69,87,1,598,667,407,494,2359,75.11708447254534,41.340367293914625
12794,/media/marda/TWOTB1/xBD/hurricanes/images/florence/hurricane-florence_00000005_post_disaster.png,90,122,1,888,978,407,529,4117,118.49630822582813,46.73180855050922
12795,/media/marda/TWOTB1/xBD/hurricanes/images/florence/hurricane-florence_00000005_post_disaster.png,69,88,1,687,756,437,525,2169,78.28007075778577,36.917340572067076
12796,/media/marda/TWOTB1/xBD/hurricanes/images/florence/hurricane-florence_00000005_post_disaster.png,65,96,1,365,430,474,570,2677,86.61054385275706,42.0547541462001
12797,/media/marda/TWOTB1/xBD/hurricanes/images/florence/hurricane-florence_00000005_post_disaster.png,73,101,1,581,654,480,581,2761,89.27958491439733,40.63761453656595
12798,/media/marda/TWOTB1/xBD/hurricanes/images/florence/hurricane-florence_00000005_post_disaster.png,76,88,1,461,537,496,584,1991,69.2280685428731,38.2219026148654
12799,/media/marda/TWOTB1/xBD/hurricanes/images/florence/hurricane-florence_00000005_post_disaster.png,72,102,1,668,740,510,612,2557,88.77634507015178,38.07012033253306
12800,/media/marda/TWOTB1/xBD/hurricanes/images/florence/hurricane-florence_00000005_post_disaster.png,88,97,1,877,965,518,615,3089,85.66812135501702,48.388784954241935
12801,/media/marda/TWOTB1/xBD/hurricanes/images/florence/hurricane-florence_00000005_post_disaster.png,93,132,1,951,1044,528,660,4125,121.88062401213732,44.88224546518316
12802,/media/marda/TWOTB1/xBD/hurricanes/images/florence/hurricane-florence_00000005_post_disaster.png,109,75,1,519,628,547,622,2420,93.40213719596322,34.43033378035524
12803,/media/marda/TWOTB1/xBD/hurricanes/images/florence/hurricane-florence_00000005_post_disaster.png,95,90,1,385,480,561,651,2737,90.34157807172588,40.13272678957984
12804,/media/marda/TWOTB1/xBD/hurricanes/images/florence/hurricane-florence_00000005_post_disaster.png,127,83,1,655,782,594,677,3271,107.95861513625856,40.13830001960991
12805,/media/marda/TWOTB1/xBD/hurricanes/images/florence/hurricane-florence_00000005_post_disaster.png,104,136,1,843,947,596,732,4516,124.04930754623271,49.46336384005237
12806,/media/marda/TWOTB1/xBD/hurricanes/images/florence/hurricane-florence_00000005_post_disaster.png,91,78,1,498,589,627,705,2172,75.52193134134853,37.98567763348186
12807,/media/marda/TWOTB1/xBD/hurricanes/images/florence/hurricane-florence_00000005_post_disaster.png,94,104,1,923,1017,645,749,3002,88.22666068602626,45.59227699562012
12808,/media/marda/TWOTB1/xBD/hurricanes/images/florence/hurricane-florence_00000005_post_disaster.png,92,72,1,568,660,653,725,1904,74.86080341313989,33.856058775238004
12809,/media/marda/TWOTB1/xBD/hurricanes/images/florence/hurricane-florence_00000005_post_disaster.png,138,88,1,635,773,675,763,3618,121.45451576765802,39.63755188246742
12810,/media/marda/TWOTB1/xBD/hurricanes/images/florence/hurricane-florence_00000005_post_disaster.png,62,67,1,982,1044,699,766,629,40.780002084804146,20.87619131408218
12811,/media/marda/TWOTB1/xBD/hurricanes/images/florence/hurricane-florence_00000005_post_disaster.png,147,98,1,809,956,723,821,4042,121.84294580784882,44.177939026961255
12812,/media/marda/TWOTB1/xBD/hurricanes/images/florence/hurricane-florence_00000005_post_disaster.png,122,95,1,921,1043,756,851,3174,86.67920427338849,49.47969939537741
12813,/media/marda/TWOTB1/xBD/hurricanes/images/florence/hurricane-florence_00000023_post_disaster.png,68,41,1,862,930,249,290,573,29.278050582851012,26.073337394773958
12814,/media/marda/TWOTB1/xBD/hurricanes/images/florence/hurricane-florence_00000023_post_disaster.png,38,38,1,5,43,455,493,625,40.64851964066152,20.551953666324643
12815,/media/marda/TWOTB1/xBD/hurricanes/images/florence/hurricane-florence_00000023_post_disaster.png,45,57,1,121,166,465,522,998,40.42384681516395,32.759975595534456
12816,/media/marda/TWOTB1/xBD/hurricanes/images/florence/hurricane-florence_00000500_post_disaster.png,52,50,1,293,345,22,72,1019,45.62202733013475,34.24241884054834
12817,/media/marda/TWOTB1/xBD/hurricanes/images/florence/hurricane-florence_00000500_post_disaster.png,91,56,1,606,697,450,506,1828,69.98299987334482,34.715657614535466
12818,/media/marda/TWOTB1/xBD/hurricanes/images/florence/hurricane-florence_00000500_post_disaster.png,89,66,1,715,804,548,614,1998,60.97369138758567,44.18017867041496
12819,/media/marda/TWOTB1/xBD/hurricanes/images/florence/hurricane-florence_00000500_post_disaster.png,58,49,1,587,645,613,662,590,39.02564942050676,20.18411968126677
12820,/media/marda/TWOTB1/xBD/hurricanes/images/florence/hurricane-florence_00000500_post_disaster.png,55,38,1,764,819,618,656,288,27.745515116068457,13.747027250571927
12821,/media/marda/TWOTB1/xBD/hurricanes/images/florence/hurricane-florence_00000500_post_disaster.png,78,81,1,765,843,825,906,1497,49.09350010493932,39.93884552616616
12822,/media/marda/TWOTB1/xBD/hurricanes/images/florence/hurricane-florence_00000500_post_disaster.png,81,76,1,962,1043,877,953,1293,46.272031140002575,39.31700983362271
12823,/media/marda/TWOTB1/xBD/hurricanes/images/florence/hurricane-florence_00000009_pre_disaster.png,23,9,1,156,179,0,9,88,16.701564009595312,7.582869403709991
12824,/media/marda/TWOTB1/xBD/hurricanes/images/florence/hurricane-florence_00000009_pre_disaster.png,30,8,1,304,334,0,8,76,15.616021574725966,7.425809064391272
12825,/media/marda/TWOTB1/xBD/hurricanes/images/florence/hurricane-florence_00000009_pre_disaster.png,64,29,1,394,458,0,29,833,41.49971100178681,27.34936602779384
12826,/media/marda/TWOTB1/xBD/hurricanes/images/florence/hurricane-florence_00000009_pre_disaster.png,42,13,1,483,525,0,13,161,21.133663286757567,10.780567479174728
12827,/media/marda/TWOTB1/xBD/hurricanes/images/florence/hurricane-florence_00000009_pre_disaster.png,49,13,1,610,659,0,13,177,22.169911956476952,11.913795475270389
12828,/media/marda/TWOTB1/xBD/hurricanes/images/florence/hurricane-florence_00000009_pre_disaster.png,77,38,1,641,718,0,38,752,55.2758190701718,19.975091119550672
12829,/media/marda/TWOTB1/xBD/hurricanes/images/florence/hurricane-florence_00000009_pre_disaster.png,53,7,1,751,804,0,7,84,26.105572484625707,5.951637400269286
12830,/media/marda/TWOTB1/xBD/hurricanes/images/florence/hurricane-florence_00000009_pre_disaster.png,64,30,1,781,845,0,30,584,35.32837608903464,22.086679227563653
12831,/media/marda/TWOTB1/xBD/hurricanes/images/florence/hurricane-florence_00000009_pre_disaster.png,89,20,1,866,955,0,20,657,49.22332904130177,19.46613646234759
12832,/media/marda/TWOTB1/xBD/hurricanes/images/florence/hurricane-florence_00000009_pre_disaster.png,80,34,1,949,1029,0,34,804,36.518232932646505,29.322862448945468
12833,/media/marda/TWOTB1/xBD/hurricanes/images/florence/hurricane-florence_00000009_pre_disaster.png,40,45,1,34,74,8,53,617,55.98752163473185,14.680238856322468
12834,/media/marda/TWOTB1/xBD/hurricanes/images/florence/hurricane-florence_00000009_pre_disaster.png,59,38,1,365,424,16,54,952,44.83036742651094,28.348697189802472
12835,/media/marda/TWOTB1/xBD/hurricanes/images/florence/hurricane-florence_00000009_pre_disaster.png,87,48,1,645,732,16,64,1164,64.1670376866768,27.67927342464966
12836,/media/marda/TWOTB1/xBD/hurricanes/images/florence/hurricane-florence_00000009_pre_disaster.png,27,21,1,0,27,22,43,269,32.545448225196544,16.562931656565546
12837,/media/marda/TWOTB1/xBD/hurricanes/images/florence/hurricane-florence_00000009_pre_disaster.png,77,40,1,793,870,23,63,975,39.74632240969548,32.42946626128746
12838,/media/marda/TWOTB1/xBD/hurricanes/images/florence/hurricane-florence_00000009_pre_disaster.png,74,57,1,547,621,27,84,1595,53.905261123536974,39.649605406997885
12839,/media/marda/TWOTB1/xBD/hurricanes/images/florence/hurricane-florence_00000009_pre_disaster.png,76,46,1,686,762,32,78,766,63.47729023030345,17.49955854936103
12840,/media/marda/TWOTB1/xBD/hurricanes/images/florence/hurricane-florence_00000009_pre_disaster.png,29,21,1,133,162,34,55,295,23.22997722872958,16.780605673061192
12841,/media/marda/TWOTB1/xBD/hurricanes/images/florence/hurricane-florence_00000009_pre_disaster.png,72,34,1,909,981,34,68,663,39.490190864188854,22.067698464743497
12842,/media/marda/TWOTB1/xBD/hurricanes/images/florence/hurricane-florence_00000009_pre_disaster.png,25,30,1,62,87,44,74,394,27.700800171453142,20.06904646028416
12843,/media/marda/TWOTB1/xBD/hurricanes/images/florence/hurricane-florence_00000009_pre_disaster.png,73,43,1,817,890,46,89,885,39.104559027258716,30.776730227083668
12844,/media/marda/TWOTB1/xBD/hurricanes/images/florence/hurricane-florence_00000009_pre_disaster.png,75,33,1,263,338,50,83,1074,70.44107180993697,20.743113162532385
12845,/media/marda/TWOTB1/xBD/hurricanes/images/florence/hurricane-florence_00000009_pre_disaster.png,85,49,1,690,775,60,109,1353,56.87105699162865,34.576118584790514
12846,/media/marda/TWOTB1/xBD/hurricanes/images/florence/hurricane-florence_00000009_pre_disaster.png,35,22,1,81,116,70,92,337,37.16259957523754,12.08355400325042
12847,/media/marda/TWOTB1/xBD/hurricanes/images/florence/hurricane-florence_00000009_pre_disaster.png,61,31,1,842,903,71,102,452,27.971309498245876,21.591137736894023
12848,/media/marda/TWOTB1/xBD/hurricanes/images/florence/hurricane-florence_00000009_pre_disaster.png,53,37,1,164,217,74,111,993,59.35357930443707,26.96767819654882
12849,/media/marda/TWOTB1/xBD/hurricanes/images/florence/hurricane-florence_00000009_pre_disaster.png,72,43,1,891,963,75,118,996,41.48967338587952,31.76003068681524
12850,/media/marda/TWOTB1/xBD/hurricanes/images/florence/hurricane-florence_00000009_pre_disaster.png,63,36,1,512,575,76,112,830,38.89426809434199,28.2827948448326
12851,/media/marda/TWOTB1/xBD/hurricanes/images/florence/hurricane-florence_00000009_pre_disaster.png,80,38,1,964,1044,82,120,856,38.362891679038206,29.582175343498246
12852,/media/marda/TWOTB1/xBD/hurricanes/images/florence/hurricane-florence_00000009_pre_disaster.png,72,43,1,735,807,85,128,755,51.503294585870535,19.576596700101515
12853,/media/marda/TWOTB1/xBD/hurricanes/images/florence/hurricane-florence_00000009_pre_disaster.png,55,33,1,609,664,87,120,443,38.1133514379736,15.412703496298512
12854,/media/marda/TWOTB1/xBD/hurricanes/images/florence/hurricane-florence_00000009_pre_disaster.png,50,17,1,262,312,89,106,310,44.96136920143769,9.240278725016111
12855,/media/marda/TWOTB1/xBD/hurricanes/images/florence/hurricane-florence_00000009_pre_disaster.png,61,39,1,867,928,90,129,741,40.355178363238565,25.370973283442947
12856,/media/marda/TWOTB1/xBD/hurricanes/images/florence/hurricane-florence_00000009_pre_disaster.png,83,63,1,327,410,94,157,2548,75.83333316684072,48.89984509502477
12857,/media/marda/TWOTB1/xBD/hurricanes/images/florence/hurricane-florence_00000009_pre_disaster.png,34,21,1,487,521,99,120,165,17.252428169496174,13.873536241329342
12858,/media/marda/TWOTB1/xBD/hurricanes/images/florence/hurricane-florence_00000009_pre_disaster.png,76,42,1,615,691,105,147,998,50.3162724606678,26.524294949905045
12859,/media/marda/TWOTB1/xBD/hurricanes/images/florence/hurricane-florence_00000009_pre_disaster.png,52,23,1,164,216,110,133,686,52.33513463033798,18.37785709698636
12860,/media/marda/TWOTB1/xBD/hurricanes/images/florence/hurricane-florence_00000009_pre_disaster.png,67,46,1,760,827,110,156,781,40.20258794207143,26.16692876410475
12861,/media/marda/TWOTB1/xBD/hurricanes/images/florence/hurricane-florence_00000009_pre_disaster.png,80,45,1,919,999,112,157,1039,37.4245217711628,36.325601889932585
12862,/media/marda/TWOTB1/xBD/hurricanes/images/florence/hurricane-florence_00000009_pre_disaster.png,69,30,1,74,143,115,145,1287,74.71908568140864,23.67519541096971
12863,/media/marda/TWOTB1/xBD/hurricanes/images/florence/hurricane-florence_00000009_pre_disaster.png,47,28,1,264,311,120,148,707,42.89807851301319,22.860642725815747
12864,/media/marda/TWOTB1/xBD/hurricanes/images/florence/hurricane-florence_00000009_pre_disaster.png,67,46,1,635,702,130,176,784,48.64090149889462,23.53763354810693
12865,/media/marda/TWOTB1/xBD/hurricanes/images/florence/hurricane-florence_00000009_pre_disaster.png,74,47,1,785,859,131,178,628,53.98853454451505,15.498784967600592
12866,/media/marda/TWOTB1/xBD/hurricanes/images/florence/hurricane-florence_00000009_pre_disaster.png,66,29,1,164,230,136,165,1038,63.589159025523635,22.50073958160948
12867,/media/marda/TWOTB1/xBD/hurricanes/images/florence/hurricane-florence_00000009_pre_disaster.png,52,25,1,480,532,140,165,516,36.67072137418457,18.828357260140326
12868,/media/marda/TWOTB1/xBD/hurricanes/images/florence/hurricane-florence_00000009_pre_disaster.png,69,47,1,560,629,147,194,929,48.74640542288539,25.418160813564885
12869,/media/marda/TWOTB1/xBD/hurricanes/images/florence/hurricane-florence_00000009_pre_disaster.png,59,39,1,675,734,148,187,584,29.722933094774838,26.378448294271433
12870,/media/marda/TWOTB1/xBD/hurricanes/images/florence/hurricane-florence_00000009_pre_disaster.png,79,32,1,65,144,152,184,1593,87.94361468322133,25.708061907792622
12871,/media/marda/TWOTB1/xBD/hurricanes/images/florence/hurricane-florence_00000009_pre_disaster.png,43,18,1,260,303,154,172,419,38.56418385152232,14.476419375143495
12872,/media/marda/TWOTB1/xBD/hurricanes/images/florence/hurricane-florence_00000009_pre_disaster.png,60,35,1,328,388,160,195,1055,50.9287078544401,27.536497636437765
12873,/media/marda/TWOTB1/xBD/hurricanes/images/florence/hurricane-florence_00000009_pre_disaster.png,76,41,1,922,998,163,204,741,41.8556064326274,23.22468215842029
12874,/media/marda/TWOTB1/xBD/hurricanes/images/florence/hurricane-florence_00000009_pre_disaster.png,53,36,1,166,219,166,202,1075,50.44679652977395,28.87556593733872
12875,/media/marda/TWOTB1/xBD/hurricanes/images/florence/hurricane-florence_00000009_pre_disaster.png,40,20,1,612,652,170,190,171,15.385264473162742,14.791550315838368
12876,/media/marda/TWOTB1/xBD/hurricanes/images/florence/hurricane-florence_00000009_pre_disaster.png,48,23,1,709,757,171,194,190,17.408239359027675,14.613797039600783
12877,/media/marda/TWOTB1/xBD/hurricanes/images/florence/hurricane-florence_00000009_pre_disaster.png,59,26,1,467,526,175,201,754,46.47991154736558,21.414332685678232
12878,/media/marda/TWOTB1/xBD/hurricanes/images/florence/hurricane-florence_00000009_pre_disaster.png,72,43,1,833,905,182,225,563,49.37410988609435,16.63900191508549
12879,/media/marda/TWOTB1/xBD/hurricanes/images/florence/hurricane-florence_00000009_pre_disaster.png,62,17,1,558,620,197,214,437,45.854864054040135,12.716083916264148
12880,/media/marda/TWOTB1/xBD/hurricanes/images/florence/hurricane-florence_00000009_pre_disaster.png,72,37,1,952,1024,197,234,538,35.89859758127816,20.275445235425636
12881,/media/marda/TWOTB1/xBD/hurricanes/images/florence/hurricane-florence_00000009_pre_disaster.png,36,22,1,603,639,199,221,157,15.098471216242366,13.859532297705709
12882,/media/marda/TWOTB1/xBD/hurricanes/images/florence/hurricane-florence_00000009_pre_disaster.png,63,40,1,713,776,199,239,513,41.43353561884495,16.700302170910614
12883,/media/marda/TWOTB1/xBD/hurricanes/images/florence/hurricane-florence_00000009_pre_disaster.png,44,26,1,680,724,200,226,160,16.375786341888112,13.108532400113706
12884,/media/marda/TWOTB1/xBD/hurricanes/images/florence/hurricane-florence_00000009_pre_disaster.png,43,25,1,354,397,203,228,343,33.28095796643635,13.797603991333151
12885,/media/marda/TWOTB1/xBD/hurricanes/images/florence/hurricane-florence_00000009_pre_disaster.png,64,54,1,159,223,204,258,1486,59.27121153949952,36.708043858541174
12886,/media/marda/TWOTB1/xBD/hurricanes/images/florence/hurricane-florence_00000009_pre_disaster.png,70,43,1,241,311,206,249,1108,64.91252308076473,22.78172681988758
12887,/media/marda/TWOTB1/xBD/hurricanes/images/florence/hurricane-florence_00000009_pre_disaster.png,68,25,1,465,533,213,238,715,56.75446959171769,16.783539738570664
12888,/media/marda/TWOTB1/xBD/hurricanes/images/florence/hurricane-florence_00000009_pre_disaster.png,38,46,1,64,102,217,263,709,34.95410935178567,28.69204033219816
12889,/media/marda/TWOTB1/xBD/hurricanes/images/florence/hurricane-florence_00000009_pre_disaster.png,36,22,1,605,641,217,239,146,14.787548630791655,13.017699982300378
12890,/media/marda/TWOTB1/xBD/hurricanes/images/florence/hurricane-florence_00000009_pre_disaster.png,68,44,1,735,803,218,262,516,47.91052331872518,14.228350086352435
12891,/media/marda/TWOTB1/xBD/hurricanes/images/florence/hurricane-florence_00000009_pre_disaster.png,81,55,1,876,957,223,278,903,55.130550322486044,24.446036873361745
12892,/media/marda/TWOTB1/xBD/hurricanes/images/florence/hurricane-florence_00000009_pre_disaster.png,38,22,1,657,695,227,249,144,14.904050917187634,12.947799072652451
12893,/media/marda/TWOTB1/xBD/hurricanes/images/florence/hurricane-florence_00000009_pre_disaster.png,63,35,1,559,622,229,264,850,44.952724535602414,25.168787071279322
12894,/media/marda/TWOTB1/xBD/hurricanes/images/florence/hurricane-florence_00000009_pre_disaster.png,48,54,1,127,175,231,285,971,49.352693457188074,26.10014290740547
12895,/media/marda/TWOTB1/xBD/hurricanes/images/florence/hurricane-florence_00000009_pre_disaster.png,47,23,1,325,372,233,256,439,39.02154298271366,15.020518120415717
12896,/media/marda/TWOTB1/xBD/hurricanes/images/florence/hurricane-florence_00000009_pre_disaster.png,63,58,1,326,389,241,299,1183,57.841208230228474,39.77422441858887
12897,/media/marda/TWOTB1/xBD/hurricanes/images/florence/hurricane-florence_00000009_pre_disaster.png,56,20,1,625,681,242,262,317,35.842629876929806,12.60991714188755
12898,/media/marda/TWOTB1/xBD/hurricanes/images/florence/hurricane-florence_00000009_pre_disaster.png,68,43,1,757,825,242,285,512,46.64357252994986,14.570631046877988
12899,/media/marda/TWOTB1/xBD/hurricanes/images/florence/hurricane-florence_00000009_pre_disaster.png,31,39,1,37,68,244,283,452,33.15333709619231,18.14596821990671
12900,/media/marda/TWOTB1/xBD/hurricanes/images/florence/hurricane-florence_00000009_pre_disaster.png,66,27,1,463,529,244,271,590,51.71937560523681,16.016088551558532
12901,/media/marda/TWOTB1/xBD/hurricanes/images/florence/hurricane-florence_00000009_pre_disaster.png,89,61,1,629,718,247,308,2091,71.80344791307841,42.95622140261697
12902,/media/marda/TWOTB1/xBD/hurricanes/images/florence/hurricane-florence_00000009_pre_disaster.png,83,55,1,906,989,255,310,1041,51.87422370876224,27.098176246686258
12903,/media/marda/TWOTB1/xBD/hurricanes/images/florence/hurricane-florence_00000009_pre_disaster.png,30,19,1,457,487,262,281,120,15.388075147362175,10.482070879640208
12904,/media/marda/TWOTB1/xBD/hurricanes/images/florence/hurricane-florence_00000009_pre_disaster.png,71,49,1,781,852,265,314,814,39.6918598811517,27.36069702193745
12905,/media/marda/TWOTB1/xBD/hurricanes/images/florence/hurricane-florence_00000009_pre_disaster.png,75,32,1,562,637,269,301,894,55.09719121269219,21.734715880361456
12906,/media/marda/TWOTB1/xBD/hurricanes/images/florence/hurricane-florence_00000009_pre_disaster.png,67,22,1,462,529,274,296,492,55.065940118008925,12.462678324599414
12907,/media/marda/TWOTB1/xBD/hurricanes/images/florence/hurricane-florence_00000009_pre_disaster.png,20,24,1,123,143,275,299,126,15.54017113987638,10.862556993425477
12908,/media/marda/TWOTB1/xBD/hurricanes/images/florence/hurricane-florence_00000009_pre_disaster.png,45,34,1,231,276,279,313,448,39.24911412409316,15.147213710894261
12909,/media/marda/TWOTB1/xBD/hurricanes/images/florence/hurricane-florence_00000009_pre_disaster.png,37,41,1,82,119,290,331,566,36.49097807093595,21.336225661881265
12910,/media/marda/TWOTB1/xBD/hurricanes/images/florence/hurricane-florence_00000009_pre_disaster.png,84,38,1,457,541,295,333,880,71.31926692221629,16.489471233045496
12911,/media/marda/TWOTB1/xBD/hurricanes/images/florence/hurricane-florence_00000009_pre_disaster.png,57,40,1,695,752,297,337,293,35.51153741222938,11.030158393264509
12912,/media/marda/TWOTB1/xBD/hurricanes/images/florence/hurricane-florence_00000009_pre_disaster.png,52,51,1,115,167,299,350,1039,48.731763484428775,29.160944622689488
12913,/media/marda/TWOTB1/xBD/hurricanes/images/florence/hurricane-florence_00000009_pre_disaster.png,40,35,1,346,386,300,335,371,28.165690844815686,17.62697505811239
12914,/media/marda/TWOTB1/xBD/hurricanes/images/florence/hurricane-florence_00000009_pre_disaster.png,61,33,1,572,633,301,334,778,44.92102058738009,23.02723978215595
12915,/media/marda/TWOTB1/xBD/hurricanes/images/florence/hurricane-florence_00000009_pre_disaster.png,46,29,1,731,777,302,331,145,18.453872336340183,10.47905759659363
12916,/media/marda/TWOTB1/xBD/hurricanes/images/florence/hurricane-florence_00000009_pre_disaster.png,78,60,1,966,1044,303,363,1022,52.2634440964203,25.977801262750134
12917,/media/marda/TWOTB1/xBD/hurricanes/images/florence/hurricane-florence_00000009_pre_disaster.png,83,60,1,828,911,311,371,847,62.54814000929843,18.336927947387203
12918,/media/marda/TWOTB1/xBD/hurricanes/images/florence/hurricane-florence_00000009_pre_disaster.png,44,34,1,646,690,313,347,298,20.806477056059702,18.920486160691553
12919,/media/marda/TWOTB1/xBD/hurricanes/images/florence/hurricane-florence_00000009_pre_disaster.png,69,54,1,294,363,323,377,1349,54.93362371332952,32.71238609099757
12920,/media/marda/TWOTB1/xBD/hurricanes/images/florence/hurricane-florence_00000009_pre_disaster.png,54,37,1,715,769,323,360,301,29.03920515678723,13.788168816167424
12921,/media/marda/TWOTB1/xBD/hurricanes/images/florence/hurricane-florence_00000009_pre_disaster.png,45,33,1,484,529,326,359,271,28.78038869353794,12.496431044713146
12922,/media/marda/TWOTB1/xBD/hurricanes/images/florence/hurricane-florence_00000009_pre_disaster.png,65,48,1,739,804,334,382,498,45.6066105003768,14.43750183520083
12923,/media/marda/TWOTB1/xBD/hurricanes/images/florence/hurricane-florence_00000009_pre_disaster.png,26,31,1,170,196,345,376,200,21.406199631658875,12.510020676624302
12924,/media/marda/TWOTB1/xBD/hurricanes/images/florence/hurricane-florence_00000009_pre_disaster.png,43,24,1,777,820,347,371,84,11.160749486524328,9.994444359972185
12925,/media/marda/TWOTB1/xBD/hurricanes/images/florence/hurricane-florence_00000009_pre_disaster.png,29,49,1,3,32,349,398,449,40.49226434585008,15.658550212094163
12926,/media/marda/TWOTB1/xBD/hurricanes/images/florence/hurricane-florence_00000009_pre_disaster.png,42,53,1,622,664,355,408,518,44.296959122406214,16.991749747873296
12927,/media/marda/TWOTB1/xBD/hurricanes/images/florence/hurricane-florence_00000009_pre_disaster.png,37,25,1,642,679,357,382,82,13.25704974865424,8.234419149611371
12928,/media/marda/TWOTB1/xBD/hurricanes/images/florence/hurricane-florence_00000009_pre_disaster.png,64,47,1,564,628,359,406,933,40.48009499685115,31.80329730484737
12929,/media/marda/TWOTB1/xBD/hurricanes/images/florence/hurricane-florence_00000009_pre_disaster.png,32,34,1,372,404,360,394,235,21.808498462884934,14.25584776886993
12930,/media/marda/TWOTB1/xBD/hurricanes/images/florence/hurricane-florence_00000009_pre_disaster.png,39,34,1,479,518,360,394,237,19.41122982825891,16.350455568885184
12931,/media/marda/TWOTB1/xBD/hurricanes/images/florence/hurricane-florence_00000009_pre_disaster.png,70,47,1,751,821,366,413,546,45.398167058127534,18.02260714479342
12932,/media/marda/TWOTB1/xBD/hurricanes/images/florence/hurricane-florence_00000009_pre_disaster.png,72,53,1,432,504,367,420,1009,63.156872836776486,22.91855179817357
12933,/media/marda/TWOTB1/xBD/hurricanes/images/florence/hurricane-florence_00000009_pre_disaster.png,49,52,1,329,378,369,421,680,44.57134595601192,20.817595497541443
12934,/media/marda/TWOTB1/xBD/hurricanes/images/florence/hurricane-florence_00000009_pre_disaster.png,86,59,1,876,962,371,430,1281,44.07752294449311,38.714005759442344
12935,/media/marda/TWOTB1/xBD/hurricanes/images/florence/hurricane-florence_00000009_pre_disaster.png,61,49,1,657,718,373,422,728,33.41959662823162,28.938194714140735
12936,/media/marda/TWOTB1/xBD/hurricanes/images/florence/hurricane-florence_00000009_pre_disaster.png,62,68,1,105,167,376,444,1294,67.7101750039786,26.181786118093154
12937,/media/marda/TWOTB1/xBD/hurricanes/images/florence/hurricane-florence_00000009_pre_disaster.png,39,37,1,40,79,381,418,478,42.212169371859936,15.139211621086508
12938,/media/marda/TWOTB1/xBD/hurricanes/images/florence/hurricane-florence_00000009_pre_disaster.png,41,34,1,424,465,388,422,274,25.641344992508035,14.279343718651383
12939,/media/marda/TWOTB1/xBD/hurricanes/images/florence/hurricane-florence_00000009_pre_disaster.png,72,51,1,777,849,388,439,534,52.86403690096902,13.485516089546081
12940,/media/marda/TWOTB1/xBD/hurricanes/images/florence/hurricane-florence_00000009_pre_disaster.png,50,53,1,359,409,389,442,752,42.969799928365035,23.50045414549051
12941,/media/marda/TWOTB1/xBD/hurricanes/images/florence/hurricane-florence_00000009_pre_disaster.png,66,47,1,538,604,390,437,835,43.86790606230096,27.714859093549197
12942,/media/marda/TWOTB1/xBD/hurricanes/images/florence/hurricane-florence_00000009_pre_disaster.png,59,47,1,640,699,392,439,416,46.76236616435183,11.813905803182433
12943,/media/marda/TWOTB1/xBD/hurricanes/images/florence/hurricane-florence_00000009_pre_disaster.png,53,68,1,386,439,397,465,1122,53.19772493614975,28.09116799360016
12944,/media/marda/TWOTB1/xBD/hurricanes/images/florence/hurricane-florence_00000009_pre_disaster.png,32,36,1,316,348,402,438,217,18.278504040885455,15.961557377595211
12945,/media/marda/TWOTB1/xBD/hurricanes/images/florence/hurricane-florence_00000009_pre_disaster.png,52,42,1,521,573,418,460,474,29.721538238145694,21.56048770809504
12946,/media/marda/TWOTB1/xBD/hurricanes/images/florence/hurricane-florence_00000009_pre_disaster.png,61,52,1,627,688,420,472,560,41.680069367258035,17.939495283032535
12947,/media/marda/TWOTB1/xBD/hurricanes/images/florence/hurricane-florence_00000009_pre_disaster.png,51,35,1,782,833,420,455,234,19.962760970297907,15.479280499035768
12948,/media/marda/TWOTB1/xBD/hurricanes/images/florence/hurricane-florence_00000009_pre_disaster.png,59,36,1,971,1030,423,459,215,18.931448613099818,15.216520379432849
12949,/media/marda/TWOTB1/xBD/hurricanes/images/florence/hurricane-florence_00000009_pre_disaster.png,42,53,1,98,140,424,477,684,37.28840583801954,24.405719652226754
12950,/media/marda/TWOTB1/xBD/hurricanes/images/florence/hurricane-florence_00000009_pre_disaster.png,55,35,1,907,962,428,463,177,17.613834339611543,13.467498312625663
12951,/media/marda/TWOTB1/xBD/hurricanes/images/florence/hurricane-florence_00000009_pre_disaster.png,54,43,1,221,275,432,475,1027,52.46682826836535,26.620464845338038
12952,/media/marda/TWOTB1/xBD/hurricanes/images/florence/hurricane-florence_00000009_pre_disaster.png,74,65,1,588,662,435,500,1205,56.84317538136053,27.98350891109152
12953,/media/marda/TWOTB1/xBD/hurricanes/images/florence/hurricane-florence_00000009_pre_disaster.png,88,69,1,835,923,436,505,1485,45.00961240259511,43.902309194095125
12954,/media/marda/TWOTB1/xBD/hurricanes/images/florence/hurricane-florence_00000009_pre_disaster.png,39,53,1,278,317,438,491,455,38.68868211419576,16.489084485830308
12955,/media/marda/TWOTB1/xBD/hurricanes/images/florence/hurricane-florence_00000009_pre_disaster.png,44,36,1,432,476,442,478,291,28.663813507226987,13.583854498084648
12956,/media/marda/TWOTB1/xBD/hurricanes/images/florence/hurricane-florence_00000009_pre_disaster.png,66,51,1,712,778,442,493,684,41.06107125636393,21.94279819133541
12957,/media/marda/TWOTB1/xBD/hurricanes/images/florence/hurricane-florence_00000009_pre_disaster.png,47,57,1,60,107,444,501,921,43.597467180357796,28.19451766939259
12958,/media/marda/TWOTB1/xBD/hurricanes/images/florence/hurricane-florence_00000009_pre_disaster.png,63,44,1,932,995,444,488,403,25.773822765235973,20.75224530022674
12959,/media/marda/TWOTB1/xBD/hurricanes/images/florence/hurricane-florence_00000009_pre_disaster.png,53,45,1,510,563,450,495,441,33.73277470872972,17.473313284163396
12960,/media/marda/TWOTB1/xBD/hurricanes/images/florence/hurricane-florence_00000009_pre_disaster.png,83,56,1,957,1040,450,506,907,42.329123406723866,28.454657898124164
12961,/media/marda/TWOTB1/xBD/hurricanes/images/florence/hurricane-florence_00000009_pre_disaster.png,55,56,1,179,234,455,511,716,55.09912235542757,19.008293857438783
12962,/media/marda/TWOTB1/xBD/hurricanes/images/florence/hurricane-florence_00000009_pre_disaster.png,44,52,1,297,341,457,509,437,41.78157995069295,13.99359882297776
12963,/media/marda/TWOTB1/xBD/hurricanes/images/florence/hurricane-florence_00000009_pre_disaster.png,68,64,1,566,634,458,522,943,55.01118682438307,22.813373953701106
12964,/media/marda/TWOTB1/xBD/hurricanes/images/florence/hurricane-florence_00000009_pre_disaster.png,70,64,1,883,953,470,534,1170,50.659057915016724,30.471803625177532
12965,/media/marda/TWOTB1/xBD/hurricanes/images/florence/hurricane-florence_00000009_pre_disaster.png,46,55,1,158,204,473,528,639,42.85974961034049,24.010327512438543
12966,/media/marda/TWOTB1/xBD/hurricanes/images/florence/hurricane-florence_00000009_pre_disaster.png,48,53,1,323,371,478,531,466,45.62031293886472,14.904803939083594
12967,/media/marda/TWOTB1/xBD/hurricanes/images/florence/hurricane-florence_00000009_pre_disaster.png,44,46,1,47,91,480,526,697,45.76522701502466,20.339477664134815
12968,/media/marda/TWOTB1/xBD/hurricanes/images/florence/hurricane-florence_00000009_pre_disaster.png,74,58,1,970,1044,485,543,743,43.51365222230115,23.106939548794646
12969,/media/marda/TWOTB1/xBD/hurricanes/images/florence/hurricane-florence_00000009_pre_disaster.png,64,74,1,489,553,487,561,1318,52.47830827392223,34.70607755505879
12970,/media/marda/TWOTB1/xBD/hurricanes/images/florence/hurricane-florence_00000009_pre_disaster.png,9,42,1,0,9,490,532,102,19.879542591777348,7.845162686385229
12971,/media/marda/TWOTB1/xBD/hurricanes/images/florence/hurricane-florence_00000009_pre_disaster.png,98,77,1,522,620,490,567,1741,81.56695615929553,31.04027313565412
12972,/media/marda/TWOTB1/xBD/hurricanes/images/florence/hurricane-florence_00000009_pre_disaster.png,68,60,1,664,732,491,551,639,53.114506344822175,15.910508251499644
12973,/media/marda/TWOTB1/xBD/hurricanes/images/florence/hurricane-florence_00000009_pre_disaster.png,78,74,1,767,845,491,565,1130,59.315622289602985,27.63705477345522
12974,/media/marda/TWOTB1/xBD/hurricanes/images/florence/hurricane-florence_00000009_pre_disaster.png,46,57,1,134,180,504,561,847,41.08808918929205,27.956079299782587
12975,/media/marda/TWOTB1/xBD/hurricanes/images/florence/hurricane-florence_00000009_pre_disaster.png,50,55,1,349,399,504,559,437,47.81139890268363,13.763258595856344
12976,/media/marda/TWOTB1/xBD/hurricanes/images/florence/hurricane-florence_00000009_pre_disaster.png,62,58,1,641,703,513,571,553,46.333479990379004,16.909632580979725
12977,/media/marda/TWOTB1/xBD/hurricanes/images/florence/hurricane-florence_00000009_pre_disaster.png,63,82,1,616,679,521,603,1203,64.2654632537243,27.029695284409375
12978,/media/marda/TWOTB1/xBD/hurricanes/images/florence/hurricane-florence_00000009_pre_disaster.png,49,37,1,36,85,522,559,621,56.277766702919,15.300390379405536
12979,/media/marda/TWOTB1/xBD/hurricanes/images/florence/hurricane-florence_00000009_pre_disaster.png,76,61,1,754,830,527,588,882,49.233421185840214,23.802231041872325
12980,/media/marda/TWOTB1/xBD/hurricanes/images/florence/hurricane-florence_00000009_pre_disaster.png,52,31,1,991,1043,529,560,65,10.371538803255646,8.456358520108392
12981,/media/marda/TWOTB1/xBD/hurricanes/images/florence/hurricane-florence_00000009_pre_disaster.png,48,51,1,371,419,530,581,470,37.85745493334227,17.177538987619304
12982,/media/marda/TWOTB1/xBD/hurricanes/images/florence/hurricane-florence_00000009_pre_disaster.png,78,72,1,874,952,532,604,1030,56.02668941186836,24.499834910983868
12983,/media/marda/TWOTB1/xBD/hurricanes/images/florence/hurricane-florence_00000009_pre_disaster.png,37,32,1,680,717,541,573,73,10.44803820491506,9.222814260591715
12984,/media/marda/TWOTB1/xBD/hurricanes/images/florence/hurricane-florence_00000009_pre_disaster.png,72,69,1,735,807,548,617,895,54.587831053463255,23.610854504854636
12985,/media/marda/TWOTB1/xBD/hurricanes/images/florence/hurricane-florence_00000009_pre_disaster.png,54,49,1,390,444,549,598,539,39.71981854854452,19.303103159375087
12986,/media/marda/TWOTB1/xBD/hurricanes/images/florence/hurricane-florence_00000009_pre_disaster.png,36,58,1,132,168,556,614,1039,43.50173014682048,31.5435689205083
12987,/media/marda/TWOTB1/xBD/hurricanes/images/florence/hurricane-florence_00000009_pre_disaster.png,35,30,1,655,690,556,586,60,9.466809993104667,8.36271870326924
12988,/media/marda/TWOTB1/xBD/hurricanes/images/florence/hurricane-florence_00000009_pre_disaster.png,30,37,1,56,86,557,594,481,34.68678839255152,18.4843728405057
12989,/media/marda/TWOTB1/xBD/hurricanes/images/florence/hurricane-florence_00000009_pre_disaster.png,83,81,1,708,791,563,644,1378,72.39525858366541,25.027883213542527
12990,/media/marda/TWOTB1/xBD/hurricanes/images/florence/hurricane-florence_00000009_pre_disaster.png,38,33,1,653,691,572,605,97,12.448871424884508,10.36023423829447
12991,/media/marda/TWOTB1/xBD/hurricanes/images/florence/hurricane-florence_00000009_pre_disaster.png,62,47,1,393,455,574,621,796,51.66462800634106,21.27351416625265
12992,/media/marda/TWOTB1/xBD/hurricanes/images/florence/hurricane-florence_00000009_pre_disaster.png,20,57,1,0,20,579,636,415,33.17211803651532,18.45786797264532
12993,/media/marda/TWOTB1/xBD/hurricanes/images/florence/hurricane-florence_00000009_pre_disaster.png,69,60,1,491,560,583,643,997,52.2838345420688,25.37006217727296
12994,/media/marda/TWOTB1/xBD/hurricanes/images/florence/hurricane-florence_00000009_pre_disaster.png,33,36,1,471,504,589,625,226,18.78222189534091,16.153785878367085
12995,/media/marda/TWOTB1/xBD/hurricanes/images/florence/hurricane-florence_00000009_pre_disaster.png,44,39,1,48,92,593,632,602,49.683638986326386,16.15618227917356
12996,/media/marda/TWOTB1/xBD/hurricanes/images/florence/hurricane-florence_00000009_pre_disaster.png,60,48,1,399,459,603,651,821,49.70049541954053,22.952359186282845
12997,/media/marda/TWOTB1/xBD/hurricanes/images/florence/hurricane-florence_00000009_pre_disaster.png,51,39,1,993,1044,609,648,120,14.566415302543616,11.09572443733976
12998,/media/marda/TWOTB1/xBD/hurricanes/images/florence/hurricane-florence_00000009_pre_disaster.png,47,50,1,133,180,614,664,842,47.714339673591915,24.657774779612794
12999,/media/marda/TWOTB1/xBD/hurricanes/images/florence/hurricane-florence_00000009_pre_disaster.png,62,52,1,489,551,615,667,541,47.63387054223156,15.698567017965908
13000,/media/marda/TWOTB1/xBD/hurricanes/images/florence/hurricane-florence_00000009_pre_disaster.png,111,104,1,747,858,620,724,3438,75.76973437390757,59.86509137121589
13001,/media/marda/TWOTB1/xBD/hurricanes/images/florence/hurricane-florence_00000009_pre_disaster.png,41,50,1,50,91,626,676,1001,45.735925758032565,28.933280955372275
13002,/media/marda/TWOTB1/xBD/hurricanes/images/florence/hurricane-florence_00000009_pre_disaster.png,54,50,1,705,759,628,678,362,23.893782363804597,19.98599414301908
13003,/media/marda/TWOTB1/xBD/hurricanes/images/florence/hurricane-florence_00000009_pre_disaster.png,71,71,1,530,601,629,700,1222,49.595000425256515,32.665506827251924
13004,/media/marda/TWOTB1/xBD/hurricanes/images/florence/hurricane-florence_00000009_pre_disaster.png,56,54,1,988,1044,637,691,264,26.024832651461217,14.988022615371971
13005,/media/marda/TWOTB1/xBD/hurricanes/images/florence/hurricane-florence_00000009_pre_disaster.png,50,50,1,402,452,640,690,386,36.703286034977324,14.036901272839643
13006,/media/marda/TWOTB1/xBD/hurricanes/images/florence/hurricane-florence_00000009_pre_disaster.png,36,40,1,467,503,644,684,194,19.78382328110049,13.161071065253465
13007,/media/marda/TWOTB1/xBD/hurricanes/images/florence/hurricane-florence_00000009_pre_disaster.png,48,53,1,135,183,648,701,750,47.5558936727755,20.995318147024634
13008,/media/marda/TWOTB1/xBD/hurricanes/images/florence/hurricane-florence_00000009_pre_disaster.png,58,49,1,490,548,659,708,424,41.56168669626575,15.859363145745949
13009,/media/marda/TWOTB1/xBD/hurricanes/images/florence/hurricane-florence_00000009_pre_disaster.png,49,59,1,372,421,663,722,507,40.45762164918301,16.736946280520392
13010,/media/marda/TWOTB1/xBD/hurricanes/images/florence/hurricane-florence_00000009_pre_disaster.png,36,39,1,535,571,668,707,124,15.585347112736812,10.605408379933461
13011,/media/marda/TWOTB1/xBD/hurricanes/images/florence/hurricane-florence_00000009_pre_disaster.png,88,68,1,730,818,671,739,1006,59.840975911308696,25.181720717496727
13012,/media/marda/TWOTB1/xBD/hurricanes/images/florence/hurricane-florence_00000009_pre_disaster.png,44,58,1,149,193,672,730,601,41.61036094464586,21.024766700647714
13013,/media/marda/TWOTB1/xBD/hurricanes/images/florence/hurricane-florence_00000009_pre_disaster.png,6,36,1,0,6,678,714,39,10.749310623292258,5.484781433190123
13014,/media/marda/TWOTB1/xBD/hurricanes/images/florence/hurricane-florence_00000009_pre_disaster.png,54,61,1,474,528,678,739,630,36.66303448514282,22.946445534302004
13015,/media/marda/TWOTB1/xBD/hurricanes/images/florence/hurricane-florence_00000009_pre_disaster.png,31,47,1,59,90,687,734,577,34.87395403067874,22.097343706811355
13016,/media/marda/TWOTB1/xBD/hurricanes/images/florence/hurricane-florence_00000009_pre_disaster.png,34,66,1,181,215,688,754,412,42.45703590417747,12.963785359554407
13017,/media/marda/TWOTB1/xBD/hurricanes/images/florence/hurricane-florence_00000009_pre_disaster.png,26,79,1,7,33,697,776,1102,55.1425891593445,26.6767056647929
13018,/media/marda/TWOTB1/xBD/hurricanes/images/florence/hurricane-florence_00000009_pre_disaster.png,71,53,1,638,709,697,750,589,49.88736051626571,20.87787693296744
13019,/media/marda/TWOTB1/xBD/hurricanes/images/florence/hurricane-florence_00000009_pre_disaster.png,54,65,1,445,499,700,765,670,37.7743328574229,23.63338281311678
13020,/media/marda/TWOTB1/xBD/hurricanes/images/florence/hurricane-florence_00000009_pre_disaster.png,70,67,1,912,982,702,769,682,38.22987800950094,23.628842128618526
13021,/media/marda/TWOTB1/xBD/hurricanes/images/florence/hurricane-florence_00000009_pre_disaster.png,74,79,1,575,649,711,790,1392,49.33135434672506,37.50117200949661
13022,/media/marda/TWOTB1/xBD/hurricanes/images/florence/hurricane-florence_00000009_pre_disaster.png,47,72,1,216,263,713,785,707,47.61175050659999,22.902602710443944
13023,/media/marda/TWOTB1/xBD/hurricanes/images/florence/hurricane-florence_00000009_pre_disaster.png,139,98,1,827,966,713,811,2955,112.97117864048862,41.411339880129184
13024,/media/marda/TWOTB1/xBD/hurricanes/images/florence/hurricane-florence_00000009_pre_disaster.png,50,81,1,239,289,726,807,738,63.9300743011414,15.409929430526006
13025,/media/marda/TWOTB1/xBD/hurricanes/images/florence/hurricane-florence_00000009_pre_disaster.png,50,70,1,298,348,727,797,718,46.419335895968736,20.520122414175304
13026,/media/marda/TWOTB1/xBD/hurricanes/images/florence/hurricane-florence_00000009_pre_disaster.png,29,76,1,283,312,741,817,580,53.281792062018134,14.565328815597402
13027,/media/marda/TWOTB1/xBD/hurricanes/images/florence/hurricane-florence_00000009_pre_disaster.png,23,45,1,198,221,745,790,126,16.136133864232505,10.477733832454781
13028,/media/marda/TWOTB1/xBD/hurricanes/images/florence/hurricane-florence_00000009_pre_disaster.png,51,56,1,401,452,752,808,518,33.1891888657602,20.594299783826873
13029,/media/marda/TWOTB1/xBD/hurricanes/images/florence/hurricane-florence_00000009_pre_disaster.png,56,72,1,125,181,754,826,1182,45.95076277183437,34.85179719835637
13030,/media/marda/TWOTB1/xBD/hurricanes/images/florence/hurricane-florence_00000009_pre_disaster.png,91,84,1,654,745,758,842,1631,70.74244043482145,39.054613717866594
13031,/media/marda/TWOTB1/xBD/hurricanes/images/florence/hurricane-florence_00000009_pre_disaster.png,60,73,1,384,444,775,848,975,46.08357041404469,28.23453619033375
13032,/media/marda/TWOTB1/xBD/hurricanes/images/florence/hurricane-florence_00000009_pre_disaster.png,84,95,1,512,596,784,879,2090,66.59622530836101,42.5281653428967
13033,/media/marda/TWOTB1/xBD/hurricanes/images/florence/hurricane-florence_00000009_pre_disaster.png,37,63,1,170,207,784,847,505,35.6556234968595,19.327150594068083
13034,/media/marda/TWOTB1/xBD/hurricanes/images/florence/hurricane-florence_00000009_pre_disaster.png,57,85,1,64,121,790,875,1559,49.65207311554572,41.693753878663216
13035,/media/marda/TWOTB1/xBD/hurricanes/images/florence/hurricane-florence_00000009_pre_disaster.png,37,61,1,198,235,803,864,430,31.781999679956524,17.873536485846937
13036,/media/marda/TWOTB1/xBD/hurricanes/images/florence/hurricane-florence_00000009_pre_disaster.png,45,75,1,223,268,816,891,721,46.13827453612308,21.8383680959188
13037,/media/marda/TWOTB1/xBD/hurricanes/images/florence/hurricane-florence_00000009_pre_disaster.png,31,51,1,302,333,817,868,216,17.317707311039353,16.73891635558907
13038,/media/marda/TWOTB1/xBD/hurricanes/images/florence/hurricane-florence_00000009_pre_disaster.png,56,81,1,333,389,820,901,974,48.913513699377674,28.65129305292885
13039,/media/marda/TWOTB1/xBD/hurricanes/images/florence/hurricane-florence_00000009_pre_disaster.png,39,71,1,249,288,835,906,539,45.37186730721956,15.786520006565707
13040,/media/marda/TWOTB1/xBD/hurricanes/images/florence/hurricane-florence_00000009_pre_disaster.png,40,79,1,306,346,842,921,680,52.24550904802924,17.238095603100614
13041,/media/marda/TWOTB1/xBD/hurricanes/images/florence/hurricane-florence_00000009_pre_disaster.png,31,76,1,285,316,849,925,602,47.30027994085241,17.00465986390785
13042,/media/marda/TWOTB1/xBD/hurricanes/images/florence/hurricane-florence_00000009_pre_disaster.png,26,49,1,310,336,894,943,146,15.405310226211917,12.722204959280896
13043,/media/marda/TWOTB1/xBD/hurricanes/images/florence/hurricane-florence_00000009_pre_disaster.png,56,82,1,129,185,899,981,1668,51.32662071037872,42.96949766130156
13044,/media/marda/TWOTB1/xBD/hurricanes/images/florence/hurricane-florence_00000009_pre_disaster.png,54,67,1,675,729,950,1017,406,31.813524250242395,17.10270884560393
13045,/media/marda/TWOTB1/xBD/hurricanes/images/florence/hurricane-florence_00000009_pre_disaster.png,75,74,1,123,198,968,1042,2129,77.53640804388057,37.3373245998749
13046,/media/marda/TWOTB1/xBD/hurricanes/images/florence/hurricane-florence_00000009_pre_disaster.png,50,58,1,686,736,978,1036,260,21.1352484894008,16.462608672656728
13047,/media/marda/TWOTB1/xBD/hurricanes/images/florence/hurricane-florence_00000519_pre_disaster.png,114,52,1,250,364,174,226,2929,118.05896264964866,33.664923798299384
13048,/media/marda/TWOTB1/xBD/hurricanes/images/florence/hurricane-florence_00000519_pre_disaster.png,115,50,1,247,362,232,282,2871,119.09570243620327,32.070188922054555
13049,/media/marda/TWOTB1/xBD/hurricanes/images/florence/hurricane-florence_00000519_pre_disaster.png,15,15,1,247,262,236,251,37,7.294922604986723,6.409192553169349
13050,/media/marda/TWOTB1/xBD/hurricanes/images/florence/hurricane-florence_00000519_pre_disaster.png,111,54,1,232,343,288,342,2769,116.84723167844975,32.05246403884269
13051,/media/marda/TWOTB1/xBD/hurricanes/images/florence/hurricane-florence_00000519_pre_disaster.png,24,27,1,241,265,336,363,178,16.89947461335583,14.177334898687128
13052,/media/marda/TWOTB1/xBD/hurricanes/images/florence/hurricane-florence_00000474_pre_disaster.png,54,70,1,802,856,558,628,608,55.13851784085048,14.738322173178943
13053,/media/marda/TWOTB1/xBD/hurricanes/images/florence/hurricane-florence_00000474_pre_disaster.png,78,48,1,790,868,611,659,501,50.61354700097958,13.248751364805404
13054,/media/marda/TWOTB1/xBD/hurricanes/images/florence/hurricane-florence_00000474_pre_disaster.png,47,49,1,756,803,666,715,316,25.814558400549593,16.40256815092119
13055,/media/marda/TWOTB1/xBD/hurricanes/images/florence/hurricane-florence_00000474_pre_disaster.png,58,46,1,805,863,675,721,486,28.608905545582235,22.57608063362562
13056,/media/marda/TWOTB1/xBD/hurricanes/images/florence/hurricane-florence_00000474_pre_disaster.png,84,61,1,907,991,828,889,1067,52.41266248830778,26.79422230714613
13057,/media/marda/TWOTB1/xBD/hurricanes/images/florence/hurricane-florence_00000474_pre_disaster.png,62,52,1,970,1032,950,1002,293,24.08936527540763,16.035414865972182
13058,/media/marda/TWOTB1/xBD/hurricanes/images/florence/hurricane-florence_00000285_post_disaster.png,65,63,1,570,635,169,232,1177,59.26912812173618,28.76738805613596
13059,/media/marda/TWOTB1/xBD/hurricanes/images/florence/hurricane-florence_00000285_post_disaster.png,69,51,1,617,686,194,245,962,48.87514833706721,28.40033887960437
13060,/media/marda/TWOTB1/xBD/hurricanes/images/florence/hurricane-florence_00000285_post_disaster.png,29,17,1,561,590,233,250,38,9.288067201267252,5.597086343069893
13061,/media/marda/TWOTB1/xBD/hurricanes/images/florence/hurricane-florence_00000285_post_disaster.png,67,38,1,574,641,234,272,680,43.49548420705868,24.24758003039753
13062,/media/marda/TWOTB1/xBD/hurricanes/images/florence/hurricane-florence_00000285_post_disaster.png,86,58,1,703,789,290,348,1304,65.8420752106568,26.19978670234889
13063,/media/marda/TWOTB1/xBD/hurricanes/images/florence/hurricane-florence_00000285_post_disaster.png,76,77,1,967,1043,677,754,1007,56.49862848660276,24.172198436212543
13064,/media/marda/TWOTB1/xBD/hurricanes/images/florence/hurricane-florence_00000285_post_disaster.png,52,48,1,856,908,732,780,201,16.86775547812757,15.955188986492445
13065,/media/marda/TWOTB1/xBD/hurricanes/images/florence/hurricane-florence_00000285_post_disaster.png,50,40,1,993,1043,743,783,68,10.47849895114657,8.540379614061282
13066,/media/marda/TWOTB1/xBD/hurricanes/images/florence/hurricane-florence_00000285_post_disaster.png,50,37,1,982,1032,755,792,44,8.38091101381512,7.185844671043456
13067,/media/marda/TWOTB1/xBD/hurricanes/images/florence/hurricane-florence_00000013_post_disaster.png,16,14,1,0,16,0,14,185,17.077110804817693,14.517274169296007
13068,/media/marda/TWOTB1/xBD/hurricanes/images/florence/hurricane-florence_00000013_post_disaster.png,51,13,1,371,422,0,13,266,32.033963244208344,12.54178147605265
13069,/media/marda/TWOTB1/xBD/hurricanes/images/florence/hurricane-florence_00000013_post_disaster.png,63,29,1,410,473,0,29,924,44.88977870437211,28.128908579299107
13070,/media/marda/TWOTB1/xBD/hurricanes/images/florence/hurricane-florence_00000013_post_disaster.png,72,48,1,455,527,0,48,1709,52.29558886230524,45.084521146770705
13071,/media/marda/TWOTB1/xBD/hurricanes/images/florence/hurricane-florence_00000013_post_disaster.png,59,7,1,674,733,0,7,123,34.64187856464789,6.022717007959857
13072,/media/marda/TWOTB1/xBD/hurricanes/images/florence/hurricane-florence_00000013_post_disaster.png,74,25,1,721,795,0,25,771,44.7447136945753,23.81724422234453
13073,/media/marda/TWOTB1/xBD/hurricanes/images/florence/hurricane-florence_00000013_post_disaster.png,67,48,1,552,619,21,69,1422,46.48703153385954,40.19756906322327
13074,/media/marda/TWOTB1/xBD/hurricanes/images/florence/hurricane-florence_00000013_post_disaster.png,5,16,1,0,5,24,40,46,16.127299612625404,4.2636414256481405
13075,/media/marda/TWOTB1/xBD/hurricanes/images/florence/hurricane-florence_00000013_post_disaster.png,69,60,1,392,461,40,100,1721,52.00556030732382,45.37352536337878
13076,/media/marda/TWOTB1/xBD/hurricanes/images/florence/hurricane-florence_00000013_post_disaster.png,72,49,1,588,660,60,109,1219,54.73801629599267,30.064065104924595
13077,/media/marda/TWOTB1/xBD/hurricanes/images/florence/hurricane-florence_00000013_post_disaster.png,7,18,1,0,7,75,93,81,16.31635815713114,7.061850674707654
13078,/media/marda/TWOTB1/xBD/hurricanes/images/florence/hurricane-florence_00000013_post_disaster.png,67,55,1,345,412,78,133,1608,52.04096243655935,42.28009256131652
13079,/media/marda/TWOTB1/xBD/hurricanes/images/florence/hurricane-florence_00000013_post_disaster.png,69,52,1,527,596,82,134,1307,44.33131151473635,39.52768763548238
13080,/media/marda/TWOTB1/xBD/hurricanes/images/florence/hurricane-florence_00000013_post_disaster.png,66,57,1,490,556,101,158,1298,48.801301899446784,36.92991173455309
13081,/media/marda/TWOTB1/xBD/hurricanes/images/florence/hurricane-florence_00000013_post_disaster.png,65,50,1,307,372,106,156,1438,45.211917003050786,41.922516050053424
13082,/media/marda/TWOTB1/xBD/hurricanes/images/florence/hurricane-florence_00000013_post_disaster.png,49,53,1,0,49,116,169,1467,52.33277958663463,38.04884292712148
13083,/media/marda/TWOTB1/xBD/hurricanes/images/florence/hurricane-florence_00000013_post_disaster.png,64,58,1,451,515,127,185,1304,48.91269478917799,37.196845681056146
13084,/media/marda/TWOTB1/xBD/hurricanes/images/florence/hurricane-florence_00000013_post_disaster.png,57,57,1,272,329,129,186,1441,49.48674418093397,38.77697916816451
13085,/media/marda/TWOTB1/xBD/hurricanes/images/florence/hurricane-florence_00000013_post_disaster.png,52,54,1,47,99,132,186,1528,54.41592248181194,38.437966467379056
13086,/media/marda/TWOTB1/xBD/hurricanes/images/florence/hurricane-florence_00000013_post_disaster.png,48,55,1,93,141,148,203,1423,51.11374287563645,36.831700564635504
13087,/media/marda/TWOTB1/xBD/hurricanes/images/florence/hurricane-florence_00000013_post_disaster.png,53,63,1,235,288,151,214,1329,55.26101557034371,33.825844296918056
13088,/media/marda/TWOTB1/xBD/hurricanes/images/florence/hurricane-florence_00000013_post_disaster.png,98,91,1,380,478,152,243,3304,103.42070715454503,45.25593456196224
13089,/media/marda/TWOTB1/xBD/hurricanes/images/florence/hurricane-florence_00000013_post_disaster.png,50,52,1,133,183,167,219,1373,43.69161749099447,41.66037748437155
13090,/media/marda/TWOTB1/xBD/hurricanes/images/florence/hurricane-florence_00000013_post_disaster.png,54,53,1,185,239,178,231,1834,53.79020367361265,45.669448061363
13091,/media/marda/TWOTB1/xBD/hurricanes/images/florence/hurricane-florence_00000013_post_disaster.png,59,61,1,338,397,205,266,1304,47.00323735723969,38.64792716755111
13092,/media/marda/TWOTB1/xBD/hurricanes/images/florence/hurricane-florence_00000013_post_disaster.png,23,66,1,0,23,218,284,750,51.39131837330515,22.55701606222257
13093,/media/marda/TWOTB1/xBD/hurricanes/images/florence/hurricane-florence_00000013_post_disaster.png,45,50,1,25,70,235,285,1267,47.879578331790796,36.14994403446546
13094,/media/marda/TWOTB1/xBD/hurricanes/images/florence/hurricane-florence_00000013_post_disaster.png,61,59,1,304,365,241,300,1356,44.38004340882921,40.77730450149882
13095,/media/marda/TWOTB1/xBD/hurricanes/images/florence/hurricane-florence_00000013_post_disaster.png,53,54,1,65,118,250,304,1466,51.8951249563585,38.645937680776825
13096,/media/marda/TWOTB1/xBD/hurricanes/images/florence/hurricane-florence_00000013_post_disaster.png,54,52,1,108,162,264,316,1318,49.54771071571139,37.229464139267314
13097,/media/marda/TWOTB1/xBD/hurricanes/images/florence/hurricane-florence_00000013_post_disaster.png,66,62,1,255,321,265,327,1774,52.5729895819833,46.27850600950227
13098,/media/marda/TWOTB1/xBD/hurricanes/images/florence/hurricane-florence_00000013_post_disaster.png,51,59,1,153,204,277,336,1388,51.016181449187805,37.5102661801023
13099,/media/marda/TWOTB1/xBD/hurricanes/images/florence/hurricane-florence_00000013_post_disaster.png,50,51,1,206,256,279,330,1245,44.41199601096092,37.97516406163738
13100,/media/marda/TWOTB1/xBD/hurricanes/images/florence/hurricane-florence_00000013_post_disaster.png,35,57,1,0,35,310,367,1162,45.06276665682294,33.60055072384798
13101,/media/marda/TWOTB1/xBD/hurricanes/images/florence/hurricane-florence_00000013_post_disaster.png,40,60,1,38,78,328,388,1238,47.688038556130955,35.00380967332012
13102,/media/marda/TWOTB1/xBD/hurricanes/images/florence/hurricane-florence_00000013_post_disaster.png,43,61,1,77,120,336,397,1101,45.34445793241867,35.07014628369201
13103,/media/marda/TWOTB1/xBD/hurricanes/images/florence/hurricane-florence_00000013_post_disaster.png,50,59,1,108,158,367,426,1137,49.777065679433456,32.28479619838384
13104,/media/marda/TWOTB1/xBD/hurricanes/images/florence/hurricane-florence_00000013_post_disaster.png,21,53,1,0,21,412,465,566,36.88460115514317,20.310080378406504
13105,/media/marda/TWOTB1/xBD/hurricanes/images/florence/hurricane-florence_00000013_post_disaster.png,51,47,1,134,185,426,473,1088,48.63525352707573,30.558231862397225
13106,/media/marda/TWOTB1/xBD/hurricanes/images/florence/hurricane-florence_00000013_post_disaster.png,39,64,1,42,81,427,491,1262,49.79806242126446,35.31919387884736
13107,/media/marda/TWOTB1/xBD/hurricanes/images/florence/hurricane-florence_00000013_post_disaster.png,50,59,1,123,173,466,525,1234,43.72557537364736,39.025965050288484
13108,/media/marda/TWOTB1/xBD/hurricanes/images/florence/hurricane-florence_00000013_post_disaster.png,42,57,1,28,70,475,532,1122,43.08265645813625,35.2985137706683
13109,/media/marda/TWOTB1/xBD/hurricanes/images/florence/hurricane-florence_00000013_post_disaster.png,58,63,1,107,165,513,576,1392,53.568381736697695,35.40113242746584
13110,/media/marda/TWOTB1/xBD/hurricanes/images/florence/hurricane-florence_00000013_post_disaster.png,47,58,1,0,47,518,576,1173,48.07750638218316,32.91814128794342
13111,/media/marda/TWOTB1/xBD/hurricanes/images/florence/hurricane-florence_00000013_post_disaster.png,44,60,1,97,141,554,614,1108,42.6474706389253,35.74359183588841
13112,/media/marda/TWOTB1/xBD/hurricanes/images/florence/hurricane-florence_00000013_post_disaster.png,51,91,1,69,120,591,682,1610,57.09450323143646,39.65989424079501
13113,/media/marda/TWOTB1/xBD/hurricanes/images/florence/hurricane-florence_00000013_post_disaster.png,15,79,1,0,15,593,672,464,50.83370463907724,13.325994864757646
13114,/media/marda/TWOTB1/xBD/hurricanes/images/florence/hurricane-florence_00000013_post_disaster.png,36,72,1,25,61,605,677,1315,48.401897015921456,35.86615739188317
13115,/media/marda/TWOTB1/xBD/hurricanes/images/florence/hurricane-florence_00000330_post_disaster.png,33,12,1,191,224,0,12,228,26.639439053256318,11.879817692164467
13116,/media/marda/TWOTB1/xBD/hurricanes/images/florence/hurricane-florence_00000330_post_disaster.png,42,13,1,296,338,0,13,261,29.032995904058076,12.477743974024653
13117,/media/marda/TWOTB1/xBD/hurricanes/images/florence/hurricane-florence_00000330_post_disaster.png,32,22,1,176,208,4,26,327,26.073925822611773,16.707297579114094
13118,/media/marda/TWOTB1/xBD/hurricanes/images/florence/hurricane-florence_00000330_post_disaster.png,56,59,1,160,216,27,86,1637,62.53249358115568,37.12939925060817
13119,/media/marda/TWOTB1/xBD/hurricanes/images/florence/hurricane-florence_00000330_post_disaster.png,20,9,1,326,346,31,40,61,9.458909452539176,8.646395355010812
13120,/media/marda/TWOTB1/xBD/hurricanes/images/florence/hurricane-florence_00000330_post_disaster.png,93,43,1,917,1010,78,121,1248,57.787430800986954,30.005339253960667
13121,/media/marda/TWOTB1/xBD/hurricanes/images/florence/hurricane-florence_00000330_post_disaster.png,66,35,1,888,954,150,185,336,39.58382033187163,18.759377703813445
13122,/media/marda/TWOTB1/xBD/hurricanes/images/florence/hurricane-florence_00000330_post_disaster.png,47,33,1,527,574,170,203,500,25.90343278739231,25.327900383352915
13123,/media/marda/TWOTB1/xBD/hurricanes/images/florence/hurricane-florence_00000330_post_disaster.png,75,35,1,438,513,194,229,810,65.91186469399744,16.23339710037856
13124,/media/marda/TWOTB1/xBD/hurricanes/images/florence/hurricane-florence_00000330_post_disaster.png,62,61,1,553,615,207,268,1188,53.35616122214698,29.54878727650846
13125,/media/marda/TWOTB1/xBD/hurricanes/images/florence/hurricane-florence_00000330_post_disaster.png,75,38,1,877,952,275,313,811,42.87474653277403,24.963060683548505
13126,/media/marda/TWOTB1/xBD/hurricanes/images/florence/hurricane-florence_00000330_post_disaster.png,83,50,1,891,974,439,489,982,49.64235062963826,26.22755627869833
13127,/media/marda/TWOTB1/xBD/hurricanes/images/florence/hurricane-florence_00000330_post_disaster.png,59,34,1,894,953,486,520,210,23.918421306250504,11.768585233883389
13128,/media/marda/TWOTB1/xBD/hurricanes/images/florence/hurricane-florence_00000330_post_disaster.png,65,59,1,979,1044,656,715,704,33.490750408676185,27.823775965252853
13129,/media/marda/TWOTB1/xBD/hurricanes/images/florence/hurricane-florence_00000507_pre_disaster.png,15,30,1,180,195,567,597,90,12.890551152345214,9.40746287026625
13130,/media/marda/TWOTB1/xBD/hurricanes/images/florence/hurricane-florence_00000507_pre_disaster.png,30,39,1,197,227,581,620,418,25.37715508089904,21.908902300206645
13131,/media/marda/TWOTB1/xBD/hurricanes/images/florence/hurricane-florence_00000507_pre_disaster.png,22,30,1,158,180,584,614,163,20.689347870929325,10.413981774909269
13132,/media/marda/TWOTB1/xBD/hurricanes/images/florence/hurricane-florence_00000507_pre_disaster.png,57,37,1,137,194,628,665,528,60.80475638543277,11.608336606843315
13133,/media/marda/TWOTB1/xBD/hurricanes/images/florence/hurricane-florence_00000507_pre_disaster.png,21,37,1,299,320,748,785,73,10.456994410450253,9.302818361581979
13134,/media/marda/TWOTB1/xBD/hurricanes/images/florence/hurricane-florence_00000507_pre_disaster.png,25,41,1,291,316,775,816,128,14.922714942648918,11.55620946409084
13135,/media/marda/TWOTB1/xBD/hurricanes/images/florence/hurricane-florence_00000507_pre_disaster.png,62,63,1,286,348,828,891,955,57.728758303460545,21.940246260475657
13136,/media/marda/TWOTB1/xBD/hurricanes/images/florence/hurricane-florence_00000507_pre_disaster.png,51,77,1,391,442,829,906,1127,46.69569826735756,33.66470909822419
13137,/media/marda/TWOTB1/xBD/hurricanes/images/florence/hurricane-florence_00000213_pre_disaster.png,22,17,1,324,346,261,278,78,11.47974144543645,8.958221049969504
13138,/media/marda/TWOTB1/xBD/hurricanes/images/florence/hurricane-florence_00000213_pre_disaster.png,69,40,1,424,493,273,313,1218,57.20911924070867,28.838539442039462
13139,/media/marda/TWOTB1/xBD/hurricanes/images/florence/hurricane-florence_00000213_pre_disaster.png,62,43,1,301,363,291,334,1434,55.262408221135225,34.544515808157776
13140,/media/marda/TWOTB1/xBD/hurricanes/images/florence/hurricane-florence_00000213_pre_disaster.png,40,25,1,713,753,412,437,83,13.58322661295089,8.25511038743634
13141,/media/marda/TWOTB1/xBD/hurricanes/images/florence/hurricane-florence_00000213_pre_disaster.png,93,52,1,767,860,419,471,1808,70.76427257751955,34.04052594568855
13142,/media/marda/TWOTB1/xBD/hurricanes/images/florence/hurricane-florence_00000213_pre_disaster.png,103,55,1,588,691,420,475,2145,88.91974235469597,33.21996474829418
13143,/media/marda/TWOTB1/xBD/hurricanes/images/florence/hurricane-florence_00000213_pre_disaster.png,50,46,1,403,453,423,469,749,37.04375805321699,27.80606457969486
13144,/media/marda/TWOTB1/xBD/hurricanes/images/florence/hurricane-florence_00000213_pre_disaster.png,74,49,1,496,570,429,478,1420,60.084834278467476,31.34708427123569
13145,/media/marda/TWOTB1/xBD/hurricanes/images/florence/hurricane-florence_00000213_pre_disaster.png,59,46,1,288,347,433,479,910,52.652706366208754,23.273768760945263
13146,/media/marda/TWOTB1/xBD/hurricanes/images/florence/hurricane-florence_00000213_pre_disaster.png,43,40,1,213,256,441,481,711,39.742415202152365,23.79862162692736
13147,/media/marda/TWOTB1/xBD/hurricanes/images/florence/hurricane-florence_00000213_pre_disaster.png,87,92,1,871,958,771,863,2445,68.58870507879392,48.83678217681216
13148,/media/marda/TWOTB1/xBD/hurricanes/images/florence/hurricane-florence_00000213_pre_disaster.png,80,95,1,883,963,920,1015,2086,64.49862418999419,45.453628493826564
13149,/media/marda/TWOTB1/xBD/hurricanes/images/florence/hurricane-florence_00000038_pre_disaster.png,52,12,1,619,671,0,12,182,25.708348877984193,10.52554576400714
13150,/media/marda/TWOTB1/xBD/hurricanes/images/florence/hurricane-florence_00000038_pre_disaster.png,42,22,1,528,570,10,32,249,21.35221036732323,15.54666199783567
13151,/media/marda/TWOTB1/xBD/hurricanes/images/florence/hurricane-florence_00000038_pre_disaster.png,117,80,1,578,695,31,111,3206,103.84090577006764,46.283293266340365
13152,/media/marda/TWOTB1/xBD/hurricanes/images/florence/hurricane-florence_00000038_pre_disaster.png,60,31,1,436,496,46,77,607,48.98340422360008,16.51059775945814
13153,/media/marda/TWOTB1/xBD/hurricanes/images/florence/hurricane-florence_00000038_pre_disaster.png,36,18,1,453,489,81,99,166,22.352159353342977,9.850593256930436
13154,/media/marda/TWOTB1/xBD/hurricanes/images/florence/hurricane-florence_00000038_pre_disaster.png,25,19,1,277,302,109,128,128,17.535182537020848,9.643741410539745
13155,/media/marda/TWOTB1/xBD/hurricanes/images/florence/hurricane-florence_00000038_pre_disaster.png,38,25,1,489,527,112,137,220,19.20952573650641,15.238784966639875
13156,/media/marda/TWOTB1/xBD/hurricanes/images/florence/hurricane-florence_00000038_pre_disaster.png,69,53,1,360,429,181,234,1325,55.91668566146703,31.516626833318938
13157,/media/marda/TWOTB1/xBD/hurricanes/images/florence/hurricane-florence_00000038_pre_disaster.png,22,14,1,357,379,185,199,52,8.632155251202503,8.162954410825769
13158,/media/marda/TWOTB1/xBD/hurricanes/images/florence/hurricane-florence_00000038_pre_disaster.png,76,64,1,379,455,253,317,1814,65.06302384408042,38.18537000650667
13159,/media/marda/TWOTB1/xBD/hurricanes/images/florence/hurricane-florence_00000038_pre_disaster.png,66,54,1,586,652,336,390,1040,44.01107749463352,31.530681241237257
13160,/media/marda/TWOTB1/xBD/hurricanes/images/florence/hurricane-florence_00000038_pre_disaster.png,46,35,1,632,678,374,409,254,19.350988418088868,17.554934933401977
13161,/media/marda/TWOTB1/xBD/hurricanes/images/florence/hurricane-florence_00000038_pre_disaster.png,48,39,1,3,51,390,429,965,53.27186298333673,23.970979490922375
13162,/media/marda/TWOTB1/xBD/hurricanes/images/florence/hurricane-florence_00000038_pre_disaster.png,37,78,1,0,37,426,504,1333,63.61233284152941,29.21438965534153
13163,/media/marda/TWOTB1/xBD/hurricanes/images/florence/hurricane-florence_00000038_pre_disaster.png,52,45,1,981,1033,749,794,124,15.362158884224042,10.796958541639553
13164,/media/marda/TWOTB1/xBD/hurricanes/images/florence/hurricane-florence_00000038_pre_disaster.png,67,64,1,945,1012,791,855,521,34.527783455543144,19.828789237548158
13165,/media/marda/TWOTB1/xBD/hurricanes/images/florence/hurricane-florence_00000490_post_disaster.png,68,68,1,238,306,86,154,2453,77.14603412903702,43.92658051885559
13166,/media/marda/TWOTB1/xBD/hurricanes/images/florence/hurricane-florence_00000490_post_disaster.png,72,96,1,303,375,405,501,2518,75.96071968674426,48.622409055021926
13167,/media/marda/TWOTB1/xBD/hurricanes/images/florence/hurricane-florence_00000490_post_disaster.png,67,69,1,357,424,493,562,1461,45.709825436555775,42.005506277341
13168,/media/marda/TWOTB1/xBD/hurricanes/images/florence/hurricane-florence_00000490_post_disaster.png,71,93,1,484,555,504,597,2200,71.27672582491148,43.744746181573774
13169,/media/marda/TWOTB1/xBD/hurricanes/images/florence/hurricane-florence_00000490_post_disaster.png,11,54,1,0,11,557,611,287,35.01318423653297,11.138333916515512
13170,/media/marda/TWOTB1/xBD/hurricanes/images/florence/hurricane-florence_00000490_post_disaster.png,85,64,1,382,467,562,626,1858,76.34263581252556,36.784115498156126
13171,/media/marda/TWOTB1/xBD/hurricanes/images/florence/hurricane-florence_00000490_post_disaster.png,54,69,1,230,284,566,635,1257,43.60273882951917,40.030218885289976
13172,/media/marda/TWOTB1/xBD/hurricanes/images/florence/hurricane-florence_00000490_post_disaster.png,71,70,1,256,327,633,703,1703,59.81455470036099,38.64949485520742
13173,/media/marda/TWOTB1/xBD/hurricanes/images/florence/hurricane-florence_00000490_post_disaster.png,69,77,1,138,207,673,750,1917,56.60781262974175,45.02423569319082
13174,/media/marda/TWOTB1/xBD/hurricanes/images/florence/hurricane-florence_00000490_post_disaster.png,9,64,1,0,9,746,810,206,38.12892446885949,8.810902539951769
13175,/media/marda/TWOTB1/xBD/hurricanes/images/florence/hurricane-florence_00000490_post_disaster.png,115,131,1,474,589,835,966,3759,114.37671450542133,64.36225113985535
13176,/media/marda/TWOTB1/xBD/hurricanes/images/florence/hurricane-florence_00000490_post_disaster.png,89,91,1,136,225,841,932,3030,78.27655028803778,54.32977040373992
13177,/media/marda/TWOTB1/xBD/hurricanes/images/florence/hurricane-florence_00000490_post_disaster.png,80,103,1,82,162,891,994,2928,71.55528487875893,56.55918152530258
13178,/media/marda/TWOTB1/xBD/hurricanes/images/florence/hurricane-florence_00000490_post_disaster.png,55,62,1,532,587,929,991,636,37.73852512510665,21.6356560584378
13179,/media/marda/TWOTB1/xBD/hurricanes/images/florence/hurricane-florence_00000490_post_disaster.png,125,110,1,420,545,931,1041,4680,103.98867560588823,67.1678547201175
13180,/media/marda/TWOTB1/xBD/hurricanes/images/florence/hurricane-florence_00000490_post_disaster.png,74,17,1,614,688,0,17,516,44.354804047806205,16.84680413598843
13181,/media/marda/TWOTB1/xBD/hurricanes/images/florence/hurricane-florence_00000490_post_disaster.png,94,82,1,906,1000,104,186,2277,72.9159744692897,49.79570147664077
13182,/media/marda/TWOTB1/xBD/hurricanes/images/florence/hurricane-florence_00000490_post_disaster.png,103,68,1,732,835,283,351,2248,65.08845107065184,47.54647066601355
13183,/media/marda/TWOTB1/xBD/hurricanes/images/florence/hurricane-florence_00000490_post_disaster.png,87,103,1,674,761,329,432,2574,91.98602548944186,48.33703577485956
13184,/media/marda/TWOTB1/xBD/hurricanes/images/florence/hurricane-florence_00000490_post_disaster.png,85,72,1,632,717,399,471,1949,53.0852971038096,49.258802752258994
13185,/media/marda/TWOTB1/xBD/hurricanes/images/florence/hurricane-florence_00000490_post_disaster.png,93,78,1,796,889,463,541,2107,54.660590212780754,50.994346190346626
13186,/media/marda/TWOTB1/xBD/hurricanes/images/florence/hurricane-florence_00000059_pre_disaster.png,94,86,1,938,1032,596,682,1316,67.42440772311934,35.27847084271766
13187,/media/marda/TWOTB1/xBD/hurricanes/images/florence/hurricane-florence_00000059_pre_disaster.png,78,81,1,775,853,651,732,1413,53.24476151053055,37.78913574487084
13188,/media/marda/TWOTB1/xBD/hurricanes/images/florence/hurricane-florence_00000284_post_disaster.png,41,25,1,139,180,24,49,687,40.41480184878803,22.423425003316996
13189,/media/marda/TWOTB1/xBD/hurricanes/images/florence/hurricane-florence_00000284_post_disaster.png,22,28,1,104,126,34,62,409,29.078144607833778,18.49508012070757
13190,/media/marda/TWOTB1/xBD/hurricanes/images/florence/hurricane-florence_00000284_post_disaster.png,22,18,1,155,177,93,111,240,18.79300145984058,17.12602102446537
13191,/media/marda/TWOTB1/xBD/hurricanes/images/florence/hurricane-florence_00000284_post_disaster.png,8,19,1,0,8,193,212,120,17.281975195754296,9.16515138991168
13192,/media/marda/TWOTB1/xBD/hurricanes/images/florence/hurricane-florence_00000284_post_disaster.png,50,40,1,85,135,209,249,1128,48.77897257306396,30.345332840316484
13193,/media/marda/TWOTB1/xBD/hurricanes/images/florence/hurricane-florence_00000284_post_disaster.png,51,26,1,857,908,221,247,306,21.053831126989405,19.437475090720977
13194,/media/marda/TWOTB1/xBD/hurricanes/images/florence/hurricane-florence_00000284_post_disaster.png,14,18,1,89,103,249,267,106,12.795846674632822,10.908925195725011
13195,/media/marda/TWOTB1/xBD/hurricanes/images/florence/hurricane-florence_00000284_post_disaster.png,31,64,1,93,124,290,354,1326,62.33274338271444,28.299277129468994
13196,/media/marda/TWOTB1/xBD/hurricanes/images/florence/hurricane-florence_00000284_post_disaster.png,20,38,1,7,27,401,439,348,22.203001148830918,20.995710119767057
13197,/media/marda/TWOTB1/xBD/hurricanes/images/florence/hurricane-florence_00000284_post_disaster.png,40,68,1,28,68,416,484,1325,49.0846220969521,37.49292922322193
13198,/media/marda/TWOTB1/xBD/hurricanes/images/florence/hurricane-florence_00000284_post_disaster.png,47,56,1,520,567,672,728,658,34.25584809920946,26.762794428538772
13199,/media/marda/TWOTB1/xBD/hurricanes/images/florence/hurricane-florence_00000284_post_disaster.png,47,58,1,64,111,818,876,783,50.319566162253224,22.554771328623225
13200,/media/marda/TWOTB1/xBD/hurricanes/images/florence/hurricane-florence_00000284_post_disaster.png,22,48,1,201,223,829,877,168,15.328508355987282,14.72089100679517
13201,/media/marda/TWOTB1/xBD/hurricanes/images/florence/hurricane-florence_00000284_post_disaster.png,20,46,1,328,348,927,973,80,11.489125293076057,9.16515138991168
13202,/media/marda/TWOTB1/xBD/hurricanes/images/florence/hurricane-florence_00000284_post_disaster.png,32,80,1,524,556,933,1013,453,49.81145783770771,12.14358799231693
13203,/media/marda/TWOTB1/xBD/hurricanes/images/florence/hurricane-florence_00000284_post_disaster.png,33,63,1,314,347,942,1005,527,30.212925202366524,23.384509007658565
13204,/media/marda/TWOTB1/xBD/hurricanes/images/florence/hurricane-florence_00000284_post_disaster.png,67,56,1,537,604,964,1020,699,52.66616942380638,18.132435560720683
13205,/media/marda/TWOTB1/xBD/hurricanes/images/florence/hurricane-florence_00000304_post_disaster.png,90,60,1,792,882,0,60,2121,66.87898059734498,42.56344399877967
13206,/media/marda/TWOTB1/xBD/hurricanes/images/florence/hurricane-florence_00000304_post_disaster.png,72,33,1,871,943,69,102,559,47.68589391106164,17.028138663507203
13207,/media/marda/TWOTB1/xBD/hurricanes/images/florence/hurricane-florence_00000304_post_disaster.png,53,28,1,692,745,93,121,403,26.525454000174648,20.305118993437713
13208,/media/marda/TWOTB1/xBD/hurricanes/images/florence/hurricane-florence_00000304_post_disaster.png,54,18,1,960,1014,95,113,222,18.24691129488253,15.891314420294457
13209,/media/marda/TWOTB1/xBD/hurricanes/images/florence/hurricane-florence_00000304_post_disaster.png,61,44,1,812,873,108,152,660,42.301867614787646,20.877691046788406
13210,/media/marda/TWOTB1/xBD/hurricanes/images/florence/hurricane-florence_00000304_post_disaster.png,52,16,1,974,1026,134,150,134,13.815184113321989,12.337033448460042
13211,/media/marda/TWOTB1/xBD/hurricanes/images/florence/hurricane-florence_00000304_post_disaster.png,89,81,1,906,995,138,219,2226,81.63176739821904,36.87919803404353
13212,/media/marda/TWOTB1/xBD/hurricanes/images/florence/hurricane-florence_00000304_post_disaster.png,97,99,1,813,910,146,245,3683,94.57342273678569,51.58518890548951
13213,/media/marda/TWOTB1/xBD/hurricanes/images/florence/hurricane-florence_00000304_post_disaster.png,63,34,1,856,919,234,268,505,28.604439603548325,23.289470445962472
13214,/media/marda/TWOTB1/xBD/hurricanes/images/florence/hurricane-florence_00000304_post_disaster.png,65,37,1,712,777,288,325,574,37.818321403270566,20.292842438724783
13215,/media/marda/TWOTB1/xBD/hurricanes/images/florence/hurricane-florence_00000304_post_disaster.png,88,49,1,670,758,321,370,1253,64.33696869352619,28.4649815886124
13216,/media/marda/TWOTB1/xBD/hurricanes/images/florence/hurricane-florence_00000267_pre_disaster.png,28,37,1,218,246,428,465,181,23.312689963348756,10.396084520684633
13217,/media/marda/TWOTB1/xBD/hurricanes/images/florence/hurricane-florence_00000267_pre_disaster.png,35,42,1,194,229,460,502,374,23.844411769304383,20.96742972168948
13218,/media/marda/TWOTB1/xBD/hurricanes/images/florence/hurricane-florence_00000295_post_disaster.png,32,35,1,218,250,421,456,425,27.245726082524932,20.601608812627873
13219,/media/marda/TWOTB1/xBD/hurricanes/images/florence/hurricane-florence_00000295_post_disaster.png,31,40,1,137,168,444,484,636,30.664482834247902,27.62518322104718
13220,/media/marda/TWOTB1/xBD/hurricanes/images/florence/hurricane-florence_00000295_post_disaster.png,65,67,1,717,782,858,925,667,34.09124379890692,26.315427830821086
13221,/media/marda/TWOTB1/xBD/hurricanes/images/florence/hurricane-florence_00000295_post_disaster.png,41,53,1,689,730,985,1038,83,12.29359711884532,8.997991743810767
13222,/media/marda/TWOTB1/xBD/hurricanes/images/florence/hurricane-florence_00000295_post_disaster.png,52,47,1,608,660,996,1043,140,31.412582878478187,6.083822992893653
13223,/media/marda/TWOTB1/xBD/hurricanes/images/florence/hurricane-florence_00000524_post_disaster.png,58,60,1,143,201,0,60,1880,65.48478123173896,38.24937112252303
13224,/media/marda/TWOTB1/xBD/hurricanes/images/florence/hurricane-florence_00000524_post_disaster.png,59,39,1,312,371,0,39,1082,44.28593988617251,32.151481835728276
13225,/media/marda/TWOTB1/xBD/hurricanes/images/florence/hurricane-florence_00000524_post_disaster.png,48,79,1,301,349,370,449,1232,74.44098488736783,22.025480988314257
13226,/media/marda/TWOTB1/xBD/hurricanes/images/florence/hurricane-florence_00000524_post_disaster.png,19,84,1,146,165,440,524,986,78.48112217369025,16.739595481630555
13227,/media/marda/TWOTB1/xBD/hurricanes/images/florence/hurricane-florence_00000524_post_disaster.png,22,84,1,164,186,440,524,1092,76.36197069665963,19.09288586601505
13228,/media/marda/TWOTB1/xBD/hurricanes/images/florence/hurricane-florence_00000524_post_disaster.png,64,54,1,758,822,440,494,766,34.31461022004819,30.152191908759256
13229,/media/marda/TWOTB1/xBD/hurricanes/images/florence/hurricane-florence_00000524_post_disaster.png,16,83,1,129,145,441,524,703,76.96752898280137,12.301059093623893
13230,/media/marda/TWOTB1/xBD/hurricanes/images/florence/hurricane-florence_00000524_post_disaster.png,71,54,1,248,319,473,527,1218,66.40820550003936,24.47517080853383
13231,/media/marda/TWOTB1/xBD/hurricanes/images/florence/hurricane-florence_00000524_post_disaster.png,74,56,1,254,328,493,549,1190,70.76336299963968,22.4472998892768
13232,/media/marda/TWOTB1/xBD/hurricanes/images/florence/hurricane-florence_00000524_post_disaster.png,59,65,1,655,714,498,563,1157,48.955035241817775,32.05013621008173
13233,/media/marda/TWOTB1/xBD/hurricanes/images/florence/hurricane-florence_00000524_post_disaster.png,39,77,1,189,228,514,591,1767,64.82722518625829,36.35594819184924
13234,/media/marda/TWOTB1/xBD/hurricanes/images/florence/hurricane-florence_00000524_post_disaster.png,19,87,1,140,159,516,603,925,76.30691598664923,16.166981535328492
13235,/media/marda/TWOTB1/xBD/hurricanes/images/florence/hurricane-florence_00000524_post_disaster.png,22,86,1,157,179,516,602,1122,76.22257088247005,19.615971929361418
13236,/media/marda/TWOTB1/xBD/hurricanes/images/florence/hurricane-florence_00000524_post_disaster.png,73,57,1,261,334,517,574,1205,69.84970222703936,23.01657375150922
13237,/media/marda/TWOTB1/xBD/hurricanes/images/florence/hurricane-florence_00000524_post_disaster.png,77,53,1,901,978,522,575,949,43.83338120507313,28.345098971654
13238,/media/marda/TWOTB1/xBD/hurricanes/images/florence/hurricane-florence_00000524_post_disaster.png,67,56,1,910,977,556,612,768,34.55500407863953,29.665384313346408
13239,/media/marda/TWOTB1/xBD/hurricanes/images/florence/hurricane-florence_00000524_post_disaster.png,34,59,1,240,274,573,632,528,41.49271593902256,17.00037680238982
13240,/media/marda/TWOTB1/xBD/hurricanes/images/florence/hurricane-florence_00000524_post_disaster.png,63,55,1,190,253,588,643,807,63.4747919745817,16.9447263148185
13241,/media/marda/TWOTB1/xBD/hurricanes/images/florence/hurricane-florence_00000524_post_disaster.png,98,63,1,842,940,588,651,1668,67.36235453260707,33.77653817983055
13242,/media/marda/TWOTB1/xBD/hurricanes/images/florence/hurricane-florence_00000524_post_disaster.png,76,56,1,694,770,595,651,1451,54.123127780062774,35.63314215118047
13243,/media/marda/TWOTB1/xBD/hurricanes/images/florence/hurricane-florence_00000524_post_disaster.png,75,63,1,185,260,607,670,1314,76.3129447998802,22.9197491419508
13244,/media/marda/TWOTB1/xBD/hurricanes/images/florence/hurricane-florence_00000524_post_disaster.png,44,48,1,223,267,633,681,460,36.62420325767782,16.792024403459763
13245,/media/marda/TWOTB1/xBD/hurricanes/images/florence/hurricane-florence_00000524_post_disaster.png,55,55,1,281,336,638,693,845,44.26571128586737,25.48057271965404
13246,/media/marda/TWOTB1/xBD/hurricanes/images/florence/hurricane-florence_00000524_post_disaster.png,27,54,1,124,151,644,698,403,27.384917108613173,20.19359475613252
13247,/media/marda/TWOTB1/xBD/hurricanes/images/florence/hurricane-florence_00000524_post_disaster.png,59,54,1,612,671,646,700,756,36.96743855480017,27.166940929534796
13248,/media/marda/TWOTB1/xBD/hurricanes/images/florence/hurricane-florence_00000524_post_disaster.png,59,78,1,230,289,696,774,1887,53.54148393831442,47.00706210159477
13249,/media/marda/TWOTB1/xBD/hurricanes/images/florence/hurricane-florence_00000524_post_disaster.png,62,51,1,877,939,762,813,446,29.509835338493797,20.18844238020677
13250,/media/marda/TWOTB1/xBD/hurricanes/images/florence/hurricane-florence_00000524_post_disaster.png,61,63,1,883,944,783,846,613,34.20386784751333,23.66458539908286
13251,/media/marda/TWOTB1/xBD/hurricanes/images/florence/hurricane-florence_00000524_post_disaster.png,54,97,1,124,178,848,945,1667,68.51160476715609,33.19839798880862
13252,/media/marda/TWOTB1/xBD/hurricanes/images/florence/hurricane-florence_00000524_post_disaster.png,14,56,1,115,129,950,1006,124,18.839337170297096,9.256675143555093
13253,/media/marda/TWOTB1/xBD/hurricanes/images/florence/hurricane-florence_00000524_post_disaster.png,35,69,1,114,149,963,1032,597,30.155288310601602,26.28137139380732
13254,/media/marda/TWOTB1/xBD/hurricanes/images/florence/hurricane-florence_00000524_post_disaster.png,76,53,1,869,945,990,1043,359,46.324416046975564,10.995867463390681
13255,/media/marda/TWOTB1/xBD/hurricanes/images/florence/hurricane-florence_00000524_post_disaster.png,22,73,1,190,212,450,523,813,64.76401482327294,16.753039424602846
13256,/media/marda/TWOTB1/xBD/hurricanes/images/florence/hurricane-florence_00000524_post_disaster.png,20,71,1,204,224,451,522,604,63.57518119161183,12.66262341767942
13257,/media/marda/TWOTB1/xBD/hurricanes/images/florence/hurricane-florence_00000524_post_disaster.png,33,76,1,216,249,451,527,987,66.57230604606963,19.820219112702773
13258,/media/marda/TWOTB1/xBD/hurricanes/images/florence/hurricane-florence_00000524_post_disaster.png,37,78,1,222,259,512,590,1540,65.91731489070875,31.163302177806656
13259,/media/marda/TWOTB1/xBD/hurricanes/images/florence/hurricane-florence_00000524_post_disaster.png,89,86,1,263,352,545,631,2600,83.78572965292928,52.3000412166183
13260,/media/marda/TWOTB1/xBD/hurricanes/images/florence/hurricane-florence_00000524_post_disaster.png,62,50,1,184,246,576,626,710,63.233065527190725,14.982496410207853
13261,/media/marda/TWOTB1/xBD/hurricanes/images/florence/hurricane-florence_00000070_post_disaster.png,89,103,1,767,856,828,931,2220,61.533132383838876,48.87047904521717
13262,/media/marda/TWOTB1/xBD/hurricanes/images/florence/hurricane-florence_00000070_post_disaster.png,50,44,1,367,417,133,177,795,38.92617661947216,27.07298235744209
13263,/media/marda/TWOTB1/xBD/hurricanes/images/florence/hurricane-florence_00000070_post_disaster.png,59,60,1,157,216,237,297,1483,48.32522388600307,40.84816609249385
13264,/media/marda/TWOTB1/xBD/hurricanes/images/florence/hurricane-florence_00000070_post_disaster.png,72,56,1,256,328,315,371,1783,64.61192458125724,37.2210170461151
13265,/media/marda/TWOTB1/xBD/hurricanes/images/florence/hurricane-florence_00000070_post_disaster.png,40,50,1,332,372,331,381,707,38.654275220681114,24.26703817709374
13266,/media/marda/TWOTB1/xBD/hurricanes/images/florence/hurricane-florence_00000070_post_disaster.png,59,71,1,500,559,863,934,790,39.71043130853852,26.274427348420144
13267,/media/marda/TWOTB1/xBD/hurricanes/images/florence/hurricane-florence_00000070_post_disaster.png,53,50,1,441,494,873,923,448,39.63764204788158,15.031085942762207
13268,/media/marda/TWOTB1/xBD/hurricanes/images/florence/hurricane-florence_00000070_post_disaster.png,68,79,1,470,538,890,969,1214,46.422024500571254,37.14749507290567
13269,/media/marda/TWOTB1/xBD/hurricanes/images/florence/hurricane-florence_00000070_post_disaster.png,46,68,1,163,209,892,960,839,39.80555840482611,27.762178239839812
13270,/media/marda/TWOTB1/xBD/hurricanes/images/florence/hurricane-florence_00000070_post_disaster.png,41,66,1,445,486,898,964,374,27.679404673326,18.85970039343987
13271,/media/marda/TWOTB1/xBD/hurricanes/images/florence/hurricane-florence_00000070_post_disaster.png,25,68,1,127,152,902,970,366,34.3814610383268,14.241183649311045
13272,/media/marda/TWOTB1/xBD/hurricanes/images/florence/hurricane-florence_00000070_post_disaster.png,44,67,1,354,398,904,971,554,30.661994401868466,23.70618800386267
13273,/media/marda/TWOTB1/xBD/hurricanes/images/florence/hurricane-florence_00000070_post_disaster.png,22,56,1,112,134,912,968,256,20.404148305720454,16.823897724740842
13274,/media/marda/TWOTB1/xBD/hurricanes/images/florence/hurricane-florence_00000070_post_disaster.png,63,89,1,375,438,951,1040,1359,54.14750848934471,33.16305614820452
13275,/media/marda/TWOTB1/xBD/hurricanes/images/florence/hurricane-florence_00000443_post_disaster.png,50,84,1,295,345,794,878,1437,53.12550406248019,35.9592516384297
13276,/media/marda/TWOTB1/xBD/hurricanes/images/florence/hurricane-florence_00000443_post_disaster.png,57,74,1,0,57,835,909,2048,63.75115659442408,42.88311928156942
13277,/media/marda/TWOTB1/xBD/hurricanes/images/florence/hurricane-florence_00000443_post_disaster.png,57,69,1,307,364,858,927,1092,44.42899811870693,32.94241230798036
13278,/media/marda/TWOTB1/xBD/hurricanes/images/florence/hurricane-florence_00000443_post_disaster.png,64,68,1,436,500,858,926,1393,52.227513224124955,35.455574096984364
13279,/media/marda/TWOTB1/xBD/hurricanes/images/florence/hurricane-florence_00000443_post_disaster.png,29,47,1,408,437,876,923,195,17.281975195754296,14.966629547095765
13280,/media/marda/TWOTB1/xBD/hurricanes/images/florence/hurricane-florence_00000443_post_disaster.png,59,73,1,0,59,884,957,1729,66.27319011887442,34.81802451164029
13281,/media/marda/TWOTB1/xBD/hurricanes/images/florence/hurricane-florence_00000443_post_disaster.png,28,52,1,445,473,894,946,176,18.591331294067054,12.584212359708612
13282,/media/marda/TWOTB1/xBD/hurricanes/images/florence/hurricane-florence_00000443_post_disaster.png,132,107,1,118,250,934,1041,3747,126.29302543440724,40.32153252173523
13283,/media/marda/TWOTB1/xBD/hurricanes/images/florence/hurricane-florence_00000443_post_disaster.png,67,81,1,0,67,951,1032,2395,75.68483387878167,42.22469993276511
13284,/media/marda/TWOTB1/xBD/hurricanes/images/florence/hurricane-florence_00000443_post_disaster.png,14,51,1,109,123,981,1032,93,15.309419371564235,8.193956876016053
13285,/media/marda/TWOTB1/xBD/hurricanes/images/florence/hurricane-florence_00000443_post_disaster.png,27,56,1,127,154,987,1043,208,19.69410661994176,14.137511642728478
13286,/media/marda/TWOTB1/xBD/hurricanes/images/florence/hurricane-florence_00000521_pre_disaster.png,32,18,1,510,542,53,71,130,18.810287415656713,9.323448761474605
13287,/media/marda/TWOTB1/xBD/hurricanes/images/florence/hurricane-florence_00000358_post_disaster.png,62,44,1,484,546,99,143,972,41.30142508382255,32.938871941964436
13288,/media/marda/TWOTB1/xBD/hurricanes/images/florence/hurricane-florence_00000358_post_disaster.png,37,21,1,531,568,134,155,164,14.936956014171788,14.635805332724924
13289,/media/marda/TWOTB1/xBD/hurricanes/images/florence/hurricane-florence_00000358_post_disaster.png,52,36,1,533,585,154,190,602,30.869380027023837,25.849428075051883
13290,/media/marda/TWOTB1/xBD/hurricanes/images/florence/hurricane-florence_00000358_post_disaster.png,106,74,1,909,1015,365,439,2233,72.60796934422694,40.70631525124849
13291,/media/marda/TWOTB1/xBD/hurricanes/images/florence/hurricane-florence_00000358_post_disaster.png,84,48,1,898,982,473,521,1244,54.29245793369357,30.948504334207016
13292,/media/marda/TWOTB1/xBD/hurricanes/images/florence/hurricane-florence_00000358_post_disaster.png,58,39,1,974,1032,514,553,291,20.430764438040438,18.980140275325024
13293,/media/marda/TWOTB1/xBD/hurricanes/images/florence/hurricane-florence_00000358_post_disaster.png,33,52,1,34,67,605,657,424,33.390549113436755,16.97544018651091
13294,/media/marda/TWOTB1/xBD/hurricanes/images/florence/hurricane-florence_00000358_post_disaster.png,23,37,1,88,111,632,669,131,21.857811822809595,9.148405328482577
13295,/media/marda/TWOTB1/xBD/hurricanes/images/florence/hurricane-florence_00000358_post_disaster.png,42,66,1,0,42,670,736,722,53.35607366924691,18.156534762419202
13296,/media/marda/TWOTB1/xBD/hurricanes/images/florence/hurricane-florence_00000358_post_disaster.png,90,91,1,634,724,347,438,3793,80.8857552694572,61.67979741709931
13297,/media/marda/TWOTB1/xBD/hurricanes/images/florence/hurricane-florence_00000358_post_disaster.png,368,85,1,524,892,481,566,9686,419.27169627386536,42.706564637792425
13298,/media/marda/TWOTB1/xBD/hurricanes/images/florence/hurricane-florence_00000358_post_disaster.png,71,57,1,463,534,553,610,1543,57.80902575369349,35.28082165429324
13299,/media/marda/TWOTB1/xBD/hurricanes/images/florence/hurricane-florence_00000358_post_disaster.png,71,59,1,471,542,592,651,1447,58.214075694588885,33.58031077715929
13300,/media/marda/TWOTB1/xBD/hurricanes/images/florence/hurricane-florence_00000358_post_disaster.png,94,74,1,719,813,594,668,2337,65.53434479599555,47.71775974408024
13301,/media/marda/TWOTB1/xBD/hurricanes/images/florence/hurricane-florence_00000541_post_disaster.png,69,39,1,909,978,54,93,719,37.615616682390474,25.95858302217414
13302,/media/marda/TWOTB1/xBD/hurricanes/images/florence/hurricane-florence_00000541_post_disaster.png,69,41,1,785,854,70,111,843,42.20762908594723,26.45375170837699
13303,/media/marda/TWOTB1/xBD/hurricanes/images/florence/hurricane-florence_00000541_post_disaster.png,147,43,1,221,368,93,136,4015,154.04749630122902,34.58929800924197
13304,/media/marda/TWOTB1/xBD/hurricanes/images/florence/hurricane-florence_00000541_post_disaster.png,59,46,1,724,783,134,180,621,38.52900961971848,25.925862374091327
13305,/media/marda/TWOTB1/xBD/hurricanes/images/florence/hurricane-florence_00000541_post_disaster.png,65,56,1,117,182,273,329,1029,75.7532907466324,27.21945689251546
13306,/media/marda/TWOTB1/xBD/hurricanes/images/florence/hurricane-florence_00000541_post_disaster.png,70,58,1,812,882,354,412,638,54.24130649540473,15.700573938462005
13307,/media/marda/TWOTB1/xBD/hurricanes/images/florence/hurricane-florence_00000541_post_disaster.png,55,39,1,75,130,358,397,1053,59.23586371250829,25.00406586707964
13308,/media/marda/TWOTB1/xBD/hurricanes/images/florence/hurricane-florence_00000541_post_disaster.png,47,43,1,389,436,527,570,599,36.036186663206344,22.202834769677676
13309,/media/marda/TWOTB1/xBD/hurricanes/images/florence/hurricane-florence_00000541_post_disaster.png,30,42,1,392,422,560,602,297,25.38779482603211,15.571167124316975
13310,/media/marda/TWOTB1/xBD/hurricanes/images/florence/hurricane-florence_00000132_post_disaster.png,59,52,1,384,443,21,73,1148,49.89760054268539,31.784383388250074
13311,/media/marda/TWOTB1/xBD/hurricanes/images/florence/hurricane-florence_00000132_post_disaster.png,56,37,1,569,625,171,208,566,33.41346977481009,22.433585151751153
13312,/media/marda/TWOTB1/xBD/hurricanes/images/florence/hurricane-florence_00000132_post_disaster.png,64,62,1,549,613,425,487,1015,42.267143597762484,32.722931960367276
13313,/media/marda/TWOTB1/xBD/hurricanes/images/florence/hurricane-florence_00000132_post_disaster.png,77,54,1,895,972,426,480,849,38.10317588259493,29.42840895525524
13314,/media/marda/TWOTB1/xBD/hurricanes/images/florence/hurricane-florence_00000132_post_disaster.png,78,64,1,759,837,585,649,1024,43.70887101870924,31.286164418412394
13315,/media/marda/TWOTB1/xBD/hurricanes/images/florence/hurricane-florence_00000132_post_disaster.png,61,51,1,810,871,612,663,373,27.925284778438943,17.853038365102826
13316,/media/marda/TWOTB1/xBD/hurricanes/images/florence/hurricane-florence_00000190_pre_disaster.png,37,44,1,0,37,43,87,945,40.45219530262454,30.658846683154767
13317,/media/marda/TWOTB1/xBD/hurricanes/images/florence/hurricane-florence_00000190_pre_disaster.png,27,22,1,226,253,46,68,221,19.679639411932456,14.922355683663357
13318,/media/marda/TWOTB1/xBD/hurricanes/images/florence/hurricane-florence_00000190_pre_disaster.png,62,45,1,197,259,70,115,1263,49.11951643653408,35.193721089966196
13319,/media/marda/TWOTB1/xBD/hurricanes/images/florence/hurricane-florence_00000190_pre_disaster.png,38,32,1,167,205,129,161,506,33.19641524802243,20.015675605430925
13320,/media/marda/TWOTB1/xBD/hurricanes/images/florence/hurricane-florence_00000190_pre_disaster.png,30,15,1,368,398,183,198,183,19.463509710676067,12.243381362692555
13321,/media/marda/TWOTB1/xBD/hurricanes/images/florence/hurricane-florence_00000190_pre_disaster.png,24,31,1,370,394,197,228,275,26.448419149346687,13.768410383935814
13322,/media/marda/TWOTB1/xBD/hurricanes/images/florence/hurricane-florence_00000190_pre_disaster.png,66,27,1,384,450,204,231,854,58.25996177138456,19.54922519327666
13323,/media/marda/TWOTB1/xBD/hurricanes/images/florence/hurricane-florence_00000190_pre_disaster.png,55,34,1,491,546,207,241,881,40.843233706099966,28.403083141971162
13324,/media/marda/TWOTB1/xBD/hurricanes/images/florence/hurricane-florence_00000190_pre_disaster.png,71,38,1,802,873,209,247,1020,42.31497532549537,31.59343251016004
13325,/media/marda/TWOTB1/xBD/hurricanes/images/florence/hurricane-florence_00000190_pre_disaster.png,61,35,1,558,619,212,247,824,41.89034805570744,26.591841644801423
13326,/media/marda/TWOTB1/xBD/hurricanes/images/florence/hurricane-florence_00000190_pre_disaster.png,64,34,1,608,672,225,259,886,43.60187522288376,26.764310685766773
13327,/media/marda/TWOTB1/xBD/hurricanes/images/florence/hurricane-florence_00000190_pre_disaster.png,59,36,1,675,734,226,262,837,35.92624869295671,30.620459435106348
13328,/media/marda/TWOTB1/xBD/hurricanes/images/florence/hurricane-florence_00000190_pre_disaster.png,62,33,1,744,806,230,263,748,37.19875937561151,26.360083017420923
13329,/media/marda/TWOTB1/xBD/hurricanes/images/florence/hurricane-florence_00000190_pre_disaster.png,11,32,1,0,11,343,375,128,17.609532981597795,10.102069545767318
13330,/media/marda/TWOTB1/xBD/hurricanes/images/florence/hurricane-florence_00000190_pre_disaster.png,50,43,1,46,96,345,388,1366,56.42084745943153,32.22441266295659
13331,/media/marda/TWOTB1/xBD/hurricanes/images/florence/hurricane-florence_00000190_pre_disaster.png,66,27,1,762,828,362,389,453,40.059354747680636,14.948166412278146
13332,/media/marda/TWOTB1/xBD/hurricanes/images/florence/hurricane-florence_00000190_pre_disaster.png,65,39,1,569,634,363,402,1011,47.8251877114359,28.023112313586537
13333,/media/marda/TWOTB1/xBD/hurricanes/images/florence/hurricane-florence_00000190_pre_disaster.png,47,26,1,383,430,366,392,344,37.24993012350476,12.322686430824781
13334,/media/marda/TWOTB1/xBD/hurricanes/images/florence/hurricane-florence_00000190_pre_disaster.png,80,26,1,692,772,366,392,722,59.59287517571506,16.044022156009184
13335,/media/marda/TWOTB1/xBD/hurricanes/images/florence/hurricane-florence_00000190_pre_disaster.png,70,49,1,197,267,380,429,2107,68.78277518062431,40.10672306937247
13336,/media/marda/TWOTB1/xBD/hurricanes/images/florence/hurricane-florence_00000190_pre_disaster.png,52,101,1,0,52,385,486,1285,105.81969147473698,32.13798413219748
13337,/media/marda/TWOTB1/xBD/hurricanes/images/florence/hurricane-florence_00000190_pre_disaster.png,47,30,1,198,245,416,446,532,43.91434721828209,16.109938187099296
13338,/media/marda/TWOTB1/xBD/hurricanes/images/florence/hurricane-florence_00000190_pre_disaster.png,19,29,1,283,302,417,446,132,13.912757250478327,12.586666214908385
13339,/media/marda/TWOTB1/xBD/hurricanes/images/florence/hurricane-florence_00000190_pre_disaster.png,14,26,1,36,50,431,457,74,13.782459165531314,7.299598670676726
13340,/media/marda/TWOTB1/xBD/hurricanes/images/florence/hurricane-florence_00000190_pre_disaster.png,58,44,1,173,231,453,497,1283,57.204454396132896,29.452610443383787
13341,/media/marda/TWOTB1/xBD/hurricanes/images/florence/hurricane-florence_00000190_pre_disaster.png,29,41,1,49,78,461,502,307,33.2523499924727,12.304396617720704
13342,/media/marda/TWOTB1/xBD/hurricanes/images/florence/hurricane-florence_00000190_pre_disaster.png,43,39,1,378,421,499,538,514,32.97436746717284,20.791340017406473
13343,/media/marda/TWOTB1/xBD/hurricanes/images/florence/hurricane-florence_00000190_pre_disaster.png,20,35,1,187,207,503,538,107,14.377031349847003,9.88994730940605
13344,/media/marda/TWOTB1/xBD/hurricanes/images/florence/hurricane-florence_00000540_pre_disaster.png,61,58,1,576,637,561,619,1022,39.369078257069454,34.1981084439173
13345,/media/marda/TWOTB1/xBD/hurricanes/images/florence/hurricane-florence_00000495_pre_disaster.png,65,57,1,463,528,67,124,1885,55.288831745668574,45.32570511178117
13346,/media/marda/TWOTB1/xBD/hurricanes/images/florence/hurricane-florence_00000495_pre_disaster.png,82,74,1,832,914,445,519,1653,56.123706312698886,39.41878087965462
13347,/media/marda/TWOTB1/xBD/hurricanes/images/florence/hurricane-florence_00000495_pre_disaster.png,70,79,1,974,1044,799,878,798,49.225455913627776,22.5089827160344
13348,/media/marda/TWOTB1/xBD/hurricanes/images/florence/hurricane-florence_00000127_pre_disaster.png,48,16,1,843,891,7,23,233,18.318402100595115,16.666273250805535
13349,/media/marda/TWOTB1/xBD/hurricanes/images/florence/hurricane-florence_00000127_pre_disaster.png,54,24,1,906,960,15,39,332,26.632403471909022,17.10152678623183
13350,/media/marda/TWOTB1/xBD/hurricanes/images/florence/hurricane-florence_00000127_pre_disaster.png,49,36,1,739,788,50,86,682,39.41380593683489,23.12215416025222
13351,/media/marda/TWOTB1/xBD/hurricanes/images/florence/hurricane-florence_00000127_pre_disaster.png,58,44,1,48,106,130,174,1055,58.15512632051947,24.21726046857077
13352,/media/marda/TWOTB1/xBD/hurricanes/images/florence/hurricane-florence_00000367_post_disaster.png,93,87,1,14,107,22,109,3729,99.12985397534699,52.209809010326694
13353,/media/marda/TWOTB1/xBD/hurricanes/images/florence/hurricane-florence_00000367_post_disaster.png,79,62,1,918,997,318,380,1472,48.05755315210138,39.72522514976224
13354,/media/marda/TWOTB1/xBD/hurricanes/images/florence/hurricane-florence_00000367_post_disaster.png,51,53,1,196,247,368,421,904,41.676613488034505,28.62525829552783
13355,/media/marda/TWOTB1/xBD/hurricanes/images/florence/hurricane-florence_00000367_post_disaster.png,73,60,1,915,988,384,444,1481,51.02494811487413,38.533559163305405
13356,/media/marda/TWOTB1/xBD/hurricanes/images/florence/hurricane-florence_00000367_post_disaster.png,32,39,1,177,209,430,469,270,26.87409618674996,13.431862982154575
13357,/media/marda/TWOTB1/xBD/hurricanes/images/florence/hurricane-florence_00000367_post_disaster.png,50,59,1,148,198,445,504,1021,42.50999862834024,32.06473947245327
13358,/media/marda/TWOTB1/xBD/hurricanes/images/florence/hurricane-florence_00000367_post_disaster.png,32,52,1,163,195,495,547,393,35.178522956935424,14.931239644668068
13359,/media/marda/TWOTB1/xBD/hurricanes/images/florence/hurricane-florence_00000367_post_disaster.png,90,87,1,571,661,511,598,2165,75.53545511206174,40.321535644264515
13360,/media/marda/TWOTB1/xBD/hurricanes/images/florence/hurricane-florence_00000367_post_disaster.png,49,56,1,162,211,537,593,584,49.12775145683678,15.850637233553154
13361,/media/marda/TWOTB1/xBD/hurricanes/images/florence/hurricane-florence_00000367_post_disaster.png,81,86,1,503,584,578,664,1963,67.61437330906493,38.489897304764554
13362,/media/marda/TWOTB1/xBD/hurricanes/images/florence/hurricane-florence_00000367_post_disaster.png,72,57,1,894,966,620,677,891,39.45223060390899,29.617035300753134
13363,/media/marda/TWOTB1/xBD/hurricanes/images/florence/hurricane-florence_00000367_post_disaster.png,73,68,1,940,1013,620,688,1102,47.38160308850308,31.124042819928267
13364,/media/marda/TWOTB1/xBD/hurricanes/images/florence/hurricane-florence_00000367_post_disaster.png,78,78,1,560,638,630,708,1511,50.95720311204909,39.56510858209388
13365,/media/marda/TWOTB1/xBD/hurricanes/images/florence/hurricane-florence_00000367_post_disaster.png,50,48,1,608,658,630,678,318,22.35305277381219,19.005566733872822
13366,/media/marda/TWOTB1/xBD/hurricanes/images/florence/hurricane-florence_00000367_post_disaster.png,61,53,1,544,605,680,733,478,44.80966048578631,14.248058159188828
13367,/media/marda/TWOTB1/xBD/hurricanes/images/florence/hurricane-florence_00000367_post_disaster.png,73,68,1,816,889,692,760,921,41.10239662395347,29.435749913060924
13368,/media/marda/TWOTB1/xBD/hurricanes/images/florence/hurricane-florence_00000367_post_disaster.png,56,42,1,531,587,706,748,337,40.202771487222236,11.233625833417875
13369,/media/marda/TWOTB1/xBD/hurricanes/images/florence/hurricane-florence_00000367_post_disaster.png,62,56,1,613,675,712,768,427,42.16189602720443,13.534551817686944
13370,/media/marda/TWOTB1/xBD/hurricanes/images/florence/hurricane-florence_00000367_post_disaster.png,61,47,1,524,585,724,771,399,43.76020300006949,12.34237256237811
13371,/media/marda/TWOTB1/xBD/hurricanes/images/florence/hurricane-florence_00000367_post_disaster.png,89,91,1,681,770,726,817,1856,63.744828108418616,41.883510009102906
13372,/media/marda/TWOTB1/xBD/hurricanes/images/florence/hurricane-florence_00000367_post_disaster.png,58,71,1,582,640,727,798,829,38.32890368250493,29.30984983814445
13373,/media/marda/TWOTB1/xBD/hurricanes/images/florence/hurricane-florence_00000367_post_disaster.png,54,58,1,656,710,750,808,465,25.15000365714553,24.69063704508249
13374,/media/marda/TWOTB1/xBD/hurricanes/images/florence/hurricane-florence_00000367_post_disaster.png,50,47,1,967,1017,767,814,256,21.953390820634638,15.530944999265975
13375,/media/marda/TWOTB1/xBD/hurricanes/images/florence/hurricane-florence_00000367_post_disaster.png,57,56,1,575,632,769,825,399,39.138368711220664,13.610276289730383
13376,/media/marda/TWOTB1/xBD/hurricanes/images/florence/hurricane-florence_00000367_post_disaster.png,45,60,1,497,542,782,842,698,34.24570630225708,27.226801305423116
13377,/media/marda/TWOTB1/xBD/hurricanes/images/florence/hurricane-florence_00000367_post_disaster.png,52,71,1,561,613,798,869,568,39.12913757840588,19.37629465896381
13378,/media/marda/TWOTB1/xBD/hurricanes/images/florence/hurricane-florence_00000367_post_disaster.png,78,84,1,652,730,798,882,1412,48.077479166628464,40.41707245892261
13379,/media/marda/TWOTB1/xBD/hurricanes/images/florence/hurricane-florence_00000367_post_disaster.png,78,88,1,779,857,807,895,1188,60.23890734984649,26.38188043670038
13380,/media/marda/TWOTB1/xBD/hurricanes/images/florence/hurricane-florence_00000367_post_disaster.png,37,62,1,184,221,809,871,514,29.350458093666255,23.712609200280127
13381,/media/marda/TWOTB1/xBD/hurricanes/images/florence/hurricane-florence_00000367_post_disaster.png,72,72,1,71,143,810,882,1441,75.47459068382899,25.315218769519273
13382,/media/marda/TWOTB1/xBD/hurricanes/images/florence/hurricane-florence_00000367_post_disaster.png,46,63,1,626,672,812,875,344,31.2474753610895,17.322836980999195
13383,/media/marda/TWOTB1/xBD/hurricanes/images/florence/hurricane-florence_00000367_post_disaster.png,57,52,1,483,540,818,870,396,42.30013794615477,12.515446347630016
13384,/media/marda/TWOTB1/xBD/hurricanes/images/florence/hurricane-florence_00000367_post_disaster.png,38,44,1,625,663,840,884,99,13.56425491845788,9.83630792587812
13385,/media/marda/TWOTB1/xBD/hurricanes/images/florence/hurricane-florence_00000367_post_disaster.png,70,58,1,453,523,844,902,555,56.69732968514373,14.119262414249992
13386,/media/marda/TWOTB1/xBD/hurricanes/images/florence/hurricane-florence_00000367_post_disaster.png,59,62,1,541,600,845,907,485,43.99007013944619,14.719244791014052
13387,/media/marda/TWOTB1/xBD/hurricanes/images/florence/hurricane-florence_00000367_post_disaster.png,60,74,1,635,695,867,941,812,39.57274040124598,27.383072705128665
13388,/media/marda/TWOTB1/xBD/hurricanes/images/florence/hurricane-florence_00000367_post_disaster.png,79,75,1,839,918,871,946,979,38.320578230327094,34.085558066149524
13389,/media/marda/TWOTB1/xBD/hurricanes/images/florence/hurricane-florence_00000367_post_disaster.png,62,54,1,444,506,872,926,575,51.73939138068181,14.860543448316854
13390,/media/marda/TWOTB1/xBD/hurricanes/images/florence/hurricane-florence_00000367_post_disaster.png,63,55,1,517,580,873,928,564,47.385312075693555,15.77371732802129
13391,/media/marda/TWOTB1/xBD/hurricanes/images/florence/hurricane-florence_00000367_post_disaster.png,66,74,1,747,813,878,952,873,39.52294886695262,29.485529091651344
13392,/media/marda/TWOTB1/xBD/hurricanes/images/florence/hurricane-florence_00000367_post_disaster.png,63,65,1,425,488,892,957,838,51.29151509812637,21.74005239857405
13393,/media/marda/TWOTB1/xBD/hurricanes/images/florence/hurricane-florence_00000367_post_disaster.png,64,78,1,574,638,921,999,1011,42.592941899239975,31.80609427304611
13394,/media/marda/TWOTB1/xBD/hurricanes/images/florence/hurricane-florence_00000367_post_disaster.png,65,84,1,815,880,929,1013,895,48.81308706822948,24.41124752442148
13395,/media/marda/TWOTB1/xBD/hurricanes/images/florence/hurricane-florence_00000367_post_disaster.png,66,82,1,714,780,934,1016,933,46.03222662689114,26.613726233415875
13396,/media/marda/TWOTB1/xBD/hurricanes/images/florence/hurricane-florence_00000367_post_disaster.png,73,79,1,518,591,942,1021,1166,57.57754905868984,27.51094017564788
13397,/media/marda/TWOTB1/xBD/hurricanes/images/florence/hurricane-florence_00000367_post_disaster.png,50,61,1,466,516,943,1004,395,33.331507641499684,15.760558676173966
13398,/media/marda/TWOTB1/xBD/hurricanes/images/florence/hurricane-florence_00000367_post_disaster.png,73,78,1,939,1012,945,1023,717,43.1152723915044,22.270895381434418
13399,/media/marda/TWOTB1/xBD/hurricanes/images/florence/hurricane-florence_00000367_post_disaster.png,41,58,1,432,473,961,1019,293,24.837368953954396,15.827441845070355
13400,/media/marda/TWOTB1/xBD/hurricanes/images/florence/hurricane-florence_00000367_post_disaster.png,59,77,1,456,515,964,1041,1043,41.34478901402572,33.96997236434243
13401,/media/marda/TWOTB1/xBD/hurricanes/images/florence/hurricane-florence_00000367_post_disaster.png,54,57,1,779,833,967,1024,275,24.175647064923677,15.057701900121028
13402,/media/marda/TWOTB1/xBD/hurricanes/images/florence/hurricane-florence_00000367_post_disaster.png,37,57,1,412,449,974,1031,247,19.175244927115024,17.83444497616695
13403,/media/marda/TWOTB1/xBD/hurricanes/images/florence/hurricane-florence_00000367_post_disaster.png,64,56,1,792,856,987,1043,304,30.312344521369138,14.452989878645424
13404,/media/marda/TWOTB1/xBD/hurricanes/images/florence/hurricane-florence_00000415_pre_disaster.png,83,56,1,904,987,0,56,1193,67.7123886594048,36.81468561701703
13405,/media/marda/TWOTB1/xBD/hurricanes/images/florence/hurricane-florence_00000415_pre_disaster.png,56,34,1,878,934,18,52,677,37.65817653164366,23.786124172977452
13406,/media/marda/TWOTB1/xBD/hurricanes/images/florence/hurricane-florence_00000415_pre_disaster.png,91,55,1,856,947,68,123,2130,59.584590958955104,51.89382201163068
13407,/media/marda/TWOTB1/xBD/hurricanes/images/florence/hurricane-florence_00000415_pre_disaster.png,61,55,1,938,999,229,284,1109,52.57060487112661,27.987100569512567
13408,/media/marda/TWOTB1/xBD/hurricanes/images/florence/hurricane-florence_00000299_post_disaster.png,65,57,1,465,530,16,73,1400,60.793137052852124,30.34803395319306
13409,/media/marda/TWOTB1/xBD/hurricanes/images/florence/hurricane-florence_00000299_post_disaster.png,29,20,1,286,315,26,46,183,20.105829175004704,12.164308047313892
13410,/media/marda/TWOTB1/xBD/hurricanes/images/florence/hurricane-florence_00000299_post_disaster.png,69,57,1,389,458,45,102,1516,58.02917943720812,35.348374230061815
13411,/media/marda/TWOTB1/xBD/hurricanes/images/florence/hurricane-florence_00000299_post_disaster.png,31,20,1,377,408,73,93,176,18.121000669549296,13.089811981438102
13412,/media/marda/TWOTB1/xBD/hurricanes/images/florence/hurricane-florence_00000299_post_disaster.png,75,67,1,572,647,398,465,1477,47.42747629956522,41.78121784415372
13413,/media/marda/TWOTB1/xBD/hurricanes/images/florence/hurricane-florence_00000299_post_disaster.png,52,40,1,672,724,477,517,397,23.945490980521633,21.868483367302176
13414,/media/marda/TWOTB1/xBD/hurricanes/images/florence/hurricane-florence_00000299_post_disaster.png,72,58,1,697,769,485,543,1114,39.88900549203392,37.0995884735772
13415,/media/marda/TWOTB1/xBD/hurricanes/images/florence/hurricane-florence_00000299_post_disaster.png,78,60,1,769,847,679,739,1007,50.40757761147396,26.040338546927376
13416,/media/marda/TWOTB1/xBD/hurricanes/images/florence/hurricane-florence_00000299_post_disaster.png,44,44,1,758,802,731,775,156,14.762813057922964,14.188346847017458
13417,/media/marda/TWOTB1/xBD/hurricanes/images/florence/hurricane-florence_00000299_post_disaster.png,61,85,1,99,160,792,877,1592,58.12483074221779,36.40279840204098
13418,/media/marda/TWOTB1/xBD/hurricanes/images/florence/hurricane-florence_00000299_post_disaster.png,53,81,1,15,68,946,1027,1363,54.35562530470714,33.463601145792275
13419,/media/marda/TWOTB1/xBD/hurricanes/images/florence/hurricane-florence_00000299_post_disaster.png,7,53,1,0,7,990,1043,51,13.21604245742181,5.793429600074661
13420,/media/marda/TWOTB1/xBD/hurricanes/images/florence/hurricane-florence_00000378_post_disaster.png,40,35,1,490,530,159,194,559,34.584337970401656,21.835863892624655
13421,/media/marda/TWOTB1/xBD/hurricanes/images/florence/hurricane-florence_00000378_post_disaster.png,68,84,1,781,849,616,700,1610,62.550709635130325,34.82634106258097
13422,/media/marda/TWOTB1/xBD/hurricanes/images/florence/hurricane-florence_00000378_post_disaster.png,54,50,1,677,731,622,672,699,31.776395536008497,29.375171798235197
13423,/media/marda/TWOTB1/xBD/hurricanes/images/florence/hurricane-florence_00000378_post_disaster.png,62,57,1,510,572,657,714,1168,46.07941440203552,33.669515772115
13424,/media/marda/TWOTB1/xBD/hurricanes/images/florence/hurricane-florence_00000027_pre_disaster.png,42,53,1,122,164,463,516,630,40.44293868666956,20.805939731811016
13425,/media/marda/TWOTB1/xBD/hurricanes/images/florence/hurricane-florence_00000044_post_disaster.png,80,40,1,724,804,608,648,652,58.026003761709525,14.810990464498058
13426,/media/marda/TWOTB1/xBD/hurricanes/images/florence/hurricane-florence_00000044_post_disaster.png,81,51,1,735,816,704,755,747,52.87542255063369,21.27370714867569
13427,/media/marda/TWOTB1/xBD/hurricanes/images/florence/hurricane-florence_00000044_post_disaster.png,36,38,1,724,760,732,770,60,10.910393961102889,7.389705546094112
13428,/media/marda/TWOTB1/xBD/hurricanes/images/florence/hurricane-florence_00000044_post_disaster.png,41,40,1,738,779,756,796,109,13.47644604823127,10.940446637073277
13429,/media/marda/TWOTB1/xBD/hurricanes/images/florence/hurricane-florence_00000044_post_disaster.png,39,39,1,734,773,768,807,101,12.356149927624656,10.95108599113064
13430,/media/marda/TWOTB1/xBD/hurricanes/images/florence/hurricane-florence_00000326_pre_disaster.png,39,34,1,311,350,93,127,511,32.13670178271267,21.309133145121084
13431,/media/marda/TWOTB1/xBD/hurricanes/images/florence/hurricane-florence_00000326_pre_disaster.png,53,42,1,325,378,123,165,885,37.025588270997495,31.8856905423981
13432,/media/marda/TWOTB1/xBD/hurricanes/images/florence/hurricane-florence_00000326_pre_disaster.png,26,17,1,329,355,150,167,91,11.527930924778188,10.626228631595575
13433,/media/marda/TWOTB1/xBD/hurricanes/images/florence/hurricane-florence_00000326_pre_disaster.png,49,38,1,370,419,184,222,651,33.62889723786087,25.35060437755053
13434,/media/marda/TWOTB1/xBD/hurricanes/images/florence/hurricane-florence_00000326_pre_disaster.png,26,28,1,352,378,205,233,123,19.01651319068033,10.134782764310192
13435,/media/marda/TWOTB1/xBD/hurricanes/images/florence/hurricane-florence_00000326_pre_disaster.png,70,48,1,402,472,227,275,1091,51.55556932427393,29.25123421157223
13436,/media/marda/TWOTB1/xBD/hurricanes/images/florence/hurricane-florence_00000326_pre_disaster.png,60,31,1,869,929,293,324,314,25.371460202617488,16.56362995853363
13437,/media/marda/TWOTB1/xBD/hurricanes/images/florence/hurricane-florence_00000326_pre_disaster.png,55,61,1,412,467,321,382,978,49.06054624986446,26.632781596869787
13438,/media/marda/TWOTB1/xBD/hurricanes/images/florence/hurricane-florence_00000326_pre_disaster.png,78,60,1,820,898,324,384,937,53.54922421332648,23.355688772480192
13439,/media/marda/TWOTB1/xBD/hurricanes/images/florence/hurricane-florence_00000326_pre_disaster.png,87,70,1,554,641,409,479,1725,61.092664445895835,41.308567485045515
13440,/media/marda/TWOTB1/xBD/hurricanes/images/florence/hurricane-florence_00000326_pre_disaster.png,85,73,1,836,921,432,505,1551,56.89851280989489,38.83948987177406
13441,/media/marda/TWOTB1/xBD/hurricanes/images/florence/hurricane-florence_00000326_pre_disaster.png,34,30,1,553,587,450,480,97,13.049149194797932,10.004275348645582
13442,/media/marda/TWOTB1/xBD/hurricanes/images/florence/hurricane-florence_00000326_pre_disaster.png,68,63,1,627,695,480,543,933,49.9960696009676,24.92339483047166
13443,/media/marda/TWOTB1/xBD/hurricanes/images/florence/hurricane-florence_00000326_pre_disaster.png,63,54,1,907,970,490,544,469,31.17595147098293,21.029881404150476
13444,/media/marda/TWOTB1/xBD/hurricanes/images/florence/hurricane-florence_00000326_pre_disaster.png,85,70,1,864,949,499,569,1093,59.70086525149725,26.813151928296367
13445,/media/marda/TWOTB1/xBD/hurricanes/images/florence/hurricane-florence_00000326_pre_disaster.png,51,40,1,955,1006,627,667,120,15.552063100009164,10.353743284435827
13446,/media/marda/TWOTB1/xBD/hurricanes/images/florence/hurricane-florence_00000326_pre_disaster.png,72,79,1,500,572,634,713,1600,51.70671276609024,41.28941577359796
13447,/media/marda/TWOTB1/xBD/hurricanes/images/florence/hurricane-florence_00000326_pre_disaster.png,58,55,1,784,842,651,706,320,36.86317878281075,11.621301294456273
13448,/media/marda/TWOTB1/xBD/hurricanes/images/florence/hurricane-florence_00000326_pre_disaster.png,78,67,1,840,918,709,776,813,45.43507940678729,23.629462952320065
13449,/media/marda/TWOTB1/xBD/hurricanes/images/florence/hurricane-florence_00000326_pre_disaster.png,64,60,1,677,741,713,773,723,40.35078031267041,23.78610720417541
13450,/media/marda/TWOTB1/xBD/hurricanes/images/florence/hurricane-florence_00000326_pre_disaster.png,74,70,1,560,634,729,799,1393,53.096825891690834,35.691851110903805
13451,/media/marda/TWOTB1/xBD/hurricanes/images/florence/hurricane-florence_00000326_pre_disaster.png,47,61,1,315,362,841,902,617,37.514387183165134,21.66174705116653
13452,/media/marda/TWOTB1/xBD/hurricanes/images/florence/hurricane-florence_00000544_pre_disaster.png,126,79,1,233,359,743,822,4802,131.27272889003112,48.4391467074918
13453,/media/marda/TWOTB1/xBD/hurricanes/images/florence/hurricane-florence_00000544_pre_disaster.png,16,41,1,214,230,767,808,85,14.704831738043618,7.888173862030706
13454,/media/marda/TWOTB1/xBD/hurricanes/images/florence/hurricane-florence_00000087_post_disaster.png,79,35,1,346,425,0,35,1381,61.249431926625824,34.73655821213022
13455,/media/marda/TWOTB1/xBD/hurricanes/images/florence/hurricane-florence_00000087_post_disaster.png,52,9,1,499,551,0,9,245,36.608945285840484,9.205067263961539
13456,/media/marda/TWOTB1/xBD/hurricanes/images/florence/hurricane-florence_00000087_post_disaster.png,56,55,1,491,547,15,70,1621,60.95672893446505,36.63487263466059
13457,/media/marda/TWOTB1/xBD/hurricanes/images/florence/hurricane-florence_00000087_post_disaster.png,61,59,1,313,374,39,98,1801,60.16520040656405,40.404785917365025
13458,/media/marda/TWOTB1/xBD/hurricanes/images/florence/hurricane-florence_00000087_post_disaster.png,50,29,1,540,590,49,78,634,32.99878609338766,25.84904122964668
13459,/media/marda/TWOTB1/xBD/hurricanes/images/florence/hurricane-florence_00000087_post_disaster.png,39,18,1,393,432,58,76,263,25.526924343614784,13.90469539518031
13460,/media/marda/TWOTB1/xBD/hurricanes/images/florence/hurricane-florence_00000087_post_disaster.png,58,39,1,480,538,99,138,1127,40.81622479251096,36.8041480486422
13461,/media/marda/TWOTB1/xBD/hurricanes/images/florence/hurricane-florence_00000087_post_disaster.png,67,52,1,366,433,103,155,1261,56.67819128998457,30.052336761085325
13462,/media/marda/TWOTB1/xBD/hurricanes/images/florence/hurricane-florence_00000087_post_disaster.png,231,183,1,680,911,161,344,13675,224.55517689538252,118.6705158865782
13463,/media/marda/TWOTB1/xBD/hurricanes/images/florence/hurricane-florence_00000087_post_disaster.png,68,38,1,814,882,163,201,695,35.51912763104662,25.83350004546368
13464,/media/marda/TWOTB1/xBD/hurricanes/images/florence/hurricane-florence_00000087_post_disaster.png,68,37,1,843,911,180,217,660,35.36997119167836,24.724833420475747
13465,/media/marda/TWOTB1/xBD/hurricanes/images/florence/hurricane-florence_00000087_post_disaster.png,49,27,1,764,813,192,219,251,21.748056642752584,15.465490448525259
13466,/media/marda/TWOTB1/xBD/hurricanes/images/florence/hurricane-florence_00000087_post_disaster.png,169,132,1,377,546,303,435,8859,139.75379169034724,88.46965739271769
13467,/media/marda/TWOTB1/xBD/hurricanes/images/florence/hurricane-florence_00000087_post_disaster.png,105,144,1,73,178,345,489,7351,124.61752752888188,84.59868199232393
13468,/media/marda/TWOTB1/xBD/hurricanes/images/florence/hurricane-florence_00000087_post_disaster.png,71,61,1,552,623,377,438,1460,46.197176229760515,41.2148245670378
13469,/media/marda/TWOTB1/xBD/hurricanes/images/florence/hurricane-florence_00000087_post_disaster.png,123,160,1,211,334,380,540,10130,136.96510690075837,98.70840487008104
13470,/media/marda/TWOTB1/xBD/hurricanes/images/florence/hurricane-florence_00000087_post_disaster.png,57,52,1,986,1043,393,445,414,33.361673633297855,17.10561146706331
13471,/media/marda/TWOTB1/xBD/hurricanes/images/florence/hurricane-florence_00000087_post_disaster.png,29,28,1,405,434,427,455,83,13.059219885880433,8.469937185296656
13472,/media/marda/TWOTB1/xBD/hurricanes/images/florence/hurricane-florence_00000087_post_disaster.png,77,68,1,657,734,427,495,1392,44.55249492527905,41.67893047107785
13473,/media/marda/TWOTB1/xBD/hurricanes/images/florence/hurricane-florence_00000087_post_disaster.png,36,33,1,538,574,451,484,160,16.858115842470536,12.437500964496198
13474,/media/marda/TWOTB1/xBD/hurricanes/images/florence/hurricane-florence_00000087_post_disaster.png,21,34,1,172,193,478,512,166,16.168777030205298,13.685544254780911
13475,/media/marda/TWOTB1/xBD/hurricanes/images/florence/hurricane-florence_00000087_post_disaster.png,22,37,1,63,85,485,522,252,18.926628232547134,17.586468591897518
13476,/media/marda/TWOTB1/xBD/hurricanes/images/florence/hurricane-florence_00000087_post_disaster.png,70,64,1,760,830,488,552,980,47.33729135106155,27.625013978560116
13477,/media/marda/TWOTB1/xBD/hurricanes/images/florence/hurricane-florence_00000087_post_disaster.png,23,35,1,165,188,490,525,193,18.63377067696825,13.783523569119893
13478,/media/marda/TWOTB1/xBD/hurricanes/images/florence/hurricane-florence_00000087_post_disaster.png,107,93,1,210,317,500,593,2554,117.9433497883205,31.43165644204697
13479,/media/marda/TWOTB1/xBD/hurricanes/images/florence/hurricane-florence_00000087_post_disaster.png,66,67,1,447,513,505,572,1885,51.07936843138946,47.96158680876798
13480,/media/marda/TWOTB1/xBD/hurricanes/images/florence/hurricane-florence_00000087_post_disaster.png,61,69,1,495,556,521,590,1187,43.20999836318626,38.92665360464195
13481,/media/marda/TWOTB1/xBD/hurricanes/images/florence/hurricane-florence_00000087_post_disaster.png,20,40,1,116,136,551,591,168,20.234795185581813,11.133838549651657
13482,/media/marda/TWOTB1/xBD/hurricanes/images/florence/hurricane-florence_00000087_post_disaster.png,63,69,1,527,590,551,620,1238,44.68877186128005,38.062271155658486
13483,/media/marda/TWOTB1/xBD/hurricanes/images/florence/hurricane-florence_00000087_post_disaster.png,67,75,1,570,637,574,649,1539,48.93752852119185,41.23074210492821
13484,/media/marda/TWOTB1/xBD/hurricanes/images/florence/hurricane-florence_00000087_post_disaster.png,45,45,1,332,377,589,634,553,33.50657311176401,21.974006658269634
13485,/media/marda/TWOTB1/xBD/hurricanes/images/florence/hurricane-florence_00000087_post_disaster.png,62,70,1,621,683,594,664,1180,43.503547997713,38.12473444542996
13486,/media/marda/TWOTB1/xBD/hurricanes/images/florence/hurricane-florence_00000087_post_disaster.png,66,69,1,174,240,615,684,1350,65.75097023177409,27.122597723491456
13487,/media/marda/TWOTB1/xBD/hurricanes/images/florence/hurricane-florence_00000087_post_disaster.png,69,64,1,555,624,703,767,1251,49.57531217802615,33.42038572175227
13488,/media/marda/TWOTB1/xBD/hurricanes/images/florence/hurricane-florence_00000087_post_disaster.png,60,72,1,602,662,705,777,1162,46.81465627597774,32.68451025135938
13489,/media/marda/TWOTB1/xBD/hurricanes/images/florence/hurricane-florence_00000087_post_disaster.png,64,76,1,642,706,705,781,1325,46.81423241655484,40.093928345441526
13490,/media/marda/TWOTB1/xBD/hurricanes/images/florence/hurricane-florence_00000087_post_disaster.png,70,76,1,914,984,706,782,1408,53.96316064081799,35.21037323665767
13491,/media/marda/TWOTB1/xBD/hurricanes/images/florence/hurricane-florence_00000087_post_disaster.png,64,66,1,686,750,707,773,1111,42.04545406873148,35.07883562654403
13492,/media/marda/TWOTB1/xBD/hurricanes/images/florence/hurricane-florence_00000087_post_disaster.png,69,62,1,726,795,709,771,1060,41.39837087099285,34.30741068418857
13493,/media/marda/TWOTB1/xBD/hurricanes/images/florence/hurricane-florence_00000087_post_disaster.png,73,71,1,815,888,709,780,1338,46.19205216080641,39.050571798524466
13494,/media/marda/TWOTB1/xBD/hurricanes/images/florence/hurricane-florence_00000087_post_disaster.png,79,67,1,954,1033,742,809,1151,41.663084622167446,36.43544081859122
13495,/media/marda/TWOTB1/xBD/hurricanes/images/florence/hurricane-florence_00000087_post_disaster.png,57,74,1,511,568,802,876,1051,41.583288471513036,35.52067922346496
13496,/media/marda/TWOTB1/xBD/hurricanes/images/florence/hurricane-florence_00000087_post_disaster.png,63,68,1,560,623,818,886,1107,40.79455107654204,35.79486237310085
13497,/media/marda/TWOTB1/xBD/hurricanes/images/florence/hurricane-florence_00000087_post_disaster.png,58,76,1,606,664,823,899,1198,46.15688277033869,33.91094669220263
13498,/media/marda/TWOTB1/xBD/hurricanes/images/florence/hurricane-florence_00000087_post_disaster.png,55,79,1,696,751,828,907,1201,53.54125430375765,29.633943816203185
13499,/media/marda/TWOTB1/xBD/hurricanes/images/florence/hurricane-florence_00000087_post_disaster.png,61,76,1,647,708,833,909,1400,46.80778087952662,39.15496340616735
13500,/media/marda/TWOTB1/xBD/hurricanes/images/florence/hurricane-florence_00000087_post_disaster.png,73,69,1,811,884,834,903,1249,42.833550734787806,38.17269853686358
13501,/media/marda/TWOTB1/xBD/hurricanes/images/florence/hurricane-florence_00000087_post_disaster.png,59,83,1,516,575,914,997,1452,51.368281887606585,37.76985770570965
13502,/media/marda/TWOTB1/xBD/hurricanes/images/florence/hurricane-florence_00000087_post_disaster.png,58,82,1,564,622,923,1005,1168,47.061932701041066,32.979774915755726
13503,/media/marda/TWOTB1/xBD/hurricanes/images/florence/hurricane-florence_00000087_post_disaster.png,65,82,1,604,669,940,1022,1281,42.87430606105707,41.056338531481714
13504,/media/marda/TWOTB1/xBD/hurricanes/images/florence/hurricane-florence_00000087_post_disaster.png,68,75,1,771,839,943,1018,1222,43.95982893626745,37.40791973520137
13505,/media/marda/TWOTB1/xBD/hurricanes/images/florence/hurricane-florence_00000087_post_disaster.png,71,70,1,727,798,944,1014,1097,44.73450454248939,32.831316985976265
13506,/media/marda/TWOTB1/xBD/hurricanes/images/florence/hurricane-florence_00000087_post_disaster.png,76,68,1,815,891,944,1012,1097,44.51131459607525,33.020998054640444
13507,/media/marda/TWOTB1/xBD/hurricanes/images/florence/hurricane-florence_00000087_post_disaster.png,60,74,1,650,710,946,1020,1128,42.154462236622166,35.27510185599445
13508,/media/marda/TWOTB1/xBD/hurricanes/images/florence/hurricane-florence_00000087_post_disaster.png,65,73,1,687,752,946,1019,1104,41.63060495302701,35.68105782063691
13509,/media/marda/TWOTB1/xBD/hurricanes/images/florence/hurricane-florence_00000381_post_disaster.png,37,27,1,648,685,371,398,147,15.694209446802125,12.584596217151764
13510,/media/marda/TWOTB1/xBD/hurricanes/images/florence/hurricane-florence_00000381_post_disaster.png,52,37,1,941,993,335,372,353,27.152071662774418,17.281786145529697
13511,/media/marda/TWOTB1/xBD/hurricanes/images/florence/hurricane-florence_00000381_post_disaster.png,56,58,1,510,566,855,913,579,39.1912600860826,19.97341356110092
13512,/media/marda/TWOTB1/xBD/hurricanes/images/florence/hurricane-florence_00000381_post_disaster.png,46,87,1,104,150,895,982,1081,51.64049784211236,27.781975665801244
13513,/media/marda/TWOTB1/xBD/hurricanes/images/florence/hurricane-florence_00000381_post_disaster.png,21,56,1,70,91,941,997,267,20.303598594064855,17.19843806503203
13514,/media/marda/TWOTB1/xBD/hurricanes/images/florence/hurricane-florence_00000381_post_disaster.png,87,71,1,709,796,956,1027,1263,63.93203480771189,26.543446016456404
13515,/media/marda/TWOTB1/xBD/hurricanes/images/florence/hurricane-florence_00000381_post_disaster.png,71,76,1,534,605,965,1041,1218,46.19798580942928,34.832720422256074
13516,/media/marda/TWOTB1/xBD/hurricanes/images/florence/hurricane-florence_00000440_pre_disaster.png,51,29,1,782,833,250,279,411,23.88075980461782,22.967628363102854
13517,/media/marda/TWOTB1/xBD/hurricanes/images/florence/hurricane-florence_00000440_pre_disaster.png,74,56,1,790,864,372,428,1556,50.50343409819763,42.19623946979274
13518,/media/marda/TWOTB1/xBD/hurricanes/images/florence/hurricane-florence_00000440_pre_disaster.png,48,29,1,832,880,394,423,176,17.389301268403475,13.36265499457871
13519,/media/marda/TWOTB1/xBD/hurricanes/images/florence/hurricane-florence_00000518_post_disaster.png,86,43,1,469,555,0,43,1683,65.58236538010219,33.949077512232705
13520,/media/marda/TWOTB1/xBD/hurricanes/images/florence/hurricane-florence_00000322_pre_disaster.png,89,59,1,938,1027,298,357,1231,51.37760119306037,31.57796822226936
13521,/media/marda/TWOTB1/xBD/hurricanes/images/florence/hurricane-florence_00000322_pre_disaster.png,53,31,1,830,883,364,395,206,22.45431107085837,12.117126132161825
13522,/media/marda/TWOTB1/xBD/hurricanes/images/florence/hurricane-florence_00000322_pre_disaster.png,40,36,1,640,680,377,413,302,26.34684167923561,15.1066955588694
13523,/media/marda/TWOTB1/xBD/hurricanes/images/florence/hurricane-florence_00000322_pre_disaster.png,51,37,1,790,841,399,436,187,22.721873778386115,10.912069177647858
13524,/media/marda/TWOTB1/xBD/hurricanes/images/florence/hurricane-florence_00000322_pre_disaster.png,92,67,1,807,899,410,477,1628,61.74535462839107,35.51972863481329
13525,/media/marda/TWOTB1/xBD/hurricanes/images/florence/hurricane-florence_00000322_pre_disaster.png,35,34,1,596,631,439,473,171,19.82136039978378,11.535168701059456
13526,/media/marda/TWOTB1/xBD/hurricanes/images/florence/hurricane-florence_00000322_pre_disaster.png,57,48,1,684,741,467,515,557,30.644813887291157,24.843254920941813
13527,/media/marda/TWOTB1/xBD/hurricanes/images/florence/hurricane-florence_00000322_pre_disaster.png,44,33,1,728,772,486,519,144,14.817601918026705,12.896206038560903
13528,/media/marda/TWOTB1/xBD/hurricanes/images/florence/hurricane-florence_00000322_pre_disaster.png,44,36,1,587,631,494,530,287,24.489887586705123,15.725565088305014
13529,/media/marda/TWOTB1/xBD/hurricanes/images/florence/hurricane-florence_00000322_pre_disaster.png,70,67,1,746,816,510,577,1010,43.55747910100516,31.198507546112506
13530,/media/marda/TWOTB1/xBD/hurricanes/images/florence/hurricane-florence_00000322_pre_disaster.png,40,38,1,577,617,518,556,276,20.2419462667027,18.050781675218204
13531,/media/marda/TWOTB1/xBD/hurricanes/images/florence/hurricane-florence_00000322_pre_disaster.png,66,60,1,819,885,647,707,648,31.608277359054217,27.18231416002348
13532,/media/marda/TWOTB1/xBD/hurricanes/images/florence/hurricane-florence_00000322_pre_disaster.png,45,48,1,583,628,664,712,280,19.90503941372594,18.783449559827613
13533,/media/marda/TWOTB1/xBD/hurricanes/images/florence/hurricane-florence_00000322_pre_disaster.png,57,56,1,611,668,669,725,524,28.713190645533814,24.36387663078163
13534,/media/marda/TWOTB1/xBD/hurricanes/images/florence/hurricane-florence_00000322_pre_disaster.png,35,51,1,490,525,681,732,273,28.943539993541336,12.581604484040442
13535,/media/marda/TWOTB1/xBD/hurricanes/images/florence/hurricane-florence_00000322_pre_disaster.png,66,56,1,829,895,683,739,569,30.404638882532463,24.842134089636467
13536,/media/marda/TWOTB1/xBD/hurricanes/images/florence/hurricane-florence_00000322_pre_disaster.png,38,41,1,571,609,687,728,148,17.37391105915811,11.393984824640553
13537,/media/marda/TWOTB1/xBD/hurricanes/images/florence/hurricane-florence_00000322_pre_disaster.png,48,54,1,582,630,687,741,311,27.529979114427565,15.099068455438577
13538,/media/marda/TWOTB1/xBD/hurricanes/images/florence/hurricane-florence_00000322_pre_disaster.png,56,67,1,533,589,696,763,677,39.313442291345424,22.945984489290336
13539,/media/marda/TWOTB1/xBD/hurricanes/images/florence/hurricane-florence_00000322_pre_disaster.png,46,56,1,505,551,725,781,400,26.425549341381558,20.080237598350493
13540,/media/marda/TWOTB1/xBD/hurricanes/images/florence/hurricane-florence_00000322_pre_disaster.png,56,64,1,544,600,744,808,638,33.08723095500124,25.73616200160988
13541,/media/marda/TWOTB1/xBD/hurricanes/images/florence/hurricane-florence_00000322_pre_disaster.png,76,68,1,313,389,747,815,1663,66.94201768929689,32.637132201322615
13542,/media/marda/TWOTB1/xBD/hurricanes/images/florence/hurricane-florence_00000322_pre_disaster.png,68,74,1,496,564,759,833,1308,45.38554351331068,39.49400420352932
13543,/media/marda/TWOTB1/xBD/hurricanes/images/florence/hurricane-florence_00000322_pre_disaster.png,59,47,1,141,200,779,826,709,63.26971988225682,15.659694567852657
13544,/media/marda/TWOTB1/xBD/hurricanes/images/florence/hurricane-florence_00000322_pre_disaster.png,49,58,1,361,410,786,844,472,35.539094427425375,17.738030731793717
13545,/media/marda/TWOTB1/xBD/hurricanes/images/florence/hurricane-florence_00000322_pre_disaster.png,59,74,1,448,507,829,903,940,40.02894331909205,31.065440982232392
13546,/media/marda/TWOTB1/xBD/hurricanes/images/florence/hurricane-florence_00000322_pre_disaster.png,58,70,1,558,616,852,922,751,31.847320952901956,31.21418478026681
13547,/media/marda/TWOTB1/xBD/hurricanes/images/florence/hurricane-florence_00000322_pre_disaster.png,72,94,1,562,634,883,977,1386,61.77740679708571,40.5305066997927
13548,/media/marda/TWOTB1/xBD/hurricanes/images/florence/hurricane-florence_00000322_pre_disaster.png,27,93,1,252,279,910,1003,971,63.17120671491719,20.379467905058434
13549,/media/marda/TWOTB1/xBD/hurricanes/images/florence/hurricane-florence_00000322_pre_disaster.png,68,98,1,726,794,917,1015,1704,69.09650638017465,34.12764944388558
13550,/media/marda/TWOTB1/xBD/hurricanes/images/florence/hurricane-florence_00000322_pre_disaster.png,63,76,1,474,537,927,1003,895,40.878863697629306,29.64727948074981
13551,/media/marda/TWOTB1/xBD/hurricanes/images/florence/hurricane-florence_00000322_pre_disaster.png,69,71,1,937,1006,936,1007,937,36.39284395368704,34.14271416714135
13552,/media/marda/TWOTB1/xBD/hurricanes/images/florence/hurricane-florence_00000322_pre_disaster.png,17,43,1,216,233,978,1021,62,10.219031327149235,7.901587334048377
13553,/media/marda/TWOTB1/xBD/hurricanes/images/florence/hurricane-florence_00000322_pre_disaster.png,44,64,1,656,700,978,1042,414,31.123104448290395,17.572795408820024
13554,/media/marda/TWOTB1/xBD/hurricanes/images/florence/hurricane-florence_00000322_pre_disaster.png,71,61,1,404,475,981,1042,758,53.72364053717333,20.950177257188283
13555,/media/marda/TWOTB1/xBD/hurricanes/images/florence/hurricane-florence_00000322_pre_disaster.png,59,57,1,928,987,985,1042,335,25.807865983635924,17.30368887914498
13556,/media/marda/TWOTB1/xBD/hurricanes/images/florence/hurricane-florence_00000322_pre_disaster.png,55,50,1,756,811,994,1044,270,31.15552385479446,11.489125293076057
13557,/media/marda/TWOTB1/xBD/hurricanes/images/florence/hurricane-florence_00000322_pre_disaster.png,39,48,1,784,823,994,1042,72,10.327955589886445,9.16515138991168
13558,/media/marda/TWOTB1/xBD/hurricanes/images/florence/hurricane-florence_00000161_pre_disaster.png,29,31,1,328,357,491,522,116,19.565861898634186,7.893305876011578
13559,/media/marda/TWOTB1/xBD/hurricanes/images/florence/hurricane-florence_00000161_pre_disaster.png,157,137,1,295,452,512,649,9448,138.85224472587558,93.99107768103116
13560,/media/marda/TWOTB1/xBD/hurricanes/images/florence/hurricane-florence_00000161_pre_disaster.png,42,42,1,423,465,519,561,364,27.12460488536368,17.868112813273516
13561,/media/marda/TWOTB1/xBD/hurricanes/images/florence/hurricane-florence_00000161_pre_disaster.png,31,39,1,435,466,615,654,120,13.120898631661767,12.174190239459264
13562,/media/marda/TWOTB1/xBD/hurricanes/images/florence/hurricane-florence_00000161_pre_disaster.png,70,88,1,343,413,731,819,1981,56.86926154630223,51.3395317908862
13563,/media/marda/TWOTB1/xBD/hurricanes/images/florence/hurricane-florence_00000161_pre_disaster.png,82,73,1,703,785,840,913,1341,55.385096761859025,32.315729232771055
13564,/media/marda/TWOTB1/xBD/hurricanes/images/florence/hurricane-florence_00000161_pre_disaster.png,61,68,1,798,859,971,1039,635,30.71594424784082,27.5094491373706
13565,/media/marda/TWOTB1/xBD/hurricanes/images/florence/hurricane-florence_00000161_pre_disaster.png,49,57,1,730,779,987,1044,300,21.385330970261315,18.61201694733641
13566,/media/marda/TWOTB1/xBD/hurricanes/images/florence/hurricane-florence_00000469_pre_disaster.png,58,89,1,0,58,415,504,2520,73.42636075710391,54.5028673488195
13567,/media/marda/TWOTB1/xBD/hurricanes/images/florence/hurricane-florence_00000014_post_disaster.png,67,24,1,46,113,0,24,936,62.7005212530591,21.62117377597356
13568,/media/marda/TWOTB1/xBD/hurricanes/images/florence/hurricane-florence_00000014_post_disaster.png,41,14,1,228,269,0,14,261,29.532304746190828,12.951769040524923
13569,/media/marda/TWOTB1/xBD/hurricanes/images/florence/hurricane-florence_00000014_post_disaster.png,61,23,1,470,531,0,23,699,42.45957054561059,22.2165676767145
13570,/media/marda/TWOTB1/xBD/hurricanes/images/florence/hurricane-florence_00000014_post_disaster.png,69,39,1,518,587,0,39,1434,48.71055507432669,38.47060677212805
13571,/media/marda/TWOTB1/xBD/hurricanes/images/florence/hurricane-florence_00000014_post_disaster.png,57,10,1,803,860,0,10,130,22.990506177981594,8.656765230735537
13572,/media/marda/TWOTB1/xBD/hurricanes/images/florence/hurricane-florence_00000014_post_disaster.png,78,34,1,840,918,0,34,905,40.717709875489945,31.613508153965164
13573,/media/marda/TWOTB1/xBD/hurricanes/images/florence/hurricane-florence_00000014_post_disaster.png,87,59,1,879,966,0,59,1694,55.48903188819078,40.36096907519052
13574,/media/marda/TWOTB1/xBD/hurricanes/images/florence/hurricane-florence_00000014_post_disaster.png,68,56,1,568,636,1,57,1534,52.49581705526723,38.75616136715693
13575,/media/marda/TWOTB1/xBD/hurricanes/images/florence/hurricane-florence_00000014_post_disaster.png,68,47,1,171,239,5,52,1709,57.22430107734542,39.695516817479636
13576,/media/marda/TWOTB1/xBD/hurricanes/images/florence/hurricane-florence_00000014_post_disaster.png,53,50,1,298,351,9,59,1641,51.9897872097139,41.08528554404603
13577,/media/marda/TWOTB1/xBD/hurricanes/images/florence/hurricane-florence_00000014_post_disaster.png,63,55,1,349,412,9,64,1817,55.33153479930952,43.26863721061667
13578,/media/marda/TWOTB1/xBD/hurricanes/images/florence/hurricane-florence_00000014_post_disaster.png,73,56,1,610,683,18,74,1777,56.20204747323894,41.6984332164407
13579,/media/marda/TWOTB1/xBD/hurricanes/images/florence/hurricane-florence_00000014_post_disaster.png,89,66,1,921,1010,20,86,1710,61.91064934647599,36.99519903298769
13580,/media/marda/TWOTB1/xBD/hurricanes/images/florence/hurricane-florence_00000014_post_disaster.png,59,50,1,33,92,21,71,1800,58.69710161421387,40.27179959149536
13581,/media/marda/TWOTB1/xBD/hurricanes/images/florence/hurricane-florence_00000014_post_disaster.png,77,51,1,656,733,38,89,1782,52.16307953511155,44.68859704974015
13582,/media/marda/TWOTB1/xBD/hurricanes/images/florence/hurricane-florence_00000014_post_disaster.png,67,54,1,245,312,40,94,1649,57.96506423793317,37.48568073026849
13583,/media/marda/TWOTB1/xBD/hurricanes/images/florence/hurricane-florence_00000014_post_disaster.png,67,53,1,155,222,49,102,1982,61.60142722398404,42.460305343600915
13584,/media/marda/TWOTB1/xBD/hurricanes/images/florence/hurricane-florence_00000014_post_disaster.png,82,61,1,962,1044,50,111,1605,57.646194847386674,36.93504685549761
13585,/media/marda/TWOTB1/xBD/hurricanes/images/florence/hurricane-florence_00000014_post_disaster.png,26,9,1,448,474,52,61,78,10.579911083716063,9.697448009513476
13586,/media/marda/TWOTB1/xBD/hurricanes/images/florence/hurricane-florence_00000014_post_disaster.png,76,54,1,701,777,53,107,1622,55.842479208082494,38.16859322855619
13587,/media/marda/TWOTB1/xBD/hurricanes/images/florence/hurricane-florence_00000014_post_disaster.png,66,57,1,470,536,65,122,1722,56.136981460975946,40.46580923140709
13588,/media/marda/TWOTB1/xBD/hurricanes/images/florence/hurricane-florence_00000014_post_disaster.png,86,56,1,749,835,70,126,1833,56.57086009063429,42.43351388378542
13589,/media/marda/TWOTB1/xBD/hurricanes/images/florence/hurricane-florence_00000014_post_disaster.png,68,56,1,509,577,95,151,1635,52.68734275123218,40.96114017624427
13590,/media/marda/TWOTB1/xBD/hurricanes/images/florence/hurricane-florence_00000014_post_disaster.png,63,48,1,135,198,98,146,1735,56.58784902500288,40.601754217210846
13591,/media/marda/TWOTB1/xBD/hurricanes/images/florence/hurricane-florence_00000014_post_disaster.png,84,53,1,792,876,99,152,1594,55.70732746646613,37.38554262575429
13592,/media/marda/TWOTB1/xBD/hurricanes/images/florence/hurricane-florence_00000014_post_disaster.png,67,54,1,221,288,98,152,1979,59.02315887187629,44.18886859913795
13593,/media/marda/TWOTB1/xBD/hurricanes/images/florence/hurricane-florence_00000014_post_disaster.png,68,60,1,557,625,110,170,1517,50.95133796269452,39.79892766725345
13594,/media/marda/TWOTB1/xBD/hurricanes/images/florence/hurricane-florence_00000014_post_disaster.png,37,18,1,644,681,115,133,110,13.099481136085824,11.112242846193098
13595,/media/marda/TWOTB1/xBD/hurricanes/images/florence/hurricane-florence_00000014_post_disaster.png,87,59,1,836,923,117,176,1596,53.22044614687101,39.65368754422453
13596,/media/marda/TWOTB1/xBD/hurricanes/images/florence/hurricane-florence_00000014_post_disaster.png,72,60,1,601,673,126,186,1688,54.427081159638426,40.95211808758473
13597,/media/marda/TWOTB1/xBD/hurricanes/images/florence/hurricane-florence_00000014_post_disaster.png,45,22,1,762,807,129,151,154,17.319825027603496,11.87479153502126
13598,/media/marda/TWOTB1/xBD/hurricanes/images/florence/hurricane-florence_00000014_post_disaster.png,63,59,1,378,441,133,192,2108,57.738612684553814,48.66444707395964
13599,/media/marda/TWOTB1/xBD/hurricanes/images/florence/hurricane-florence_00000014_post_disaster.png,42,18,1,708,750,138,156,108,12.274196647300153,11.82333644078841
13600,/media/marda/TWOTB1/xBD/hurricanes/images/florence/hurricane-florence_00000014_post_disaster.png,64,57,1,119,183,139,196,1970,61.066945570706544,43.014075721028625
13601,/media/marda/TWOTB1/xBD/hurricanes/images/florence/hurricane-florence_00000014_post_disaster.png,66,60,1,260,326,140,200,1677,60.335545301551306,36.77817933098829
13602,/media/marda/TWOTB1/xBD/hurricanes/images/florence/hurricane-florence_00000014_post_disaster.png,15,44,1,0,15,142,186,344,37.675966299962624,13.756288117408884
13603,/media/marda/TWOTB1/xBD/hurricanes/images/florence/hurricane-florence_00000014_post_disaster.png,74,60,1,647,721,142,202,1643,54.12558435398116,40.050798790362734
13604,/media/marda/TWOTB1/xBD/hurricanes/images/florence/hurricane-florence_00000014_post_disaster.png,85,58,1,881,966,146,204,1523,52.644153941216125,38.290087455004866
13605,/media/marda/TWOTB1/xBD/hurricanes/images/florence/hurricane-florence_00000014_post_disaster.png,50,55,1,328,378,153,208,1566,54.07204077610758,38.227329800854825
13606,/media/marda/TWOTB1/xBD/hurricanes/images/florence/hurricane-florence_00000014_post_disaster.png,23,19,1,246,269,159,178,115,14.153723100097693,10.901254046992271
13607,/media/marda/TWOTB1/xBD/hurricanes/images/florence/hurricane-florence_00000014_post_disaster.png,77,56,1,691,768,162,218,1558,51.79310194016705,40.418693625285854
13608,/media/marda/TWOTB1/xBD/hurricanes/images/florence/hurricane-florence_00000014_post_disaster.png,87,64,1,922,1009,163,227,1702,56.835910979572674,39.403104344099084
13609,/media/marda/TWOTB1/xBD/hurricanes/images/florence/hurricane-florence_00000014_post_disaster.png,77,59,1,744,821,169,228,1346,51.71655208949737,34.91048793774347
13610,/media/marda/TWOTB1/xBD/hurricanes/images/florence/hurricane-florence_00000014_post_disaster.png,68,63,1,424,492,181,244,1859,55.885445352841884,44.118722981761294
13611,/media/marda/TWOTB1/xBD/hurricanes/images/florence/hurricane-florence_00000014_post_disaster.png,79,62,1,965,1044,193,255,1417,53.522670860416156,34.99406279684689
13612,/media/marda/TWOTB1/xBD/hurricanes/images/florence/hurricane-florence_00000014_post_disaster.png,58,49,1,99,157,195,244,1635,56.16270109663477,38.27536663386567
13613,/media/marda/TWOTB1/xBD/hurricanes/images/florence/hurricane-florence_00000014_post_disaster.png,65,64,1,471,536,198,262,1602,56.36215785900597,37.53856497801719
13614,/media/marda/TWOTB1/xBD/hurricanes/images/florence/hurricane-florence_00000014_post_disaster.png,55,63,1,166,221,199,262,1698,56.06107049526845,40.30934212280872
13615,/media/marda/TWOTB1/xBD/hurricanes/images/florence/hurricane-florence_00000014_post_disaster.png,86,67,1,779,865,202,269,1824,54.42989204034754,44.47561700770816
13616,/media/marda/TWOTB1/xBD/hurricanes/images/florence/hurricane-florence_00000014_post_disaster.png,70,69,1,516,586,212,281,1828,59.488469332361106,40.594379161024825
13617,/media/marda/TWOTB1/xBD/hurricanes/images/florence/hurricane-florence_00000014_post_disaster.png,59,63,1,212,271,219,282,1706,56.43691548678873,39.919928805491914
13618,/media/marda/TWOTB1/xBD/hurricanes/images/florence/hurricane-florence_00000014_post_disaster.png,75,73,1,560,635,229,302,2017,63.28912802093293,41.941682405923174
13619,/media/marda/TWOTB1/xBD/hurricanes/images/florence/hurricane-florence_00000014_post_disaster.png,55,64,1,259,314,236,300,1498,51.75527867370496,38.56106387429486
13620,/media/marda/TWOTB1/xBD/hurricanes/images/florence/hurricane-florence_00000014_post_disaster.png,77,66,1,606,683,246,312,1876,56.7618998349301,43.79563541120507
13621,/media/marda/TWOTB1/xBD/hurricanes/images/florence/hurricane-florence_00000014_post_disaster.png,65,63,1,301,366,253,316,1750,55.365869316050556,41.69990471016925
13622,/media/marda/TWOTB1/xBD/hurricanes/images/florence/hurricane-florence_00000014_post_disaster.png,84,56,1,802,886,264,320,1945,57.22374334776586,45.53853137346187
13623,/media/marda/TWOTB1/xBD/hurricanes/images/florence/hurricane-florence_00000014_post_disaster.png,60,67,1,352,412,269,336,1741,55.22223520283348,41.91653730779671
13624,/media/marda/TWOTB1/xBD/hurricanes/images/florence/hurricane-florence_00000014_post_disaster.png,39,24,1,503,542,275,299,173,18.044480726195147,12.881304516365795
13625,/media/marda/TWOTB1/xBD/hurricanes/images/florence/hurricane-florence_00000014_post_disaster.png,81,44,1,664,745,282,326,1720,59.12195614608673,38.541451584117496
13626,/media/marda/TWOTB1/xBD/hurricanes/images/florence/hurricane-florence_00000014_post_disaster.png,67,64,1,392,459,288,352,1763,55.496223085345534,41.91769392072863
13627,/media/marda/TWOTB1/xBD/hurricanes/images/florence/hurricane-florence_00000014_post_disaster.png,60,55,1,65,125,290,345,1637,58.065254005252775,37.340370758019446
13628,/media/marda/TWOTB1/xBD/hurricanes/images/florence/hurricane-florence_00000014_post_disaster.png,48,24,1,980,1028,309,333,119,13.724491206533829,11.409185698310319
13629,/media/marda/TWOTB1/xBD/hurricanes/images/florence/hurricane-florence_00000014_post_disaster.png,64,62,1,442,506,310,372,1474,52.328550472092466,37.57733459964535
13630,/media/marda/TWOTB1/xBD/hurricanes/images/florence/hurricane-florence_00000014_post_disaster.png,51,70,1,993,1044,315,385,504,69.42492471909539,10.934016537605736
13631,/media/marda/TWOTB1/xBD/hurricanes/images/florence/hurricane-florence_00000014_post_disaster.png,51,56,1,126,177,316,372,1311,43.33095283846622,40.272685728352116
13632,/media/marda/TWOTB1/xBD/hurricanes/images/florence/hurricane-florence_00000014_post_disaster.png,67,73,1,489,556,318,391,1749,58.71592227222855,39.22944721460449
13633,/media/marda/TWOTB1/xBD/hurricanes/images/florence/hurricane-florence_00000014_post_disaster.png,77,63,1,951,1028,322,385,1668,53.20489141400484,41.09672673516823
13634,/media/marda/TWOTB1/xBD/hurricanes/images/florence/hurricane-florence_00000014_post_disaster.png,76,63,1,899,975,323,386,1794,54.084860908270464,43.816417614624335
13635,/media/marda/TWOTB1/xBD/hurricanes/images/florence/hurricane-florence_00000014_post_disaster.png,73,63,1,854,927,325,388,1640,53.14558206119792,40.430621368701296
13636,/media/marda/TWOTB1/xBD/hurricanes/images/florence/hurricane-florence_00000014_post_disaster.png,70,65,1,801,871,327,392,1821,57.20409770620734,42.03969198475962
13637,/media/marda/TWOTB1/xBD/hurricanes/images/florence/hurricane-florence_00000014_post_disaster.png,57,68,1,170,227,332,400,1823,56.70030372039794,42.35162025844543
13638,/media/marda/TWOTB1/xBD/hurricanes/images/florence/hurricane-florence_00000014_post_disaster.png,63,66,1,645,708,333,399,1886,58.161683708913976,42.835324763635874
13639,/media/marda/TWOTB1/xBD/hurricanes/images/florence/hurricane-florence_00000014_post_disaster.png,18,26,1,98,116,334,360,119,15.449587570867383,10.304297363303382
13640,/media/marda/TWOTB1/xBD/hurricanes/images/florence/hurricane-florence_00000014_post_disaster.png,63,64,1,543,606,334,398,1758,54.36642313829735,42.66333319960307
13641,/media/marda/TWOTB1/xBD/hurricanes/images/florence/hurricane-florence_00000014_post_disaster.png,64,62,1,696,760,334,396,1532,52.74048124082625,38.387888043599716
13642,/media/marda/TWOTB1/xBD/hurricanes/images/florence/hurricane-florence_00000014_post_disaster.png,60,65,1,46,106,335,400,1902,57.17728899207834,43.84344110299209
13643,/media/marda/TWOTB1/xBD/hurricanes/images/florence/hurricane-florence_00000014_post_disaster.png,62,63,1,597,659,338,401,1596,54.231832273993994,38.62446550973711
13644,/media/marda/TWOTB1/xBD/hurricanes/images/florence/hurricane-florence_00000014_post_disaster.png,62,68,1,264,326,370,438,1781,55.47463584619493,42.35518624494854
13645,/media/marda/TWOTB1/xBD/hurricanes/images/florence/hurricane-florence_00000014_post_disaster.png,62,63,1,111,173,382,445,1857,57.37286696841567,42.451041339653905
13646,/media/marda/TWOTB1/xBD/hurricanes/images/florence/hurricane-florence_00000014_post_disaster.png,60,56,1,28,88,387,443,1518,56.71916449635888,36.00270303053864
13647,/media/marda/TWOTB1/xBD/hurricanes/images/florence/hurricane-florence_00000014_post_disaster.png,62,66,1,308,370,390,456,1646,57.36500783891467,37.79486847572445
13648,/media/marda/TWOTB1/xBD/hurricanes/images/florence/hurricane-florence_00000014_post_disaster.png,62,71,1,356,418,403,474,1493,53.3968248451739,37.26125426996105
13649,/media/marda/TWOTB1/xBD/hurricanes/images/florence/hurricane-florence_00000014_post_disaster.png,67,72,1,398,465,420,492,1762,56.2305773939998,41.3933299912541
13650,/media/marda/TWOTB1/xBD/hurricanes/images/florence/hurricane-florence_00000014_post_disaster.png,65,72,1,448,513,437,509,1685,55.174629596518244,40.12370600905367
13651,/media/marda/TWOTB1/xBD/hurricanes/images/florence/hurricane-florence_00000014_post_disaster.png,64,70,1,102,166,438,508,1788,59.77561041171196,39.88608325091284
13652,/media/marda/TWOTB1/xBD/hurricanes/images/florence/hurricane-florence_00000014_post_disaster.png,67,65,1,276,343,442,507,1693,56.757516580482786,39.55946024102691
13653,/media/marda/TWOTB1/xBD/hurricanes/images/florence/hurricane-florence_00000014_post_disaster.png,50,64,1,994,1044,443,507,454,54.992979148567755,10.943539929733747
13654,/media/marda/TWOTB1/xBD/hurricanes/images/florence/hurricane-florence_00000014_post_disaster.png,74,71,1,947,1021,445,516,1793,58.60450764592658,40.31450524702771
13655,/media/marda/TWOTB1/xBD/hurricanes/images/florence/hurricane-florence_00000014_post_disaster.png,73,68,1,897,970,446,514,1617,55.44078556986038,38.09722075253346
13656,/media/marda/TWOTB1/xBD/hurricanes/images/florence/hurricane-florence_00000014_post_disaster.png,74,68,1,849,923,447,515,1647,53.09694310012283,40.97458623462787
13657,/media/marda/TWOTB1/xBD/hurricanes/images/florence/hurricane-florence_00000014_post_disaster.png,57,53,1,25,82,449,502,1520,57.85238360265218,35.084526853172356
13658,/media/marda/TWOTB1/xBD/hurricanes/images/florence/hurricane-florence_00000014_post_disaster.png,66,74,1,498,564,450,524,1849,57.658710873525166,42.184055593297714
13659,/media/marda/TWOTB1/xBD/hurricanes/images/florence/hurricane-florence_00000014_post_disaster.png,71,67,1,798,869,450,517,1834,56.50155938174225,42.99167419422735
13660,/media/marda/TWOTB1/xBD/hurricanes/images/florence/hurricane-florence_00000014_post_disaster.png,68,67,1,752,820,451,518,1670,53.2994232698435,41.34129694001302
13661,/media/marda/TWOTB1/xBD/hurricanes/images/florence/hurricane-florence_00000014_post_disaster.png,66,68,1,701,767,456,524,1803,56.25289576122012,42.138860263306945
13662,/media/marda/TWOTB1/xBD/hurricanes/images/florence/hurricane-florence_00000014_post_disaster.png,60,69,1,554,614,457,526,1563,54.66903441016744,37.84595763743446
13663,/media/marda/TWOTB1/xBD/hurricanes/images/florence/hurricane-florence_00000014_post_disaster.png,65,69,1,653,718,458,527,1768,56.246680103808536,41.50423079712172
13664,/media/marda/TWOTB1/xBD/hurricanes/images/florence/hurricane-florence_00000014_post_disaster.png,63,69,1,602,665,459,528,1901,57.955230703608116,43.328338780800046
13665,/media/marda/TWOTB1/xBD/hurricanes/images/florence/hurricane-florence_00000014_post_disaster.png,61,73,1,225,286,473,546,1758,54.98106159128076,42.14073534846479
13666,/media/marda/TWOTB1/xBD/hurricanes/images/florence/hurricane-florence_00000014_post_disaster.png,62,74,1,164,226,474,548,1826,57.39665747991357,41.9994840631979
13667,/media/marda/TWOTB1/xBD/hurricanes/images/florence/hurricane-florence_00000014_post_disaster.png,20,30,1,119,139,490,520,121,14.41982147082763,11.13828407808584
13668,/media/marda/TWOTB1/xBD/hurricanes/images/florence/hurricane-florence_00000014_post_disaster.png,59,77,1,49,108,490,567,1775,57.95673026423432,40.79938553467168
13669,/media/marda/TWOTB1/xBD/hurricanes/images/florence/hurricane-florence_00000014_post_disaster.png,26,29,1,365,391,495,524,120,15.569200364822851,10.02640957117197
13670,/media/marda/TWOTB1/xBD/hurricanes/images/florence/hurricane-florence_00000014_post_disaster.png,32,31,1,432,464,499,530,117,16.31063875711025,9.511573988539716
13671,/media/marda/TWOTB1/xBD/hurricanes/images/florence/hurricane-florence_00000014_post_disaster.png,32,30,1,486,518,504,534,98,14.795204869607552,8.910253928457351
13672,/media/marda/TWOTB1/xBD/hurricanes/images/florence/hurricane-florence_00000014_post_disaster.png,31,29,1,549,580,511,540,86,12.57236155777951,9.023829856680456
13673,/media/marda/TWOTB1/xBD/hurricanes/images/florence/hurricane-florence_00000014_post_disaster.png,55,64,1,989,1044,521,585,562,47.94712464490115,15.71784237315136
13674,/media/marda/TWOTB1/xBD/hurricanes/images/florence/hurricane-florence_00000014_post_disaster.png,68,76,1,745,813,523,599,1873,57.61624636155821,42.71238950832589
13675,/media/marda/TWOTB1/xBD/hurricanes/images/florence/hurricane-florence_00000014_post_disaster.png,74,70,1,891,965,523,593,1755,55.25304056074791,41.71249497589848
13676,/media/marda/TWOTB1/xBD/hurricanes/images/florence/hurricane-florence_00000014_post_disaster.png,72,69,1,943,1015,524,593,1522,52.55012146212017,38.228919198810615
13677,/media/marda/TWOTB1/xBD/hurricanes/images/florence/hurricane-florence_00000014_post_disaster.png,73,69,1,845,918,527,596,1630,52.91544033369161,40.30697313192071
13678,/media/marda/TWOTB1/xBD/hurricanes/images/florence/hurricane-florence_00000014_post_disaster.png,67,70,1,797,864,529,599,1610,56.541378029956476,37.4719689220035
13679,/media/marda/TWOTB1/xBD/hurricanes/images/florence/hurricane-florence_00000014_post_disaster.png,64,73,1,647,711,532,605,1864,56.41017919877312,43.25936046854977
13680,/media/marda/TWOTB1/xBD/hurricanes/images/florence/hurricane-florence_00000014_post_disaster.png,56,80,1,403,459,534,614,2021,61.72713446695262,42.64278652276112
13681,/media/marda/TWOTB1/xBD/hurricanes/images/florence/hurricane-florence_00000014_post_disaster.png,64,70,1,699,763,534,604,1508,53.09391839633698,37.41047344044144
13682,/media/marda/TWOTB1/xBD/hurricanes/images/florence/hurricane-florence_00000014_post_disaster.png,57,75,1,453,510,537,612,1919,58.50882021437586,43.01607768875473
13683,/media/marda/TWOTB1/xBD/hurricanes/images/florence/hurricane-florence_00000014_post_disaster.png,61,68,1,601,662,538,606,1476,50.72305247407845,38.20600651922495
13684,/media/marda/TWOTB1/xBD/hurricanes/images/florence/hurricane-florence_00000014_post_disaster.png,52,70,1,98,150,539,609,1360,52.52594476730675,34.45504224334114
13685,/media/marda/TWOTB1/xBD/hurricanes/images/florence/hurricane-florence_00000014_post_disaster.png,56,67,1,553,609,541,608,1474,51.11617473902805,37.69442632552028
13686,/media/marda/TWOTB1/xBD/hurricanes/images/florence/hurricane-florence_00000014_post_disaster.png,55,69,1,504,559,542,611,1430,51.91449119966187,36.04952941249718
13687,/media/marda/TWOTB1/xBD/hurricanes/images/florence/hurricane-florence_00000014_post_disaster.png,50,75,1,309,359,547,622,1649,56.85120440337444,38.45949649472294
13688,/media/marda/TWOTB1/xBD/hurricanes/images/florence/hurricane-florence_00000014_post_disaster.png,47,70,1,358,405,547,617,1531,53.90351107958536,37.307267519398735
13689,/media/marda/TWOTB1/xBD/hurricanes/images/florence/hurricane-florence_00000014_post_disaster.png,42,73,1,159,201,548,621,1832,57.208172960755334,41.86702126853019
13690,/media/marda/TWOTB1/xBD/hurricanes/images/florence/hurricane-florence_00000014_post_disaster.png,46,68,1,260,306,551,619,1448,49.86399002585468,38.35813087236935
13691,/media/marda/TWOTB1/xBD/hurricanes/images/florence/hurricane-florence_00000014_post_disaster.png,46,68,1,209,255,553,621,1497,49.13226752942143,40.44132238626468
13692,/media/marda/TWOTB1/xBD/hurricanes/images/florence/hurricane-florence_00000014_post_disaster.png,18,61,1,0,18,585,646,415,35.787954750924,17.96335032987655
13693,/media/marda/TWOTB1/xBD/hurricanes/images/florence/hurricane-florence_00000014_post_disaster.png,57,77,1,4,61,626,703,1629,58.48522189464004,36.76204165245785
13694,/media/marda/TWOTB1/xBD/hurricanes/images/florence/hurricane-florence_00000014_post_disaster.png,60,72,1,984,1044,642,714,875,51.78926612744157,22.562168086346293
13695,/media/marda/TWOTB1/xBD/hurricanes/images/florence/hurricane-florence_00000014_post_disaster.png,75,82,1,890,965,645,727,2012,61.83980042364017,42.69370555198092
13696,/media/marda/TWOTB1/xBD/hurricanes/images/florence/hurricane-florence_00000014_post_disaster.png,74,81,1,938,1012,645,726,1929,60.53461838551589,41.758387860135436
13697,/media/marda/TWOTB1/xBD/hurricanes/images/florence/hurricane-florence_00000014_post_disaster.png,70,80,1,843,913,648,728,1895,59.31993804759796,41.93502200880591
13698,/media/marda/TWOTB1/xBD/hurricanes/images/florence/hurricane-florence_00000014_post_disaster.png,56,82,1,55,111,651,733,1868,57.46363441307463,42.554574535599045
13699,/media/marda/TWOTB1/xBD/hurricanes/images/florence/hurricane-florence_00000014_post_disaster.png,70,73,1,792,862,652,725,1731,53.84519820924473,42.543159050285226
13700,/media/marda/TWOTB1/xBD/hurricanes/images/florence/hurricane-florence_00000014_post_disaster.png,65,64,1,744,809,653,717,1329,44.29039477009154,40.36427758439764
13701,/media/marda/TWOTB1/xBD/hurricanes/images/florence/hurricane-florence_00000014_post_disaster.png,64,76,1,695,759,654,730,1587,54.62312479393667,38.553795465567084
13702,/media/marda/TWOTB1/xBD/hurricanes/images/florence/hurricane-florence_00000014_post_disaster.png,63,81,1,646,709,656,737,1931,59.25457518028108,42.64683618215738
13703,/media/marda/TWOTB1/xBD/hurricanes/images/florence/hurricane-florence_00000014_post_disaster.png,64,77,1,596,660,658,735,1829,56.2730627009133,43.28392971552083
13704,/media/marda/TWOTB1/xBD/hurricanes/images/florence/hurricane-florence_00000014_post_disaster.png,56,78,1,552,608,659,737,1580,54.63847334579155,38.21224737243694
13705,/media/marda/TWOTB1/xBD/hurricanes/images/florence/hurricane-florence_00000014_post_disaster.png,58,76,1,500,558,663,739,1738,56.107772296231,40.84955699728251
13706,/media/marda/TWOTB1/xBD/hurricanes/images/florence/hurricane-florence_00000014_post_disaster.png,56,75,1,403,459,666,741,1761,55.31917502017934,41.81198336049651
13707,/media/marda/TWOTB1/xBD/hurricanes/images/florence/hurricane-florence_00000014_post_disaster.png,55,75,1,452,507,666,741,1828,56.57352046168395,42.58933212880596
13708,/media/marda/TWOTB1/xBD/hurricanes/images/florence/hurricane-florence_00000014_post_disaster.png,49,83,1,259,308,669,752,1947,60.76910535156783,42.18333216575121
13709,/media/marda/TWOTB1/xBD/hurricanes/images/florence/hurricane-florence_00000014_post_disaster.png,50,81,1,355,405,669,750,1941,60.045207327208544,42.21159973980344
13710,/media/marda/TWOTB1/xBD/hurricanes/images/florence/hurricane-florence_00000014_post_disaster.png,51,82,1,106,157,670,752,1917,59.51367778577341,41.97324440903905
13711,/media/marda/TWOTB1/xBD/hurricanes/images/florence/hurricane-florence_00000014_post_disaster.png,48,79,1,308,356,672,751,1531,55.302850205558514,37.62913950200182
13712,/media/marda/TWOTB1/xBD/hurricanes/images/florence/hurricane-florence_00000014_post_disaster.png,45,77,1,162,207,675,752,1754,54.37304981162859,42.558257592840285
13713,/media/marda/TWOTB1/xBD/hurricanes/images/florence/hurricane-florence_00000014_post_disaster.png,49,75,1,210,259,675,750,1756,55.081478958764805,42.11176048049459
13714,/media/marda/TWOTB1/xBD/hurricanes/images/florence/hurricane-florence_00000014_post_disaster.png,32,38,1,482,514,714,752,136,15.814233000620797,11.240682415959922
13715,/media/marda/TWOTB1/xBD/hurricanes/images/florence/hurricane-florence_00000014_post_disaster.png,27,38,1,300,327,722,760,149,17.188498105243774,11.429192035893946
13716,/media/marda/TWOTB1/xBD/hurricanes/images/florence/hurricane-florence_00000014_post_disaster.png,19,40,1,135,154,724,764,142,16.500491265951887,11.385806297593517
13717,/media/marda/TWOTB1/xBD/hurricanes/images/florence/hurricane-florence_00000120_post_disaster.png,55,33,1,520,575,110,143,546,31.770621096227124,23.599058242468058
13718,/media/marda/TWOTB1/xBD/hurricanes/images/florence/hurricane-florence_00000120_post_disaster.png,41,34,1,156,197,157,191,470,39.00208305784573,16.09900440029811
13719,/media/marda/TWOTB1/xBD/hurricanes/images/florence/hurricane-florence_00000120_post_disaster.png,63,40,1,444,507,197,237,855,46.76530818466286,23.93345775916467
13720,/media/marda/TWOTB1/xBD/hurricanes/images/florence/hurricane-florence_00000120_post_disaster.png,34,43,1,38,72,217,260,648,32.77746797594067,26.181789316061845
13721,/media/marda/TWOTB1/xBD/hurricanes/images/florence/hurricane-florence_00000120_post_disaster.png,33,22,1,440,473,235,257,132,15.08018716977703,11.815006679643096
13722,/media/marda/TWOTB1/xBD/hurricanes/images/florence/hurricane-florence_00000120_post_disaster.png,31,24,1,412,443,262,286,165,16.032214233410134,13.509756644312665
13723,/media/marda/TWOTB1/xBD/hurricanes/images/florence/hurricane-florence_00000120_post_disaster.png,112,93,1,853,965,276,369,2811,95.39441707935337,39.18939968270184
13724,/media/marda/TWOTB1/xBD/hurricanes/images/florence/hurricane-florence_00000120_post_disaster.png,35,21,1,408,443,287,308,131,19.58482037650441,8.878639666171743
13725,/media/marda/TWOTB1/xBD/hurricanes/images/florence/hurricane-florence_00000120_post_disaster.png,44,37,1,494,538,307,344,402,23.68316332277739,22.364012081502032
13726,/media/marda/TWOTB1/xBD/hurricanes/images/florence/hurricane-florence_00000120_post_disaster.png,101,77,1,923,1024,320,397,2047,65.37398879420655,41.48490391832402
13727,/media/marda/TWOTB1/xBD/hurricanes/images/florence/hurricane-florence_00000120_post_disaster.png,31,31,1,401,432,350,381,172,17.972571653752862,12.85067017149324
13728,/media/marda/TWOTB1/xBD/hurricanes/images/florence/hurricane-florence_00000120_post_disaster.png,100,77,1,822,922,367,444,2135,58.1175047940038,49.072489361029795
13729,/media/marda/TWOTB1/xBD/hurricanes/images/florence/hurricane-florence_00000120_post_disaster.png,81,70,1,962,1043,389,459,1179,58.157465615844714,27.689666528531095
13730,/media/marda/TWOTB1/xBD/hurricanes/images/florence/hurricane-florence_00000120_post_disaster.png,49,48,1,349,398,421,469,729,35.628706386900596,27.060597450232844
13731,/media/marda/TWOTB1/xBD/hurricanes/images/florence/hurricane-florence_00000120_post_disaster.png,60,53,1,983,1043,430,483,379,30.83499913468866,18.910823027600976
13732,/media/marda/TWOTB1/xBD/hurricanes/images/florence/hurricane-florence_00000120_post_disaster.png,57,35,1,934,991,443,478,183,19.471607324064447,14.400556311742468
13733,/media/marda/TWOTB1/xBD/hurricanes/images/florence/hurricane-florence_00000120_post_disaster.png,51,31,1,945,996,452,483,82,20.45607585784343,5.290592067471217
13734,/media/marda/TWOTB1/xBD/hurricanes/images/florence/hurricane-florence_00000120_post_disaster.png,64,40,1,979,1043,479,519,191,33.11600000927571,7.727297396781267
13735,/media/marda/TWOTB1/xBD/hurricanes/images/florence/hurricane-florence_00000120_post_disaster.png,65,40,1,970,1035,489,529,224,32.42724367682075,9.246966693694336
13736,/media/marda/TWOTB1/xBD/hurricanes/images/florence/hurricane-florence_00000120_post_disaster.png,40,57,1,209,249,741,798,594,31.981807440694528,24.359695460517568
13737,/media/marda/TWOTB1/xBD/hurricanes/images/florence/hurricane-florence_00000120_post_disaster.png,42,85,1,24,66,868,953,1166,47.99835420980765,36.06854570987248
13738,/media/marda/TWOTB1/xBD/hurricanes/images/florence/hurricane-florence_00000120_post_disaster.png,26,59,1,90,116,900,959,297,20.533547522445453,19.092562694995355
13739,/media/marda/TWOTB1/xBD/hurricanes/images/florence/hurricane-florence_00000017_pre_disaster.png,104,242,1,0,104,0,242,10895,203.51352265808728,91.4646174989609
13740,/media/marda/TWOTB1/xBD/hurricanes/images/florence/hurricane-florence_00000017_pre_disaster.png,95,72,1,116,211,0,72,3630,83.85239604076823,56.851745564242506
13741,/media/marda/TWOTB1/xBD/hurricanes/images/florence/hurricane-florence_00000017_pre_disaster.png,140,75,1,511,651,0,75,4995,108.25153183423801,63.66954731844685
13742,/media/marda/TWOTB1/xBD/hurricanes/images/florence/hurricane-florence_00000017_pre_disaster.png,98,74,1,622,720,22,96,2260,85.47538661677977,36.703502037085634
13743,/media/marda/TWOTB1/xBD/hurricanes/images/florence/hurricane-florence_00000017_pre_disaster.png,119,92,1,410,529,48,140,3644,105.80578313090051,60.62381190729501
13744,/media/marda/TWOTB1/xBD/hurricanes/images/florence/hurricane-florence_00000017_pre_disaster.png,160,148,1,512,672,80,228,5305,200.02947983330301,36.84905517368871
13745,/media/marda/TWOTB1/xBD/hurricanes/images/florence/hurricane-florence_00000017_pre_disaster.png,43,14,1,744,787,85,99,103,13.568223077696707,10.205866381701401
13746,/media/marda/TWOTB1/xBD/hurricanes/images/florence/hurricane-florence_00000017_pre_disaster.png,51,16,1,989,1040,92,108,118,15.601684749167044,10.184746386491788
13747,/media/marda/TWOTB1/xBD/hurricanes/images/florence/hurricane-florence_00000017_pre_disaster.png,172,170,1,576,748,103,273,6032,224.0667089472372,36.34049620983979
13748,/media/marda/TWOTB1/xBD/hurricanes/images/florence/hurricane-florence_00000017_pre_disaster.png,75,54,1,729,804,117,171,1113,51.387477211494584,30.95336853501125
13749,/media/marda/TWOTB1/xBD/hurricanes/images/florence/hurricane-florence_00000017_pre_disaster.png,86,56,1,958,1044,119,175,1874,53.814207424761314,47.53454722742404
13750,/media/marda/TWOTB1/xBD/hurricanes/images/florence/hurricane-florence_00000017_pre_disaster.png,48,18,1,853,901,132,150,176,17.133139176713883,13.817133804789298
13751,/media/marda/TWOTB1/xBD/hurricanes/images/florence/hurricane-florence_00000017_pre_disaster.png,72,48,1,785,857,154,202,970,39.906847654027516,33.60780947881177
13752,/media/marda/TWOTB1/xBD/hurricanes/images/florence/hurricane-florence_00000017_pre_disaster.png,83,58,1,896,979,154,212,1555,52.56644422864649,43.31445268226469
13753,/media/marda/TWOTB1/xBD/hurricanes/images/florence/hurricane-florence_00000017_pre_disaster.png,98,114,1,338,436,167,281,4188,110.60832560331983,51.865368441306984
13754,/media/marda/TWOTB1/xBD/hurricanes/images/florence/hurricane-florence_00000017_pre_disaster.png,90,50,1,838,928,170,220,2024,60.81226955811211,44.19304364821166
13755,/media/marda/TWOTB1/xBD/hurricanes/images/florence/hurricane-florence_00000017_pre_disaster.png,68,58,1,445,513,237,295,1221,48.278011626286016,33.75408406030601
13756,/media/marda/TWOTB1/xBD/hurricanes/images/florence/hurricane-florence_00000017_pre_disaster.png,71,46,1,710,781,244,290,882,40.47380438906301,29.118625451794102
13757,/media/marda/TWOTB1/xBD/hurricanes/images/florence/hurricane-florence_00000017_pre_disaster.png,68,75,1,976,1044,249,324,1076,63.72380489210279,24.404777378400574
13758,/media/marda/TWOTB1/xBD/hurricanes/images/florence/hurricane-florence_00000017_pre_disaster.png,23,18,1,312,335,254,272,54,10.085094162802685,7.270026822063393
13759,/media/marda/TWOTB1/xBD/hurricanes/images/florence/hurricane-florence_00000017_pre_disaster.png,22,48,1,0,22,259,307,485,34.75521334779343,20.54960719070947
13760,/media/marda/TWOTB1/xBD/hurricanes/images/florence/hurricane-florence_00000017_pre_disaster.png,80,62,1,652,732,268,330,1495,46.764301086444014,44.30269237453117
13761,/media/marda/TWOTB1/xBD/hurricanes/images/florence/hurricane-florence_00000017_pre_disaster.png,83,46,1,791,874,274,320,1334,53.12477515803423,33.01932852870849
13762,/media/marda/TWOTB1/xBD/hurricanes/images/florence/hurricane-florence_00000017_pre_disaster.png,64,56,1,263,327,280,336,1111,58.50897086197475,25.344331612798275
13763,/media/marda/TWOTB1/xBD/hurricanes/images/florence/hurricane-florence_00000017_pre_disaster.png,79,45,1,901,980,285,330,1118,49.019368588651716,32.485254223053616
13764,/media/marda/TWOTB1/xBD/hurricanes/images/florence/hurricane-florence_00000017_pre_disaster.png,52,30,1,704,756,289,319,229,27.729957498898756,10.967937709581047
13765,/media/marda/TWOTB1/xBD/hurricanes/images/florence/hurricane-florence_00000017_pre_disaster.png,73,53,1,858,931,294,347,1471,49.190767527153604,38.96595285253245
13766,/media/marda/TWOTB1/xBD/hurricanes/images/florence/hurricane-florence_00000017_pre_disaster.png,67,56,1,490,557,294,350,1034,45.12113482190694,30.454224784230654
13767,/media/marda/TWOTB1/xBD/hurricanes/images/florence/hurricane-florence_00000017_pre_disaster.png,72,59,1,715,787,315,374,1178,46.20555474698159,34.82354546170994
13768,/media/marda/TWOTB1/xBD/hurricanes/images/florence/hurricane-florence_00000017_pre_disaster.png,84,89,1,212,296,323,412,2514,84.04964390874265,40.98404775509842
13769,/media/marda/TWOTB1/xBD/hurricanes/images/florence/hurricane-florence_00000017_pre_disaster.png,66,57,1,446,512,325,382,1139,40.61647503169706,37.17757946934795
13770,/media/marda/TWOTB1/xBD/hurricanes/images/florence/hurricane-florence_00000017_pre_disaster.png,83,66,1,961,1044,326,392,1334,51.92898554946233,33.918188969265614
13771,/media/marda/TWOTB1/xBD/hurricanes/images/florence/hurricane-florence_00000017_pre_disaster.png,78,73,1,564,642,336,409,1526,64.89642465927186,31.377180576636658
13772,/media/marda/TWOTB1/xBD/hurricanes/images/florence/hurricane-florence_00000017_pre_disaster.png,87,59,1,752,839,347,406,1381,51.76683200888377,37.43422017180585
13773,/media/marda/TWOTB1/xBD/hurricanes/images/florence/hurricane-florence_00000017_pre_disaster.png,84,67,1,915,999,363,430,1243,57.12717250026041,31.059726175322734
13774,/media/marda/TWOTB1/xBD/hurricanes/images/florence/hurricane-florence_00000017_pre_disaster.png,63,50,1,606,669,376,426,745,33.12910050777789,30.01208290267829
13775,/media/marda/TWOTB1/xBD/hurricanes/images/florence/hurricane-florence_00000017_pre_disaster.png,248,273,1,5,253,377,650,17962,342.8524907089119,75.98913387682686
13776,/media/marda/TWOTB1/xBD/hurricanes/images/florence/hurricane-florence_00000017_pre_disaster.png,79,64,1,792,871,382,446,1206,45.964061997296746,35.72747251124871
13777,/media/marda/TWOTB1/xBD/hurricanes/images/florence/hurricane-florence_00000017_pre_disaster.png,72,75,1,309,381,383,458,1703,67.20241782802997,33.80234679059284
13778,/media/marda/TWOTB1/xBD/hurricanes/images/florence/hurricane-florence_00000017_pre_disaster.png,73,66,1,644,717,397,463,1178,46.88094113037281,33.659455220123654
13779,/media/marda/TWOTB1/xBD/hurricanes/images/florence/hurricane-florence_00000017_pre_disaster.png,56,50,1,417,473,401,451,668,33.67681553127837,27.255607706761086
13780,/media/marda/TWOTB1/xBD/hurricanes/images/florence/hurricane-florence_00000017_pre_disaster.png,84,82,1,364,448,414,496,2299,61.62323978379825,49.796516912653004
13781,/media/marda/TWOTB1/xBD/hurricanes/images/florence/hurricane-florence_00000017_pre_disaster.png,80,70,1,514,594,432,502,1469,63.53658670295412,30.79604973949095
13782,/media/marda/TWOTB1/xBD/hurricanes/images/florence/hurricane-florence_00000017_pre_disaster.png,84,73,1,874,958,434,507,1550,51.85792025861858,41.643492961500286
13783,/media/marda/TWOTB1/xBD/hurricanes/images/florence/hurricane-florence_00000017_pre_disaster.png,116,106,1,281,397,437,543,3395,124.75851646116527,36.2944624988679
13784,/media/marda/TWOTB1/xBD/hurricanes/images/florence/hurricane-florence_00000017_pre_disaster.png,59,47,1,697,756,439,486,505,30.085713216742764,22.277812235032126
13785,/media/marda/TWOTB1/xBD/hurricanes/images/florence/hurricane-florence_00000017_pre_disaster.png,74,71,1,724,798,465,536,1341,49.50699852506383,37.51761880406555
13786,/media/marda/TWOTB1/xBD/hurricanes/images/florence/hurricane-florence_00000017_pre_disaster.png,106,95,1,265,371,469,564,1883,123.459527466673,20.360071920488448
13787,/media/marda/TWOTB1/xBD/hurricanes/images/florence/hurricane-florence_00000017_pre_disaster.png,77,65,1,573,650,480,545,1231,57.164986570586834,28.733899789116045
13788,/media/marda/TWOTB1/xBD/hurricanes/images/florence/hurricane-florence_00000017_pre_disaster.png,68,83,1,220,288,490,573,1702,67.17596014371601,33.80743478463854
13789,/media/marda/TWOTB1/xBD/hurricanes/images/florence/hurricane-florence_00000017_pre_disaster.png,90,70,1,951,1041,491,561,1308,43.29603065000649,40.302862849514334
13790,/media/marda/TWOTB1/xBD/hurricanes/images/florence/hurricane-florence_00000017_pre_disaster.png,81,67,1,765,846,494,561,1191,45.04642427660939,35.30631977198042
13791,/media/marda/TWOTB1/xBD/hurricanes/images/florence/hurricane-florence_00000017_pre_disaster.png,68,64,1,617,685,508,572,1065,38.500962909075184,36.41277557724304
13792,/media/marda/TWOTB1/xBD/hurricanes/images/florence/hurricane-florence_00000017_pre_disaster.png,76,76,1,279,355,511,587,1270,79.35728024807882,21.353710524066855
13793,/media/marda/TWOTB1/xBD/hurricanes/images/florence/hurricane-florence_00000017_pre_disaster.png,50,54,1,449,499,512,566,580,29.387907920445663,26.35917374412939
13794,/media/marda/TWOTB1/xBD/hurricanes/images/florence/hurricane-florence_00000017_pre_disaster.png,84,78,1,464,548,522,600,1603,64.98503483114213,37.84135395274536
13795,/media/marda/TWOTB1/xBD/hurricanes/images/florence/hurricane-florence_00000017_pre_disaster.png,84,71,1,793,877,529,600,1344,54.71992955957677,34.82589397857702
13796,/media/marda/TWOTB1/xBD/hurricanes/images/florence/hurricane-florence_00000017_pre_disaster.png,77,77,1,263,340,532,609,1287,80.81804821464776,21.256239040796622
13797,/media/marda/TWOTB1/xBD/hurricanes/images/florence/hurricane-florence_00000017_pre_disaster.png,76,62,1,656,732,539,601,1011,46.1607851967102,30.516033006985673
13798,/media/marda/TWOTB1/xBD/hurricanes/images/florence/hurricane-florence_00000017_pre_disaster.png,90,112,1,149,239,543,655,2815,110.17397582886368,34.07922333278289
13799,/media/marda/TWOTB1/xBD/hurricanes/images/florence/hurricane-florence_00000017_pre_disaster.png,75,76,1,248,323,553,629,1214,79.13104379514141,20.463421860519734
13800,/media/marda/TWOTB1/xBD/hurricanes/images/florence/hurricane-florence_00000017_pre_disaster.png,65,62,1,515,580,555,617,871,46.551161325090774,24.978349366235392
13801,/media/marda/TWOTB1/xBD/hurricanes/images/florence/hurricane-florence_00000017_pre_disaster.png,75,73,1,231,306,575,648,1042,79.67485690775221,17.4485752274359
13802,/media/marda/TWOTB1/xBD/hurricanes/images/florence/hurricane-florence_00000017_pre_disaster.png,77,64,1,695,772,579,643,1097,49.94800729324662,29.831389434449676
13803,/media/marda/TWOTB1/xBD/hurricanes/images/florence/hurricane-florence_00000017_pre_disaster.png,52,58,1,379,431,586,644,727,34.92484802544055,27.809348577014834
13804,/media/marda/TWOTB1/xBD/hurricanes/images/florence/hurricane-florence_00000017_pre_disaster.png,72,75,1,548,620,587,662,1363,50.93522261682443,35.99489521699922
13805,/media/marda/TWOTB1/xBD/hurricanes/images/florence/hurricane-florence_00000017_pre_disaster.png,87,86,1,740,827,595,681,1814,62.42646268639553,38.554409598600195
13806,/media/marda/TWOTB1/xBD/hurricanes/images/florence/hurricane-florence_00000017_pre_disaster.png,68,72,1,405,473,603,675,1263,44.899579336171264,37.85873284195297
13807,/media/marda/TWOTB1/xBD/hurricanes/images/florence/hurricane-florence_00000017_pre_disaster.png,96,79,1,907,1003,608,687,1627,52.34099008461758,41.897364027940746
13808,/media/marda/TWOTB1/xBD/hurricanes/images/florence/hurricane-florence_00000017_pre_disaster.png,69,65,1,596,665,618,683,1029,43.21526936450365,31.8464153352717
13809,/media/marda/TWOTB1/xBD/hurricanes/images/florence/hurricane-florence_00000017_pre_disaster.png,71,76,1,440,511,629,705,1490,47.18117834865884,41.605843482535064
13810,/media/marda/TWOTB1/xBD/hurricanes/images/florence/hurricane-florence_00000017_pre_disaster.png,87,75,1,957,1044,642,717,1276,50.71391692242947,34.41093856242125
13811,/media/marda/TWOTB1/xBD/hurricanes/images/florence/hurricane-florence_00000017_pre_disaster.png,77,81,1,631,708,653,734,1513,50.32566970437725,41.1745478691988
13812,/media/marda/TWOTB1/xBD/hurricanes/images/florence/hurricane-florence_00000017_pre_disaster.png,69,68,1,490,559,664,732,1120,46.331103018910845,32.413869428323075
13813,/media/marda/TWOTB1/xBD/hurricanes/images/florence/hurricane-florence_00000017_pre_disaster.png,72,88,1,848,920,671,759,1775,71.85929312930112,33.32489187397383
13814,/media/marda/TWOTB1/xBD/hurricanes/images/florence/hurricane-florence_00000017_pre_disaster.png,11,46,1,0,11,673,719,126,19.07169179333461,10.133225682980719
13815,/media/marda/TWOTB1/xBD/hurricanes/images/florence/hurricane-florence_00000017_pre_disaster.png,57,49,1,886,943,673,722,498,28.549736375083878,23.06801830901158
13816,/media/marda/TWOTB1/xBD/hurricanes/images/florence/hurricane-florence_00000017_pre_disaster.png,77,78,1,670,747,683,761,1235,59.21928661772962,27.810276736888422
13817,/media/marda/TWOTB1/xBD/hurricanes/images/florence/hurricane-florence_00000017_pre_disaster.png,63,77,1,537,600,690,767,1143,43.530457516429124,35.44857738436896
13818,/media/marda/TWOTB1/xBD/hurricanes/images/florence/hurricane-florence_00000017_pre_disaster.png,64,80,1,313,377,697,777,1272,54.193161723409624,31.293874546857882
13819,/media/marda/TWOTB1/xBD/hurricanes/images/florence/hurricane-florence_00000017_pre_disaster.png,106,127,1,33,139,708,835,4064,105.66989960133927,65.74430141226752
13820,/media/marda/TWOTB1/xBD/hurricanes/images/florence/hurricane-florence_00000017_pre_disaster.png,63,74,1,368,431,723,797,1125,45.65306069196394,32.88966786275781
13821,/media/marda/TWOTB1/xBD/hurricanes/images/florence/hurricane-florence_00000017_pre_disaster.png,79,72,1,745,824,739,811,1227,45.013218574359165,36.47701430536301
13822,/media/marda/TWOTB1/xBD/hurricanes/images/florence/hurricane-florence_00000017_pre_disaster.png,55,83,1,245,300,741,824,1212,55.12875157502127,30.017412124024222
13823,/media/marda/TWOTB1/xBD/hurricanes/images/florence/hurricane-florence_00000017_pre_disaster.png,70,81,1,422,492,743,824,1451,45.19565338603158,42.832054394419906
13824,/media/marda/TWOTB1/xBD/hurricanes/images/florence/hurricane-florence_00000017_pre_disaster.png,103,85,1,941,1044,754,839,1608,77.34691048131913,29.75018080383166
13825,/media/marda/TWOTB1/xBD/hurricanes/images/florence/hurricane-florence_00000017_pre_disaster.png,89,86,1,605,694,755,841,1784,66.0779952507812,38.49407010096156
13826,/media/marda/TWOTB1/xBD/hurricanes/images/florence/hurricane-florence_00000017_pre_disaster.png,82,78,1,779,861,769,847,1439,45.35227620451008,42.199454703868454
13827,/media/marda/TWOTB1/xBD/hurricanes/images/florence/hurricane-florence_00000017_pre_disaster.png,54,71,1,275,329,780,851,940,41.26484278897981,30.391391974409494
13828,/media/marda/TWOTB1/xBD/hurricanes/images/florence/hurricane-florence_00000017_pre_disaster.png,82,101,1,461,543,787,888,2306,60.358483291925246,50.67711316175457
13829,/media/marda/TWOTB1/xBD/hurricanes/images/florence/hurricane-florence_00000017_pre_disaster.png,49,67,1,354,403,789,856,644,30.980298807997766,27.774252106177684
13830,/media/marda/TWOTB1/xBD/hurricanes/images/florence/hurricane-florence_00000017_pre_disaster.png,69,68,1,831,900,798,866,670,33.982946232987445,26.201009534642285
13831,/media/marda/TWOTB1/xBD/hurricanes/images/florence/hurricane-florence_00000017_pre_disaster.png,83,73,1,687,770,816,889,1157,49.050289985347824,35.86766320899939
13832,/media/marda/TWOTB1/xBD/hurricanes/images/florence/hurricane-florence_00000017_pre_disaster.png,76,90,1,344,420,821,911,1706,58.16257384787342,40.800654447300246
13833,/media/marda/TWOTB1/xBD/hurricanes/images/florence/hurricane-florence_00000017_pre_disaster.png,64,64,1,824,888,827,891,497,30.59267905678992,21.68773797081082
13834,/media/marda/TWOTB1/xBD/hurricanes/images/florence/hurricane-florence_00000017_pre_disaster.png,77,79,1,862,939,830,909,995,46.88466214085627,29.01774459474589
13835,/media/marda/TWOTB1/xBD/hurricanes/images/florence/hurricane-florence_00000017_pre_disaster.png,38,83,1,0,38,835,918,883,56.498642580692724,20.56508818344014
13836,/media/marda/TWOTB1/xBD/hurricanes/images/florence/hurricane-florence_00000017_pre_disaster.png,35,60,1,186,221,839,899,392,27.84200042975584,18.809641248737584
13837,/media/marda/TWOTB1/xBD/hurricanes/images/florence/hurricane-florence_00000017_pre_disaster.png,80,83,1,899,979,854,937,1185,44.84152001804912,35.48239171800695
13838,/media/marda/TWOTB1/xBD/hurricanes/images/florence/hurricane-florence_00000017_pre_disaster.png,78,88,1,761,839,857,945,1323,54.1419233218497,33.05115409441187
13839,/media/marda/TWOTB1/xBD/hurricanes/images/florence/hurricane-florence_00000017_pre_disaster.png,52,79,1,209,261,858,937,1097,40.12546932610184,37.7202767647177
13840,/media/marda/TWOTB1/xBD/hurricanes/images/florence/hurricane-florence_00000017_pre_disaster.png,68,92,1,4,72,864,956,2134,59.64818706770717,47.38968306613813
13841,/media/marda/TWOTB1/xBD/hurricanes/images/florence/hurricane-florence_00000017_pre_disaster.png,57,80,1,245,302,886,966,1064,45.10071519655348,31.90831366787516
13842,/media/marda/TWOTB1/xBD/hurricanes/images/florence/hurricane-florence_00000017_pre_disaster.png,69,83,1,490,559,900,983,1222,45.20722854458002,36.19424275098082
13843,/media/marda/TWOTB1/xBD/hurricanes/images/florence/hurricane-florence_00000017_pre_disaster.png,65,104,1,93,158,901,1005,1725,78.17976132522978,29.41106609167906
13844,/media/marda/TWOTB1/xBD/hurricanes/images/florence/hurricane-florence_00000017_pre_disaster.png,61,69,1,619,680,901,970,573,36.833466111423114,20.77928106808999
13845,/media/marda/TWOTB1/xBD/hurricanes/images/florence/hurricane-florence_00000017_pre_disaster.png,74,79,1,786,860,903,982,880,42.11616058787115,27.879411017074258
13846,/media/marda/TWOTB1/xBD/hurricanes/images/florence/hurricane-florence_00000017_pre_disaster.png,53,74,1,283,336,916,990,762,43.00085037025179,23.650054409344648
13847,/media/marda/TWOTB1/xBD/hurricanes/images/florence/hurricane-florence_00000017_pre_disaster.png,62,70,1,656,718,928,998,593,34.551163286629254,22.925731143160895
13848,/media/marda/TWOTB1/xBD/hurricanes/images/florence/hurricane-florence_00000017_pre_disaster.png,79,79,1,825,904,933,1012,1105,39.876038152519136,36.822282775504604
13849,/media/marda/TWOTB1/xBD/hurricanes/images/florence/hurricane-florence_00000017_pre_disaster.png,62,90,1,125,187,934,1024,1466,61.04406461202936,32.308986317789305
13850,/media/marda/TWOTB1/xBD/hurricanes/images/florence/hurricane-florence_00000017_pre_disaster.png,55,71,1,476,531,935,1006,639,36.22070652605434,23.568541387764164
13851,/media/marda/TWOTB1/xBD/hurricanes/images/florence/hurricane-florence_00000017_pre_disaster.png,88,77,1,956,1044,935,1012,1044,59.119595488180096,23.592159244302884
13852,/media/marda/TWOTB1/xBD/hurricanes/images/florence/hurricane-florence_00000017_pre_disaster.png,39,50,1,592,631,937,987,105,12.74983975985501,11.069999853460555
13853,/media/marda/TWOTB1/xBD/hurricanes/images/florence/hurricane-florence_00000017_pre_disaster.png,58,79,1,320,378,943,1022,1005,39.246760432187266,36.5478353061692
13854,/media/marda/TWOTB1/xBD/hurricanes/images/florence/hurricane-florence_00000017_pre_disaster.png,33,53,1,455,488,951,1004,148,15.113371679011172,13.138811330675175
13855,/media/marda/TWOTB1/xBD/hurricanes/images/florence/hurricane-florence_00000017_pre_disaster.png,69,76,1,678,747,957,1033,866,36.383330543184506,31.73760379355307
13856,/media/marda/TWOTB1/xBD/hurricanes/images/florence/hurricane-florence_00000017_pre_disaster.png,11,59,1,0,11,964,1023,133,19.837480320993432,10.267707303066365
13857,/media/marda/TWOTB1/xBD/hurricanes/images/florence/hurricane-florence_00000017_pre_disaster.png,61,77,1,573,634,964,1041,770,42.63714185825708,24.042097578350443
13858,/media/marda/TWOTB1/xBD/hurricanes/images/florence/hurricane-florence_00000017_pre_disaster.png,50,75,1,250,300,967,1042,872,43.26803127874302,26.593954646250488
13859,/media/marda/TWOTB1/xBD/hurricanes/images/florence/hurricane-florence_00000017_pre_disaster.png,41,64,1,196,237,978,1042,448,37.51315307587265,16.103255727666873
13860,/media/marda/TWOTB1/xBD/hurricanes/images/florence/hurricane-florence_00000017_pre_disaster.png,52,63,1,358,410,981,1044,511,34.74609921849913,19.89407609395928
13861,/media/marda/TWOTB1/xBD/hurricanes/images/florence/hurricane-florence_00000017_pre_disaster.png,77,63,1,712,789,981,1044,686,47.59824373498906,20.276576172047236
13862,/media/marda/TWOTB1/xBD/hurricanes/images/florence/hurricane-florence_00000123_post_disaster.png,64,43,1,600,664,186,229,775,39.947037339050794,25.602995762520138
13863,/media/marda/TWOTB1/xBD/hurricanes/images/florence/hurricane-florence_00000123_post_disaster.png,97,75,1,617,714,206,281,2541,63.47509168096984,53.07340000609553
13864,/media/marda/TWOTB1/xBD/hurricanes/images/florence/hurricane-florence_00000123_post_disaster.png,56,45,1,520,576,233,278,643,42.055588807559865,20.1288193914295
13865,/media/marda/TWOTB1/xBD/hurricanes/images/florence/hurricane-florence_00000123_post_disaster.png,136,106,1,553,689,239,345,4846,129.85665510289462,50.085359387146184
13866,/media/marda/TWOTB1/xBD/hurricanes/images/florence/hurricane-florence_00000123_post_disaster.png,66,62,1,670,736,979,1041,645,40.80314699134042,21.905106486038655
13867,/media/marda/TWOTB1/xBD/hurricanes/images/florence/hurricane-florence_00000123_post_disaster.png,50,49,1,748,798,994,1043,116,22.857924700341098,7.423037470610536
13868,/media/marda/TWOTB1/xBD/hurricanes/images/florence/hurricane-florence_00000232_post_disaster.png,73,41,1,707,780,72,113,875,50.352854406080056,23.2429944033374
13869,/media/marda/TWOTB1/xBD/hurricanes/images/florence/hurricane-florence_00000232_post_disaster.png,54,34,1,143,197,107,141,1258,54.518484030640224,30.81941021909745
13870,/media/marda/TWOTB1/xBD/hurricanes/images/florence/hurricane-florence_00000232_post_disaster.png,76,16,1,560,636,111,127,635,61.124730755803014,13.76177984379851
13871,/media/marda/TWOTB1/xBD/hurricanes/images/florence/hurricane-florence_00000232_post_disaster.png,76,45,1,792,868,118,163,828,46.90274972963176,23.45737474459426
13872,/media/marda/TWOTB1/xBD/hurricanes/images/florence/hurricane-florence_00000232_post_disaster.png,60,29,1,853,913,184,213,377,23.76928739704339,20.888711277244056
13873,/media/marda/TWOTB1/xBD/hurricanes/images/florence/hurricane-florence_00000232_post_disaster.png,66,32,1,412,478,186,218,1279,56.38897519473075,30.084932483036592
13874,/media/marda/TWOTB1/xBD/hurricanes/images/florence/hurricane-florence_00000232_post_disaster.png,47,34,1,582,629,194,228,664,31.71082557611858,28.020609589164824
13875,/media/marda/TWOTB1/xBD/hurricanes/images/florence/hurricane-florence_00000232_post_disaster.png,38,30,1,466,504,227,257,473,25.614496455915674,24.58933238950996
13876,/media/marda/TWOTB1/xBD/hurricanes/images/florence/hurricane-florence_00000232_post_disaster.png,63,46,1,456,519,264,310,1152,46.41359738681662,37.20860754832781
13877,/media/marda/TWOTB1/xBD/hurricanes/images/florence/hurricane-florence_00000232_post_disaster.png,69,48,1,547,616,269,317,1262,54.799382317209684,33.32432272029009
13878,/media/marda/TWOTB1/xBD/hurricanes/images/florence/hurricane-florence_00000232_post_disaster.png,75,36,1,761,836,295,331,719,49.106863491222974,19.565922314414333
13879,/media/marda/TWOTB1/xBD/hurricanes/images/florence/hurricane-florence_00000232_post_disaster.png,83,58,1,832,915,431,489,935,56.38800807332621,22.136040746564156
13880,/media/marda/TWOTB1/xBD/hurricanes/images/florence/hurricane-florence_00000232_post_disaster.png,46,37,1,391,437,449,486,420,35.75109335152262,17.09508435792959
13881,/media/marda/TWOTB1/xBD/hurricanes/images/florence/hurricane-florence_00000232_post_disaster.png,56,59,1,375,431,476,535,1274,44.49749604469408,41.32546985264629
13882,/media/marda/TWOTB1/xBD/hurricanes/images/florence/hurricane-florence_00000232_post_disaster.png,29,26,1,337,366,483,509,113,18.486116830834696,8.253551262922695
13883,/media/marda/TWOTB1/xBD/hurricanes/images/florence/hurricane-florence_00000232_post_disaster.png,19,29,1,328,347,505,534,58,10.423361364603895,7.382236395603707
13884,/media/marda/TWOTB1/xBD/hurricanes/images/florence/hurricane-florence_00000232_post_disaster.png,25,32,1,366,391,511,543,82,11.014576906480427,10.019836353771252
13885,/media/marda/TWOTB1/xBD/hurricanes/images/florence/hurricane-florence_00000232_post_disaster.png,24,36,1,314,338,521,557,159,17.629722161180705,12.0735153304368
13886,/media/marda/TWOTB1/xBD/hurricanes/images/florence/hurricane-florence_00000232_post_disaster.png,21,36,1,326,347,522,558,121,17.544059413821902,9.230734390811268
13887,/media/marda/TWOTB1/xBD/hurricanes/images/florence/hurricane-florence_00000232_post_disaster.png,20,35,1,336,356,524,559,94,15.353352734956113,8.23705213538934
13888,/media/marda/TWOTB1/xBD/hurricanes/images/florence/hurricane-florence_00000232_post_disaster.png,21,35,1,344,365,525,560,113,16.39954773721334,9.226720193899611
13889,/media/marda/TWOTB1/xBD/hurricanes/images/florence/hurricane-florence_00000232_post_disaster.png,21,28,1,356,377,542,570,50,9.531164280244877,7.213661169127931
13890,/media/marda/TWOTB1/xBD/hurricanes/images/florence/hurricane-florence_00000232_post_disaster.png,21,28,1,373,394,544,572,64,10.454829124972864,8.159138923171927
13891,/media/marda/TWOTB1/xBD/hurricanes/images/florence/hurricane-florence_00000232_post_disaster.png,22,29,1,387,409,545,574,58,9.529758218520893,8.225962978109198
13892,/media/marda/TWOTB1/xBD/hurricanes/images/florence/hurricane-florence_00000232_post_disaster.png,44,60,1,537,581,574,634,695,41.72579188067925,22.236469375335275
13893,/media/marda/TWOTB1/xBD/hurricanes/images/florence/hurricane-florence_00000232_post_disaster.png,40,73,1,348,388,650,723,1051,52.43499197276822,27.170730653643158
13894,/media/marda/TWOTB1/xBD/hurricanes/images/florence/hurricane-florence_00000232_post_disaster.png,52,79,1,573,625,771,850,957,51.434504918318325,24.593229118099114
13895,/media/marda/TWOTB1/xBD/hurricanes/images/florence/hurricane-florence_00000232_post_disaster.png,15,47,1,9,24,784,831,170,17.40165094441971,13.076214616594285
13896,/media/marda/TWOTB1/xBD/hurricanes/images/florence/hurricane-florence_00000232_post_disaster.png,59,84,1,65,124,823,907,1496,62.73320071617218,32.43810786775073
13897,/media/marda/TWOTB1/xBD/hurricanes/images/florence/hurricane-florence_00000232_post_disaster.png,38,85,1,375,413,840,925,1151,59.00867866768853,26.036416737790123
13898,/media/marda/TWOTB1/xBD/hurricanes/images/florence/hurricane-florence_00000232_post_disaster.png,37,45,1,633,670,841,886,112,13.578885937313276,11.422725271133991
13899,/media/marda/TWOTB1/xBD/hurricanes/images/florence/hurricane-florence_00000232_post_disaster.png,40,50,1,305,345,856,906,442,30.267568226674925,19.112576559996757
13900,/media/marda/TWOTB1/xBD/hurricanes/images/florence/hurricane-florence_00000232_post_disaster.png,43,80,1,385,428,927,1007,991,48.008545542374726,27.197740474941938
13901,/media/marda/TWOTB1/xBD/hurricanes/images/florence/hurricane-florence_00000232_post_disaster.png,55,68,1,565,620,962,1030,619,29.965732713291636,27.64338768554156
13902,/media/marda/TWOTB1/xBD/hurricanes/images/florence/hurricane-florence_00000232_post_disaster.png,66,62,1,509,575,979,1041,698,42.25825793515685,23.087238870753353
13903,/media/marda/TWOTB1/xBD/hurricanes/images/florence/hurricane-florence_00000104_pre_disaster.png,38,18,1,498,536,0,18,212,17.666422120090573,15.738373177661385
13904,/media/marda/TWOTB1/xBD/hurricanes/images/florence/hurricane-florence_00000104_pre_disaster.png,351,103,1,346,697,0,103,11491,369.5970919364129,41.54491415168885
13905,/media/marda/TWOTB1/xBD/hurricanes/images/florence/hurricane-florence_00000104_pre_disaster.png,266,69,1,778,1044,0,69,6964,238.97020982590982,40.52491960810528
13906,/media/marda/TWOTB1/xBD/hurricanes/images/florence/hurricane-florence_00000104_pre_disaster.png,355,126,1,366,721,55,181,12729,393.269964364127,43.86182283584624
13907,/media/marda/TWOTB1/xBD/hurricanes/images/florence/hurricane-florence_00000104_pre_disaster.png,34,10,1,502,536,94,104,88,16.1642341230358,7.311019510989235
13908,/media/marda/TWOTB1/xBD/hurricanes/images/florence/hurricane-florence_00000104_pre_disaster.png,221,90,1,823,1044,153,243,7114,220.88156964375585,43.89477958887404
13909,/media/marda/TWOTB1/xBD/hurricanes/images/florence/hurricane-florence_00000104_pre_disaster.png,359,136,1,408,767,225,361,12905,394.69375240559793,44.22676378058734
13910,/media/marda/TWOTB1/xBD/hurricanes/images/florence/hurricane-florence_00000104_pre_disaster.png,201,96,1,843,1044,228,324,6537,198.44874357344668,44.92988926377426
13911,/media/marda/TWOTB1/xBD/hurricanes/images/florence/hurricane-florence_00000104_pre_disaster.png,358,140,1,429,787,299,439,13018,392.1597273716266,44.87219945195082
13912,/media/marda/TWOTB1/xBD/hurricanes/images/florence/hurricane-florence_00000272_pre_disaster.png,24,24,1,0,24,0,24,303,27.12590815232815,15.118919039028242
13913,/media/marda/TWOTB1/xBD/hurricanes/images/florence/hurricane-florence_00000272_pre_disaster.png,20,13,1,23,43,0,13,155,17.684735121340253,12.103158233020366
13914,/media/marda/TWOTB1/xBD/hurricanes/images/florence/hurricane-florence_00000272_pre_disaster.png,22,6,1,120,142,0,6,57,16.606545682910102,5.18537134639757
13915,/media/marda/TWOTB1/xBD/hurricanes/images/florence/hurricane-florence_00000272_pre_disaster.png,43,52,1,10,53,44,96,1036,54.601368422976996,25.676522725465624
13916,/media/marda/TWOTB1/xBD/hurricanes/images/florence/hurricane-florence_00000272_pre_disaster.png,18,17,1,63,81,53,70,168,15.632535961621809,14.16233261908467
13917,/media/marda/TWOTB1/xBD/hurricanes/images/florence/hurricane-florence_00000272_pre_disaster.png,85,50,1,535,620,176,226,1684,60.661987312459246,38.491243718073434
13918,/media/marda/TWOTB1/xBD/hurricanes/images/florence/hurricane-florence_00000272_pre_disaster.png,63,71,1,756,819,180,251,1477,73.91809825455735,26.369169437582485
13919,/media/marda/TWOTB1/xBD/hurricanes/images/florence/hurricane-florence_00000272_pre_disaster.png,55,31,1,689,744,206,237,337,26.452124303413967,17.026779865740323
13920,/media/marda/TWOTB1/xBD/hurricanes/images/florence/hurricane-florence_00000272_pre_disaster.png,105,74,1,320,425,237,311,1754,108.31598934564242,33.865993569500084
13921,/media/marda/TWOTB1/xBD/hurricanes/images/florence/hurricane-florence_00000272_pre_disaster.png,37,37,1,159,196,243,280,513,30.433679536861455,22.726851254010914
13922,/media/marda/TWOTB1/xBD/hurricanes/images/florence/hurricane-florence_00000272_pre_disaster.png,50,46,1,198,248,260,306,898,37.20751278477994,31.988286578622546
13923,/media/marda/TWOTB1/xBD/hurricanes/images/florence/hurricane-florence_00000272_pre_disaster.png,60,75,1,212,272,310,385,1866,56.67632010616684,43.40100596340562
13924,/media/marda/TWOTB1/xBD/hurricanes/images/florence/hurricane-florence_00000272_pre_disaster.png,38,49,1,46,84,353,402,773,34.81473114762794,29.256718234934095
13925,/media/marda/TWOTB1/xBD/hurricanes/images/florence/hurricane-florence_00000272_pre_disaster.png,43,47,1,322,365,416,463,479,26.530533446942275,24.118956778476953
13926,/media/marda/TWOTB1/xBD/hurricanes/images/florence/hurricane-florence_00000272_pre_disaster.png,35,32,1,504,539,445,477,117,13.238784560118821,12.083885435594215
13927,/media/marda/TWOTB1/xBD/hurricanes/images/florence/hurricane-florence_00000272_pre_disaster.png,44,59,1,223,267,543,602,686,38.4520205208557,23.683591547783564
13928,/media/marda/TWOTB1/xBD/hurricanes/images/florence/hurricane-florence_00000272_pre_disaster.png,37,49,1,258,295,687,736,455,29.187100748174753,20.438565598067335
13929,/media/marda/TWOTB1/xBD/hurricanes/images/florence/hurricane-florence_00000272_pre_disaster.png,53,64,1,192,245,704,768,939,50.22887997199569,24.620313519608747
13930,/media/marda/TWOTB1/xBD/hurricanes/images/florence/hurricane-florence_00000272_pre_disaster.png,36,59,1,101,137,759,818,528,35.362105322644204,19.711745245677143
13931,/media/marda/TWOTB1/xBD/hurricanes/images/florence/hurricane-florence_00000272_pre_disaster.png,27,43,1,305,332,779,822,118,13.029907512805224,12.405773287807243
13932,/media/marda/TWOTB1/xBD/hurricanes/images/florence/hurricane-florence_00000272_pre_disaster.png,65,86,1,377,442,796,882,1143,62.77030821281353,24.199650885493412
13933,/media/marda/TWOTB1/xBD/hurricanes/images/florence/hurricane-florence_00000272_pre_disaster.png,35,63,1,226,261,809,872,445,32.573571279456765,18.429834796405267
13934,/media/marda/TWOTB1/xBD/hurricanes/images/florence/hurricane-florence_00000272_pre_disaster.png,47,75,1,346,393,857,932,761,37.71553564367984,27.841183201314088
13935,/media/marda/TWOTB1/xBD/hurricanes/images/florence/hurricane-florence_00000272_pre_disaster.png,52,91,1,82,134,926,1017,1280,59.46821213284992,28.416236171320026
13936,/media/marda/TWOTB1/xBD/hurricanes/images/florence/hurricane-florence_00000183_pre_disaster.png,50,38,1,182,232,28,66,824,42.11967295127078,26.256348254850426
13937,/media/marda/TWOTB1/xBD/hurricanes/images/florence/hurricane-florence_00000183_pre_disaster.png,35,27,1,436,471,208,235,181,16.35164075764641,14.808651806714769
13938,/media/marda/TWOTB1/xBD/hurricanes/images/florence/hurricane-florence_00000183_pre_disaster.png,66,52,1,439,505,223,275,1274,46.39600076435855,35.92602590201763
13939,/media/marda/TWOTB1/xBD/hurricanes/images/florence/hurricane-florence_00000183_pre_disaster.png,32,31,1,243,275,229,260,261,24.102448413013516,14.549854907245699
13940,/media/marda/TWOTB1/xBD/hurricanes/images/florence/hurricane-florence_00000183_pre_disaster.png,83,74,1,917,1000,531,605,1097,50.66438728184117,34.62604101124455
13941,/media/marda/TWOTB1/xBD/hurricanes/images/florence/hurricane-florence_00000183_pre_disaster.png,79,63,1,962,1041,577,640,860,44.23126203903295,26.10467760546867
13942,/media/marda/TWOTB1/xBD/hurricanes/images/florence/hurricane-florence_00000183_pre_disaster.png,70,59,1,841,911,653,712,629,37.54011994226685,22.362246889068466
13943,/media/marda/TWOTB1/xBD/hurricanes/images/florence/hurricane-florence_00000183_pre_disaster.png,61,50,1,918,979,682,732,313,27.512541063191186,15.060916157927126
13944,/media/marda/TWOTB1/xBD/hurricanes/images/florence/hurricane-florence_00000245_pre_disaster.png,22,10,1,33,55,0,10,115,19.035980008048796,9.24784193447725
13945,/media/marda/TWOTB1/xBD/hurricanes/images/florence/hurricane-florence_00000245_pre_disaster.png,134,82,1,536,670,104,186,3327,128.2321484943163,34.643982822057446
13946,/media/marda/TWOTB1/xBD/hurricanes/images/florence/hurricane-florence_00000245_pre_disaster.png,18,64,1,0,18,202,266,613,55.98859928302842,16.837961765264996
13947,/media/marda/TWOTB1/xBD/hurricanes/images/florence/hurricane-florence_00000245_pre_disaster.png,33,27,1,41,74,258,285,524,37.71805348779121,18.598193862929477
13948,/media/marda/TWOTB1/xBD/hurricanes/images/florence/hurricane-florence_00000241_pre_disaster.png,71,82,1,638,709,302,384,1771,75.28162743946035,36.12566554096531
13949,/media/marda/TWOTB1/xBD/hurricanes/images/florence/hurricane-florence_00000241_pre_disaster.png,59,54,1,750,809,316,370,833,41.85945150764483,26.66691590365306
13950,/media/marda/TWOTB1/xBD/hurricanes/images/florence/hurricane-florence_00000241_pre_disaster.png,55,36,1,710,765,327,363,382,25.659147479468672,20.43837094824034
13951,/media/marda/TWOTB1/xBD/hurricanes/images/florence/hurricane-florence_00000241_pre_disaster.png,131,66,1,653,784,401,467,2257,114.02946535361117,42.12893485421769
13952,/media/marda/TWOTB1/xBD/hurricanes/images/florence/hurricane-florence_00000241_pre_disaster.png,72,83,1,517,589,411,494,2149,63.445708649021235,47.76175321564983
13953,/media/marda/TWOTB1/xBD/hurricanes/images/florence/hurricane-florence_00000241_pre_disaster.png,41,34,1,593,634,431,465,223,17.505392322741123,16.263937178461177
13954,/media/marda/TWOTB1/xBD/hurricanes/images/florence/hurricane-florence_00000241_pre_disaster.png,120,81,1,714,834,580,661,3528,97.04189019412723,53.820593597258494
13955,/media/marda/TWOTB1/xBD/hurricanes/images/florence/hurricane-florence_00000241_pre_disaster.png,64,75,1,749,813,663,738,1489,55.90156332345034,36.2689807400793
13956,/media/marda/TWOTB1/xBD/hurricanes/images/florence/hurricane-florence_00000241_pre_disaster.png,51,83,1,993,1044,872,955,471,56.30867538110191,11.095316144419005
13957,/media/marda/TWOTB1/xBD/hurricanes/images/florence/hurricane-florence_00000215_post_disaster.png,31,25,1,228,259,205,230,228,22.926042365301022,13.310974942410686
13958,/media/marda/TWOTB1/xBD/hurricanes/images/florence/hurricane-florence_00000215_post_disaster.png,33,40,1,200,233,244,284,648,32.47682712398745,26.42064913511234
13959,/media/marda/TWOTB1/xBD/hurricanes/images/florence/hurricane-florence_00000215_post_disaster.png,64,36,1,196,260,393,429,1150,64.46230298714228,23.649399010462453
13960,/media/marda/TWOTB1/xBD/hurricanes/images/florence/hurricane-florence_00000215_post_disaster.png,45,57,1,316,361,495,552,738,33.18090944555775,29.251177014564785
13961,/media/marda/TWOTB1/xBD/hurricanes/images/florence/hurricane-florence_00000215_post_disaster.png,24,36,1,363,387,579,615,156,16.602280055097328,12.632521602379171
13962,/media/marda/TWOTB1/xBD/hurricanes/images/florence/hurricane-florence_00000215_post_disaster.png,43,60,1,250,293,765,825,592,33.48501743239391,23.459570404505776
13963,/media/marda/TWOTB1/xBD/hurricanes/images/florence/hurricane-florence_00000215_post_disaster.png,42,67,1,185,227,788,855,670,31.652899237355594,28.132115478695507
13964,/media/marda/TWOTB1/xBD/hurricanes/images/florence/hurricane-florence_00000215_post_disaster.png,17,43,1,0,17,415,458,325,26.05794758685693,16.91329177205118
13965,/media/marda/TWOTB1/xBD/hurricanes/images/florence/hurricane-florence_00000215_post_disaster.png,26,30,1,133,159,426,456,239,22.69002445033367,14.129260293609002
13966,/media/marda/TWOTB1/xBD/hurricanes/images/florence/hurricane-florence_00000215_post_disaster.png,16,36,1,149,165,452,488,240,23.065125189341593,13.808210118138652
13967,/media/marda/TWOTB1/xBD/hurricanes/images/florence/hurricane-florence_00000215_post_disaster.png,43,53,1,327,370,603,656,575,30.108214664106928,25.32892443714702
13968,/media/marda/TWOTB1/xBD/hurricanes/images/florence/hurricane-florence_00000215_post_disaster.png,38,83,1,69,107,958,1041,1020,46.268751601193486,29.370233084432847
13969,/media/marda/TWOTB1/xBD/hurricanes/images/florence/hurricane-florence_00000325_post_disaster.png,45,24,1,559,604,97,121,300,22.236140509766795,18.040160436183527
13970,/media/marda/TWOTB1/xBD/hurricanes/images/florence/hurricane-florence_00000325_post_disaster.png,32,10,1,582,614,97,107,50,8.916820244024562,7.627576072105328
13971,/media/marda/TWOTB1/xBD/hurricanes/images/florence/hurricane-florence_00000325_post_disaster.png,63,45,1,585,648,106,151,682,50.310400618861074,18.14975582312128
13972,/media/marda/TWOTB1/xBD/hurricanes/images/florence/hurricane-florence_00000325_post_disaster.png,48,32,1,533,581,117,149,317,31.797504947977977,15.994668037521139
13973,/media/marda/TWOTB1/xBD/hurricanes/images/florence/hurricane-florence_00000325_post_disaster.png,51,68,1,111,162,133,201,1152,68.63640853691375,36.15868288956603
13974,/media/marda/TWOTB1/xBD/hurricanes/images/florence/hurricane-florence_00000325_post_disaster.png,36,20,1,519,555,141,161,135,14.57834618718229,12.494331146038174
13975,/media/marda/TWOTB1/xBD/hurricanes/images/florence/hurricane-florence_00000325_post_disaster.png,54,33,1,563,617,151,184,418,33.379761395680106,16.86130361418412
13976,/media/marda/TWOTB1/xBD/hurricanes/images/florence/hurricane-florence_00000325_post_disaster.png,52,35,1,634,686,155,190,499,28.968817672892182,22.40310434281474
13977,/media/marda/TWOTB1/xBD/hurricanes/images/florence/hurricane-florence_00000325_post_disaster.png,21,20,1,104,125,157,177,137,14.067118420371223,13.043545576517978
13978,/media/marda/TWOTB1/xBD/hurricanes/images/florence/hurricane-florence_00000325_post_disaster.png,57,33,1,732,789,178,211,407,28.165867920416193,19.3108831028341
13979,/media/marda/TWOTB1/xBD/hurricanes/images/florence/hurricane-florence_00000325_post_disaster.png,52,47,1,232,284,184,231,898,39.37537872979023,30.802197121722926
13980,/media/marda/TWOTB1/xBD/hurricanes/images/florence/hurricane-florence_00000325_post_disaster.png,48,57,1,189,237,219,276,1135,41.800679875510774,35.76947392725605
13981,/media/marda/TWOTB1/xBD/hurricanes/images/florence/hurricane-florence_00000325_post_disaster.png,83,60,1,615,698,226,286,1624,52.97839773934957,42.420730073214386
13982,/media/marda/TWOTB1/xBD/hurricanes/images/florence/hurricane-florence_00000325_post_disaster.png,83,48,1,678,761,231,279,1014,60.70539689497944,26.568782129352666
13983,/media/marda/TWOTB1/xBD/hurricanes/images/florence/hurricane-florence_00000325_post_disaster.png,33,32,1,219,252,251,283,297,22.68217739507382,17.514917970163456
13984,/media/marda/TWOTB1/xBD/hurricanes/images/florence/hurricane-florence_00000325_post_disaster.png,50,23,1,961,1011,269,292,110,12.943198719564473,11.37537809220315
13985,/media/marda/TWOTB1/xBD/hurricanes/images/florence/hurricane-florence_00000325_post_disaster.png,93,65,1,870,963,322,387,1524,62.88000655724633,31.819321256127203
13986,/media/marda/TWOTB1/xBD/hurricanes/images/florence/hurricane-florence_00000325_post_disaster.png,70,46,1,929,999,341,387,590,28.30311650187316,27.84931675533571
13987,/media/marda/TWOTB1/xBD/hurricanes/images/florence/hurricane-florence_00000325_post_disaster.png,32,44,1,129,161,508,552,385,25.477820451613805,20.221261924000526
13988,/media/marda/TWOTB1/xBD/hurricanes/images/florence/hurricane-florence_00000325_post_disaster.png,19,36,1,169,188,616,652,157,16.546689567283703,12.503426329886166
13989,/media/marda/TWOTB1/xBD/hurricanes/images/florence/hurricane-florence_00000325_post_disaster.png,87,84,1,866,953,692,776,1397,55.22505941893659,34.10504377445734
13990,/media/marda/TWOTB1/xBD/hurricanes/images/florence/hurricane-florence_00000325_post_disaster.png,94,122,1,688,782,779,901,3635,94.87934823399173,50.78675511186662
13991,/media/marda/TWOTB1/xBD/hurricanes/images/florence/hurricane-florence_00000325_post_disaster.png,67,64,1,828,895,783,847,751,31.918981858136856,31.25481855337944
13992,/media/marda/TWOTB1/xBD/hurricanes/images/florence/hurricane-florence_00000325_post_disaster.png,78,78,1,939,1017,793,871,1004,50.13479174438946,26.518474137981542
13993,/media/marda/TWOTB1/xBD/hurricanes/images/florence/hurricane-florence_00000325_post_disaster.png,47,51,1,624,671,875,926,263,23.059755397674444,15.122181072150777
13994,/media/marda/TWOTB1/xBD/hurricanes/images/florence/hurricane-florence_00000325_post_disaster.png,193,132,1,540,733,895,1027,5760,196.1066677652002,39.06531111249033
13995,/media/marda/TWOTB1/xBD/hurricanes/images/florence/hurricane-florence_00000325_post_disaster.png,63,70,1,981,1044,922,992,494,36.235187371212696,17.87573966769852
13996,/media/marda/TWOTB1/xBD/hurricanes/images/florence/hurricane-florence_00000325_post_disaster.png,64,49,1,486,550,148,197,1207,42.06791333698649,37.4707048851536
13997,/media/marda/TWOTB1/xBD/hurricanes/images/florence/hurricane-florence_00000325_post_disaster.png,33,17,1,491,524,0,17,136,18.558006773748826,9.842797437827414
13998,/media/marda/TWOTB1/xBD/hurricanes/images/florence/hurricane-florence_00000325_post_disaster.png,48,25,1,516,564,0,25,407,25.828706683296033,20.884364371511523
13999,/media/marda/TWOTB1/xBD/hurricanes/images/florence/hurricane-florence_00000325_post_disaster.png,64,35,1,583,647,0,35,810,40.06708889212892,26.916461199771515
14000,/media/marda/TWOTB1/xBD/hurricanes/images/florence/hurricane-florence_00000325_post_disaster.png,41,9,1,661,702,0,9,88,14.778333646721599,8.390004585232708
14001,/media/marda/TWOTB1/xBD/hurricanes/images/florence/hurricane-florence_00000325_post_disaster.png,52,41,1,454,506,59,100,449,46.06327821796306,16.40043556494318
14002,/media/marda/TWOTB1/xBD/hurricanes/images/florence/hurricane-florence_00000325_post_disaster.png,64,48,1,404,468,77,125,1374,43.214089124188256,41.88242223594565
14003,/media/marda/TWOTB1/xBD/hurricanes/images/florence/hurricane-florence_00000419_pre_disaster.png,22,47,1,19,41,70,117,1024,53.75404742802571,25.35959411196346
14004,/media/marda/TWOTB1/xBD/hurricanes/images/florence/hurricane-florence_00000419_pre_disaster.png,24,27,1,276,300,110,137,329,24.377609211930086,17.748948495214478
14005,/media/marda/TWOTB1/xBD/hurricanes/images/florence/hurricane-florence_00000419_pre_disaster.png,19,37,1,246,265,114,151,346,38.09364405428395,12.099908206507576
14006,/media/marda/TWOTB1/xBD/hurricanes/images/florence/hurricane-florence_00000419_pre_disaster.png,20,38,1,258,278,114,152,397,38.19216883234985,13.834425240986231
14007,/media/marda/TWOTB1/xBD/hurricanes/images/florence/hurricane-florence_00000419_pre_disaster.png,17,39,1,2,19,189,228,562,39.323940164607976,19.066154117619774
14008,/media/marda/TWOTB1/xBD/hurricanes/images/florence/hurricane-florence_00000419_pre_disaster.png,42,30,1,281,323,283,313,617,36.459315551244295,22.62323334046466
14009,/media/marda/TWOTB1/xBD/hurricanes/images/florence/hurricane-florence_00000344_post_disaster.png,50,16,1,129,179,0,16,508,48.96973125594249,14.429612996105963
14010,/media/marda/TWOTB1/xBD/hurricanes/images/florence/hurricane-florence_00000344_post_disaster.png,49,25,1,250,299,23,48,818,45.80135824323046,23.859236855789977
14011,/media/marda/TWOTB1/xBD/hurricanes/images/florence/hurricane-florence_00000344_post_disaster.png,52,49,1,916,968,26,75,727,56.26070722960485,17.17259569356296
14012,/media/marda/TWOTB1/xBD/hurricanes/images/florence/hurricane-florence_00000344_post_disaster.png,78,20,1,966,1044,42,62,569,43.405618591132495,18.824682914397105
14013,/media/marda/TWOTB1/xBD/hurricanes/images/florence/hurricane-florence_00000344_post_disaster.png,35,22,1,183,218,18,40,542,31.99070653734708,22.52554094208279
14014,/media/marda/TWOTB1/xBD/hurricanes/images/florence/hurricane-florence_00000344_post_disaster.png,67,28,1,381,448,26,54,1209,57.56313679277652,27.941199410441712
14015,/media/marda/TWOTB1/xBD/hurricanes/images/florence/hurricane-florence_00000344_post_disaster.png,47,47,1,866,913,28,75,701,53.9655273984617,17.246090947237153
14016,/media/marda/TWOTB1/xBD/hurricanes/images/florence/hurricane-florence_00000344_post_disaster.png,68,22,1,743,811,34,56,722,44.60728343467524,21.49744858478926
14017,/media/marda/TWOTB1/xBD/hurricanes/images/florence/hurricane-florence_00000344_post_disaster.png,46,35,1,827,873,49,84,443,39.37885787453612,15.014681021556536
14018,/media/marda/TWOTB1/xBD/hurricanes/images/florence/hurricane-florence_00000212_post_disaster.png,58,48,1,60,118,105,153,1449,56.301658886064665,34.85298342298232
14019,/media/marda/TWOTB1/xBD/hurricanes/images/florence/hurricane-florence_00000212_post_disaster.png,47,45,1,659,706,360,405,709,36.805898157556015,25.527250412982838
14020,/media/marda/TWOTB1/xBD/hurricanes/images/florence/hurricane-florence_00000212_post_disaster.png,86,45,1,891,977,392,437,1202,54.43679439428952,29.601865375270144
14021,/media/marda/TWOTB1/xBD/hurricanes/images/florence/hurricane-florence_00000212_post_disaster.png,56,56,1,115,171,396,452,1534,51.82366198310085,38.588287328950734
14022,/media/marda/TWOTB1/xBD/hurricanes/images/florence/hurricane-florence_00000212_post_disaster.png,60,47,1,983,1043,408,455,424,29.683205266237497,19.59504069628924
14023,/media/marda/TWOTB1/xBD/hurricanes/images/florence/hurricane-florence_00000212_post_disaster.png,22,30,1,138,160,437,467,188,18.73630901396844,13.300632062462903
14024,/media/marda/TWOTB1/xBD/hurricanes/images/florence/hurricane-florence_00000212_post_disaster.png,63,38,1,910,973,449,487,500,29.05801604780158,22.921550195519192
14025,/media/marda/TWOTB1/xBD/hurricanes/images/florence/hurricane-florence_00000212_post_disaster.png,23,31,1,148,171,463,494,246,20.556601597694225,15.989891901288619
14026,/media/marda/TWOTB1/xBD/hurricanes/images/florence/hurricane-florence_00000212_post_disaster.png,59,40,1,580,639,479,519,731,40.823052229782036,23.801103075250772
14027,/media/marda/TWOTB1/xBD/hurricanes/images/florence/hurricane-florence_00000212_post_disaster.png,56,41,1,503,559,504,545,589,39.32586030386793,20.50414278458874
14028,/media/marda/TWOTB1/xBD/hurricanes/images/florence/hurricane-florence_00000212_post_disaster.png,32,36,1,305,337,511,547,235,21.924525728074777,14.222356524407695
14029,/media/marda/TWOTB1/xBD/hurricanes/images/florence/hurricane-florence_00000212_post_disaster.png,40,40,1,295,335,534,574,371,28.997428608604668,16.95624710763224
14030,/media/marda/TWOTB1/xBD/hurricanes/images/florence/hurricane-florence_00000212_post_disaster.png,69,37,1,346,415,536,573,574,61.62699280169782,12.45220909439302
14031,/media/marda/TWOTB1/xBD/hurricanes/images/florence/hurricane-florence_00000212_post_disaster.png,50,63,1,555,605,557,620,943,47.71551615221498,26.41485460735995
14032,/media/marda/TWOTB1/xBD/hurricanes/images/florence/hurricane-florence_00000212_post_disaster.png,45,37,1,506,551,571,608,348,27.404042709991433,17.20617323625999
14033,/media/marda/TWOTB1/xBD/hurricanes/images/florence/hurricane-florence_00000212_post_disaster.png,35,31,1,597,632,572,603,106,12.305608040770615,11.523016702032022
14034,/media/marda/TWOTB1/xBD/hurricanes/images/florence/hurricane-florence_00000212_post_disaster.png,29,35,1,493,522,573,608,113,15.251383679820616,9.968414888085936
14035,/media/marda/TWOTB1/xBD/hurricanes/images/florence/hurricane-florence_00000212_post_disaster.png,30,43,1,351,381,578,621,372,25.24657691119115,19.586029486679166
14036,/media/marda/TWOTB1/xBD/hurricanes/images/florence/hurricane-florence_00000212_post_disaster.png,25,34,1,363,388,599,633,102,14.68350854666666,9.386532643134032
14037,/media/marda/TWOTB1/xBD/hurricanes/images/florence/hurricane-florence_00000212_post_disaster.png,70,48,1,904,974,680,728,676,36.73297421082909,24.48725204259576
14038,/media/marda/TWOTB1/xBD/hurricanes/images/florence/hurricane-florence_00000212_post_disaster.png,49,37,1,902,951,720,757,93,15.23108933244425,8.228781348309465
14039,/media/marda/TWOTB1/xBD/hurricanes/images/florence/hurricane-florence_00000212_post_disaster.png,81,63,1,764,845,790,853,1265,54.58590678504129,30.718227750516142
14040,/media/marda/TWOTB1/xBD/hurricanes/images/florence/hurricane-florence_00000212_post_disaster.png,63,58,1,893,956,791,849,390,26.287036965934153,19.52360220959901
14041,/media/marda/TWOTB1/xBD/hurricanes/images/florence/hurricane-florence_00000433_pre_disaster.png,60,35,1,984,1044,0,35,435,39.57263981497671,18.255637048118476
14042,/media/marda/TWOTB1/xBD/hurricanes/images/florence/hurricane-florence_00000433_pre_disaster.png,45,32,1,98,143,84,116,581,45.54566635659273,18.370086897385004
14043,/media/marda/TWOTB1/xBD/hurricanes/images/florence/hurricane-florence_00000433_pre_disaster.png,70,38,1,863,933,93,131,738,36.079331793862565,27.864606514310232
14044,/media/marda/TWOTB1/xBD/hurricanes/images/florence/hurricane-florence_00000433_pre_disaster.png,56,25,1,907,963,117,142,216,18.367347962383604,15.895403374706634
14045,/media/marda/TWOTB1/xBD/hurricanes/images/florence/hurricane-florence_00000433_pre_disaster.png,75,46,1,969,1044,132,178,767,43.1947611484637,25.440088666332045
14046,/media/marda/TWOTB1/xBD/hurricanes/images/florence/hurricane-florence_00000433_pre_disaster.png,18,17,1,23,41,140,157,128,16.53880872055161,10.641028050898374
14047,/media/marda/TWOTB1/xBD/hurricanes/images/florence/hurricane-florence_00000433_pre_disaster.png,29,37,1,66,95,145,182,410,38.7820542335082,16.325690329344276
14048,/media/marda/TWOTB1/xBD/hurricanes/images/florence/hurricane-florence_00000433_pre_disaster.png,68,37,1,753,821,149,186,475,45.03662453871977,14.546547210728479
14049,/media/marda/TWOTB1/xBD/hurricanes/images/florence/hurricane-florence_00000433_pre_disaster.png,70,38,1,908,978,169,207,651,30.393208079687966,28.291787136003144
14050,/media/marda/TWOTB1/xBD/hurricanes/images/florence/hurricane-florence_00000433_pre_disaster.png,35,32,1,248,283,176,208,329,30.60609006498529,14.36234459518825
14051,/media/marda/TWOTB1/xBD/hurricanes/images/florence/hurricane-florence_00000433_pre_disaster.png,74,82,1,455,529,199,281,1799,78.35768126545054,40.40039730098816
14052,/media/marda/TWOTB1/xBD/hurricanes/images/florence/hurricane-florence_00000433_pre_disaster.png,80,53,1,667,747,206,259,1140,56.538748806198015,26.79554562596786
14053,/media/marda/TWOTB1/xBD/hurricanes/images/florence/hurricane-florence_00000433_pre_disaster.png,40,37,1,284,324,215,252,420,33.19344758147701,16.735030648542754
14054,/media/marda/TWOTB1/xBD/hurricanes/images/florence/hurricane-florence_00000433_pre_disaster.png,50,49,1,200,250,235,284,689,48.95106345775146,18.821637998286523
14055,/media/marda/TWOTB1/xBD/hurricanes/images/florence/hurricane-florence_00000433_pre_disaster.png,58,49,1,319,377,235,284,739,53.004282771452644,19.59195409195222
14056,/media/marda/TWOTB1/xBD/hurricanes/images/florence/hurricane-florence_00000433_pre_disaster.png,36,53,1,59,95,254,307,929,40.21137830385406,31.46093249199584
14057,/media/marda/TWOTB1/xBD/hurricanes/images/florence/hurricane-florence_00000433_pre_disaster.png,73,65,1,361,434,258,323,1705,51.4308882312694,44.318415114361265
14058,/media/marda/TWOTB1/xBD/hurricanes/images/florence/hurricane-florence_00000433_pre_disaster.png,8,28,1,0,8,261,289,83,17.954870317112317,7.099303009928973
14059,/media/marda/TWOTB1/xBD/hurricanes/images/florence/hurricane-florence_00000433_pre_disaster.png,43,44,1,228,271,266,310,560,41.372595511968626,18.47602207249824
14060,/media/marda/TWOTB1/xBD/hurricanes/images/florence/hurricane-florence_00000433_pre_disaster.png,54,34,1,714,768,270,304,307,27.860834009696838,14.722872272611367
14061,/media/marda/TWOTB1/xBD/hurricanes/images/florence/hurricane-florence_00000433_pre_disaster.png,64,61,1,657,721,271,332,933,50.99722334004338,31.119679236822304
14062,/media/marda/TWOTB1/xBD/hurricanes/images/florence/hurricane-florence_00000433_pre_disaster.png,51,30,1,743,794,275,305,264,23.63270521651715,14.883541513000912
14063,/media/marda/TWOTB1/xBD/hurricanes/images/florence/hurricane-florence_00000433_pre_disaster.png,40,42,1,254,294,283,325,453,38.05747690139207,15.899474632766493
14064,/media/marda/TWOTB1/xBD/hurricanes/images/florence/hurricane-florence_00000433_pre_disaster.png,69,65,1,586,655,289,354,1300,52.642927599223725,36.63108591674144
14065,/media/marda/TWOTB1/xBD/hurricanes/images/florence/hurricane-florence_00000433_pre_disaster.png,44,30,1,676,720,315,345,163,15.06887761152957,14.488304741237009
14066,/media/marda/TWOTB1/xBD/hurricanes/images/florence/hurricane-florence_00000433_pre_disaster.png,38,25,1,651,689,320,345,96,12.955632344714871,9.890311279997434
14067,/media/marda/TWOTB1/xBD/hurricanes/images/florence/hurricane-florence_00000433_pre_disaster.png,64,58,1,137,201,336,394,1181,67.72060559108338,23.202570011504154
14068,/media/marda/TWOTB1/xBD/hurricanes/images/florence/hurricane-florence_00000433_pre_disaster.png,58,55,1,297,355,349,404,722,55.908625035843784,17.23015838532305
14069,/media/marda/TWOTB1/xBD/hurricanes/images/florence/hurricane-florence_00000433_pre_disaster.png,40,41,1,217,257,382,423,497,30.21802429103743,21.97499634500174
14070,/media/marda/TWOTB1/xBD/hurricanes/images/florence/hurricane-florence_00000433_pre_disaster.png,52,32,1,611,663,382,414,276,26.724965426754437,13.82207274248158
14071,/media/marda/TWOTB1/xBD/hurricanes/images/florence/hurricane-florence_00000433_pre_disaster.png,39,34,1,445,484,400,434,282,22.514336331087005,16.759406589019964
14072,/media/marda/TWOTB1/xBD/hurricanes/images/florence/hurricane-florence_00000433_pre_disaster.png,48,48,1,495,543,404,452,522,31.99315487103197,22.069615989936302
14073,/media/marda/TWOTB1/xBD/hurricanes/images/florence/hurricane-florence_00000433_pre_disaster.png,32,48,1,0,32,412,460,644,35.187987959443326,24.03868778823626
14074,/media/marda/TWOTB1/xBD/hurricanes/images/florence/hurricane-florence_00000433_pre_disaster.png,36,33,1,521,557,414,447,142,15.986687150988741,11.968405714415859
14075,/media/marda/TWOTB1/xBD/hurricanes/images/florence/hurricane-florence_00000433_pre_disaster.png,44,57,1,436,480,416,473,816,43.522326737269935,24.924645781614384
14076,/media/marda/TWOTB1/xBD/hurricanes/images/florence/hurricane-florence_00000433_pre_disaster.png,42,61,1,48,90,514,575,888,34.90989982495853,33.959925711106706
14077,/media/marda/TWOTB1/xBD/hurricanes/images/florence/hurricane-florence_00000433_pre_disaster.png,60,63,1,576,636,565,628,1136,42.378812874234974,35.92152329751758
14078,/media/marda/TWOTB1/xBD/hurricanes/images/florence/hurricane-florence_00000433_pre_disaster.png,46,60,1,189,235,602,662,799,37.15612607574015,28.26427793945172
14079,/media/marda/TWOTB1/xBD/hurricanes/images/florence/hurricane-florence_00000433_pre_disaster.png,27,46,1,210,237,632,678,219,18.276244403434838,15.928813596589858
14080,/media/marda/TWOTB1/xBD/hurricanes/images/florence/hurricane-florence_00000433_pre_disaster.png,47,48,1,585,632,638,686,344,22.412609005622613,20.543783745560116
14081,/media/marda/TWOTB1/xBD/hurricanes/images/florence/hurricane-florence_00000433_pre_disaster.png,53,65,1,79,132,642,707,710,60.05438946868211,15.78691556587334
14082,/media/marda/TWOTB1/xBD/hurricanes/images/florence/hurricane-florence_00000433_pre_disaster.png,20,36,1,232,252,649,685,72,10.127654814476266,9.609588347360633
14083,/media/marda/TWOTB1/xBD/hurricanes/images/florence/hurricane-florence_00000433_pre_disaster.png,48,65,1,99,147,655,720,885,46.58667530295433,25.364115347723992
14084,/media/marda/TWOTB1/xBD/hurricanes/images/florence/hurricane-florence_00000433_pre_disaster.png,44,64,1,196,240,687,751,758,39.24684792568231,25.609830155987964
14085,/media/marda/TWOTB1/xBD/hurricanes/images/florence/hurricane-florence_00000433_pre_disaster.png,18,43,1,154,172,686,729,106,12.782238216082495,11.169266477025714
14086,/media/marda/TWOTB1/xBD/hurricanes/images/florence/hurricane-florence_00000433_pre_disaster.png,45,57,1,384,429,686,743,505,29.572199367589057,22.675905453277075
14087,/media/marda/TWOTB1/xBD/hurricanes/images/florence/hurricane-florence_00000433_pre_disaster.png,30,45,1,312,342,698,743,228,18.6306563669325,16.368136100665687
14088,/media/marda/TWOTB1/xBD/hurricanes/images/florence/hurricane-florence_00000433_pre_disaster.png,19,44,1,130,149,705,749,119,14.810099269971323,10.760463510723783
14089,/media/marda/TWOTB1/xBD/hurricanes/images/florence/hurricane-florence_00000433_pre_disaster.png,65,69,1,298,363,716,785,762,61.16978428946465,17.855040880606552
14090,/media/marda/TWOTB1/xBD/hurricanes/images/florence/hurricane-florence_00000433_pre_disaster.png,47,58,1,192,239,863,921,446,45.3781953601719,13.131404184162466
14091,/media/marda/TWOTB1/xBD/hurricanes/images/florence/hurricane-florence_00000433_pre_disaster.png,9,54,1,0,9,884,938,86,15.70944305973323,8.3922101423387
14092,/media/marda/TWOTB1/xBD/hurricanes/images/florence/hurricane-florence_00000433_pre_disaster.png,66,74,1,278,344,893,967,1086,58.017377461784086,25.398286117112956
14093,/media/marda/TWOTB1/xBD/hurricanes/images/florence/hurricane-florence_00000433_pre_disaster.png,50,78,1,270,320,947,1025,1208,43.44675965145411,36.65396243873801
14094,/media/marda/TWOTB1/xBD/hurricanes/images/florence/hurricane-florence_00000433_pre_disaster.png,86,90,1,350,436,952,1042,2211,76.04897713789394,39.38040308134076
14095,/media/marda/TWOTB1/xBD/hurricanes/images/florence/hurricane-florence_00000311_pre_disaster.png,28,19,1,291,319,0,19,282,22.68948716088564,16.562666577247015
14096,/media/marda/TWOTB1/xBD/hurricanes/images/florence/hurricane-florence_00000311_pre_disaster.png,19,10,1,270,289,11,21,105,12.34801186491647,11.267841173323225
14097,/media/marda/TWOTB1/xBD/hurricanes/images/florence/hurricane-florence_00000311_pre_disaster.png,38,53,1,434,472,307,360,576,44.31357136540809,19.09883970169153
14098,/media/marda/TWOTB1/xBD/hurricanes/images/florence/hurricane-florence_00000311_pre_disaster.png,26,22,1,461,487,317,339,68,10.218753853058553,8.902542916641433
14099,/media/marda/TWOTB1/xBD/hurricanes/images/florence/hurricane-florence_00000311_pre_disaster.png,28,26,1,418,446,335,361,128,14.418164461635705,11.983278158843897
14100,/media/marda/TWOTB1/xBD/hurricanes/images/florence/hurricane-florence_00000311_pre_disaster.png,60,48,1,903,963,703,751,310,23.12605286771909,17.74698102120926
14101,/media/marda/TWOTB1/xBD/hurricanes/images/florence/hurricane-florence_00000311_pre_disaster.png,65,79,1,865,930,716,795,842,55.33645905534258,20.310129437118594
14102,/media/marda/TWOTB1/xBD/hurricanes/images/florence/hurricane-florence_00000311_pre_disaster.png,52,46,1,906,958,727,773,189,17.04671957832748,14.87091743871583
14103,/media/marda/TWOTB1/xBD/hurricanes/images/florence/hurricane-florence_00000311_pre_disaster.png,59,47,1,940,999,752,799,269,22.232359230841066,16.18511896606893
14104,/media/marda/TWOTB1/xBD/hurricanes/images/florence/hurricane-florence_00000311_pre_disaster.png,59,49,1,919,978,758,807,292,22.50531802710724,17.375675909275188
14105,/media/marda/TWOTB1/xBD/hurricanes/images/florence/hurricane-florence_00000311_pre_disaster.png,65,56,1,883,948,769,825,524,28.203909035544708,24.812991622991742
14106,/media/marda/TWOTB1/xBD/hurricanes/images/florence/hurricane-florence_00000311_pre_disaster.png,50,46,1,860,910,784,830,150,18.066677774490948,11.156843379411344
14107,/media/marda/TWOTB1/xBD/hurricanes/images/florence/hurricane-florence_00000311_pre_disaster.png,51,48,1,915,966,790,838,134,14.486593741147484,12.448872345496557
14108,/media/marda/TWOTB1/xBD/hurricanes/images/florence/hurricane-florence_00000311_pre_disaster.png,67,63,1,866,933,798,861,657,30.316492425122604,28.324307058366774
14109,/media/marda/TWOTB1/xBD/hurricanes/images/florence/hurricane-florence_00000311_pre_disaster.png,76,76,1,888,964,872,948,1114,44.43955028660081,33.62544343517435
14110,/media/marda/TWOTB1/xBD/hurricanes/images/florence/hurricane-florence_00000311_pre_disaster.png,52,53,1,938,990,882,935,172,16.10466411056615,14.30198484931475
14111,/media/marda/TWOTB1/xBD/hurricanes/images/florence/hurricane-florence_00000311_pre_disaster.png,64,55,1,951,1015,989,1044,300,27.87917566590265,14.559221887433388
14112,/media/marda/TWOTB1/xBD/hurricanes/images/florence/hurricane-florence_00000205_post_disaster.png,86,54,1,712,798,230,284,1561,64.70860276737946,32.21487220953711
14113,/media/marda/TWOTB1/xBD/hurricanes/images/florence/hurricane-florence_00000205_post_disaster.png,102,53,1,853,955,268,321,1625,74.19398228153939,29.099632093885994
14114,/media/marda/TWOTB1/xBD/hurricanes/images/florence/hurricane-florence_00000205_post_disaster.png,52,27,1,817,869,279,306,241,21.920861928992725,14.740880217542951
14115,/media/marda/TWOTB1/xBD/hurricanes/images/florence/hurricane-florence_00000205_post_disaster.png,97,56,1,946,1043,330,386,1687,61.440211871355366,38.138250081950865
14116,/media/marda/TWOTB1/xBD/hurricanes/images/florence/hurricane-florence_00000277_pre_disaster.png,63,23,1,99,162,49,72,928,63.18504807161575,19.273151268513324
14117,/media/marda/TWOTB1/xBD/hurricanes/images/florence/hurricane-florence_00000277_pre_disaster.png,61,43,1,87,148,128,171,1267,58.23977215182082,33.35399458280308
14118,/media/marda/TWOTB1/xBD/hurricanes/images/florence/hurricane-florence_00000277_pre_disaster.png,44,41,1,172,216,138,179,1033,38.37248921133743,35.667182581608046
14119,/media/marda/TWOTB1/xBD/hurricanes/images/florence/hurricane-florence_00000277_pre_disaster.png,51,19,1,993,1044,193,212,165,17.281975195754296,12.649110640673518
14120,/media/marda/TWOTB1/xBD/hurricanes/images/florence/hurricane-florence_00000277_pre_disaster.png,33,19,1,174,207,196,215,299,29.450508239544256,13.550154295972048
14121,/media/marda/TWOTB1/xBD/hurricanes/images/florence/hurricane-florence_00000277_pre_disaster.png,31,29,1,169,200,210,239,429,27.961224406558145,20.535356876086627
14122,/media/marda/TWOTB1/xBD/hurricanes/images/florence/hurricane-florence_00000277_pre_disaster.png,19,20,1,179,198,257,277,152,17.476893263119017,11.672292508151978
14123,/media/marda/TWOTB1/xBD/hurricanes/images/florence/hurricane-florence_00000277_pre_disaster.png,56,42,1,909,965,432,474,385,25.079716688844584,20.209442852644575
14124,/media/marda/TWOTB1/xBD/hurricanes/images/florence/hurricane-florence_00000277_pre_disaster.png,57,54,1,819,876,774,828,300,27.969205016277947,14.328185652438549
14125,/media/marda/TWOTB1/xBD/hurricanes/images/florence/hurricane-florence_00000277_pre_disaster.png,52,86,1,917,969,786,872,806,62.200653598263436,17.22926819640328
14126,/media/marda/TWOTB1/xBD/hurricanes/images/florence/hurricane-florence_00000277_pre_disaster.png,42,42,1,861,903,792,834,100,11.489125293076057,11.489125293076057
14127,/media/marda/TWOTB1/xBD/hurricanes/images/florence/hurricane-florence_00000277_pre_disaster.png,87,58,1,849,936,818,876,1139,59.17542989284273,25.606061869537285
14128,/media/marda/TWOTB1/xBD/hurricanes/images/florence/hurricane-florence_00000277_pre_disaster.png,46,48,1,824,870,849,897,161,17.230524197936376,12.816555071269477
14129,/media/marda/TWOTB1/xBD/hurricanes/images/florence/hurricane-florence_00000277_pre_disaster.png,45,40,1,875,920,849,889,80,11.704871156226073,8.923339689608758
14130,/media/marda/TWOTB1/xBD/hurricanes/images/florence/hurricane-florence_00000365_post_disaster.png,63,32,1,452,515,12,44,902,50.73558279825305,23.470735855286936
14131,/media/marda/TWOTB1/xBD/hurricanes/images/florence/hurricane-florence_00000365_post_disaster.png,78,63,1,865,943,499,562,618,57.445082939382516,14.312990031160721
14132,/media/marda/TWOTB1/xBD/hurricanes/images/florence/hurricane-florence_00000365_post_disaster.png,58,54,1,986,1044,548,602,480,35.47230587323519,18.22721833571613
14133,/media/marda/TWOTB1/xBD/hurricanes/images/florence/hurricane-florence_00000365_post_disaster.png,55,43,1,832,887,769,812,261,26.233532341859473,13.28014289927122
14134,/media/marda/TWOTB1/xBD/hurricanes/images/florence/hurricane-florence_00000365_post_disaster.png,88,61,1,888,976,783,844,1466,61.817533025467434,33.75829041905473
14135,/media/marda/TWOTB1/xBD/hurricanes/images/florence/hurricane-florence_00000365_post_disaster.png,66,77,1,782,848,964,1041,1142,44.0821814471899,34.97426735662964
14136,/media/marda/TWOTB1/xBD/hurricanes/images/florence/hurricane-florence_00000365_post_disaster.png,56,26,1,622,678,0,26,579,30.549188979886296,25.49399275222566
14137,/media/marda/TWOTB1/xBD/hurricanes/images/florence/hurricane-florence_00000106_pre_disaster.png,36,33,1,173,209,29,62,492,29.94899888690166,21.97241884824649
14138,/media/marda/TWOTB1/xBD/hurricanes/images/florence/hurricane-florence_00000106_pre_disaster.png,35,37,1,111,146,62,99,603,35.07225259107344,22.821453328631122
14139,/media/marda/TWOTB1/xBD/hurricanes/images/florence/hurricane-florence_00000106_pre_disaster.png,15,15,1,51,66,70,85,124,14.129095524095195,11.813909240994192
14140,/media/marda/TWOTB1/xBD/hurricanes/images/florence/hurricane-florence_00000106_pre_disaster.png,55,57,1,43,98,106,163,1610,50.396480521818454,46.08545388596618
14141,/media/marda/TWOTB1/xBD/hurricanes/images/florence/hurricane-florence_00000106_pre_disaster.png,89,57,1,491,580,240,297,1976,72.01471989859016,37.55866880185762
14142,/media/marda/TWOTB1/xBD/hurricanes/images/florence/hurricane-florence_00000106_pre_disaster.png,70,60,1,593,663,269,329,1299,44.171285197407094,38.94334571592166
14143,/media/marda/TWOTB1/xBD/hurricanes/images/florence/hurricane-florence_00000106_pre_disaster.png,84,67,1,834,918,314,381,1441,56.16910243539477,35.255869342551875
14144,/media/marda/TWOTB1/xBD/hurricanes/images/florence/hurricane-florence_00000106_pre_disaster.png,44,48,1,349,393,475,523,534,29.765131426767518,24.209706600389854
14145,/media/marda/TWOTB1/xBD/hurricanes/images/florence/hurricane-florence_00000106_pre_disaster.png,75,88,1,278,353,485,573,2573,68.78196226847982,50.39633585532013
14146,/media/marda/TWOTB1/xBD/hurricanes/images/florence/hurricane-florence_00000106_pre_disaster.png,59,69,1,451,510,552,621,1116,47.56437629274488,31.435912352680436
14147,/media/marda/TWOTB1/xBD/hurricanes/images/florence/hurricane-florence_00000106_pre_disaster.png,37,43,1,402,439,582,625,261,23.38054382929062,14.875173346857492
14148,/media/marda/TWOTB1/xBD/hurricanes/images/florence/hurricane-florence_00000106_pre_disaster.png,40,58,1,361,401,697,755,454,28.63427438779038,20.97293504427
14149,/media/marda/TWOTB1/xBD/hurricanes/images/florence/hurricane-florence_00000069_pre_disaster.png,58,79,1,320,378,704,783,1519,47.664381542929746,42.51957008136125
14150,/media/marda/TWOTB1/xBD/hurricanes/images/florence/hurricane-florence_00000069_pre_disaster.png,32,46,1,265,297,713,759,247,25.406864190511975,13.02288932758351
14151,/media/marda/TWOTB1/xBD/hurricanes/images/florence/hurricane-florence_00000069_pre_disaster.png,32,48,1,369,401,775,823,245,19.166111962793035,16.98949163793792
14152,/media/marda/TWOTB1/xBD/hurricanes/images/florence/hurricane-florence_00000069_pre_disaster.png,56,69,1,392,448,784,853,1054,43.666967020890226,31.3768387387202
14153,/media/marda/TWOTB1/xBD/hurricanes/images/florence/hurricane-florence_00000069_pre_disaster.png,53,95,1,253,306,812,907,1696,62.35846712813222,37.96382905864735
14154,/media/marda/TWOTB1/xBD/hurricanes/images/florence/hurricane-florence_00000069_pre_disaster.png,22,58,1,62,84,859,917,365,23.777972634974898,20.474383963387012
14155,/media/marda/TWOTB1/xBD/hurricanes/images/florence/hurricane-florence_00000069_pre_disaster.png,46,47,1,815,861,913,960,89,14.567779621393392,8.252759434648457
14156,/media/marda/TWOTB1/xBD/hurricanes/images/florence/hurricane-florence_00000069_pre_disaster.png,75,89,1,785,860,916,1005,1289,55.761238742895515,32.0424281536504
14157,/media/marda/TWOTB1/xBD/hurricanes/images/florence/hurricane-florence_00000069_pre_disaster.png,49,70,1,108,157,958,1028,1000,45.38355892904893,28.706963387539663
14158,/media/marda/TWOTB1/xBD/hurricanes/images/florence/hurricane-florence_00000036_post_disaster.png,46,12,1,177,223,0,12,350,43.46846366985854,10.985018223283113
14159,/media/marda/TWOTB1/xBD/hurricanes/images/florence/hurricane-florence_00000036_post_disaster.png,46,11,1,498,544,0,11,225,28.337722035055258,10.67339041496953
14160,/media/marda/TWOTB1/xBD/hurricanes/images/florence/hurricane-florence_00000036_post_disaster.png,37,23,1,572,609,71,94,368,25.923242937260934,18.721553927915934
14161,/media/marda/TWOTB1/xBD/hurricanes/images/florence/hurricane-florence_00000036_post_disaster.png,38,21,1,417,455,75,96,395,23.55899471656234,22.222680426889532
14162,/media/marda/TWOTB1/xBD/hurricanes/images/florence/hurricane-florence_00000036_post_disaster.png,32,49,1,153,185,82,131,1012,52.629200979731536,25.664628052804115
14163,/media/marda/TWOTB1/xBD/hurricanes/images/florence/hurricane-florence_00000036_post_disaster.png,69,42,1,517,586,98,140,1326,54.70000847091664,34.70004950560142
14164,/media/marda/TWOTB1/xBD/hurricanes/images/florence/hurricane-florence_00000036_post_disaster.png,58,46,1,370,428,119,165,1317,48.7476995561392,38.100832247113125
14165,/media/marda/TWOTB1/xBD/hurricanes/images/florence/hurricane-florence_00000036_post_disaster.png,27,29,1,0,27,181,210,623,31.248540908680127,26.62510595889762
14166,/media/marda/TWOTB1/xBD/hurricanes/images/florence/hurricane-florence_00000036_post_disaster.png,53,56,1,196,249,212,268,1434,55.288704173009556,38.13864757966404
14167,/media/marda/TWOTB1/xBD/hurricanes/images/florence/hurricane-florence_00000036_post_disaster.png,67,48,1,528,595,214,262,1410,55.17516352419198,36.08381542313503
14168,/media/marda/TWOTB1/xBD/hurricanes/images/florence/hurricane-florence_00000036_post_disaster.png,63,64,1,371,434,238,302,1979,57.80621083682075,46.735487557187604
14169,/media/marda/TWOTB1/xBD/hurricanes/images/florence/hurricane-florence_00000036_post_disaster.png,49,31,1,588,637,254,285,441,25.93798657979634,22.498283263417722
14170,/media/marda/TWOTB1/xBD/hurricanes/images/florence/hurricane-florence_00000036_post_disaster.png,67,30,1,444,511,271,301,961,55.500369800066515,23.12825982800042
14171,/media/marda/TWOTB1/xBD/hurricanes/images/florence/hurricane-florence_00000036_post_disaster.png,44,35,1,373,417,342,377,529,32.41993547284643,21.75575141748278
14172,/media/marda/TWOTB1/xBD/hurricanes/images/florence/hurricane-florence_00000036_post_disaster.png,23,39,1,193,216,440,479,327,24.555720369231274,17.77548175584873
14173,/media/marda/TWOTB1/xBD/hurricanes/images/florence/hurricane-florence_00000036_post_disaster.png,49,35,1,217,266,446,481,652,44.51825351086523,19.27881961093987
14174,/media/marda/TWOTB1/xBD/hurricanes/images/florence/hurricane-florence_00000036_post_disaster.png,49,32,1,422,471,487,519,506,36.59377404002464,18.224728946498853
14175,/media/marda/TWOTB1/xBD/hurricanes/images/florence/hurricane-florence_00000036_post_disaster.png,59,79,1,461,520,496,575,1932,64.20798266408758,40.28492450018047
14176,/media/marda/TWOTB1/xBD/hurricanes/images/florence/hurricane-florence_00000036_post_disaster.png,46,59,1,385,431,500,559,1008,43.28281354027697,31.634469324098177
14177,/media/marda/TWOTB1/xBD/hurricanes/images/florence/hurricane-florence_00000036_post_disaster.png,12,32,1,160,172,514,546,90,13.829725346675374,8.627142384614592
14178,/media/marda/TWOTB1/xBD/hurricanes/images/florence/hurricane-florence_00000036_post_disaster.png,51,46,1,116,167,538,584,988,52.74793548202011,25.00665365511566
14179,/media/marda/TWOTB1/xBD/hurricanes/images/florence/hurricane-florence_00000036_post_disaster.png,80,65,1,199,279,547,612,2011,83.0214898679694,40.27134364729893
14180,/media/marda/TWOTB1/xBD/hurricanes/images/florence/hurricane-florence_00000036_post_disaster.png,59,122,1,456,515,605,727,2895,108.91843423300473,35.40725083950366
14181,/media/marda/TWOTB1/xBD/hurricanes/images/florence/hurricane-florence_00000036_post_disaster.png,44,48,1,240,284,611,659,664,37.709028432359254,23.229989646791324
14182,/media/marda/TWOTB1/xBD/hurricanes/images/florence/hurricane-florence_00000036_post_disaster.png,63,54,1,600,663,614,668,1125,43.45700772189582,34.49691690439117
14183,/media/marda/TWOTB1/xBD/hurricanes/images/florence/hurricane-florence_00000036_post_disaster.png,28,38,1,196,224,615,653,239,23.048530956332147,13.772346557982603
14184,/media/marda/TWOTB1/xBD/hurricanes/images/florence/hurricane-florence_00000036_post_disaster.png,24,37,1,197,221,652,689,150,17.02243528887729,11.870122490821073
14185,/media/marda/TWOTB1/xBD/hurricanes/images/florence/hurricane-florence_00000036_post_disaster.png,37,53,1,235,272,662,715,583,28.429267099870373,27.89708696485078
14186,/media/marda/TWOTB1/xBD/hurricanes/images/florence/hurricane-florence_00000036_post_disaster.png,32,58,1,143,175,682,740,758,35.64158863270919,28.40760743759474
14187,/media/marda/TWOTB1/xBD/hurricanes/images/florence/hurricane-florence_00000036_post_disaster.png,20,46,1,38,58,686,732,270,19.954558274723563,18.111814549704388
14188,/media/marda/TWOTB1/xBD/hurricanes/images/florence/hurricane-florence_00000036_post_disaster.png,44,86,1,211,255,692,778,1483,58.811671829370304,33.47440559205623
14189,/media/marda/TWOTB1/xBD/hurricanes/images/florence/hurricane-florence_00000036_post_disaster.png,23,52,1,147,170,723,775,316,23.855093987082764,17.70926410586406
14190,/media/marda/TWOTB1/xBD/hurricanes/images/florence/hurricane-florence_00000036_post_disaster.png,32,64,1,137,169,787,851,593,31.989904010087116,24.764779685173092
14191,/media/marda/TWOTB1/xBD/hurricanes/images/florence/hurricane-florence_00000036_post_disaster.png,45,86,1,200,245,800,886,1472,58.53187969558659,34.41842034374546
14192,/media/marda/TWOTB1/xBD/hurricanes/images/florence/hurricane-florence_00000036_post_disaster.png,16,45,1,140,156,826,871,110,12.799681582673466,11.618404577905213
14193,/media/marda/TWOTB1/xBD/hurricanes/images/florence/hurricane-florence_00000036_post_disaster.png,21,49,1,121,142,839,888,210,17.373117764178314,16.241524397448007
14194,/media/marda/TWOTB1/xBD/hurricanes/images/florence/hurricane-florence_00000036_post_disaster.png,54,72,1,178,232,910,982,1352,49.74043560758631,35.735416792917164
14195,/media/marda/TWOTB1/xBD/hurricanes/images/florence/hurricane-florence_00000036_post_disaster.png,25,52,1,151,176,935,987,320,23.261388431279826,18.30048655771537
14196,/media/marda/TWOTB1/xBD/hurricanes/images/florence/hurricane-florence_00000324_post_disaster.png,16,48,1,0,16,691,739,198,17.650583187183305,14.881781556118993
14197,/media/marda/TWOTB1/xBD/hurricanes/images/florence/hurricane-florence_00000324_post_disaster.png,28,62,1,0,28,376,438,895,47.0755919105705,28.147685681142942
14198,/media/marda/TWOTB1/xBD/hurricanes/images/florence/hurricane-florence_00000135_post_disaster.png,40,48,1,221,261,382,430,648,33.7708196703203,25.6340217169401
14199,/media/marda/TWOTB1/xBD/hurricanes/images/florence/hurricane-florence_00000135_post_disaster.png,42,44,1,544,586,740,784,163,23.958010946439323,9.046794555139162
14200,/media/marda/TWOTB1/xBD/hurricanes/images/florence/hurricane-florence_00000135_post_disaster.png,82,97,1,565,647,761,858,1604,82.33235866796134,28.171917857295977
14201,/media/marda/TWOTB1/xBD/hurricanes/images/florence/hurricane-florence_00000135_post_disaster.png,25,44,1,144,169,883,927,150,21.814531249700092,9.262032637498118
14202,/media/marda/TWOTB1/xBD/hurricanes/images/florence/hurricane-florence_00000135_post_disaster.png,82,87,1,636,718,906,993,1291,63.59434517174845,26.91164198023773
14203,/media/marda/TWOTB1/xBD/hurricanes/images/florence/hurricane-florence_00000343_post_disaster.png,34,14,1,288,322,0,14,188,20.88085025741278,13.099768889160407
14204,/media/marda/TWOTB1/xBD/hurricanes/images/florence/hurricane-florence_00000343_post_disaster.png,28,20,1,264,292,66,86,272,20.27204196581668,17.9439541630811
14205,/media/marda/TWOTB1/xBD/hurricanes/images/florence/hurricane-florence_00000343_post_disaster.png,52,50,1,177,229,69,119,1136,47.33820728744161,32.13234475620635
14206,/media/marda/TWOTB1/xBD/hurricanes/images/florence/hurricane-florence_00000343_post_disaster.png,27,25,1,274,301,93,118,331,24.991801292466768,17.704921598880606
14207,/media/marda/TWOTB1/xBD/hurricanes/images/florence/hurricane-florence_00000343_post_disaster.png,65,53,1,613,678,95,148,1191,53.31686095920902,29.813557864571386
14208,/media/marda/TWOTB1/xBD/hurricanes/images/florence/hurricane-florence_00000343_post_disaster.png,51,71,1,257,308,727,798,1036,40.5983097679703,33.97163533054578
14209,/media/marda/TWOTB1/xBD/hurricanes/images/florence/hurricane-florence_00000335_post_disaster.png,148,88,1,121,269,0,88,6326,126.96847571002846,69.63498664725104
14210,/media/marda/TWOTB1/xBD/hurricanes/images/florence/hurricane-florence_00000335_post_disaster.png,44,20,1,699,743,195,215,128,13.51390863960617,12.693473649099278
14211,/media/marda/TWOTB1/xBD/hurricanes/images/florence/hurricane-florence_00000335_post_disaster.png,116,98,1,600,716,284,382,3950,84.23587857833304,63.07712018159927
14212,/media/marda/TWOTB1/xBD/hurricanes/images/florence/hurricane-florence_00000335_post_disaster.png,127,103,1,826,953,381,484,4120,84.25311397935741,66.34940729932858
14213,/media/marda/TWOTB1/xBD/hurricanes/images/florence/hurricane-florence_00000335_post_disaster.png,50,55,1,336,386,406,461,502,49.39226496919721,13.570029076051014
14214,/media/marda/TWOTB1/xBD/hurricanes/images/florence/hurricane-florence_00000335_post_disaster.png,27,31,1,330,357,419,450,112,13.574568649644753,11.036879931807857
14215,/media/marda/TWOTB1/xBD/hurricanes/images/florence/hurricane-florence_00000335_post_disaster.png,40,43,1,300,340,425,468,407,25.158082166313683,21.507452623970398
14216,/media/marda/TWOTB1/xBD/hurricanes/images/florence/hurricane-florence_00000335_post_disaster.png,186,167,1,590,776,436,603,10176,177.25440962042455,76.86566634062845
14217,/media/marda/TWOTB1/xBD/hurricanes/images/florence/hurricane-florence_00000335_post_disaster.png,190,177,1,646,836,491,668,11214,180.7532793216613,83.00483864094842
14218,/media/marda/TWOTB1/xBD/hurricanes/images/florence/hurricane-florence_00000335_post_disaster.png,74,55,1,947,1021,532,587,431,47.233568921251624,12.134733411071563
14219,/media/marda/TWOTB1/xBD/hurricanes/images/florence/hurricane-florence_00000335_post_disaster.png,184,172,1,696,880,552,724,10255,168.71221557995165,81.06285555747384
14220,/media/marda/TWOTB1/xBD/hurricanes/images/florence/hurricane-florence_00000335_post_disaster.png,132,118,1,903,1035,614,732,4316,88.58845029673301,64.97227553080576
14221,/media/marda/TWOTB1/xBD/hurricanes/images/florence/hurricane-florence_00000335_post_disaster.png,57,45,1,890,947,656,701,203,22.084477307172893,12.250263895820423
14222,/media/marda/TWOTB1/xBD/hurricanes/images/florence/hurricane-florence_00000335_post_disaster.png,60,64,1,984,1044,692,756,368,29.78187600602153,19.063814918733364
14223,/media/marda/TWOTB1/xBD/hurricanes/images/florence/hurricane-florence_00000335_post_disaster.png,87,80,1,846,933,737,817,1353,52.23262691137381,34.3296869207611
14224,/media/marda/TWOTB1/xBD/hurricanes/images/florence/hurricane-florence_00000335_post_disaster.png,50,50,1,994,1044,819,869,98,15.968235209075704,8.894450951410297
14225,/media/marda/TWOTB1/xBD/hurricanes/images/florence/hurricane-florence_00000335_post_disaster.png,100,93,1,944,1044,830,923,1473,74.33099761160138,28.777732521087128
14226,/media/marda/TWOTB1/xBD/hurricanes/images/florence/hurricane-florence_00000335_post_disaster.png,72,106,1,972,1044,872,978,1277,63.40712488539861,31.119850362094333
14227,/media/marda/TWOTB1/xBD/hurricanes/images/florence/hurricane-florence_00000335_post_disaster.png,42,48,1,848,890,961,1009,73,10.775186576394377,9.177042905436041
14228,/media/marda/TWOTB1/xBD/hurricanes/images/florence/hurricane-florence_00000335_post_disaster.png,62,70,1,846,908,969,1039,612,32.89662828797599,24.852303716190523
14229,/media/marda/TWOTB1/xBD/hurricanes/images/florence/hurricane-florence_00000110_pre_disaster.png,30,16,1,163,193,0,16,291,25.67218207817685,15.399169972616825
14230,/media/marda/TWOTB1/xBD/hurricanes/images/florence/hurricane-florence_00000110_pre_disaster.png,59,20,1,293,352,0,20,686,51.35581418159012,18.207494400924404
14231,/media/marda/TWOTB1/xBD/hurricanes/images/florence/hurricane-florence_00000110_pre_disaster.png,107,85,1,759,866,0,85,3784,88.42117706345863,59.377451381616204
14232,/media/marda/TWOTB1/xBD/hurricanes/images/florence/hurricane-florence_00000110_pre_disaster.png,51,45,1,126,177,3,48,1384,44.92840179283126,40.72635341229802
14233,/media/marda/TWOTB1/xBD/hurricanes/images/florence/hurricane-florence_00000110_pre_disaster.png,16,14,1,87,103,4,18,133,13.78804234262056,12.805370491939486
14234,/media/marda/TWOTB1/xBD/hurricanes/images/florence/hurricane-florence_00000110_pre_disaster.png,47,45,1,85,132,20,65,1186,50.19074701108999,35.55057596609841
14235,/media/marda/TWOTB1/xBD/hurricanes/images/florence/hurricane-florence_00000110_pre_disaster.png,68,42,1,636,704,33,75,1039,51.753794725954165,27.839516904475403
14236,/media/marda/TWOTB1/xBD/hurricanes/images/florence/hurricane-florence_00000110_pre_disaster.png,61,32,1,580,641,49,81,846,39.62826998114609,27.927898703705793
14237,/media/marda/TWOTB1/xBD/hurricanes/images/florence/hurricane-florence_00000110_pre_disaster.png,101,41,1,457,558,73,114,2195,88.68452015367237,33.18143809878765
14238,/media/marda/TWOTB1/xBD/hurricanes/images/florence/hurricane-florence_00000110_pre_disaster.png,78,58,1,891,969,102,160,1287,58.51543329534099,30.247715309025747
14239,/media/marda/TWOTB1/xBD/hurricanes/images/florence/hurricane-florence_00000110_pre_disaster.png,84,52,1,339,423,107,159,2027,69.0373323289636,40.10803558268213
14240,/media/marda/TWOTB1/xBD/hurricanes/images/florence/hurricane-florence_00000110_pre_disaster.png,96,87,1,814,910,115,202,3458,84.66353840129018,54.270419304780035
14241,/media/marda/TWOTB1/xBD/hurricanes/images/florence/hurricane-florence_00000110_pre_disaster.png,42,15,1,784,826,124,139,93,11.866464933974974,10.371548556103237
14242,/media/marda/TWOTB1/xBD/hurricanes/images/florence/hurricane-florence_00000110_pre_disaster.png,79,84,1,752,831,136,220,2399,85.03538677726497,37.48000248178224
14243,/media/marda/TWOTB1/xBD/hurricanes/images/florence/hurricane-florence_00000110_pre_disaster.png,43,40,1,240,283,140,180,911,35.19283198881864,33.710251434680245
14244,/media/marda/TWOTB1/xBD/hurricanes/images/florence/hurricane-florence_00000110_pre_disaster.png,63,37,1,169,232,159,196,1164,60.28868432665721,28.44704767417516
14245,/media/marda/TWOTB1/xBD/hurricanes/images/florence/hurricane-florence_00000110_pre_disaster.png,39,29,1,251,290,179,208,502,32.174548364234965,20.655952559248103
14246,/media/marda/TWOTB1/xBD/hurricanes/images/florence/hurricane-florence_00000110_pre_disaster.png,84,61,1,890,974,184,245,1715,58.381477287393366,40.15216257234789
14247,/media/marda/TWOTB1/xBD/hurricanes/images/florence/hurricane-florence_00000110_pre_disaster.png,91,55,1,74,165,189,244,2669,92.32086501217327,38.27191155539155
14248,/media/marda/TWOTB1/xBD/hurricanes/images/florence/hurricane-florence_00000110_pre_disaster.png,55,44,1,640,695,198,242,859,36.69437917087174,30.871140731151055
14249,/media/marda/TWOTB1/xBD/hurricanes/images/florence/hurricane-florence_00000110_pre_disaster.png,41,30,1,491,532,199,229,360,24.534528410026017,19.28057942226115
14250,/media/marda/TWOTB1/xBD/hurricanes/images/florence/hurricane-florence_00000110_pre_disaster.png,61,46,1,490,551,221,267,916,39.082328792543635,32.60280725990557
14251,/media/marda/TWOTB1/xBD/hurricanes/images/florence/hurricane-florence_00000110_pre_disaster.png,25,26,1,141,166,254,280,254,21.973630954259566,15.496451614706697
14252,/media/marda/TWOTB1/xBD/hurricanes/images/florence/hurricane-florence_00000110_pre_disaster.png,63,34,1,960,1023,272,306,354,23.256573461159128,20.207237998673595
14253,/media/marda/TWOTB1/xBD/hurricanes/images/florence/hurricane-florence_00000110_pre_disaster.png,94,65,1,381,475,281,346,2727,87.28833535834264,46.23232675805608
14254,/media/marda/TWOTB1/xBD/hurricanes/images/florence/hurricane-florence_00000110_pre_disaster.png,79,58,1,902,981,293,351,1453,48.87035763551191,40.17280685297735
14255,/media/marda/TWOTB1/xBD/hurricanes/images/florence/hurricane-florence_00000110_pre_disaster.png,62,79,1,286,348,299,378,1863,70.08214793036106,44.01457342907732
14256,/media/marda/TWOTB1/xBD/hurricanes/images/florence/hurricane-florence_00000110_pre_disaster.png,13,35,1,0,13,304,339,242,23.5866589795635,13.709369848561785
14257,/media/marda/TWOTB1/xBD/hurricanes/images/florence/hurricane-florence_00000110_pre_disaster.png,35,38,1,210,245,315,353,455,28.363315608405497,22.004659230603117
14258,/media/marda/TWOTB1/xBD/hurricanes/images/florence/hurricane-florence_00000110_pre_disaster.png,92,80,1,905,997,336,416,2456,71.54369968039938,48.30449723666137
14259,/media/marda/TWOTB1/xBD/hurricanes/images/florence/hurricane-florence_00000110_pre_disaster.png,75,62,1,818,893,342,404,1202,53.08864747520121,31.010405582796814
14260,/media/marda/TWOTB1/xBD/hurricanes/images/florence/hurricane-florence_00000110_pre_disaster.png,56,50,1,236,292,350,400,1158,48.34463721642339,33.97556785274225
14261,/media/marda/TWOTB1/xBD/hurricanes/images/florence/hurricane-florence_00000110_pre_disaster.png,53,68,1,25,78,376,444,1532,55.77221782305987,43.50405910508665
14262,/media/marda/TWOTB1/xBD/hurricanes/images/florence/hurricane-florence_00000110_pre_disaster.png,125,72,1,919,1044,396,468,3026,93.20916163110715,47.55192809753409
14263,/media/marda/TWOTB1/xBD/hurricanes/images/florence/hurricane-florence_00000110_pre_disaster.png,75,61,1,747,822,398,459,1260,44.53994231500119,38.58302312705651
14264,/media/marda/TWOTB1/xBD/hurricanes/images/florence/hurricane-florence_00000110_pre_disaster.png,30,49,1,0,30,426,475,685,33.81198695770918,27.166962960711185
14265,/media/marda/TWOTB1/xBD/hurricanes/images/florence/hurricane-florence_00000110_pre_disaster.png,62,64,1,424,486,466,530,1281,47.31629282340065,39.597607020653896
14266,/media/marda/TWOTB1/xBD/hurricanes/images/florence/hurricane-florence_00000110_pre_disaster.png,55,62,1,320,375,484,546,1216,46.445486256129975,35.337477068538064
14267,/media/marda/TWOTB1/xBD/hurricanes/images/florence/hurricane-florence_00000110_pre_disaster.png,54,30,1,971,1025,488,518,161,16.497819554591633,12.91257705547456
14268,/media/marda/TWOTB1/xBD/hurricanes/images/florence/hurricane-florence_00000110_pre_disaster.png,44,56,1,266,310,502,558,832,33.6027107326746,32.4774668765132
14269,/media/marda/TWOTB1/xBD/hurricanes/images/florence/hurricane-florence_00000110_pre_disaster.png,50,65,1,220,270,517,582,1117,46.30071361113845,32.92307308254252
14270,/media/marda/TWOTB1/xBD/hurricanes/images/florence/hurricane-florence_00000110_pre_disaster.png,63,68,1,479,542,522,590,1378,47.737996358147214,38.49917157993026
14271,/media/marda/TWOTB1/xBD/hurricanes/images/florence/hurricane-florence_00000110_pre_disaster.png,55,90,1,162,217,533,623,1680,78.7536978893019,35.824716028339026
14272,/media/marda/TWOTB1/xBD/hurricanes/images/florence/hurricane-florence_00000110_pre_disaster.png,70,53,1,974,1044,560,613,769,37.54967512928912,27.340626581873572
14273,/media/marda/TWOTB1/xBD/hurricanes/images/florence/hurricane-florence_00000110_pre_disaster.png,44,56,1,312,356,574,630,729,35.95187311355743,27.336776595502876
14274,/media/marda/TWOTB1/xBD/hurricanes/images/florence/hurricane-florence_00000110_pre_disaster.png,43,112,1,0,43,584,696,2594,89.55645005211792,40.65278707359149
14275,/media/marda/TWOTB1/xBD/hurricanes/images/florence/hurricane-florence_00000110_pre_disaster.png,54,69,1,171,225,616,685,1715,58.58196066216961,41.58170621779843
14276,/media/marda/TWOTB1/xBD/hurricanes/images/florence/hurricane-florence_00000110_pre_disaster.png,78,113,1,558,636,618,731,2839,94.51643975074056,45.128551939571835
14277,/media/marda/TWOTB1/xBD/hurricanes/images/florence/hurricane-florence_00000110_pre_disaster.png,64,82,1,325,389,641,723,1779,55.22293191377802,45.941973112142854
14278,/media/marda/TWOTB1/xBD/hurricanes/images/florence/hurricane-florence_00000110_pre_disaster.png,72,74,1,972,1044,660,734,1171,51.127788068991464,30.175971264944447
14279,/media/marda/TWOTB1/xBD/hurricanes/images/florence/hurricane-florence_00000110_pre_disaster.png,108,63,1,898,1006,668,731,1550,80.8288774150149,25.393034624916485
14280,/media/marda/TWOTB1/xBD/hurricanes/images/florence/hurricane-florence_00000110_pre_disaster.png,80,58,1,843,923,687,745,1037,50.74300885298465,27.206792575603103
14281,/media/marda/TWOTB1/xBD/hurricanes/images/florence/hurricane-florence_00000110_pre_disaster.png,25,61,1,85,110,703,764,629,36.0795033368892,23.74714724465697
14282,/media/marda/TWOTB1/xBD/hurricanes/images/florence/hurricane-florence_00000110_pre_disaster.png,64,62,1,980,1044,716,778,685,33.07795235822347,27.448751634454144
14283,/media/marda/TWOTB1/xBD/hurricanes/images/florence/hurricane-florence_00000110_pre_disaster.png,87,98,1,756,843,722,820,2557,83.29481863278637,51.55883136930385
14284,/media/marda/TWOTB1/xBD/hurricanes/images/florence/hurricane-florence_00000110_pre_disaster.png,61,86,1,274,335,732,818,1797,75.39924864800963,35.534141615561005
14285,/media/marda/TWOTB1/xBD/hurricanes/images/florence/hurricane-florence_00000110_pre_disaster.png,59,77,1,179,238,735,812,1929,57.17090959769141,48.883523220595876
14286,/media/marda/TWOTB1/xBD/hurricanes/images/florence/hurricane-florence_00000110_pre_disaster.png,101,70,1,896,997,736,806,2039,70.62419203291363,38.13623697670132
14287,/media/marda/TWOTB1/xBD/hurricanes/images/florence/hurricane-florence_00000110_pre_disaster.png,114,74,1,812,926,749,823,2446,85.01827167234514,38.463994453348334
14288,/media/marda/TWOTB1/xBD/hurricanes/images/florence/hurricane-florence_00000110_pre_disaster.png,67,57,1,365,432,757,814,1433,61.26902942870779,31.20360556195091
14289,/media/marda/TWOTB1/xBD/hurricanes/images/florence/hurricane-florence_00000110_pre_disaster.png,47,68,1,0,47,763,831,1211,53.78591897264678,29.97849460169534
14290,/media/marda/TWOTB1/xBD/hurricanes/images/florence/hurricane-florence_00000110_pre_disaster.png,32,64,1,44,76,805,869,725,31.75590540194797,30.26288196810955
14291,/media/marda/TWOTB1/xBD/hurricanes/images/florence/hurricane-florence_00000110_pre_disaster.png,107,88,1,852,959,828,916,2142,66.51371288380669,44.39712682099086
14292,/media/marda/TWOTB1/xBD/hurricanes/images/florence/hurricane-florence_00000110_pre_disaster.png,43,84,1,554,597,867,951,959,61.81378643780577,21.938290775677817
14293,/media/marda/TWOTB1/xBD/hurricanes/images/florence/hurricane-florence_00000110_pre_disaster.png,36,67,1,331,367,870,937,830,40.01154929000162,27.467663291484484
14294,/media/marda/TWOTB1/xBD/hurricanes/images/florence/hurricane-florence_00000110_pre_disaster.png,100,72,1,208,308,888,960,1969,101.69481490377837,27.35379308407637
14295,/media/marda/TWOTB1/xBD/hurricanes/images/florence/hurricane-florence_00000110_pre_disaster.png,79,92,1,700,779,894,986,2200,64.1139847679229,45.92368885989957
14296,/media/marda/TWOTB1/xBD/hurricanes/images/florence/hurricane-florence_00000110_pre_disaster.png,53,50,1,935,988,896,946,167,17.41336416552298,12.637890116635864
14297,/media/marda/TWOTB1/xBD/hurricanes/images/florence/hurricane-florence_00000110_pre_disaster.png,39,58,1,34,73,902,960,754,44.57095321001711,22.595901845975405
14298,/media/marda/TWOTB1/xBD/hurricanes/images/florence/hurricane-florence_00000110_pre_disaster.png,86,82,1,895,981,924,1006,1793,55.228134801542375,42.88476940551567
14299,/media/marda/TWOTB1/xBD/hurricanes/images/florence/hurricane-florence_00000110_pre_disaster.png,52,47,1,968,1020,979,1026,106,14.015500059208115,10.13339674593131
14300,/media/marda/TWOTB1/xBD/hurricanes/images/florence/hurricane-florence_00000110_pre_disaster.png,81,61,1,715,796,983,1044,884,55.026525191228025,22.012808151468438
14301,/media/marda/TWOTB1/xBD/hurricanes/images/florence/hurricane-florence_00000110_pre_disaster.png,71,50,1,908,979,994,1044,266,34.4798203098712,11.303847233789694
14302,/media/marda/TWOTB1/xBD/hurricanes/images/florence/hurricane-florence_00000276_pre_disaster.png,24,53,1,39,63,629,682,288,32.36672070442364,11.87227637807467
14303,/media/marda/TWOTB1/xBD/hurricanes/images/florence/hurricane-florence_00000276_pre_disaster.png,42,59,1,127,169,795,854,416,40.83243418645657,13.610299041767094
14304,/media/marda/TWOTB1/xBD/hurricanes/images/florence/hurricane-florence_00000276_pre_disaster.png,45,76,1,66,111,812,888,958,47.9238964737762,26.33548769975082
14305,/media/marda/TWOTB1/xBD/hurricanes/images/florence/hurricane-florence_00000276_pre_disaster.png,51,74,1,0,51,968,1042,1221,54.216591482204365,31.29337654632605
14306,/media/marda/TWOTB1/xBD/hurricanes/images/florence/hurricane-florence_00000185_post_disaster.png,26,39,1,369,395,19,58,476,44.016341585332846,14.405927371198
14307,/media/marda/TWOTB1/xBD/hurricanes/images/florence/hurricane-florence_00000185_post_disaster.png,47,10,1,954,1001,41,51,54,9.595346649520952,7.625716025249646
14308,/media/marda/TWOTB1/xBD/hurricanes/images/florence/hurricane-florence_00000185_post_disaster.png,50,28,1,250,300,45,73,817,46.48091257648226,23.174154983869457
14309,/media/marda/TWOTB1/xBD/hurricanes/images/florence/hurricane-florence_00000185_post_disaster.png,63,26,1,953,1016,66,92,371,27.076874915035464,18.053571929671993
14310,/media/marda/TWOTB1/xBD/hurricanes/images/florence/hurricane-florence_00000185_post_disaster.png,73,35,1,801,874,179,214,677,36.07275019291219,25.831163757825124
14311,/media/marda/TWOTB1/xBD/hurricanes/images/florence/hurricane-florence_00000185_post_disaster.png,75,45,1,948,1023,197,242,718,32.81045810185564,29.217513300896343
14312,/media/marda/TWOTB1/xBD/hurricanes/images/florence/hurricane-florence_00000185_post_disaster.png,93,78,1,719,812,324,402,2243,61.47387837680089,50.619610185034276
14313,/media/marda/TWOTB1/xBD/hurricanes/images/florence/hurricane-florence_00000185_post_disaster.png,63,44,1,980,1043,339,383,451,29.688381382297027,19.90283732533566
14314,/media/marda/TWOTB1/xBD/hurricanes/images/florence/hurricane-florence_00000185_post_disaster.png,55,35,1,783,838,365,400,327,24.219337877342696,17.78673926967948
14315,/media/marda/TWOTB1/xBD/hurricanes/images/florence/hurricane-florence_00000185_post_disaster.png,61,38,1,982,1043,375,413,282,26.232712951572957,14.585040248007495
14316,/media/marda/TWOTB1/xBD/hurricanes/images/florence/hurricane-florence_00000185_post_disaster.png,85,67,1,958,1043,382,449,1275,56.530619808383776,32.22952999149243
14317,/media/marda/TWOTB1/xBD/hurricanes/images/florence/hurricane-florence_00000185_post_disaster.png,49,30,1,776,825,383,413,174,20.77508408383579,11.115723597180535
14318,/media/marda/TWOTB1/xBD/hurricanes/images/florence/hurricane-florence_00000185_post_disaster.png,92,66,1,763,855,400,466,1664,63.37603281056992,35.7250619264932
14319,/media/marda/TWOTB1/xBD/hurricanes/images/florence/hurricane-florence_00000185_post_disaster.png,44,40,1,656,700,510,550,192,19.629909152447276,13.080944580232387
14320,/media/marda/TWOTB1/xBD/hurricanes/images/florence/hurricane-florence_00000185_post_disaster.png,60,56,1,670,730,523,579,649,35.00915492940045,24.467285776973686
14321,/media/marda/TWOTB1/xBD/hurricanes/images/florence/hurricane-florence_00000185_post_disaster.png,69,69,1,689,758,546,615,690,58.51484485754354,15.75876724881271
14322,/media/marda/TWOTB1/xBD/hurricanes/images/florence/hurricane-florence_00000185_post_disaster.png,40,40,1,572,612,589,629,137,17.55685731791573,10.470295086387498
14323,/media/marda/TWOTB1/xBD/hurricanes/images/florence/hurricane-florence_00000185_post_disaster.png,59,59,1,579,638,610,669,631,35.37145967028244,23.812346127907983
14324,/media/marda/TWOTB1/xBD/hurricanes/images/florence/hurricane-florence_00000185_post_disaster.png,67,67,1,613,680,645,712,993,45.35871916927756,28.71347922932756
14325,/media/marda/TWOTB1/xBD/hurricanes/images/florence/hurricane-florence_00000185_post_disaster.png,70,66,1,520,590,680,746,758,58.85266970343162,17.191160866476473
14326,/media/marda/TWOTB1/xBD/hurricanes/images/florence/hurricane-florence_00000185_post_disaster.png,65,78,1,539,604,724,802,1016,52.64367203279417,25.75574966552704
14327,/media/marda/TWOTB1/xBD/hurricanes/images/florence/hurricane-florence_00000185_post_disaster.png,237,158,1,113,350,881,1039,14962,185.69458137984398,121.19578549772068
14328,/media/marda/TWOTB1/xBD/hurricanes/images/florence/hurricane-florence_00000080_pre_disaster.png,50,51,1,861,911,852,903,187,16.242220227462887,15.425313262030846
14329,/media/marda/TWOTB1/xBD/hurricanes/images/florence/hurricane-florence_00000080_pre_disaster.png,44,45,1,793,837,856,901,79,11.194571103769642,9.565732643015199
14330,/media/marda/TWOTB1/xBD/hurricanes/images/florence/hurricane-florence_00000080_pre_disaster.png,90,85,1,764,854,869,954,1564,61.761133084443124,37.091898122520575
14331,/media/marda/TWOTB1/xBD/hurricanes/images/florence/hurricane-florence_00000080_pre_disaster.png,76,113,1,693,769,881,994,1966,81.57911462356036,38.186844753756404
14332,/media/marda/TWOTB1/xBD/hurricanes/images/florence/hurricane-florence_00000080_pre_disaster.png,40,55,1,661,701,884,939,197,18.80266220444999,14.066280222791017
14333,/media/marda/TWOTB1/xBD/hurricanes/images/florence/hurricane-florence_00000123_pre_disaster.png,64,43,1,600,664,186,229,775,39.947037339050794,25.602995762520138
14334,/media/marda/TWOTB1/xBD/hurricanes/images/florence/hurricane-florence_00000123_pre_disaster.png,97,75,1,617,714,206,281,2541,63.47509168096984,53.07340000609553
14335,/media/marda/TWOTB1/xBD/hurricanes/images/florence/hurricane-florence_00000123_pre_disaster.png,56,45,1,520,576,233,278,643,42.055588807559865,20.1288193914295
14336,/media/marda/TWOTB1/xBD/hurricanes/images/florence/hurricane-florence_00000123_pre_disaster.png,136,106,1,553,689,239,345,4846,129.85665510289462,50.085359387146184
14337,/media/marda/TWOTB1/xBD/hurricanes/images/florence/hurricane-florence_00000123_pre_disaster.png,66,63,1,670,736,979,1042,671,40.65541608922462,22.714872785828543
14338,/media/marda/TWOTB1/xBD/hurricanes/images/florence/hurricane-florence_00000123_pre_disaster.png,50,50,1,748,798,994,1044,137,23.25497021393663,8.395735102692727
14339,/media/marda/TWOTB1/xBD/hurricanes/images/florence/hurricane-florence_00000384_pre_disaster.png,11,19,1,93,104,0,19,151,22.063933964485155,9.12409136168645
14340,/media/marda/TWOTB1/xBD/hurricanes/images/florence/hurricane-florence_00000384_pre_disaster.png,31,7,1,255,286,0,7,113,25.15541952196354,6.136253883566825
14341,/media/marda/TWOTB1/xBD/hurricanes/images/florence/hurricane-florence_00000384_pre_disaster.png,25,55,1,125,150,5,60,777,60.02885926116723,17.15488331561563
14342,/media/marda/TWOTB1/xBD/hurricanes/images/florence/hurricane-florence_00000384_pre_disaster.png,24,10,1,339,363,20,30,109,13.910682624411768,10.446726795592918
14343,/media/marda/TWOTB1/xBD/hurricanes/images/florence/hurricane-florence_00000384_pre_disaster.png,24,17,1,290,314,47,64,157,17.876017378460162,12.245164235291773
14344,/media/marda/TWOTB1/xBD/hurricanes/images/florence/hurricane-florence_00000384_pre_disaster.png,84,47,1,248,332,62,109,1933,83.19905621528122,42.011911382564584
14345,/media/marda/TWOTB1/xBD/hurricanes/images/florence/hurricane-florence_00000384_pre_disaster.png,48,38,1,267,315,214,252,881,41.25999697483329,28.81788198683688
14346,/media/marda/TWOTB1/xBD/hurricanes/images/florence/hurricane-florence_00000384_pre_disaster.png,28,29,1,328,356,225,254,269,21.870344626101872,16.27305458692195
14347,/media/marda/TWOTB1/xBD/hurricanes/images/florence/hurricane-florence_00000384_pre_disaster.png,27,37,1,112,139,261,298,540,30.319469607254337,23.822132308013217
14348,/media/marda/TWOTB1/xBD/hurricanes/images/florence/hurricane-florence_00000384_pre_disaster.png,36,63,1,156,192,265,328,1232,58.75629031813355,28.15884478845812
14349,/media/marda/TWOTB1/xBD/hurricanes/images/florence/hurricane-florence_00000384_pre_disaster.png,28,51,1,40,68,314,365,914,41.011781595040375,29.00228583092591
14350,/media/marda/TWOTB1/xBD/hurricanes/images/florence/hurricane-florence_00000384_pre_disaster.png,54,25,1,919,973,334,359,202,20.321002878949777,13.322196442955207
14351,/media/marda/TWOTB1/xBD/hurricanes/images/florence/hurricane-florence_00000384_pre_disaster.png,53,28,1,905,958,349,377,233,19.200104609941352,16.277320098088804
14352,/media/marda/TWOTB1/xBD/hurricanes/images/florence/hurricane-florence_00000384_pre_disaster.png,82,46,1,962,1044,354,400,1084,47.16634523001693,31.638002426390553
14353,/media/marda/TWOTB1/xBD/hurricanes/images/florence/hurricane-florence_00000384_pre_disaster.png,53,45,1,537,590,368,413,807,33.88964592750846,31.37782270581877
14354,/media/marda/TWOTB1/xBD/hurricanes/images/florence/hurricane-florence_00000384_pre_disaster.png,45,37,1,174,219,402,439,522,43.14382320932502,15.949283231584019
14355,/media/marda/TWOTB1/xBD/hurricanes/images/florence/hurricane-florence_00000384_pre_disaster.png,30,37,1,67,97,403,440,451,32.39429668621083,18.44209831024038
14356,/media/marda/TWOTB1/xBD/hurricanes/images/florence/hurricane-florence_00000384_pre_disaster.png,70,74,1,445,515,414,488,1933,56.43782071665012,49.443014577955765
14357,/media/marda/TWOTB1/xBD/hurricanes/images/florence/hurricane-florence_00000384_pre_disaster.png,10,30,1,58,68,425,455,101,14.538931179975421,9.2967044985158
14358,/media/marda/TWOTB1/xBD/hurricanes/images/florence/hurricane-florence_00000384_pre_disaster.png,29,66,1,178,207,441,507,746,55.14385363191527,18.07415410657422
14359,/media/marda/TWOTB1/xBD/hurricanes/images/florence/hurricane-florence_00000384_pre_disaster.png,18,35,1,123,141,514,549,190,16.366293326054794,15.50897370815412
14360,/media/marda/TWOTB1/xBD/hurricanes/images/florence/hurricane-florence_00000384_pre_disaster.png,154,83,1,60,214,542,625,5218,156.93758645811693,47.971968043869474
14361,/media/marda/TWOTB1/xBD/hurricanes/images/florence/hurricane-florence_00000384_pre_disaster.png,50,71,1,472,522,550,621,1118,54.689403606350375,27.004612556444002
14362,/media/marda/TWOTB1/xBD/hurricanes/images/florence/hurricane-florence_00000384_pre_disaster.png,44,38,1,507,551,576,614,294,23.335796103998778,16.82467975192302
14363,/media/marda/TWOTB1/xBD/hurricanes/images/florence/hurricane-florence_00000384_pre_disaster.png,42,50,1,512,554,701,751,351,23.07435449459169,20.441724819670572
14364,/media/marda/TWOTB1/xBD/hurricanes/images/florence/hurricane-florence_00000384_pre_disaster.png,55,53,1,469,524,706,759,663,40.752642307254,21.48123775564739
14365,/media/marda/TWOTB1/xBD/hurricanes/images/florence/hurricane-florence_00000384_pre_disaster.png,44,42,1,688,732,713,755,128,14.833982364793671,11.61692589289397
14366,/media/marda/TWOTB1/xBD/hurricanes/images/florence/hurricane-florence_00000384_pre_disaster.png,38,60,1,399,437,728,788,455,33.46552731462639,17.934834494374766
14367,/media/marda/TWOTB1/xBD/hurricanes/images/florence/hurricane-florence_00000384_pre_disaster.png,60,56,1,666,726,741,797,709,37.23680944445573,25.255632344694074
14368,/media/marda/TWOTB1/xBD/hurricanes/images/florence/hurricane-florence_00000384_pre_disaster.png,88,62,1,499,587,756,818,1629,74.37433075711276,29.491841486481487
14369,/media/marda/TWOTB1/xBD/hurricanes/images/florence/hurricane-florence_00000384_pre_disaster.png,36,44,1,632,668,793,837,112,13.45447365043063,11.25561519792434
14370,/media/marda/TWOTB1/xBD/hurricanes/images/florence/hurricane-florence_00000384_pre_disaster.png,56,60,1,628,684,803,863,641,33.886086245537484,25.044000652132674
14371,/media/marda/TWOTB1/xBD/hurricanes/images/florence/hurricane-florence_00000384_pre_disaster.png,66,99,1,257,323,846,945,2050,67.29007240227442,49.2940386219631
14372,/media/marda/TWOTB1/xBD/hurricanes/images/florence/hurricane-florence_00000384_pre_disaster.png,71,60,1,883,954,870,930,704,35.65927971470796,25.946543217526333
14373,/media/marda/TWOTB1/xBD/hurricanes/images/florence/hurricane-florence_00000384_pre_disaster.png,65,73,1,784,849,922,995,845,34.76275312716895,32.04366578959271
14374,/media/marda/TWOTB1/xBD/hurricanes/images/florence/hurricane-florence_00000384_pre_disaster.png,37,53,1,576,613,925,978,202,17.753490486413046,15.340552280716546
14375,/media/marda/TWOTB1/xBD/hurricanes/images/florence/hurricane-florence_00000384_pre_disaster.png,51,58,1,839,890,930,988,307,21.884425430610932,18.799340001938496
14376,/media/marda/TWOTB1/xBD/hurricanes/images/florence/hurricane-florence_00000384_pre_disaster.png,58,77,1,637,695,944,1021,1041,42.25567527083216,32.99421727283722
14377,/media/marda/TWOTB1/xBD/hurricanes/images/florence/hurricane-florence_00000384_pre_disaster.png,50,87,1,505,555,953,1040,988,51.34777579864817,27.386085322479758
14378,/media/marda/TWOTB1/xBD/hurricanes/images/florence/hurricane-florence_00000384_pre_disaster.png,64,60,1,823,887,957,1017,513,33.86481275983355,20.216547529001655
14379,/media/marda/TWOTB1/xBD/hurricanes/images/florence/hurricane-florence_00000384_pre_disaster.png,55,56,1,792,847,988,1044,302,24.819906050973625,16.346114388016122
14380,/media/marda/TWOTB1/xBD/hurricanes/images/florence/hurricane-florence_00000276_post_disaster.png,24,53,1,39,63,629,682,288,32.36672070442364,11.87227637807467
14381,/media/marda/TWOTB1/xBD/hurricanes/images/florence/hurricane-florence_00000276_post_disaster.png,42,59,1,127,169,795,854,416,40.83243418645657,13.610299041767094
14382,/media/marda/TWOTB1/xBD/hurricanes/images/florence/hurricane-florence_00000276_post_disaster.png,45,76,1,66,111,812,888,958,47.9238964737762,26.33548769975082
14383,/media/marda/TWOTB1/xBD/hurricanes/images/florence/hurricane-florence_00000276_post_disaster.png,51,73,1,0,51,968,1041,1179,53.98185233566257,30.516242791955335
14384,/media/marda/TWOTB1/xBD/hurricanes/images/florence/hurricane-florence_00000504_pre_disaster.png,80,66,1,866,946,100,166,1755,58.2318037355441,40.98770291689298
14385,/media/marda/TWOTB1/xBD/hurricanes/images/florence/hurricane-florence_00000149_post_disaster.png,54,26,1,781,835,0,26,576,29.160519567505517,26.357464611755024
14386,/media/marda/TWOTB1/xBD/hurricanes/images/florence/hurricane-florence_00000149_post_disaster.png,33,14,1,605,638,29,43,112,16.261714314203164,9.14093253247391
14387,/media/marda/TWOTB1/xBD/hurricanes/images/florence/hurricane-florence_00000149_post_disaster.png,35,40,1,561,596,38,78,580,46.16232587569546,16.73726332642546
14388,/media/marda/TWOTB1/xBD/hurricanes/images/florence/hurricane-florence_00000149_post_disaster.png,31,36,1,444,475,572,608,174,16.471803170174447,14.235995994149413
14389,/media/marda/TWOTB1/xBD/hurricanes/images/florence/hurricane-florence_00000149_post_disaster.png,59,54,1,295,354,603,657,718,50.36675854420715,21.25022503536044
14390,/media/marda/TWOTB1/xBD/hurricanes/images/florence/hurricane-florence_00000149_post_disaster.png,69,76,1,398,467,607,683,1834,56.07152149796198,47.416700762614504
14391,/media/marda/TWOTB1/xBD/hurricanes/images/florence/hurricane-florence_00000149_post_disaster.png,45,60,1,203,248,759,819,923,38.04558129281733,32.47692758808986
14392,/media/marda/TWOTB1/xBD/hurricanes/images/florence/hurricane-florence_00000149_post_disaster.png,47,64,1,539,586,844,908,654,32.77458907741168,26.332952015488548
14393,/media/marda/TWOTB1/xBD/hurricanes/images/florence/hurricane-florence_00000149_post_disaster.png,40,45,1,569,609,844,889,212,22.258526676691087,12.751302915078439
14394,/media/marda/TWOTB1/xBD/hurricanes/images/florence/hurricane-florence_00000149_post_disaster.png,54,59,1,618,672,895,954,567,34.84495134862911,21.878340992147542
14395,/media/marda/TWOTB1/xBD/hurricanes/images/florence/hurricane-florence_00000298_post_disaster.png,32,10,1,294,326,0,10,147,19.17588880062219,11.1983385394997
14396,/media/marda/TWOTB1/xBD/hurricanes/images/florence/hurricane-florence_00000298_post_disaster.png,57,27,1,644,701,0,27,601,32.98983814319529,24.25655649558376
14397,/media/marda/TWOTB1/xBD/hurricanes/images/florence/hurricane-florence_00000298_post_disaster.png,43,55,1,339,382,8,63,1316,60.048649937779096,29.56394641345529
14398,/media/marda/TWOTB1/xBD/hurricanes/images/florence/hurricane-florence_00000298_post_disaster.png,38,27,1,271,309,116,143,638,32.092424888673044,26.32708315076168
14399,/media/marda/TWOTB1/xBD/hurricanes/images/florence/hurricane-florence_00000298_post_disaster.png,47,44,1,598,645,125,169,878,45.08651552756655,25.987006490578707
14400,/media/marda/TWOTB1/xBD/hurricanes/images/florence/hurricane-florence_00000298_post_disaster.png,46,22,1,323,369,137,159,544,38.45317442656214,18.86694220079864
14401,/media/marda/TWOTB1/xBD/hurricanes/images/florence/hurricane-florence_00000298_post_disaster.png,66,33,1,343,409,164,197,1152,54.873231063679576,27.831070958607018
14402,/media/marda/TWOTB1/xBD/hurricanes/images/florence/hurricane-florence_00000298_post_disaster.png,44,40,1,549,593,195,235,838,40.31939274397188,27.64823111984388
14403,/media/marda/TWOTB1/xBD/hurricanes/images/florence/hurricane-florence_00000298_post_disaster.png,7,23,1,0,7,253,276,56,13.232657960740044,6.431652279870638
14404,/media/marda/TWOTB1/xBD/hurricanes/images/florence/hurricane-florence_00000298_post_disaster.png,28,32,1,25,53,260,292,232,31.888174529729373,11.451605636494369
14405,/media/marda/TWOTB1/xBD/hurricanes/images/florence/hurricane-florence_00000298_post_disaster.png,46,46,1,589,635,284,330,743,40.9333413879032,24.143558215902225
14406,/media/marda/TWOTB1/xBD/hurricanes/images/florence/hurricane-florence_00000298_post_disaster.png,64,52,1,367,431,305,357,1047,52.94528827103139,26.45778900420851
14407,/media/marda/TWOTB1/xBD/hurricanes/images/florence/hurricane-florence_00000298_post_disaster.png,31,51,1,0,31,308,359,728,38.12981272139286,25.498800767732725
14408,/media/marda/TWOTB1/xBD/hurricanes/images/florence/hurricane-florence_00000298_post_disaster.png,36,22,1,641,677,320,342,115,13.382995689743744,11.388788350492248
14409,/media/marda/TWOTB1/xBD/hurricanes/images/florence/hurricane-florence_00000298_post_disaster.png,46,67,1,609,655,356,423,860,59.947267943803695,20.157381415038518
14410,/media/marda/TWOTB1/xBD/hurricanes/images/florence/hurricane-florence_00000298_post_disaster.png,56,35,1,619,675,432,467,399,34.167421279681925,15.643424957289376
14411,/media/marda/TWOTB1/xBD/hurricanes/images/florence/hurricane-florence_00000298_post_disaster.png,69,72,1,276,345,462,534,1467,66.20229495147524,32.33087120745244
14412,/media/marda/TWOTB1/xBD/hurricanes/images/florence/hurricane-florence_00000298_post_disaster.png,28,41,1,259,287,491,532,225,20.70285095471407,14.36929929909231
14413,/media/marda/TWOTB1/xBD/hurricanes/images/florence/hurricane-florence_00000298_post_disaster.png,28,34,1,335,363,512,546,122,13.592516150605132,12.390114491245871
14414,/media/marda/TWOTB1/xBD/hurricanes/images/florence/hurricane-florence_00000298_post_disaster.png,43,48,1,134,177,520,568,480,41.335346067741696,15.506638324495027
14415,/media/marda/TWOTB1/xBD/hurricanes/images/florence/hurricane-florence_00000298_post_disaster.png,41,38,1,584,625,521,559,221,18.48000976025015,15.821438234172623
14416,/media/marda/TWOTB1/xBD/hurricanes/images/florence/hurricane-florence_00000298_post_disaster.png,57,76,1,607,664,533,609,738,62.39255597385363,15.797296479981709
14417,/media/marda/TWOTB1/xBD/hurricanes/images/florence/hurricane-florence_00000298_post_disaster.png,34,43,1,298,332,560,603,231,24.16363765891881,12.79876365271102
14418,/media/marda/TWOTB1/xBD/hurricanes/images/florence/hurricane-florence_00000298_post_disaster.png,39,50,1,37,76,578,628,479,44.207688402353874,14.668450451631706
14419,/media/marda/TWOTB1/xBD/hurricanes/images/florence/hurricane-florence_00000298_post_disaster.png,52,51,1,630,682,629,680,340,28.412910692716405,18.109820714566517
14420,/media/marda/TWOTB1/xBD/hurricanes/images/florence/hurricane-florence_00000298_post_disaster.png,34,58,1,20,54,630,688,581,33.723029594164636,22.85427115429312
14421,/media/marda/TWOTB1/xBD/hurricanes/images/florence/hurricane-florence_00000425_pre_disaster.png,36,55,1,256,292,484,539,758,37.74383686256199,26.67512488569934
14422,/media/marda/TWOTB1/xBD/hurricanes/images/florence/hurricane-florence_00000425_pre_disaster.png,22,27,1,231,253,491,518,123,14.364955469314191,11.133894524210612
14423,/media/marda/TWOTB1/xBD/hurricanes/images/florence/hurricane-florence_00000425_pre_disaster.png,18,57,1,0,18,490,547,613,41.61413342908536,19.676705497054883
14424,/media/marda/TWOTB1/xBD/hurricanes/images/florence/hurricane-florence_00000425_pre_disaster.png,49,74,1,422,471,567,641,778,61.428527496384284,16.88330883677441
14425,/media/marda/TWOTB1/xBD/hurricanes/images/florence/hurricane-florence_00000425_pre_disaster.png,20,58,1,0,20,568,626,722,42.78384944458643,22.523901975922524
14426,/media/marda/TWOTB1/xBD/hurricanes/images/florence/hurricane-florence_00000425_pre_disaster.png,20,33,1,340,360,609,642,52,8.8167949841457,8.006889536748778
14427,/media/marda/TWOTB1/xBD/hurricanes/images/florence/hurricane-florence_00000425_pre_disaster.png,35,41,1,406,441,629,670,199,17.504126447619182,15.10232238037948
14428,/media/marda/TWOTB1/xBD/hurricanes/images/florence/hurricane-florence_00000425_pre_disaster.png,43,64,1,0,43,655,719,1538,48.63002663799154,42.211583466001244
14429,/media/marda/TWOTB1/xBD/hurricanes/images/florence/hurricane-florence_00000425_pre_disaster.png,15,44,1,31,46,728,772,235,18.42588581369137,16.86737861287516
14430,/media/marda/TWOTB1/xBD/hurricanes/images/florence/hurricane-florence_00000425_pre_disaster.png,144,68,1,900,1044,752,820,3159,121.14500327978466,34.657007517060926
14431,/media/marda/TWOTB1/xBD/hurricanes/images/florence/hurricane-florence_00000425_pre_disaster.png,21,56,1,13,34,761,817,541,31.265808538646237,23.053636679403866
14432,/media/marda/TWOTB1/xBD/hurricanes/images/florence/hurricane-florence_00000425_pre_disaster.png,56,86,1,240,296,796,882,1259,50.47996491111982,39.540796255968594
14433,/media/marda/TWOTB1/xBD/hurricanes/images/florence/hurricane-florence_00000425_pre_disaster.png,173,76,1,871,1044,817,893,4245,157.7790096521564,35.80405787114625
14434,/media/marda/TWOTB1/xBD/hurricanes/images/florence/hurricane-florence_00000425_pre_disaster.png,32,58,1,92,124,842,900,520,30.084826990144297,22.88928178156851
14435,/media/marda/TWOTB1/xBD/hurricanes/images/florence/hurricane-florence_00000425_pre_disaster.png,71,48,1,81,152,882,930,1021,78.60635195001001,17.301408533040643
14436,/media/marda/TWOTB1/xBD/hurricanes/images/florence/hurricane-florence_00000425_pre_disaster.png,54,60,1,589,643,890,950,422,33.496727569667264,16.720879287597334
14437,/media/marda/TWOTB1/xBD/hurricanes/images/florence/hurricane-florence_00000425_pre_disaster.png,56,80,1,583,639,938,1018,747,44.515077251782415,22.099178246752874
14438,/media/marda/TWOTB1/xBD/hurricanes/images/florence/hurricane-florence_00000240_post_disaster.png,61,41,1,586,647,93,134,849,38.43307793937631,29.568148628416598
14439,/media/marda/TWOTB1/xBD/hurricanes/images/florence/hurricane-florence_00000240_post_disaster.png,59,42,1,507,566,139,181,812,40.72226298283839,26.068941284634338
14440,/media/marda/TWOTB1/xBD/hurricanes/images/florence/hurricane-florence_00000240_post_disaster.png,52,37,1,585,637,157,194,495,30.839098833671283,21.53135308947188
14441,/media/marda/TWOTB1/xBD/hurricanes/images/florence/hurricane-florence_00000240_post_disaster.png,35,20,1,561,596,180,200,147,15.71999294184912,12.089029285757215
14442,/media/marda/TWOTB1/xBD/hurricanes/images/florence/hurricane-florence_00000240_post_disaster.png,43,23,1,617,660,187,210,191,16.044708141058262,15.958629764310993
14443,/media/marda/TWOTB1/xBD/hurricanes/images/florence/hurricane-florence_00000240_post_disaster.png,57,71,1,282,339,547,618,828,62.61223475597258,17.65004364204719
14444,/media/marda/TWOTB1/xBD/hurricanes/images/florence/hurricane-florence_00000240_post_disaster.png,71,74,1,197,268,599,673,1460,67.62296602546824,29.888683729206747
14445,/media/marda/TWOTB1/xBD/hurricanes/images/florence/hurricane-florence_00000240_post_disaster.png,32,45,1,265,297,672,717,233,24.613186899850824,12.668391540711383
14446,/media/marda/TWOTB1/xBD/hurricanes/images/florence/hurricane-florence_00000240_post_disaster.png,59,80,1,159,218,675,755,1322,59.250776408238416,31.055414326983435
14447,/media/marda/TWOTB1/xBD/hurricanes/images/florence/hurricane-florence_00000240_post_disaster.png,27,41,1,231,258,678,719,156,17.848141246838875,11.69439089584132
14448,/media/marda/TWOTB1/xBD/hurricanes/images/florence/hurricane-florence_00000240_post_disaster.png,43,81,1,105,148,797,878,1036,43.57812936846865,32.75595797062797
14449,/media/marda/TWOTB1/xBD/hurricanes/images/florence/hurricane-florence_00000240_post_disaster.png,30,57,1,149,179,812,869,322,22.157423043929537,19.448422831586917
14450,/media/marda/TWOTB1/xBD/hurricanes/images/florence/hurricane-florence_00000240_post_disaster.png,24,53,1,117,141,858,911,250,18.686842514890227,17.480269014625925
14451,/media/marda/TWOTB1/xBD/hurricanes/images/florence/hurricane-florence_00000274_post_disaster.png,45,36,1,264,309,70,106,648,34.14278438846311,25.058389423762517
14452,/media/marda/TWOTB1/xBD/hurricanes/images/florence/hurricane-florence_00000274_post_disaster.png,41,42,1,119,160,111,153,726,36.266403151636005,26.416620697366653
14453,/media/marda/TWOTB1/xBD/hurricanes/images/florence/hurricane-florence_00000274_post_disaster.png,69,50,1,423,492,243,293,1164,48.12336126512312,35.3427296526307
14454,/media/marda/TWOTB1/xBD/hurricanes/images/florence/hurricane-florence_00000274_post_disaster.png,63,60,1,260,323,305,365,1256,53.956845009446845,30.72870783041602
14455,/media/marda/TWOTB1/xBD/hurricanes/images/florence/hurricane-florence_00000274_post_disaster.png,19,22,1,238,257,331,353,57,10.195220163005034,7.51996975034319
14456,/media/marda/TWOTB1/xBD/hurricanes/images/florence/hurricane-florence_00000274_post_disaster.png,42,38,1,362,404,425,463,288,32.22696010523263,11.944832452320805
14457,/media/marda/TWOTB1/xBD/hurricanes/images/florence/hurricane-florence_00000274_post_disaster.png,46,34,1,817,863,546,580,95,13.523931473797543,9.43033990548726
14458,/media/marda/TWOTB1/xBD/hurricanes/images/florence/hurricane-florence_00000274_post_disaster.png,63,50,1,784,847,554,604,525,27.53885607567244,25.23314408151332
14459,/media/marda/TWOTB1/xBD/hurricanes/images/florence/hurricane-florence_00000274_post_disaster.png,98,91,1,776,874,599,690,1988,83.02895546645368,32.479672886158816
14460,/media/marda/TWOTB1/xBD/hurricanes/images/florence/hurricane-florence_00000543_pre_disaster.png,19,28,1,0,19,329,357,274,22.260719137869316,16.676039851963164
14461,/media/marda/TWOTB1/xBD/hurricanes/images/florence/hurricane-florence_00000543_pre_disaster.png,33,57,1,51,84,597,654,560,27.628803755411305,27.08669413131358
14462,/media/marda/TWOTB1/xBD/hurricanes/images/florence/hurricane-florence_00000543_pre_disaster.png,43,62,1,131,174,624,686,579,46.12613995337122,16.758262783321
14463,/media/marda/TWOTB1/xBD/hurricanes/images/florence/hurricane-florence_00000543_pre_disaster.png,61,77,1,919,980,702,779,639,54.90235516806622,15.416721884788402
14464,/media/marda/TWOTB1/xBD/hurricanes/images/florence/hurricane-florence_00000543_pre_disaster.png,57,45,1,954,1011,718,763,199,19.75747256630906,13.45419354427249
14465,/media/marda/TWOTB1/xBD/hurricanes/images/florence/hurricane-florence_00000543_pre_disaster.png,27,92,1,0,27,901,993,752,51.452303542026016,20.862984614785606
14466,/media/marda/TWOTB1/xBD/hurricanes/images/florence/hurricane-florence_00000349_post_disaster.png,113,39,1,931,1044,0,39,2109,77.8817113307963,37.480117783412496
14467,/media/marda/TWOTB1/xBD/hurricanes/images/florence/hurricane-florence_00000349_post_disaster.png,69,35,1,606,675,21,56,949,46.224529036138,27.179417778888606
14468,/media/marda/TWOTB1/xBD/hurricanes/images/florence/hurricane-florence_00000349_post_disaster.png,67,35,1,617,684,49,84,924,43.2897365571646,28.344915798489378
14469,/media/marda/TWOTB1/xBD/hurricanes/images/florence/hurricane-florence_00000349_post_disaster.png,68,38,1,553,621,51,89,1206,45.560623656032945,34.99756863328157
14470,/media/marda/TWOTB1/xBD/hurricanes/images/florence/hurricane-florence_00000349_post_disaster.png,127,70,1,749,876,80,150,3899,98.72887778552108,52.56045592569989
14471,/media/marda/TWOTB1/xBD/hurricanes/images/florence/hurricane-florence_00000349_post_disaster.png,98,63,1,790,888,132,195,2625,61.263877266306636,56.320355270058705
14472,/media/marda/TWOTB1/xBD/hurricanes/images/florence/hurricane-florence_00000349_post_disaster.png,103,77,1,798,901,199,276,3040,66.2937855323076,61.16721457888482
14473,/media/marda/TWOTB1/xBD/hurricanes/images/florence/hurricane-florence_00000349_post_disaster.png,103,51,1,828,931,250,301,1532,76.46181259648468,26.757520621858284
14474,/media/marda/TWOTB1/xBD/hurricanes/images/florence/hurricane-florence_00000349_post_disaster.png,24,44,1,0,24,295,339,600,35.18451850662011,23.309493814790397
14475,/media/marda/TWOTB1/xBD/hurricanes/images/florence/hurricane-florence_00000349_post_disaster.png,125,68,1,835,960,333,401,2637,98.82021694458244,35.594843089835344
14476,/media/marda/TWOTB1/xBD/hurricanes/images/florence/hurricane-florence_00000349_post_disaster.png,151,86,1,853,1004,449,535,4845,119.43986965339904,53.18911670679912
14477,/media/marda/TWOTB1/xBD/hurricanes/images/florence/hurricane-florence_00000349_post_disaster.png,58,44,1,740,798,514,558,508,30.708476337769213,21.592744048103224
14478,/media/marda/TWOTB1/xBD/hurricanes/images/florence/hurricane-florence_00000349_post_disaster.png,118,72,1,918,1036,576,648,2342,87.47224127423283,35.70047295839374
14479,/media/marda/TWOTB1/xBD/hurricanes/images/florence/hurricane-florence_00000349_post_disaster.png,74,65,1,970,1044,649,714,1013,40.16361911055079,33.88333754557397
14480,/media/marda/TWOTB1/xBD/hurricanes/images/florence/hurricane-florence_00000349_post_disaster.png,60,62,1,799,859,687,749,590,35.39277717241311,22.029613396444223
14481,/media/marda/TWOTB1/xBD/hurricanes/images/florence/hurricane-florence_00000349_post_disaster.png,63,62,1,811,874,724,786,647,34.884740639398075,24.601407343197774
14482,/media/marda/TWOTB1/xBD/hurricanes/images/florence/hurricane-florence_00000349_post_disaster.png,54,53,1,877,931,753,806,361,25.180854180824582,19.052186448453593
14483,/media/marda/TWOTB1/xBD/hurricanes/images/florence/hurricane-florence_00000349_post_disaster.png,54,59,1,765,819,795,854,447,26.460650022414093,22.3652380631249
14484,/media/marda/TWOTB1/xBD/hurricanes/images/florence/hurricane-florence_00000349_post_disaster.png,63,70,1,863,926,822,892,676,35.73350490574576,25.34093494864228
14485,/media/marda/TWOTB1/xBD/hurricanes/images/florence/hurricane-florence_00000349_post_disaster.png,59,76,1,833,892,825,901,819,44.868227223576156,24.633378945505644
14486,/media/marda/TWOTB1/xBD/hurricanes/images/florence/hurricane-florence_00000349_post_disaster.png,61,49,1,705,766,829,878,270,36.354081267608045,9.964517647675596
14487,/media/marda/TWOTB1/xBD/hurricanes/images/florence/hurricane-florence_00000349_post_disaster.png,48,46,1,780,828,833,879,149,19.189881913326474,10.44346831560129
14488,/media/marda/TWOTB1/xBD/hurricanes/images/florence/hurricane-florence_00000349_post_disaster.png,74,72,1,767,841,846,918,999,47.55669095620515,29.083798826969105
14489,/media/marda/TWOTB1/xBD/hurricanes/images/florence/hurricane-florence_00000349_post_disaster.png,58,50,1,710,768,859,909,286,32.394062398080365,11.832500381494784
14490,/media/marda/TWOTB1/xBD/hurricanes/images/florence/hurricane-florence_00000349_post_disaster.png,52,59,1,547,599,875,934,539,33.11784300483553,21.530880526951343
14491,/media/marda/TWOTB1/xBD/hurricanes/images/florence/hurricane-florence_00000349_post_disaster.png,65,61,1,714,779,877,938,683,37.878970292542924,24.090252621400385
14492,/media/marda/TWOTB1/xBD/hurricanes/images/florence/hurricane-florence_00000349_post_disaster.png,37,49,1,618,655,881,930,160,17.98211142526473,11.628732462713364
14493,/media/marda/TWOTB1/xBD/hurricanes/images/florence/hurricane-florence_00000349_post_disaster.png,72,68,1,953,1025,885,953,646,31.158242170859737,27.890318490746033
14494,/media/marda/TWOTB1/xBD/hurricanes/images/florence/hurricane-florence_00000349_post_disaster.png,55,65,1,608,663,900,965,567,29.341437952436518,25.815108287403504
14495,/media/marda/TWOTB1/xBD/hurricanes/images/florence/hurricane-florence_00000349_post_disaster.png,50,62,1,558,608,912,974,506,30.870726913066004,21.7942431309443
14496,/media/marda/TWOTB1/xBD/hurricanes/images/florence/hurricane-florence_00000349_post_disaster.png,72,65,1,807,879,937,1002,686,41.5102248579615,22.078038100240324
14497,/media/marda/TWOTB1/xBD/hurricanes/images/florence/hurricane-florence_00000349_post_disaster.png,60,72,1,715,775,969,1041,748,34.97720263952225,28.412500400035412
14498,/media/marda/TWOTB1/xBD/hurricanes/images/florence/hurricane-florence_00000126_pre_disaster.png,179,179,1,162,341,393,572,20000,167.19978174733728,159.4367621594304
14499,/media/marda/TWOTB1/xBD/hurricanes/images/florence/hurricane-florence_00000359_pre_disaster.png,62,25,1,979,1041,1,26,375,22.858300739214787,21.794983729290948
14500,/media/marda/TWOTB1/xBD/hurricanes/images/florence/hurricane-florence_00000359_pre_disaster.png,44,46,1,12,56,15,61,1195,47.07170558804733,34.764677421095854
14501,/media/marda/TWOTB1/xBD/hurricanes/images/florence/hurricane-florence_00000359_pre_disaster.png,45,17,1,966,1011,22,39,145,18.591152323119605,10.374296847716176
14502,/media/marda/TWOTB1/xBD/hurricanes/images/florence/hurricane-florence_00000359_pre_disaster.png,69,46,1,922,991,44,90,1044,45.04026860791979,30.65362853821398
14503,/media/marda/TWOTB1/xBD/hurricanes/images/florence/hurricane-florence_00000359_pre_disaster.png,48,8,1,978,1026,66,74,50,10.830330662981256,6.259707479626183
14504,/media/marda/TWOTB1/xBD/hurricanes/images/florence/hurricane-florence_00000359_pre_disaster.png,67,32,1,919,986,141,173,578,32.004403922574554,23.94903201329555
14505,/media/marda/TWOTB1/xBD/hurricanes/images/florence/hurricane-florence_00000359_pre_disaster.png,62,22,1,961,1023,168,190,255,23.567579679206276,14.498178413137742
14506,/media/marda/TWOTB1/xBD/hurricanes/images/florence/hurricane-florence_00000359_pre_disaster.png,53,39,1,991,1044,378,417,273,27.522081240245175,13.282525216153537
14507,/media/marda/TWOTB1/xBD/hurricanes/images/florence/hurricane-florence_00000359_pre_disaster.png,77,45,1,893,970,404,449,688,39.63712790106021,22.955824692660563
14508,/media/marda/TWOTB1/xBD/hurricanes/images/florence/hurricane-florence_00000359_pre_disaster.png,66,59,1,925,991,489,548,764,44.931391645174934,22.692974506404468
14509,/media/marda/TWOTB1/xBD/hurricanes/images/florence/hurricane-florence_00000359_pre_disaster.png,73,63,1,957,1030,553,616,949,44.37461861464773,28.51059541968071
14510,/media/marda/TWOTB1/xBD/hurricanes/images/florence/hurricane-florence_00000359_pre_disaster.png,56,39,1,859,915,581,620,269,21.14965127048252,17.27427173934219
14511,/media/marda/TWOTB1/xBD/hurricanes/images/florence/hurricane-florence_00000359_pre_disaster.png,70,69,1,974,1044,597,666,865,48.036431620353106,23.824818521913905
14512,/media/marda/TWOTB1/xBD/hurricanes/images/florence/hurricane-florence_00000359_pre_disaster.png,63,56,1,928,991,611,667,514,29.193173740748463,23.514344730187723
14513,/media/marda/TWOTB1/xBD/hurricanes/images/florence/hurricane-florence_00000359_pre_disaster.png,71,68,1,887,958,616,684,1009,41.390543804187864,32.146320066314836
14514,/media/marda/TWOTB1/xBD/hurricanes/images/florence/hurricane-florence_00000359_pre_disaster.png,79,59,1,828,907,640,699,1024,47.22634178677965,30.682344577258206
14515,/media/marda/TWOTB1/xBD/hurricanes/images/florence/hurricane-florence_00000359_pre_disaster.png,46,46,1,998,1044,687,733,60,17.990979468437214,5.050873630664028
14516,/media/marda/TWOTB1/xBD/hurricanes/images/florence/hurricane-florence_00000359_pre_disaster.png,71,75,1,927,998,726,801,973,47.6785746564377,27.235394908426844
14517,/media/marda/TWOTB1/xBD/hurricanes/images/florence/hurricane-florence_00000359_pre_disaster.png,65,74,1,826,891,743,817,919,46.070462373954676,26.86342281639173
14518,/media/marda/TWOTB1/xBD/hurricanes/images/florence/hurricane-florence_00000359_pre_disaster.png,70,63,1,718,788,756,819,750,45.0445651647493,22.09944519682663
14519,/media/marda/TWOTB1/xBD/hurricanes/images/florence/hurricane-florence_00000359_pre_disaster.png,52,49,1,816,868,787,836,195,19.615222530362416,13.32501593569772
14520,/media/marda/TWOTB1/xBD/hurricanes/images/florence/hurricane-florence_00000359_pre_disaster.png,71,79,1,952,1023,803,882,949,48.6424548495452,26.001440460818586
14521,/media/marda/TWOTB1/xBD/hurricanes/images/florence/hurricane-florence_00000359_pre_disaster.png,69,77,1,842,911,804,881,1019,46.53678020332071,29.360894779689605
14522,/media/marda/TWOTB1/xBD/hurricanes/images/florence/hurricane-florence_00000359_pre_disaster.png,54,57,1,804,858,816,873,375,24.793165886755308,20.08441799507074
14523,/media/marda/TWOTB1/xBD/hurricanes/images/florence/hurricane-florence_00000359_pre_disaster.png,100,78,1,836,936,860,938,1589,67.75874035315232,37.625326261314406
14524,/media/marda/TWOTB1/xBD/hurricanes/images/florence/hurricane-florence_00000359_pre_disaster.png,85,77,1,722,807,946,1023,1215,56.57203641992497,28.566704857416543
14525,/media/marda/TWOTB1/xBD/hurricanes/images/florence/hurricane-florence_00000359_pre_disaster.png,42,58,1,570,612,949,1007,230,20.814389840965845,14.819688907970244
14526,/media/marda/TWOTB1/xBD/hurricanes/images/florence/hurricane-florence_00000359_pre_disaster.png,47,56,1,780,827,981,1037,146,14.687887012545337,13.348549858538195
14527,/media/marda/TWOTB1/xBD/hurricanes/images/florence/hurricane-florence_00000370_post_disaster.png,59,40,1,415,474,0,40,856,44.80211170133908,25.37237176143467
14528,/media/marda/TWOTB1/xBD/hurricanes/images/florence/hurricane-florence_00000370_post_disaster.png,22,18,1,171,193,59,77,165,15.208835478340884,14.543309538010234
14529,/media/marda/TWOTB1/xBD/hurricanes/images/florence/hurricane-florence_00000370_post_disaster.png,61,52,1,318,379,114,166,1249,45.56628813133375,36.20294441130151
14530,/media/marda/TWOTB1/xBD/hurricanes/images/florence/hurricane-florence_00000370_post_disaster.png,56,59,1,245,301,144,203,1163,60.169687068364716,25.811660286781866
14531,/media/marda/TWOTB1/xBD/hurricanes/images/florence/hurricane-florence_00000370_post_disaster.png,60,52,1,206,266,194,246,1204,50.35480802843475,31.893843115643243
14532,/media/marda/TWOTB1/xBD/hurricanes/images/florence/hurricane-florence_00000370_post_disaster.png,58,53,1,167,225,224,277,1108,48.34992892153134,31.105237769136966
14533,/media/marda/TWOTB1/xBD/hurricanes/images/florence/hurricane-florence_00000370_post_disaster.png,49,46,1,155,204,279,325,908,37.598225761516844,33.34580819438699
14534,/media/marda/TWOTB1/xBD/hurricanes/images/florence/hurricane-florence_00000370_post_disaster.png,21,39,1,137,158,304,343,375,28.866932048984335,17.241921092738185
14535,/media/marda/TWOTB1/xBD/hurricanes/images/florence/hurricane-florence_00000370_post_disaster.png,34,45,1,158,192,425,470,553,28.009136689700508,26.233253665440703
14536,/media/marda/TWOTB1/xBD/hurricanes/images/florence/hurricane-florence_00000370_post_disaster.png,20,29,1,177,197,466,495,120,15.685721053727043,10.306542664314296
14537,/media/marda/TWOTB1/xBD/hurricanes/images/florence/hurricane-florence_00000370_post_disaster.png,33,39,1,196,229,471,510,317,23.38366118519244,18.11301854456239
14538,/media/marda/TWOTB1/xBD/hurricanes/images/florence/hurricane-florence_00000370_post_disaster.png,122,65,1,922,1044,691,756,1936,96.79548573010625,26.59066441328675
14539,/media/marda/TWOTB1/xBD/hurricanes/images/florence/hurricane-florence_00000052_post_disaster.png,41,36,1,434,475,327,363,420,25.562100479332678,21.631405499683932
14540,/media/marda/TWOTB1/xBD/hurricanes/images/florence/hurricane-florence_00000052_post_disaster.png,22,23,1,212,234,340,363,96,14.423374130682536,8.823164009061733
14541,/media/marda/TWOTB1/xBD/hurricanes/images/florence/hurricane-florence_00000052_post_disaster.png,59,38,1,9,68,365,403,813,66.45708690822441,16.263929825551806
14542,/media/marda/TWOTB1/xBD/hurricanes/images/florence/hurricane-florence_00000052_post_disaster.png,22,37,1,0,22,168,205,575,32.78242240195967,23.306721382698196
14543,/media/marda/TWOTB1/xBD/hurricanes/images/florence/hurricane-florence_00000052_post_disaster.png,30,36,1,208,238,180,216,436,31.915715442163744,18.946211895844932
14544,/media/marda/TWOTB1/xBD/hurricanes/images/florence/hurricane-florence_00000052_post_disaster.png,48,46,1,449,497,298,344,730,34.75703773736644,28.132837719656283
14545,/media/marda/TWOTB1/xBD/hurricanes/images/florence/hurricane-florence_00000052_post_disaster.png,40,35,1,118,158,305,340,546,38.56284913936204,19.141993916641205
14546,/media/marda/TWOTB1/xBD/hurricanes/images/florence/hurricane-florence_00000052_post_disaster.png,7,22,1,81,88,336,358,54,9.638093752437017,7.494406829767874
14547,/media/marda/TWOTB1/xBD/hurricanes/images/florence/hurricane-florence_00000052_post_disaster.png,41,41,1,183,224,340,381,650,37.7565371009924,22.577465559973717
14548,/media/marda/TWOTB1/xBD/hurricanes/images/florence/hurricane-florence_00000052_post_disaster.png,44,31,1,447,491,378,409,371,29.786844957840355,16.384464285917105
14549,/media/marda/TWOTB1/xBD/hurricanes/images/florence/hurricane-florence_00000052_post_disaster.png,76,57,1,405,481,408,465,1620,64.11204984274792,33.45386855999165
14550,/media/marda/TWOTB1/xBD/hurricanes/images/florence/hurricane-florence_00000052_post_disaster.png,29,56,1,0,29,490,546,845,37.42673622644786,30.234731316420685
14551,/media/marda/TWOTB1/xBD/hurricanes/images/florence/hurricane-florence_00000052_post_disaster.png,25,20,1,245,270,144,164,171,17.244913956508352,13.203110167889173
14552,/media/marda/TWOTB1/xBD/hurricanes/images/florence/hurricane-florence_00000052_post_disaster.png,111,89,1,810,921,644,733,1872,91.17940822076463,27.358258902151583
14553,/media/marda/TWOTB1/xBD/hurricanes/images/florence/hurricane-florence_00000052_post_disaster.png,25,46,1,109,134,747,793,220,18.799486524635626,15.68725757459526
14554,/media/marda/TWOTB1/xBD/hurricanes/images/florence/hurricane-florence_00000052_post_disaster.png,39,57,1,142,181,749,806,643,36.259074689669966,23.392239441669997
14555,/media/marda/TWOTB1/xBD/hurricanes/images/florence/hurricane-florence_00000052_post_disaster.png,55,48,1,818,873,964,1012,221,26.716969041671945,11.097720554754986
14556,/media/marda/TWOTB1/xBD/hurricanes/images/florence/hurricane-florence_00000442_post_disaster.png,59,75,1,183,242,436,511,1561,60.10094616336042,35.995726045227265
14557,/media/marda/TWOTB1/xBD/hurricanes/images/florence/hurricane-florence_00000442_post_disaster.png,32,43,1,148,180,450,493,362,26.916695407463497,17.97296358267171
14558,/media/marda/TWOTB1/xBD/hurricanes/images/florence/hurricane-florence_00000442_post_disaster.png,36,6,1,545,581,0,6,51,14.445109756025985,5.336512516934508
14559,/media/marda/TWOTB1/xBD/hurricanes/images/florence/hurricane-florence_00000442_post_disaster.png,76,53,1,99,175,135,188,1822,76.0471168792394,37.82104007292975
14560,/media/marda/TWOTB1/xBD/hurricanes/images/florence/hurricane-florence_00000442_post_disaster.png,73,43,1,693,766,159,202,653,54.601301274607195,15.853935356133617
14561,/media/marda/TWOTB1/xBD/hurricanes/images/florence/hurricane-florence_00000442_post_disaster.png,66,50,1,641,707,203,253,671,53.22989448869958,16.638736253087764
14562,/media/marda/TWOTB1/xBD/hurricanes/images/florence/hurricane-florence_00000442_post_disaster.png,22,25,1,101,123,215,240,149,16.17699810685102,12.379869775340484
14563,/media/marda/TWOTB1/xBD/hurricanes/images/florence/hurricane-florence_00000442_post_disaster.png,61,63,1,819,880,226,289,767,60.35796264667244,16.957721220252306
14564,/media/marda/TWOTB1/xBD/hurricanes/images/florence/hurricane-florence_00000442_post_disaster.png,70,49,1,709,779,227,276,663,52.86825042824612,16.506393017320846
14565,/media/marda/TWOTB1/xBD/hurricanes/images/florence/hurricane-florence_00000442_post_disaster.png,34,27,1,351,385,232,259,176,23.536614441314608,10.021098180343015
14566,/media/marda/TWOTB1/xBD/hurricanes/images/florence/hurricane-florence_00000442_post_disaster.png,39,32,1,296,335,246,278,345,24.262043574405123,18.777483551226524
14567,/media/marda/TWOTB1/xBD/hurricanes/images/florence/hurricane-florence_00000442_post_disaster.png,49,27,1,853,902,256,283,182,18.389457689537863,13.164249889626216
14568,/media/marda/TWOTB1/xBD/hurricanes/images/florence/hurricane-florence_00000442_post_disaster.png,64,65,1,340,404,267,332,1421,58.72544968917542,33.84986467677901
14569,/media/marda/TWOTB1/xBD/hurricanes/images/florence/hurricane-florence_00000442_post_disaster.png,58,45,1,585,643,270,315,504,44.485070640080394,15.129345136236594
14570,/media/marda/TWOTB1/xBD/hurricanes/images/florence/hurricane-florence_00000442_post_disaster.png,73,54,1,643,716,288,342,796,60.68055168949798,17.373808097409405
14571,/media/marda/TWOTB1/xBD/hurricanes/images/florence/hurricane-florence_00000442_post_disaster.png,63,61,1,796,859,297,358,804,49.55427517322416,23.146326199774478
14572,/media/marda/TWOTB1/xBD/hurricanes/images/florence/hurricane-florence_00000442_post_disaster.png,59,30,1,910,969,313,343,197,24.153423919863183,10.90890638355979
14573,/media/marda/TWOTB1/xBD/hurricanes/images/florence/hurricane-florence_00000442_post_disaster.png,66,53,1,878,944,318,371,611,47.11255862351071,18.467653920687777
14574,/media/marda/TWOTB1/xBD/hurricanes/images/florence/hurricane-florence_00000442_post_disaster.png,64,58,1,513,577,339,397,727,57.79953333427795,16.721373613258404
14575,/media/marda/TWOTB1/xBD/hurricanes/images/florence/hurricane-florence_00000442_post_disaster.png,49,57,1,213,262,350,407,929,38.653691626917066,33.018721901890935
14576,/media/marda/TWOTB1/xBD/hurricanes/images/florence/hurricane-florence_00000442_post_disaster.png,68,62,1,250,318,361,423,1457,54.88574737989267,37.40647727298703
14577,/media/marda/TWOTB1/xBD/hurricanes/images/florence/hurricane-florence_00000442_post_disaster.png,63,61,1,958,1021,366,427,518,54.17362597411049,12.809864346349105
14578,/media/marda/TWOTB1/xBD/hurricanes/images/florence/hurricane-florence_00000442_post_disaster.png,42,35,1,527,569,372,407,258,21.158859496667528,16.167890268588692
14579,/media/marda/TWOTB1/xBD/hurricanes/images/florence/hurricane-florence_00000442_post_disaster.png,67,36,1,589,656,374,410,477,50.66752832627726,12.51940311123999
14580,/media/marda/TWOTB1/xBD/hurricanes/images/florence/hurricane-florence_00000442_post_disaster.png,54,46,1,807,861,376,422,387,37.327988661351995,13.780321750443656
14581,/media/marda/TWOTB1/xBD/hurricanes/images/florence/hurricane-florence_00000442_post_disaster.png,19,23,1,209,228,380,403,57,11.40424617140587,6.715732573503555
14582,/media/marda/TWOTB1/xBD/hurricanes/images/florence/hurricane-florence_00000442_post_disaster.png,61,64,1,849,910,389,453,672,57.641578774660694,15.5268385280212
14583,/media/marda/TWOTB1/xBD/hurricanes/images/florence/hurricane-florence_00000442_post_disaster.png,23,36,1,48,71,390,426,277,20.552123309837093,18.00946920785881
14584,/media/marda/TWOTB1/xBD/hurricanes/images/florence/hurricane-florence_00000442_post_disaster.png,47,54,1,6,53,404,458,956,42.72763217951948,29.706807069600274
14585,/media/marda/TWOTB1/xBD/hurricanes/images/florence/hurricane-florence_00000442_post_disaster.png,77,45,1,656,733,411,456,568,58.489639132245216,12.945367001219934
14586,/media/marda/TWOTB1/xBD/hurricanes/images/florence/hurricane-florence_00000442_post_disaster.png,58,74,1,724,782,415,489,852,63.78364299300408,20.52623748847307
14587,/media/marda/TWOTB1/xBD/hurricanes/images/florence/hurricane-florence_00000442_post_disaster.png,58,65,1,764,822,440,505,665,52.144595972387314,16.88433955055928
14588,/media/marda/TWOTB1/xBD/hurricanes/images/florence/hurricane-florence_00000442_post_disaster.png,61,57,1,933,994,442,499,561,45.550751904858146,16.28343761119605
14589,/media/marda/TWOTB1/xBD/hurricanes/images/florence/hurricane-florence_00000442_post_disaster.png,46,36,1,693,739,453,489,210,17.650542328251323,15.979049122128849
14590,/media/marda/TWOTB1/xBD/hurricanes/images/florence/hurricane-florence_00000442_post_disaster.png,57,57,1,828,885,458,515,487,44.609774018524696,14.604888369134692
14591,/media/marda/TWOTB1/xBD/hurricanes/images/florence/hurricane-florence_00000442_post_disaster.png,44,29,1,854,898,459,488,97,11.709879180019312,11.128988776611532
14592,/media/marda/TWOTB1/xBD/hurricanes/images/florence/hurricane-florence_00000442_post_disaster.png,81,53,1,686,767,499,552,627,64.13203860594689,13.140335280335158
14593,/media/marda/TWOTB1/xBD/hurricanes/images/florence/hurricane-florence_00000442_post_disaster.png,64,68,1,910,974,499,567,666,52.90139878251988,16.826168222005847
14594,/media/marda/TWOTB1/xBD/hurricanes/images/florence/hurricane-florence_00000442_post_disaster.png,25,39,1,114,139,512,551,199,17.68195403691489,15.040038989085538
14595,/media/marda/TWOTB1/xBD/hurricanes/images/florence/hurricane-florence_00000442_post_disaster.png,30,50,1,78,108,513,563,360,32.062652665833966,16.603841079641526
14596,/media/marda/TWOTB1/xBD/hurricanes/images/florence/hurricane-florence_00000442_post_disaster.png,60,72,1,983,1043,519,591,537,50.0570191341503,14.769473809768906
14597,/media/marda/TWOTB1/xBD/hurricanes/images/florence/hurricane-florence_00000442_post_disaster.png,49,67,1,111,160,527,594,939,56.35339134328594,24.401899146831713
14598,/media/marda/TWOTB1/xBD/hurricanes/images/florence/hurricane-florence_00000442_post_disaster.png,56,61,1,764,820,534,595,583,41.96353910956208,22.007580529016472
14599,/media/marda/TWOTB1/xBD/hurricanes/images/florence/hurricane-florence_00000442_post_disaster.png,66,71,1,343,409,543,614,1369,54.17893489716446,33.52518711479528
14600,/media/marda/TWOTB1/xBD/hurricanes/images/florence/hurricane-florence_00000442_post_disaster.png,39,33,1,761,800,548,581,82,11.715511528737329,9.426548550745954
14601,/media/marda/TWOTB1/xBD/hurricanes/images/florence/hurricane-florence_00000442_post_disaster.png,61,73,1,862,923,567,640,631,59.933649086947526,14.076030889326415
14602,/media/marda/TWOTB1/xBD/hurricanes/images/florence/hurricane-florence_00000442_post_disaster.png,51,64,1,746,797,608,672,496,42.22236597100514,15.73694059604707
14603,/media/marda/TWOTB1/xBD/hurricanes/images/florence/hurricane-florence_00000442_post_disaster.png,59,68,1,392,451,612,680,997,40.43752922105931,32.77000818011643
14604,/media/marda/TWOTB1/xBD/hurricanes/images/florence/hurricane-florence_00000442_post_disaster.png,60,73,1,839,899,635,708,675,53.09818786186801,16.9422935278345
14605,/media/marda/TWOTB1/xBD/hurricanes/images/florence/hurricane-florence_00000442_post_disaster.png,63,69,1,436,499,637,706,1056,40.54013238497684,34.76440126604652
14606,/media/marda/TWOTB1/xBD/hurricanes/images/florence/hurricane-florence_00000442_post_disaster.png,97,58,1,905,1002,642,700,711,68.96725958555164,13.819345956467885
14607,/media/marda/TWOTB1/xBD/hurricanes/images/florence/hurricane-florence_00000442_post_disaster.png,58,71,1,331,389,648,719,748,60.869329082797584,16.2977988811508
14608,/media/marda/TWOTB1/xBD/hurricanes/images/florence/hurricane-florence_00000442_post_disaster.png,33,42,1,386,419,672,714,199,17.0980215618905,15.339731564947188
14609,/media/marda/TWOTB1/xBD/hurricanes/images/florence/hurricane-florence_00000442_post_disaster.png,62,82,1,236,298,691,773,1281,59.74600219522625,28.679400298257193
14610,/media/marda/TWOTB1/xBD/hurricanes/images/florence/hurricane-florence_00000442_post_disaster.png,15,57,1,0,15,724,781,225,24.726298898094516,13.976660954751141
14611,/media/marda/TWOTB1/xBD/hurricanes/images/florence/hurricane-florence_00000442_post_disaster.png,46,65,1,284,330,751,816,641,34.948860460427824,24.59326068307786
14612,/media/marda/TWOTB1/xBD/hurricanes/images/florence/hurricane-florence_00000442_post_disaster.png,44,74,1,107,151,793,867,634,54.15446141962069,15.473376728251298
14613,/media/marda/TWOTB1/xBD/hurricanes/images/florence/hurricane-florence_00000442_post_disaster.png,55,69,1,84,139,856,925,978,50.59639477736124,26.630197335535026
14614,/media/marda/TWOTB1/xBD/hurricanes/images/florence/hurricane-florence_00000442_post_disaster.png,44,84,1,0,44,916,1000,1314,46.51616723533184,40.22486706241608
14615,/media/marda/TWOTB1/xBD/hurricanes/images/florence/hurricane-florence_00000442_post_disaster.png,44,70,1,58,102,922,992,857,45.46369350870429,24.932550101826134
14616,/media/marda/TWOTB1/xBD/hurricanes/images/florence/hurricane-florence_00000284_pre_disaster.png,41,25,1,139,180,24,49,687,40.41480184878803,22.423425003316996
14617,/media/marda/TWOTB1/xBD/hurricanes/images/florence/hurricane-florence_00000284_pre_disaster.png,22,28,1,104,126,34,62,409,29.078144607833778,18.49508012070757
14618,/media/marda/TWOTB1/xBD/hurricanes/images/florence/hurricane-florence_00000284_pre_disaster.png,22,18,1,155,177,93,111,240,18.79300145984058,17.12602102446537
14619,/media/marda/TWOTB1/xBD/hurricanes/images/florence/hurricane-florence_00000284_pre_disaster.png,8,19,1,0,8,193,212,120,17.281975195754296,9.16515138991168
14620,/media/marda/TWOTB1/xBD/hurricanes/images/florence/hurricane-florence_00000284_pre_disaster.png,50,40,1,85,135,209,249,1128,48.77897257306396,30.345332840316484
14621,/media/marda/TWOTB1/xBD/hurricanes/images/florence/hurricane-florence_00000284_pre_disaster.png,51,26,1,857,908,221,247,306,21.053831126989405,19.437475090720977
14622,/media/marda/TWOTB1/xBD/hurricanes/images/florence/hurricane-florence_00000284_pre_disaster.png,14,18,1,89,103,249,267,106,12.795846674632822,10.908925195725011
14623,/media/marda/TWOTB1/xBD/hurricanes/images/florence/hurricane-florence_00000284_pre_disaster.png,31,64,1,93,124,290,354,1326,62.33274338271444,28.299277129468994
14624,/media/marda/TWOTB1/xBD/hurricanes/images/florence/hurricane-florence_00000284_pre_disaster.png,20,38,1,7,27,401,439,348,22.203001148830918,20.995710119767057
14625,/media/marda/TWOTB1/xBD/hurricanes/images/florence/hurricane-florence_00000284_pre_disaster.png,40,68,1,28,68,416,484,1325,49.0846220969521,37.49292922322193
14626,/media/marda/TWOTB1/xBD/hurricanes/images/florence/hurricane-florence_00000284_pre_disaster.png,47,56,1,520,567,672,728,658,34.25584809920946,26.762794428538772
14627,/media/marda/TWOTB1/xBD/hurricanes/images/florence/hurricane-florence_00000284_pre_disaster.png,47,58,1,64,111,818,876,783,50.319566162253224,22.554771328623225
14628,/media/marda/TWOTB1/xBD/hurricanes/images/florence/hurricane-florence_00000284_pre_disaster.png,22,48,1,201,223,829,877,168,15.328508355987282,14.72089100679517
14629,/media/marda/TWOTB1/xBD/hurricanes/images/florence/hurricane-florence_00000284_pre_disaster.png,20,46,1,328,348,927,973,80,11.489125293076057,9.16515138991168
14630,/media/marda/TWOTB1/xBD/hurricanes/images/florence/hurricane-florence_00000284_pre_disaster.png,32,80,1,524,556,933,1013,453,49.81145783770771,12.14358799231693
14631,/media/marda/TWOTB1/xBD/hurricanes/images/florence/hurricane-florence_00000284_pre_disaster.png,33,63,1,314,347,942,1005,527,30.212925202366524,23.384509007658565
14632,/media/marda/TWOTB1/xBD/hurricanes/images/florence/hurricane-florence_00000284_pre_disaster.png,67,56,1,537,604,964,1020,699,52.66616942380638,18.132435560720683
14633,/media/marda/TWOTB1/xBD/hurricanes/images/florence/hurricane-florence_00000204_post_disaster.png,38,33,1,185,223,18,51,699,31.587099751335657,29.197104456375516
14634,/media/marda/TWOTB1/xBD/hurricanes/images/florence/hurricane-florence_00000204_post_disaster.png,47,46,1,745,792,738,784,162,18.985935906751507,11.404067531510076
14635,/media/marda/TWOTB1/xBD/hurricanes/images/florence/hurricane-florence_00000204_post_disaster.png,52,57,1,385,437,986,1043,502,40.97840210888817,16.35706853408554
14636,/media/marda/TWOTB1/xBD/hurricanes/images/florence/hurricane-florence_00000068_post_disaster.png,59,23,1,915,974,28,51,494,26.215056764382357,25.034296875228655
14637,/media/marda/TWOTB1/xBD/hurricanes/images/florence/hurricane-florence_00000068_post_disaster.png,75,36,1,948,1023,192,228,937,38.31101002742288,32.16805852217779
14638,/media/marda/TWOTB1/xBD/hurricanes/images/florence/hurricane-florence_00000068_post_disaster.png,59,42,1,984,1043,430,472,443,28.39369094939788,20.846685476236843
14639,/media/marda/TWOTB1/xBD/hurricanes/images/florence/hurricane-florence_00000415_post_disaster.png,83,56,1,904,987,0,56,1193,67.7123886594048,36.81468561701703
14640,/media/marda/TWOTB1/xBD/hurricanes/images/florence/hurricane-florence_00000415_post_disaster.png,56,34,1,878,934,18,52,677,37.65817653164366,23.786124172977452
14641,/media/marda/TWOTB1/xBD/hurricanes/images/florence/hurricane-florence_00000415_post_disaster.png,91,55,1,856,947,68,123,2130,59.584590958955104,51.89382201163068
14642,/media/marda/TWOTB1/xBD/hurricanes/images/florence/hurricane-florence_00000415_post_disaster.png,61,55,1,938,999,229,284,1109,52.57060487112661,27.987100569512567
14643,/media/marda/TWOTB1/xBD/hurricanes/images/florence/hurricane-florence_00000426_pre_disaster.png,52,41,1,455,507,0,41,838,46.719979912692345,25.08355834062316
14644,/media/marda/TWOTB1/xBD/hurricanes/images/florence/hurricane-florence_00000426_pre_disaster.png,83,19,1,899,982,0,19,678,51.19269964179956,18.01670459815394
14645,/media/marda/TWOTB1/xBD/hurricanes/images/florence/hurricane-florence_00000426_pre_disaster.png,81,39,1,294,375,30,69,1600,74.17038795397299,28.477849629266927
14646,/media/marda/TWOTB1/xBD/hurricanes/images/florence/hurricane-florence_00000426_pre_disaster.png,64,30,1,660,724,30,60,687,42.903746257400734,23.700330510300716
14647,/media/marda/TWOTB1/xBD/hurricanes/images/florence/hurricane-florence_00000426_pre_disaster.png,67,32,1,914,981,31,63,760,32.19411987315089,31.536106074044913
14648,/media/marda/TWOTB1/xBD/hurricanes/images/florence/hurricane-florence_00000426_pre_disaster.png,74,65,1,781,855,39,104,2113,66.97245439339719,42.09267001142055
14649,/media/marda/TWOTB1/xBD/hurricanes/images/florence/hurricane-florence_00000426_pre_disaster.png,55,35,1,246,301,56,91,1036,45.2923704403092,30.654908825208356
14650,/media/marda/TWOTB1/xBD/hurricanes/images/florence/hurricane-florence_00000426_pre_disaster.png,42,11,1,871,913,59,70,72,10.08416266847916,9.728304589661631
14651,/media/marda/TWOTB1/xBD/hurricanes/images/florence/hurricane-florence_00000426_pre_disaster.png,62,38,1,632,694,61,99,890,42.8118800447757,29.232114553601612
14652,/media/marda/TWOTB1/xBD/hurricanes/images/florence/hurricane-florence_00000426_pre_disaster.png,43,10,1,869,912,69,79,77,12.573620689767857,8.28527853802504
14653,/media/marda/TWOTB1/xBD/hurricanes/images/florence/hurricane-florence_00000426_pre_disaster.png,67,23,1,902,969,72,95,517,31.886386990426413,21.997126717727234
14654,/media/marda/TWOTB1/xBD/hurricanes/images/florence/hurricane-florence_00000426_pre_disaster.png,67,43,1,456,523,77,120,1265,45.70365069038768,36.59594429525243
14655,/media/marda/TWOTB1/xBD/hurricanes/images/florence/hurricane-florence_00000426_pre_disaster.png,39,44,1,124,163,86,130,893,45.08627993529415,26.44439747579573
14656,/media/marda/TWOTB1/xBD/hurricanes/images/florence/hurricane-florence_00000426_pre_disaster.png,31,31,1,159,190,96,127,506,29.10792127390662,23.211464178161197
14657,/media/marda/TWOTB1/xBD/hurricanes/images/florence/hurricane-florence_00000426_pre_disaster.png,72,50,1,476,548,119,169,1544,52.530098871937696,39.053224000962395
14658,/media/marda/TWOTB1/xBD/hurricanes/images/florence/hurricane-florence_00000426_pre_disaster.png,63,39,1,925,988,136,175,679,35.3338835289911,25.68346522764982
14659,/media/marda/TWOTB1/xBD/hurricanes/images/florence/hurricane-florence_00000426_pre_disaster.png,39,24,1,450,489,139,163,288,21.671902386537738,17.811332839064445
14660,/media/marda/TWOTB1/xBD/hurricanes/images/florence/hurricane-florence_00000426_pre_disaster.png,106,107,1,0,106,140,247,4912,134.18568856767666,56.614731013423516
14661,/media/marda/TWOTB1/xBD/hurricanes/images/florence/hurricane-florence_00000426_pre_disaster.png,68,41,1,271,339,147,188,1097,64.20547262339885,22.649924978083792
14662,/media/marda/TWOTB1/xBD/hurricanes/images/florence/hurricane-florence_00000426_pre_disaster.png,22,29,1,123,145,148,177,257,26.529245823168523,12.979070015931764
14663,/media/marda/TWOTB1/xBD/hurricanes/images/florence/hurricane-florence_00000426_pre_disaster.png,69,57,1,721,790,189,246,1578,54.07079841343314,38.70124210103319
14664,/media/marda/TWOTB1/xBD/hurricanes/images/florence/hurricane-florence_00000426_pre_disaster.png,37,42,1,46,83,198,240,796,37.82043322210504,27.905460981883856
14665,/media/marda/TWOTB1/xBD/hurricanes/images/florence/hurricane-florence_00000426_pre_disaster.png,76,53,1,850,926,224,277,1203,46.94666379621547,34.22594718683167
14666,/media/marda/TWOTB1/xBD/hurricanes/images/florence/hurricane-florence_00000426_pre_disaster.png,43,30,1,404,447,226,256,361,26.470408543108626,18.265433147774928
14667,/media/marda/TWOTB1/xBD/hurricanes/images/florence/hurricane-florence_00000426_pre_disaster.png,72,81,1,134,206,232,313,2598,77.09348605332278,47.82504806099872
14668,/media/marda/TWOTB1/xBD/hurricanes/images/florence/hurricane-florence_00000426_pre_disaster.png,85,61,1,635,720,232,293,1697,64.04821397240296,37.62628083529752
14669,/media/marda/TWOTB1/xBD/hurricanes/images/florence/hurricane-florence_00000426_pre_disaster.png,72,52,1,903,975,240,292,967,42.70270271848756,30.19871895457213
14670,/media/marda/TWOTB1/xBD/hurricanes/images/florence/hurricane-florence_00000426_pre_disaster.png,44,37,1,541,585,260,297,480,27.066480019292463,23.327471726336302
14671,/media/marda/TWOTB1/xBD/hurricanes/images/florence/hurricane-florence_00000426_pre_disaster.png,72,36,1,716,788,270,306,871,46.789829824871816,24.853317547435054
14672,/media/marda/TWOTB1/xBD/hurricanes/images/florence/hurricane-florence_00000426_pre_disaster.png,65,41,1,458,523,293,334,929,50.45677001365891,24.40523135413617
14673,/media/marda/TWOTB1/xBD/hurricanes/images/florence/hurricane-florence_00000426_pre_disaster.png,55,47,1,523,578,295,342,600,36.99409581432345,23.43095738055843
14674,/media/marda/TWOTB1/xBD/hurricanes/images/florence/hurricane-florence_00000426_pre_disaster.png,31,22,1,509,540,326,348,68,10.753721294181409,8.550948719400077
14675,/media/marda/TWOTB1/xBD/hurricanes/images/florence/hurricane-florence_00000426_pre_disaster.png,45,33,1,537,582,328,361,330,24.33298928386194,18.040752607412333
14676,/media/marda/TWOTB1/xBD/hurricanes/images/florence/hurricane-florence_00000426_pre_disaster.png,60,45,1,563,623,340,385,870,38.105551378054734,30.049156442394423
14677,/media/marda/TWOTB1/xBD/hurricanes/images/florence/hurricane-florence_00000426_pre_disaster.png,91,65,1,358,449,344,409,2641,76.79217972340678,45.316470685600464
14678,/media/marda/TWOTB1/xBD/hurricanes/images/florence/hurricane-florence_00000426_pre_disaster.png,27,30,1,231,258,365,395,214,18.83665834622047,15.043202935028864
14679,/media/marda/TWOTB1/xBD/hurricanes/images/florence/hurricane-florence_00000426_pre_disaster.png,61,23,1,841,902,370,393,243,33.03212080565145,9.895533680741385
14680,/media/marda/TWOTB1/xBD/hurricanes/images/florence/hurricane-florence_00000426_pre_disaster.png,39,57,1,252,291,371,428,969,44.53119706211326,28.91232270387381
14681,/media/marda/TWOTB1/xBD/hurricanes/images/florence/hurricane-florence_00000426_pre_disaster.png,68,27,1,893,961,372,399,344,35.02695025478959,13.106275782250455
14682,/media/marda/TWOTB1/xBD/hurricanes/images/florence/hurricane-florence_00000426_pre_disaster.png,40,55,1,175,215,379,434,965,41.60179706570479,30.8682965855248
14683,/media/marda/TWOTB1/xBD/hurricanes/images/florence/hurricane-florence_00000426_pre_disaster.png,51,35,1,738,789,390,425,358,23.427728794124725,20.06029545709066
14684,/media/marda/TWOTB1/xBD/hurricanes/images/florence/hurricane-florence_00000426_pre_disaster.png,52,51,1,513,565,395,446,628,34.10858311962915,24.59170731418549
14685,/media/marda/TWOTB1/xBD/hurricanes/images/florence/hurricane-florence_00000426_pre_disaster.png,62,54,1,565,627,400,454,926,36.410006831494954,33.9646264709045
14686,/media/marda/TWOTB1/xBD/hurricanes/images/florence/hurricane-florence_00000426_pre_disaster.png,66,64,1,699,765,408,472,1173,45.72166521304714,33.70128057458313
14687,/media/marda/TWOTB1/xBD/hurricanes/images/florence/hurricane-florence_00000426_pre_disaster.png,58,47,1,986,1044,427,474,378,30.84456439655151,16.957086316944388
14688,/media/marda/TWOTB1/xBD/hurricanes/images/florence/hurricane-florence_00000426_pre_disaster.png,46,81,1,68,114,431,512,1721,66.29704780071289,34.352263706195345
14689,/media/marda/TWOTB1/xBD/hurricanes/images/florence/hurricane-florence_00000426_pre_disaster.png,90,71,1,398,488,438,509,2533,71.53523234363944,46.99142496052968
14690,/media/marda/TWOTB1/xBD/hurricanes/images/florence/hurricane-florence_00000426_pre_disaster.png,63,51,1,934,997,443,494,585,35.255137002634875,22.159317914693926
14691,/media/marda/TWOTB1/xBD/hurricanes/images/florence/hurricane-florence_00000426_pre_disaster.png,61,72,1,484,545,479,551,1444,57.29076369196736,33.63707190166038
14692,/media/marda/TWOTB1/xBD/hurricanes/images/florence/hurricane-florence_00000426_pre_disaster.png,44,66,1,256,300,487,553,1059,50.59618678265174,27.940150094207308
14693,/media/marda/TWOTB1/xBD/hurricanes/images/florence/hurricane-florence_00000426_pre_disaster.png,76,85,1,402,478,505,590,2431,61.61774011389378,52.592107836862546
14694,/media/marda/TWOTB1/xBD/hurricanes/images/florence/hurricane-florence_00000426_pre_disaster.png,45,80,1,91,136,534,614,1513,55.20116896852241,37.20060184433599
14695,/media/marda/TWOTB1/xBD/hurricanes/images/florence/hurricane-florence_00000426_pre_disaster.png,51,54,1,512,563,593,647,542,27.53769339375303,26.299021696303587
14696,/media/marda/TWOTB1/xBD/hurricanes/images/florence/hurricane-florence_00000426_pre_disaster.png,18,69,1,0,18,601,670,519,46.46892515457748,15.890063990469429
14697,/media/marda/TWOTB1/xBD/hurricanes/images/florence/hurricane-florence_00000426_pre_disaster.png,66,68,1,427,493,602,670,1384,51.12276612316789,35.85525074949099
14698,/media/marda/TWOTB1/xBD/hurricanes/images/florence/hurricane-florence_00000426_pre_disaster.png,61,75,1,117,178,614,689,1412,65.37021354472347,32.19058228945852
14699,/media/marda/TWOTB1/xBD/hurricanes/images/florence/hurricane-florence_00000426_pre_disaster.png,38,39,1,492,530,635,674,155,16.334560847213265,12.755079344633517
14700,/media/marda/TWOTB1/xBD/hurricanes/images/florence/hurricane-florence_00000426_pre_disaster.png,94,98,1,294,388,642,740,3432,75.69948767808732,69.36139627553811
14701,/media/marda/TWOTB1/xBD/hurricanes/images/florence/hurricane-florence_00000426_pre_disaster.png,60,60,1,439,499,642,702,877,46.31258414262177,25.94117279073526
14702,/media/marda/TWOTB1/xBD/hurricanes/images/florence/hurricane-florence_00000426_pre_disaster.png,37,62,1,0,37,659,721,947,38.27258633225698,34.40374134576164
14703,/media/marda/TWOTB1/xBD/hurricanes/images/florence/hurricane-florence_00000426_pre_disaster.png,129,73,1,801,930,685,758,2194,105.60055135324184,27.909090339718755
14704,/media/marda/TWOTB1/xBD/hurricanes/images/florence/hurricane-florence_00000426_pre_disaster.png,108,67,1,931,1039,697,764,1554,77.88238593065537,27.077466948390118
14705,/media/marda/TWOTB1/xBD/hurricanes/images/florence/hurricane-florence_00000426_pre_disaster.png,59,60,1,472,531,701,761,796,44.452046246349646,23.6739386538544
14706,/media/marda/TWOTB1/xBD/hurricanes/images/florence/hurricane-florence_00000426_pre_disaster.png,109,78,1,697,806,719,797,1924,91.2495850691966,28.337782160526523
14707,/media/marda/TWOTB1/xBD/hurricanes/images/florence/hurricane-florence_00000426_pre_disaster.png,55,62,1,354,409,742,804,882,42.29413090144286,27.464883089717432
14708,/media/marda/TWOTB1/xBD/hurricanes/images/florence/hurricane-florence_00000426_pre_disaster.png,93,120,1,214,307,758,878,4697,86.2316282623851,72.6456808763776
14709,/media/marda/TWOTB1/xBD/hurricanes/images/florence/hurricane-florence_00000426_pre_disaster.png,98,130,1,484,582,771,901,4889,103.70907524209834,62.99787762362407
14710,/media/marda/TWOTB1/xBD/hurricanes/images/florence/hurricane-florence_00000426_pre_disaster.png,55,61,1,365,420,774,835,798,42.22148767200264,24.90778681487039
14711,/media/marda/TWOTB1/xBD/hurricanes/images/florence/hurricane-florence_00000426_pre_disaster.png,45,82,1,63,108,776,858,1374,54.555895597937806,33.47687327987596
14712,/media/marda/TWOTB1/xBD/hurricanes/images/florence/hurricane-florence_00000426_pre_disaster.png,55,77,1,989,1044,782,859,382,46.83832873149837,12.544606249508881
14713,/media/marda/TWOTB1/xBD/hurricanes/images/florence/hurricane-florence_00000426_pre_disaster.png,80,122,1,645,725,804,926,2340,100.28407866810709,31.425546962281377
14714,/media/marda/TWOTB1/xBD/hurricanes/images/florence/hurricane-florence_00000426_pre_disaster.png,67,121,1,922,989,828,949,2310,100.58225938602199,31.028243246834517
14715,/media/marda/TWOTB1/xBD/hurricanes/images/florence/hurricane-florence_00000426_pre_disaster.png,102,68,1,819,921,839,907,1529,75.24657779782731,27.605793167146693
14716,/media/marda/TWOTB1/xBD/hurricanes/images/florence/hurricane-florence_00000426_pre_disaster.png,69,70,1,558,627,891,961,948,49.13522728739365,25.663642179373603
14717,/media/marda/TWOTB1/xBD/hurricanes/images/florence/hurricane-florence_00000426_pre_disaster.png,107,114,1,815,922,908,1022,2137,95.51795580216128,29.9203776938931
14718,/media/marda/TWOTB1/xBD/hurricanes/images/florence/hurricane-florence_00000426_pre_disaster.png,72,114,1,632,704,909,1023,1903,85.71858853098207,29.885424172238203
14719,/media/marda/TWOTB1/xBD/hurricanes/images/florence/hurricane-florence_00000426_pre_disaster.png,94,93,1,351,445,917,1010,2613,79.25686109762486,43.77077252539094
14720,/media/marda/TWOTB1/xBD/hurricanes/images/florence/hurricane-florence_00000426_pre_disaster.png,66,106,1,923,989,926,1032,1723,77.3409523022848,30.513233618058948
14721,/media/marda/TWOTB1/xBD/hurricanes/images/florence/hurricane-florence_00000426_pre_disaster.png,120,64,1,686,806,978,1042,1218,81.64150835698563,22.92118461668558
14722,/media/marda/TWOTB1/xBD/hurricanes/images/florence/hurricane-florence_00000426_pre_disaster.png,51,62,1,308,359,982,1044,466,42.87598944493609,14.387292468452623
14723,/media/marda/TWOTB1/xBD/hurricanes/images/florence/hurricane-florence_00000116_pre_disaster.png,49,89,1,43,92,841,930,1786,56.58422736674609,42.55963831237635
14724,/media/marda/TWOTB1/xBD/hurricanes/images/florence/hurricane-florence_00000116_pre_disaster.png,23,52,1,166,189,889,941,228,19.679655503808135,15.564543645753222
14725,/media/marda/TWOTB1/xBD/hurricanes/images/florence/hurricane-florence_00000532_post_disaster.png,32,34,1,32,64,363,397,529,37.033715168790074,20.94204040547828
14726,/media/marda/TWOTB1/xBD/hurricanes/images/florence/hurricane-florence_00000532_post_disaster.png,40,33,1,79,119,382,415,565,41.34337434003408,18.269589924144373
14727,/media/marda/TWOTB1/xBD/hurricanes/images/florence/hurricane-florence_00000532_post_disaster.png,34,44,1,40,74,419,463,797,36.16586606384423,29.01369562473598
14728,/media/marda/TWOTB1/xBD/hurricanes/images/florence/hurricane-florence_00000532_post_disaster.png,140,72,1,491,631,662,734,3635,136.83791136608662,37.30409045035993
14729,/media/marda/TWOTB1/xBD/hurricanes/images/florence/hurricane-florence_00000532_post_disaster.png,138,70,1,492,630,714,784,3644,134.59403489157623,37.2388817761287
14730,/media/marda/TWOTB1/xBD/hurricanes/images/florence/hurricane-florence_00000532_post_disaster.png,34,35,1,493,527,776,811,83,15.3221521442733,7.144820716717879
14731,/media/marda/TWOTB1/xBD/hurricanes/images/florence/hurricane-florence_00000532_post_disaster.png,138,63,1,494,632,782,845,3606,132.03578433582658,36.31696769132193
14732,/media/marda/TWOTB1/xBD/hurricanes/images/florence/hurricane-florence_00000532_post_disaster.png,40,46,1,496,536,825,871,273,22.54891225773729,16.096077242823316
14733,/media/marda/TWOTB1/xBD/hurricanes/images/florence/hurricane-florence_00000532_post_disaster.png,36,49,1,460,496,835,884,302,23.201635200275394,17.41246845821052
14734,/media/marda/TWOTB1/xBD/hurricanes/images/florence/hurricane-florence_00000532_post_disaster.png,126,73,1,458,584,858,931,3321,122.85095593831855,37.13540679197707
14735,/media/marda/TWOTB1/xBD/hurricanes/images/florence/hurricane-florence_00000532_post_disaster.png,30,44,1,459,489,915,959,83,14.293412556694726,7.6705837609765934
14736,/media/marda/TWOTB1/xBD/hurricanes/images/florence/hurricane-florence_00000532_post_disaster.png,125,70,1,459,584,923,993,3188,120.53638044754894,35.13597576660213
14737,/media/marda/TWOTB1/xBD/hurricanes/images/florence/hurricane-florence_00000532_post_disaster.png,24,48,1,458,482,964,1012,67,12.729364880519679,7.322277896119611
14738,/media/marda/TWOTB1/xBD/hurricanes/images/florence/hurricane-florence_00000532_post_disaster.png,124,65,1,460,584,976,1041,2813,120.29800284055277,31.125197073043562
14739,/media/marda/TWOTB1/xBD/hurricanes/images/florence/hurricane-florence_00000469_post_disaster.png,58,89,1,0,58,415,504,2520,73.42636075710391,54.5028673488195
14740,/media/marda/TWOTB1/xBD/hurricanes/images/florence/hurricane-florence_00000259_pre_disaster.png,66,36,1,484,550,214,250,479,54.68285344723917,13.752367409950361
14741,/media/marda/TWOTB1/xBD/hurricanes/images/florence/hurricane-florence_00000259_pre_disaster.png,50,61,1,421,471,228,289,903,49.051674654044724,27.9283898889128
14742,/media/marda/TWOTB1/xBD/hurricanes/images/florence/hurricane-florence_00000259_pre_disaster.png,30,22,1,475,505,232,254,117,13.918462503236546,11.119226690235713
14743,/media/marda/TWOTB1/xBD/hurricanes/images/florence/hurricane-florence_00000259_pre_disaster.png,55,73,1,616,671,579,652,788,60.106629675472135,17.31058456219916
14744,/media/marda/TWOTB1/xBD/hurricanes/images/florence/hurricane-florence_00000259_pre_disaster.png,60,66,1,664,724,655,721,887,45.3135807687922,26.031787168202115
14745,/media/marda/TWOTB1/xBD/hurricanes/images/florence/hurricane-florence_00000259_pre_disaster.png,53,73,1,615,668,672,745,830,54.74876021208675,20.109550292563473
14746,/media/marda/TWOTB1/xBD/hurricanes/images/florence/hurricane-florence_00000259_pre_disaster.png,57,83,1,641,698,752,835,1021,60.790930052390486,22.191041469152495
14747,/media/marda/TWOTB1/xBD/hurricanes/images/florence/hurricane-florence_00000259_pre_disaster.png,40,94,1,285,325,897,991,1001,65.18914351912255,24.67817293282606
14748,/media/marda/TWOTB1/xBD/hurricanes/images/florence/hurricane-florence_00000259_pre_disaster.png,29,68,1,287,316,974,1042,461,35.64315517145884,17.04742567677034
14749,/media/marda/TWOTB1/xBD/hurricanes/images/florence/hurricane-florence_00000491_pre_disaster.png,82,60,1,545,627,0,60,2146,59.417745312013345,50.5015176938536
14750,/media/marda/TWOTB1/xBD/hurricanes/images/florence/hurricane-florence_00000491_pre_disaster.png,79,59,1,588,667,54,113,2047,56.39305513944912,50.20126428589471
14751,/media/marda/TWOTB1/xBD/hurricanes/images/florence/hurricane-florence_00000491_pre_disaster.png,98,61,1,891,989,149,210,2117,65.88225679183182,44.58997772612035
14752,/media/marda/TWOTB1/xBD/hurricanes/images/florence/hurricane-florence_00000491_pre_disaster.png,87,76,1,826,913,173,249,2366,68.56652974836801,48.11551450587205
14753,/media/marda/TWOTB1/xBD/hurricanes/images/florence/hurricane-florence_00000491_pre_disaster.png,88,72,1,953,1041,290,362,1753,58.2345182772727,41.33006964468328
14754,/media/marda/TWOTB1/xBD/hurricanes/images/florence/hurricane-florence_00000491_pre_disaster.png,85,70,1,836,921,349,419,1627,60.98737966472331,35.20695721080173
14755,/media/marda/TWOTB1/xBD/hurricanes/images/florence/hurricane-florence_00000491_pre_disaster.png,106,70,1,905,1011,508,578,1994,66.68359686199157,41.79831307283724
14756,/media/marda/TWOTB1/xBD/hurricanes/images/florence/hurricane-florence_00000491_pre_disaster.png,76,82,1,790,866,555,637,1748,60.62498400470072,39.421236745924716
14757,/media/marda/TWOTB1/xBD/hurricanes/images/florence/hurricane-florence_00000491_pre_disaster.png,86,78,1,797,883,616,694,1599,49.703181438309144,44.49182104205396
14758,/media/marda/TWOTB1/xBD/hurricanes/images/florence/hurricane-florence_00000491_pre_disaster.png,73,107,1,971,1044,810,917,1647,76.65609232634428,32.42091694486685
14759,/media/marda/TWOTB1/xBD/hurricanes/images/florence/hurricane-florence_00000339_post_disaster.png,30,36,1,317,347,0,36,615,40.02482398905553,20.33676696516156
14760,/media/marda/TWOTB1/xBD/hurricanes/images/florence/hurricane-florence_00000339_post_disaster.png,29,15,1,339,368,4,19,227,18.993227795732246,15.895773212920142
14761,/media/marda/TWOTB1/xBD/hurricanes/images/florence/hurricane-florence_00000339_post_disaster.png,54,44,1,990,1044,35,79,582,49.694911382459544,15.616393339461649
14762,/media/marda/TWOTB1/xBD/hurricanes/images/florence/hurricane-florence_00000339_post_disaster.png,31,14,1,519,550,123,137,72,10.811633248950676,9.061719446644242
14763,/media/marda/TWOTB1/xBD/hurricanes/images/florence/hurricane-florence_00000339_post_disaster.png,30,14,1,537,567,126,140,77,10.38990466845612,9.912109498633223
14764,/media/marda/TWOTB1/xBD/hurricanes/images/florence/hurricane-florence_00000339_post_disaster.png,55,19,1,531,586,178,197,330,39.07957237621636,11.312537553705804
14765,/media/marda/TWOTB1/xBD/hurricanes/images/florence/hurricane-florence_00000339_post_disaster.png,80,33,1,622,702,221,254,746,62.75907264753479,15.768283074408929
14766,/media/marda/TWOTB1/xBD/hurricanes/images/florence/hurricane-florence_00000339_post_disaster.png,33,34,1,483,516,267,301,390,30.0,17.281975195754296
14767,/media/marda/TWOTB1/xBD/hurricanes/images/florence/hurricane-florence_00000339_post_disaster.png,78,47,1,441,519,308,355,1299,62.19994187794104,30.246453687784694
14768,/media/marda/TWOTB1/xBD/hurricanes/images/florence/hurricane-florence_00000339_post_disaster.png,43,26,1,649,692,315,341,218,21.003170406113775,13.930523803583458
14769,/media/marda/TWOTB1/xBD/hurricanes/images/florence/hurricane-florence_00000339_post_disaster.png,83,66,1,596,679,325,391,1673,61.97833033432035,51.28967277386833
14770,/media/marda/TWOTB1/xBD/hurricanes/images/florence/hurricane-florence_00000339_post_disaster.png,58,54,1,736,794,373,427,933,43.39937297848313,28.704722159946538
14771,/media/marda/TWOTB1/xBD/hurricanes/images/florence/hurricane-florence_00000339_post_disaster.png,52,65,1,992,1044,413,478,321,45.19072751299484,12.88756952908518
14772,/media/marda/TWOTB1/xBD/hurricanes/images/florence/hurricane-florence_00000339_post_disaster.png,44,44,1,129,173,432,476,751,41.926177133980964,23.843920380824418
14773,/media/marda/TWOTB1/xBD/hurricanes/images/florence/hurricane-florence_00000339_post_disaster.png,48,57,1,663,711,526,583,774,40.60895948902834,25.133594882803003
14774,/media/marda/TWOTB1/xBD/hurricanes/images/florence/hurricane-florence_00000339_post_disaster.png,63,50,1,770,833,540,590,765,33.79541014505462,30.090914938530286
14775,/media/marda/TWOTB1/xBD/hurricanes/images/florence/hurricane-florence_00000339_post_disaster.png,36,35,1,654,690,569,604,176,17.172325961622498,13.513371935523196
14776,/media/marda/TWOTB1/xBD/hurricanes/images/florence/hurricane-florence_00000339_post_disaster.png,56,40,1,666,722,586,626,532,34.12346711560735,20.723967388877007
14777,/media/marda/TWOTB1/xBD/hurricanes/images/florence/hurricane-florence_00000339_post_disaster.png,53,55,1,750,803,598,653,640,32.03109708726419,26.69569603089148
14778,/media/marda/TWOTB1/xBD/hurricanes/images/florence/hurricane-florence_00000339_post_disaster.png,36,33,1,699,735,599,632,58,9.529758218520893,8.225962978109198
14779,/media/marda/TWOTB1/xBD/hurricanes/images/florence/hurricane-florence_00000339_post_disaster.png,60,71,1,850,910,600,671,968,50.34141179658548,25.66581371910492
14780,/media/marda/TWOTB1/xBD/hurricanes/images/florence/hurricane-florence_00000339_post_disaster.png,35,32,1,691,726,605,637,56,9.16515138991168,8.0
14781,/media/marda/TWOTB1/xBD/hurricanes/images/florence/hurricane-florence_00000339_post_disaster.png,82,64,1,786,868,636,700,1555,54.030765072749325,38.303398183448245
14782,/media/marda/TWOTB1/xBD/hurricanes/images/florence/hurricane-florence_00000522_pre_disaster.png,91,32,1,516,607,0,32,1601,76.54353268415693,27.911665695975405
14783,/media/marda/TWOTB1/xBD/hurricanes/images/florence/hurricane-florence_00000522_pre_disaster.png,34,16,1,507,541,17,33,161,16.242225925866418,13.351291792946979
14784,/media/marda/TWOTB1/xBD/hurricanes/images/florence/hurricane-florence_00000522_pre_disaster.png,31,18,1,431,462,29,47,158,17.69208056106116,12.002232149069702
14785,/media/marda/TWOTB1/xBD/hurricanes/images/florence/hurricane-florence_00000522_pre_disaster.png,53,54,1,437,490,48,102,782,61.18687799452869,17.053634859861795
14786,/media/marda/TWOTB1/xBD/hurricanes/images/florence/hurricane-florence_00000522_pre_disaster.png,31,34,1,276,307,141,175,374,29.87754782583415,16.44574265082682
14787,/media/marda/TWOTB1/xBD/hurricanes/images/florence/hurricane-florence_00000522_pre_disaster.png,62,54,1,298,360,153,207,1213,51.476572928238475,31.37223025362079
14788,/media/marda/TWOTB1/xBD/hurricanes/images/florence/hurricane-florence_00000522_pre_disaster.png,50,45,1,34,84,409,454,1171,54.01501834861368,29.09107411141544
14789,/media/marda/TWOTB1/xBD/hurricanes/images/florence/hurricane-florence_00000522_pre_disaster.png,64,61,1,114,178,442,503,1450,63.85578415034511,30.887854635068752
14790,/media/marda/TWOTB1/xBD/hurricanes/images/florence/hurricane-florence_00000522_pre_disaster.png,176,83,1,747,923,776,859,5491,161.7770005198399,46.25591160078407
14791,/media/marda/TWOTB1/xBD/hurricanes/images/florence/hurricane-florence_00000522_pre_disaster.png,37,76,1,187,224,809,885,672,47.83999940466624,18.76099046116657
14792,/media/marda/TWOTB1/xBD/hurricanes/images/florence/hurricane-florence_00000522_pre_disaster.png,41,38,1,820,861,818,856,43,8.812134722060538,6.181773080346047
14793,/media/marda/TWOTB1/xBD/hurricanes/images/florence/hurricane-florence_00000522_pre_disaster.png,171,80,1,687,858,848,928,5549,159.77602879946875,46.95523508971008
14794,/media/marda/TWOTB1/xBD/hurricanes/images/florence/hurricane-florence_00000522_pre_disaster.png,145,96,1,899,1044,851,947,4487,123.78392141165405,48.15411284916725
14795,/media/marda/TWOTB1/xBD/hurricanes/images/florence/hurricane-florence_00000522_pre_disaster.png,48,50,1,882,930,889,939,124,14.252246693146574,12.011501559454631
14796,/media/marda/TWOTB1/xBD/hurricanes/images/florence/hurricane-florence_00000522_pre_disaster.png,37,43,1,758,795,891,934,50,9.33098103299551,6.833212492077066
14797,/media/marda/TWOTB1/xBD/hurricanes/images/florence/hurricane-florence_00000522_pre_disaster.png,38,42,1,683,721,895,937,58,12.860558729893109,5.838458590674225
14798,/media/marda/TWOTB1/xBD/hurricanes/images/florence/hurricane-florence_00000522_pre_disaster.png,81,84,1,963,1044,924,1008,1719,49.91757439793052,45.59378411095449
14799,/media/marda/TWOTB1/xBD/hurricanes/images/florence/hurricane-florence_00000522_pre_disaster.png,46,49,1,954,1000,929,978,86,13.784700119133522,9.085638969635886
14800,/media/marda/TWOTB1/xBD/hurricanes/images/florence/hurricane-florence_00000522_pre_disaster.png,65,55,1,817,882,953,1008,360,35.87022619632653,13.321511742047377
14801,/media/marda/TWOTB1/xBD/hurricanes/images/florence/hurricane-florence_00000302_post_disaster.png,75,45,1,787,862,58,103,915,45.97636010868128,26.54933534632693
14802,/media/marda/TWOTB1/xBD/hurricanes/images/florence/hurricane-florence_00000302_post_disaster.png,89,78,1,687,776,310,388,1803,70.91490538955254,33.855013221847486
14803,/media/marda/TWOTB1/xBD/hurricanes/images/florence/hurricane-florence_00000302_post_disaster.png,56,41,1,650,706,340,381,463,28.262111285592386,21.88849783278559
14804,/media/marda/TWOTB1/xBD/hurricanes/images/florence/hurricane-florence_00000302_post_disaster.png,57,38,1,980,1037,502,540,201,18.764910234880446,14.235246182439257
14805,/media/marda/TWOTB1/xBD/hurricanes/images/florence/hurricane-florence_00000302_post_disaster.png,81,73,1,930,1011,508,581,1290,56.63843896479948,30.120785413621434
14806,/media/marda/TWOTB1/xBD/hurricanes/images/florence/hurricane-florence_00000302_post_disaster.png,59,60,1,711,770,804,864,439,32.06859839776743,18.086690983275293
14807,/media/marda/TWOTB1/xBD/hurricanes/images/florence/hurricane-florence_00000302_post_disaster.png,79,80,1,690,769,914,994,1192,46.740223132928975,34.547624645609986
14808,/media/marda/TWOTB1/xBD/hurricanes/images/florence/hurricane-florence_00000302_post_disaster.png,85,98,1,487,572,935,1033,1842,74.8728450733214,34.697956483327964
14809,/media/marda/TWOTB1/xBD/hurricanes/images/florence/hurricane-florence_00000302_post_disaster.png,65,74,1,759,824,957,1031,659,34.13556719733166,25.766740347777016
14810,/media/marda/TWOTB1/xBD/hurricanes/images/florence/hurricane-florence_00000537_post_disaster.png,17,27,1,36,53,316,343,201,17.82129013535105,14.386535227867764
14811,/media/marda/TWOTB1/xBD/hurricanes/images/florence/hurricane-florence_00000537_post_disaster.png,39,54,1,33,72,345,399,1007,36.841351016220045,36.07266788735688
14812,/media/marda/TWOTB1/xBD/hurricanes/images/florence/hurricane-florence_00000537_post_disaster.png,31,41,1,101,132,412,453,407,25.594587120862517,21.236775842771348
14813,/media/marda/TWOTB1/xBD/hurricanes/images/florence/hurricane-florence_00000537_post_disaster.png,10,44,1,0,10,481,525,153,25.311482604750598,10.099629739179774
14814,/media/marda/TWOTB1/xBD/hurricanes/images/florence/hurricane-florence_00000537_post_disaster.png,44,28,1,925,969,504,532,48,8.30772235959311,7.367991907668753
14815,/media/marda/TWOTB1/xBD/hurricanes/images/florence/hurricane-florence_00000537_post_disaster.png,120,48,1,923,1043,514,562,2186,93.50119718432117,31.062255627660864
14816,/media/marda/TWOTB1/xBD/hurricanes/images/florence/hurricane-florence_00000537_post_disaster.png,121,49,1,922,1043,564,613,2239,94.02724895721627,31.630303491243673
14817,/media/marda/TWOTB1/xBD/hurricanes/images/florence/hurricane-florence_00000537_post_disaster.png,46,32,1,922,968,590,622,53,9.604320503904235,7.142985832087935
14818,/media/marda/TWOTB1/xBD/hurricanes/images/florence/hurricane-florence_00000537_post_disaster.png,48,37,1,933,981,604,641,139,14.043096459631126,13.241611484318698
14819,/media/marda/TWOTB1/xBD/hurricanes/images/florence/hurricane-florence_00000537_post_disaster.png,143,60,1,899,1042,624,684,3023,120.16515968618998,34.26107501812148
14820,/media/marda/TWOTB1/xBD/hurricanes/images/florence/hurricane-florence_00000537_post_disaster.png,50,56,1,58,108,731,787,1070,52.59690232399547,27.20615563184259
14821,/media/marda/TWOTB1/xBD/hurricanes/images/florence/hurricane-florence_00000537_post_disaster.png,32,66,1,83,115,785,851,670,32.56284544840528,27.462346937003513
14822,/media/marda/TWOTB1/xBD/hurricanes/images/florence/hurricane-florence_00000537_post_disaster.png,26,82,1,10,36,794,876,732,54.467085255566005,17.87042755812218
14823,/media/marda/TWOTB1/xBD/hurricanes/images/florence/hurricane-florence_00000537_post_disaster.png,42,39,1,852,894,795,834,48,9.370221764179126,6.609992408895746
14824,/media/marda/TWOTB1/xBD/hurricanes/images/florence/hurricane-florence_00000537_post_disaster.png,39,44,1,848,887,803,847,78,13.815841185108308,7.47871719273107
14825,/media/marda/TWOTB1/xBD/hurricanes/images/florence/hurricane-florence_00000474_post_disaster.png,54,70,1,802,856,558,628,608,55.13851784085048,14.738322173178943
14826,/media/marda/TWOTB1/xBD/hurricanes/images/florence/hurricane-florence_00000474_post_disaster.png,78,48,1,790,868,611,659,501,50.61354700097958,13.248751364805404
14827,/media/marda/TWOTB1/xBD/hurricanes/images/florence/hurricane-florence_00000474_post_disaster.png,47,49,1,756,803,666,715,316,25.814558400549593,16.40256815092119
14828,/media/marda/TWOTB1/xBD/hurricanes/images/florence/hurricane-florence_00000474_post_disaster.png,58,46,1,805,863,675,721,486,28.608905545582235,22.57608063362562
14829,/media/marda/TWOTB1/xBD/hurricanes/images/florence/hurricane-florence_00000474_post_disaster.png,84,61,1,907,991,828,889,1067,52.41266248830778,26.79422230714613
14830,/media/marda/TWOTB1/xBD/hurricanes/images/florence/hurricane-florence_00000474_post_disaster.png,62,52,1,970,1032,950,1002,293,24.08936527540763,16.035414865972182
14831,/media/marda/TWOTB1/xBD/hurricanes/images/florence/hurricane-florence_00000145_post_disaster.png,36,59,1,332,368,972,1031,393,24.112318094951842,21.473159201072043
14832,/media/marda/TWOTB1/xBD/hurricanes/images/florence/hurricane-florence_00000115_post_disaster.png,73,46,1,604,677,0,46,1400,50.53818532936936,36.69787864555256
14833,/media/marda/TWOTB1/xBD/hurricanes/images/florence/hurricane-florence_00000115_post_disaster.png,85,34,1,740,825,0,34,1177,53.05809479619599,29.226808901198044
14834,/media/marda/TWOTB1/xBD/hurricanes/images/florence/hurricane-florence_00000115_post_disaster.png,49,6,1,890,939,0,6,42,11.698476980650792,5.428409693274463
14835,/media/marda/TWOTB1/xBD/hurricanes/images/florence/hurricane-florence_00000115_post_disaster.png,81,37,1,911,992,0,37,1070,44.08851229316624,33.193024156642345
14836,/media/marda/TWOTB1/xBD/hurricanes/images/florence/hurricane-florence_00000115_post_disaster.png,65,47,1,637,702,37,84,1228,49.17205471154057,33.608583597702136
14837,/media/marda/TWOTB1/xBD/hurricanes/images/florence/hurricane-florence_00000115_post_disaster.png,52,30,1,650,702,89,119,635,29.87175609114986,27.926150868572634
14838,/media/marda/TWOTB1/xBD/hurricanes/images/florence/hurricane-florence_00000115_post_disaster.png,40,13,1,615,655,92,105,111,17.11999012264402,8.682460485666398
14839,/media/marda/TWOTB1/xBD/hurricanes/images/florence/hurricane-florence_00000115_post_disaster.png,91,46,1,842,933,95,141,1434,55.177644163368,34.51892975851268
14840,/media/marda/TWOTB1/xBD/hurricanes/images/florence/hurricane-florence_00000115_post_disaster.png,85,50,1,766,851,103,153,1391,55.59795350981172,33.84399174170935
14841,/media/marda/TWOTB1/xBD/hurricanes/images/florence/hurricane-florence_00000115_post_disaster.png,66,63,1,674,740,120,183,1378,53.203318865235595,34.76162912645032
14842,/media/marda/TWOTB1/xBD/hurricanes/images/florence/hurricane-florence_00000115_post_disaster.png,66,54,1,723,789,129,183,1467,51.956976410708705,37.35419071241621
14843,/media/marda/TWOTB1/xBD/hurricanes/images/florence/hurricane-florence_00000115_post_disaster.png,77,56,1,882,959,131,187,1217,47.767781229987065,33.75105394586985
14844,/media/marda/TWOTB1/xBD/hurricanes/images/florence/hurricane-florence_00000115_post_disaster.png,14,14,1,84,98,169,183,89,14.54830142213533,8.202277964486187
14845,/media/marda/TWOTB1/xBD/hurricanes/images/florence/hurricane-florence_00000115_post_disaster.png,43,19,1,781,824,169,188,103,14.021000825388121,9.893965994255659
14846,/media/marda/TWOTB1/xBD/hurricanes/images/florence/hurricane-florence_00000115_post_disaster.png,35,43,1,142,177,255,298,1006,38.06372781863492,35.15531452855602
14847,/media/marda/TWOTB1/xBD/hurricanes/images/florence/hurricane-florence_00000115_post_disaster.png,14,16,1,178,192,276,292,75,11.31345276538022,8.662691900902116
14848,/media/marda/TWOTB1/xBD/hurricanes/images/florence/hurricane-florence_00000115_post_disaster.png,106,93,1,161,267,300,393,5252,102.38670139096746,68.13817135238945
14849,/media/marda/TWOTB1/xBD/hurricanes/images/florence/hurricane-florence_00000115_post_disaster.png,12,47,1,0,12,403,450,261,32.26039034505744,11.19411062115736
14850,/media/marda/TWOTB1/xBD/hurricanes/images/florence/hurricane-florence_00000115_post_disaster.png,34,80,1,0,34,471,551,1666,66.42635806873149,33.89191683459902
14851,/media/marda/TWOTB1/xBD/hurricanes/images/florence/hurricane-florence_00000115_post_disaster.png,115,136,1,686,801,543,679,4884,119.03610960011757,57.79671159636631
14852,/media/marda/TWOTB1/xBD/hurricanes/images/florence/hurricane-florence_00000115_post_disaster.png,32,52,1,0,32,552,604,700,35.516092352018866,26.3970122065097
14853,/media/marda/TWOTB1/xBD/hurricanes/images/florence/hurricane-florence_00000115_post_disaster.png,69,77,1,596,665,576,653,1606,55.01368883278641,40.72364523532476
14854,/media/marda/TWOTB1/xBD/hurricanes/images/florence/hurricane-florence_00000115_post_disaster.png,37,40,1,666,703,656,696,114,14.325535385850324,10.509651834227377
14855,/media/marda/TWOTB1/xBD/hurricanes/images/florence/hurricane-florence_00000115_post_disaster.png,102,111,1,731,833,657,768,3973,88.0182412248977,62.55506887053352
14856,/media/marda/TWOTB1/xBD/hurricanes/images/florence/hurricane-florence_00000115_post_disaster.png,100,133,1,561,661,681,814,5193,118.08266395515815,62.331649258872694
14857,/media/marda/TWOTB1/xBD/hurricanes/images/florence/hurricane-florence_00000115_post_disaster.png,60,102,1,0,60,695,797,3006,71.9231564300126,57.225607824866614
14858,/media/marda/TWOTB1/xBD/hurricanes/images/florence/hurricane-florence_00000115_post_disaster.png,94,137,1,757,851,746,883,5424,121.75635081097026,61.205046067799245
14859,/media/marda/TWOTB1/xBD/hurricanes/images/florence/hurricane-florence_00000115_post_disaster.png,18,58,1,70,88,789,847,321,27.02205458863334,15.879709730873522
14860,/media/marda/TWOTB1/xBD/hurricanes/images/florence/hurricane-florence_00000115_post_disaster.png,99,132,1,575,674,794,926,4685,101.02461507197253,64.45201308774838
14861,/media/marda/TWOTB1/xBD/hurricanes/images/florence/hurricane-florence_00000115_post_disaster.png,132,91,1,660,792,852,943,5317,120.77797613836546,59.54603476091835
14862,/media/marda/TWOTB1/xBD/hurricanes/images/florence/hurricane-florence_00000115_post_disaster.png,33,97,1,18,51,867,964,1112,72.655320008114,20.300640277127897
14863,/media/marda/TWOTB1/xBD/hurricanes/images/florence/hurricane-florence_00000115_post_disaster.png,26,96,1,0,26,868,964,1054,67.72867323835047,20.89677501312299
14864,/media/marda/TWOTB1/xBD/hurricanes/images/florence/hurricane-florence_00000115_post_disaster.png,85,113,1,51,136,868,981,4170,88.7360296859219,64.80139927579026
14865,/media/marda/TWOTB1/xBD/hurricanes/images/florence/hurricane-florence_00000115_post_disaster.png,66,86,1,81,147,948,1034,1943,68.88351049103547,38.3021734207608
14866,/media/marda/TWOTB1/xBD/hurricanes/images/florence/hurricane-florence_00000115_post_disaster.png,18,49,1,4,22,952,1001,232,20.60428147231356,14.882191953080854
14867,/media/marda/TWOTB1/xBD/hurricanes/images/florence/hurricane-florence_00000115_post_disaster.png,81,72,1,429,510,969,1041,1188,49.913690233723926,41.649473270025716
14868,/media/marda/TWOTB1/xBD/hurricanes/images/florence/hurricane-florence_00000431_pre_disaster.png,43,48,1,658,701,786,834,186,20.59612959035736,12.09698641421937
14869,/media/marda/TWOTB1/xBD/hurricanes/images/florence/hurricane-florence_00000129_post_disaster.png,21,24,1,22,43,196,220,309,21.0200442631445,19.199600498335357
14870,/media/marda/TWOTB1/xBD/hurricanes/images/florence/hurricane-florence_00000129_post_disaster.png,24,56,1,0,24,231,287,762,45.81666275263716,23.316536951735113
14871,/media/marda/TWOTB1/xBD/hurricanes/images/florence/hurricane-florence_00000129_post_disaster.png,35,43,1,409,444,788,831,183,20.963441301114216,11.602182189009927
14872,/media/marda/TWOTB1/xBD/hurricanes/images/florence/hurricane-florence_00000129_post_disaster.png,21,38,1,431,452,790,828,30,6.831300510639732,5.656854249492381
14873,/media/marda/TWOTB1/xBD/hurricanes/images/florence/hurricane-florence_00000065_post_disaster.png,56,37,1,449,505,15,52,975,38.55888272545904,33.75349162904973
14874,/media/marda/TWOTB1/xBD/hurricanes/images/florence/hurricane-florence_00000065_post_disaster.png,64,55,1,889,953,433,488,738,36.79880387504642,26.84141988522532
14875,/media/marda/TWOTB1/xBD/hurricanes/images/florence/hurricane-florence_00000148_pre_disaster.png,56,28,1,764,820,132,160,365,26.587465619408206,18.072241423458465
14876,/media/marda/TWOTB1/xBD/hurricanes/images/florence/hurricane-florence_00000148_pre_disaster.png,45,43,1,761,806,589,632,181,18.418272682994516,14.088457661092285
14877,/media/marda/TWOTB1/xBD/hurricanes/images/florence/hurricane-florence_00000148_pre_disaster.png,61,40,1,802,863,747,787,342,32.92153515284303,13.800769087148828
14878,/media/marda/TWOTB1/xBD/hurricanes/images/florence/hurricane-florence_00000148_pre_disaster.png,56,65,1,787,843,891,956,631,32.54368617724705,25.878077469880484
14879,/media/marda/TWOTB1/xBD/hurricanes/images/florence/hurricane-florence_00000148_pre_disaster.png,48,70,1,181,229,936,1006,1179,45.04240704130275,34.47843186322143
14880,/media/marda/TWOTB1/xBD/hurricanes/images/florence/hurricane-florence_00000148_pre_disaster.png,36,53,1,258,294,991,1044,293,32.09969093227164,12.42360730070798
14881,/media/marda/TWOTB1/xBD/hurricanes/images/florence/hurricane-florence_00000418_pre_disaster.png,34,18,1,72,106,0,18,377,30.975020065996087,16.814700295428356
14882,/media/marda/TWOTB1/xBD/hurricanes/images/florence/hurricane-florence_00000418_pre_disaster.png,166,76,1,197,363,0,76,6142,169.3166615270342,62.525827553121836
14883,/media/marda/TWOTB1/xBD/hurricanes/images/florence/hurricane-florence_00000418_pre_disaster.png,54,16,1,338,392,0,16,473,42.5627169037018,15.071170972228632
14884,/media/marda/TWOTB1/xBD/hurricanes/images/florence/hurricane-florence_00000418_pre_disaster.png,64,33,1,556,620,0,33,886,38.70359315311805,31.88327104667671
14885,/media/marda/TWOTB1/xBD/hurricanes/images/florence/hurricane-florence_00000418_pre_disaster.png,50,20,1,607,657,0,20,359,24.75529264777595,19.570110796625347
14886,/media/marda/TWOTB1/xBD/hurricanes/images/florence/hurricane-florence_00000418_pre_disaster.png,73,39,1,505,578,8,47,1261,53.958910821745974,31.181267126307382
14887,/media/marda/TWOTB1/xBD/hurricanes/images/florence/hurricane-florence_00000418_pre_disaster.png,76,51,1,853,929,27,78,1265,47.54376471014656,36.01142820498112
14888,/media/marda/TWOTB1/xBD/hurricanes/images/florence/hurricane-florence_00000418_pre_disaster.png,55,36,1,81,136,31,67,1025,58.88354414563867,23.01588721521958
14889,/media/marda/TWOTB1/xBD/hurricanes/images/florence/hurricane-florence_00000418_pre_disaster.png,73,53,1,724,797,50,103,1376,52.3136439335101,37.899486488918555
14890,/media/marda/TWOTB1/xBD/hurricanes/images/florence/hurricane-florence_00000418_pre_disaster.png,75,43,1,777,852,58,101,1218,44.37572486482547,36.49254523571339
14891,/media/marda/TWOTB1/xBD/hurricanes/images/florence/hurricane-florence_00000418_pre_disaster.png,47,33,1,99,146,63,96,800,46.98084698692702,23.501561467080236
14892,/media/marda/TWOTB1/xBD/hurricanes/images/florence/hurricane-florence_00000418_pre_disaster.png,12,13,1,59,71,66,79,96,11.997049873108564,10.797358339886829
14893,/media/marda/TWOTB1/xBD/hurricanes/images/florence/hurricane-florence_00000418_pre_disaster.png,77,52,1,664,741,68,120,1654,48.90404051998931,44.80764831832164
14894,/media/marda/TWOTB1/xBD/hurricanes/images/florence/hurricane-florence_00000418_pre_disaster.png,57,23,1,891,948,82,105,294,20.8572917732427,18.872128615057363
14895,/media/marda/TWOTB1/xBD/hurricanes/images/florence/hurricane-florence_00000418_pre_disaster.png,86,90,1,455,541,139,229,3694,84.73593400594935,57.67834532633442
14896,/media/marda/TWOTB1/xBD/hurricanes/images/florence/hurricane-florence_00000418_pre_disaster.png,98,49,1,613,711,165,214,1887,81.6855977359906,33.616667713725214
14897,/media/marda/TWOTB1/xBD/hurricanes/images/florence/hurricane-florence_00000418_pre_disaster.png,57,44,1,571,628,166,210,898,38.814097874105954,30.682132697982432
14898,/media/marda/TWOTB1/xBD/hurricanes/images/florence/hurricane-florence_00000418_pre_disaster.png,94,63,1,327,421,183,246,2907,76.76612917509752,51.38434118467794
14899,/media/marda/TWOTB1/xBD/hurricanes/images/florence/hurricane-florence_00000418_pre_disaster.png,54,50,1,243,297,207,257,1188,43.98239621541436,36.37500167528393
14900,/media/marda/TWOTB1/xBD/hurricanes/images/florence/hurricane-florence_00000418_pre_disaster.png,65,56,1,831,896,210,266,923,49.12228868804863,24.84752055776706
14901,/media/marda/TWOTB1/xBD/hurricanes/images/florence/hurricane-florence_00000418_pre_disaster.png,70,50,1,764,834,220,270,1133,41.255007151523785,36.09152855763292
14902,/media/marda/TWOTB1/xBD/hurricanes/images/florence/hurricane-florence_00000418_pre_disaster.png,60,53,1,163,223,230,283,1651,53.68197214004921,40.59805437160248
14903,/media/marda/TWOTB1/xBD/hurricanes/images/florence/hurricane-florence_00000418_pre_disaster.png,68,46,1,600,668,272,318,1058,42.73879068492541,32.995585124976635
14904,/media/marda/TWOTB1/xBD/hurricanes/images/florence/hurricane-florence_00000418_pre_disaster.png,33,36,1,312,345,276,312,417,27.311543705152303,20.175164158916076
14905,/media/marda/TWOTB1/xBD/hurricanes/images/florence/hurricane-florence_00000418_pre_disaster.png,38,57,1,27,65,285,342,1188,50.590246334834546,31.351032944398824
14906,/media/marda/TWOTB1/xBD/hurricanes/images/florence/hurricane-florence_00000418_pre_disaster.png,59,32,1,862,921,286,318,356,25.053711447849977,18.82592813003266
14907,/media/marda/TWOTB1/xBD/hurricanes/images/florence/hurricane-florence_00000418_pre_disaster.png,52,26,1,795,847,291,317,226,20.131691593813574,14.902517585276323
14908,/media/marda/TWOTB1/xBD/hurricanes/images/florence/hurricane-florence_00000418_pre_disaster.png,59,54,1,527,586,294,348,1158,42.81052244979198,35.30272969281261
14909,/media/marda/TWOTB1/xBD/hurricanes/images/florence/hurricane-florence_00000418_pre_disaster.png,87,50,1,957,1044,294,344,1106,48.38720067382769,32.00472055696369
14910,/media/marda/TWOTB1/xBD/hurricanes/images/florence/hurricane-florence_00000418_pre_disaster.png,44,30,1,646,690,305,335,227,18.913685321383227,15.846948433563153
14911,/media/marda/TWOTB1/xBD/hurricanes/images/florence/hurricane-florence_00000418_pre_disaster.png,65,53,1,876,941,327,380,730,39.380978293058035,24.788777530319816
14912,/media/marda/TWOTB1/xBD/hurricanes/images/florence/hurricane-florence_00000418_pre_disaster.png,33,33,1,166,199,333,366,299,31.495789212443352,12.509979876581186
14913,/media/marda/TWOTB1/xBD/hurricanes/images/florence/hurricane-florence_00000418_pre_disaster.png,69,72,1,687,756,341,413,1397,63.3679626570322,29.41963259789274
14914,/media/marda/TWOTB1/xBD/hurricanes/images/florence/hurricane-florence_00000418_pre_disaster.png,45,49,1,173,218,343,392,713,41.140552674255964,22.948206243632566
14915,/media/marda/TWOTB1/xBD/hurricanes/images/florence/hurricane-florence_00000418_pre_disaster.png,49,46,1,514,563,343,389,628,32.88673584124455,25.33227822718235
14916,/media/marda/TWOTB1/xBD/hurricanes/images/florence/hurricane-florence_00000418_pre_disaster.png,63,57,1,981,1044,362,419,836,45.214468924563185,24.598859177884382
14917,/media/marda/TWOTB1/xBD/hurricanes/images/florence/hurricane-florence_00000418_pre_disaster.png,46,48,1,328,374,373,421,831,35.59098263236845,31.613337287483244
14918,/media/marda/TWOTB1/xBD/hurricanes/images/florence/hurricane-florence_00000418_pre_disaster.png,19,35,1,0,19,376,411,276,19.999674792762903,18.23735506933379
14919,/media/marda/TWOTB1/xBD/hurricanes/images/florence/hurricane-florence_00000418_pre_disaster.png,36,29,1,528,564,393,422,147,15.21753851224594,12.974814623551831
14920,/media/marda/TWOTB1/xBD/hurricanes/images/florence/hurricane-florence_00000418_pre_disaster.png,89,64,1,710,799,401,465,1684,57.47145239610368,40.12631101101989
14921,/media/marda/TWOTB1/xBD/hurricanes/images/florence/hurricane-florence_00000418_pre_disaster.png,55,46,1,856,911,409,455,422,29.015614796034413,20.72089477501371
14922,/media/marda/TWOTB1/xBD/hurricanes/images/florence/hurricane-florence_00000418_pre_disaster.png,73,53,1,896,969,410,463,964,37.59644578674079,33.353373443390254
14923,/media/marda/TWOTB1/xBD/hurricanes/images/florence/hurricane-florence_00000418_pre_disaster.png,45,63,1,84,129,414,477,1072,45.65658169770026,31.681282461357256
14924,/media/marda/TWOTB1/xBD/hurricanes/images/florence/hurricane-florence_00000418_pre_disaster.png,32,28,1,575,607,418,446,73,10.426526937472167,9.446924153109965
14925,/media/marda/TWOTB1/xBD/hurricanes/images/florence/hurricane-florence_00000418_pre_disaster.png,47,43,1,384,431,424,467,564,35.58119570548822,20.998763799398088
14926,/media/marda/TWOTB1/xBD/hurricanes/images/florence/hurricane-florence_00000418_pre_disaster.png,44,45,1,336,380,426,471,612,29.772264703759728,27.053914226958614
14927,/media/marda/TWOTB1/xBD/hurricanes/images/florence/hurricane-florence_00000418_pre_disaster.png,65,49,1,576,641,428,477,874,44.13467680042179,28.01648510585262
14928,/media/marda/TWOTB1/xBD/hurricanes/images/florence/hurricane-florence_00000418_pre_disaster.png,55,57,1,219,274,429,486,967,44.76220236210875,29.29593546348778
14929,/media/marda/TWOTB1/xBD/hurricanes/images/florence/hurricane-florence_00000418_pre_disaster.png,34,47,1,39,73,446,493,516,30.494419311009,22.617339133678186
14930,/media/marda/TWOTB1/xBD/hurricanes/images/florence/hurricane-florence_00000418_pre_disaster.png,49,60,1,177,226,466,526,868,45.77963541845605,25.295016983173788
14931,/media/marda/TWOTB1/xBD/hurricanes/images/florence/hurricane-florence_00000418_pre_disaster.png,68,45,1,585,653,477,522,688,50.921904302288475,17.893911957978585
14932,/media/marda/TWOTB1/xBD/hurricanes/images/florence/hurricane-florence_00000418_pre_disaster.png,42,51,1,233,275,491,542,476,40.763363177602386,15.588206251817937
14933,/media/marda/TWOTB1/xBD/hurricanes/images/florence/hurricane-florence_00000418_pre_disaster.png,43,65,1,25,68,493,558,905,46.2759397836894,26.097962441308052
14934,/media/marda/TWOTB1/xBD/hurricanes/images/florence/hurricane-florence_00000418_pre_disaster.png,50,52,1,369,419,498,550,686,33.17384841551344,27.299375418910344
14935,/media/marda/TWOTB1/xBD/hurricanes/images/florence/hurricane-florence_00000418_pre_disaster.png,82,57,1,903,985,506,563,1042,48.35803758165687,28.70439579311791
14936,/media/marda/TWOTB1/xBD/hurricanes/images/florence/hurricane-florence_00000418_pre_disaster.png,48,60,1,248,296,507,567,941,39.893216740861675,32.442968929778516
14937,/media/marda/TWOTB1/xBD/hurricanes/images/florence/hurricane-florence_00000418_pre_disaster.png,41,62,1,147,188,514,576,865,36.96999723817551,31.069793138955465
14938,/media/marda/TWOTB1/xBD/hurricanes/images/florence/hurricane-florence_00000418_pre_disaster.png,69,54,1,601,670,518,572,864,48.58178880985089,23.449447386434272
14939,/media/marda/TWOTB1/xBD/hurricanes/images/florence/hurricane-florence_00000418_pre_disaster.png,54,40,1,890,944,533,573,220,18.684499617365383,15.747392899765407
14940,/media/marda/TWOTB1/xBD/hurricanes/images/florence/hurricane-florence_00000418_pre_disaster.png,109,66,1,798,907,534,600,1839,85.82690724165326,30.674976670503117
14941,/media/marda/TWOTB1/xBD/hurricanes/images/florence/hurricane-florence_00000418_pre_disaster.png,32,62,1,0,32,539,601,804,39.55564576405064,26.975261663354214
14942,/media/marda/TWOTB1/xBD/hurricanes/images/florence/hurricane-florence_00000418_pre_disaster.png,63,55,1,717,780,545,600,774,32.84684974911381,31.39955849779973
14943,/media/marda/TWOTB1/xBD/hurricanes/images/florence/hurricane-florence_00000418_pre_disaster.png,47,59,1,481,528,553,612,718,41.999566581095,24.878149549706542
14944,/media/marda/TWOTB1/xBD/hurricanes/images/florence/hurricane-florence_00000418_pre_disaster.png,62,68,1,104,166,555,623,1331,53.84993533695267,35.62483507679595
14945,/media/marda/TWOTB1/xBD/hurricanes/images/florence/hurricane-florence_00000418_pre_disaster.png,67,50,1,958,1025,580,630,518,26.75980073226489,25.864158041304954
14946,/media/marda/TWOTB1/xBD/hurricanes/images/florence/hurricane-florence_00000418_pre_disaster.png,52,47,1,705,757,584,631,419,26.104699114455414,21.464265897448037
14947,/media/marda/TWOTB1/xBD/hurricanes/images/florence/hurricane-florence_00000418_pre_disaster.png,42,67,1,71,113,602,669,795,45.73376082064281,23.040644171811483
14948,/media/marda/TWOTB1/xBD/hurricanes/images/florence/hurricane-florence_00000418_pre_disaster.png,55,56,1,591,646,607,663,664,33.4675125609477,26.201363790863454
14949,/media/marda/TWOTB1/xBD/hurricanes/images/florence/hurricane-florence_00000418_pre_disaster.png,65,52,1,970,1035,609,661,450,25.12880827260949,23.92987826569074
14950,/media/marda/TWOTB1/xBD/hurricanes/images/florence/hurricane-florence_00000418_pre_disaster.png,30,51,1,119,149,623,674,346,24.57597821856563,18.808265591466856
14951,/media/marda/TWOTB1/xBD/hurricanes/images/florence/hurricane-florence_00000418_pre_disaster.png,52,62,1,727,779,634,696,576,38.408533210420146,20.18670207888312
14952,/media/marda/TWOTB1/xBD/hurricanes/images/florence/hurricane-florence_00000418_pre_disaster.png,77,55,1,967,1044,643,698,699,44.976913222253685,20.62027452025925
14953,/media/marda/TWOTB1/xBD/hurricanes/images/florence/hurricane-florence_00000418_pre_disaster.png,88,96,1,502,590,644,740,2156,73.69267015795569,53.00442778149252
14954,/media/marda/TWOTB1/xBD/hurricanes/images/florence/hurricane-florence_00000418_pre_disaster.png,47,69,1,23,70,648,717,959,49.08206024607951,26.08773110967473
14955,/media/marda/TWOTB1/xBD/hurricanes/images/florence/hurricane-florence_00000418_pre_disaster.png,54,39,1,930,984,666,705,156,18.328881970039713,11.392790504171613
14956,/media/marda/TWOTB1/xBD/hurricanes/images/florence/hurricane-florence_00000418_pre_disaster.png,58,75,1,404,462,667,742,1301,51.24494726636551,34.2863284809949
14957,/media/marda/TWOTB1/xBD/hurricanes/images/florence/hurricane-florence_00000418_pre_disaster.png,32,52,1,74,106,670,722,434,30.41099268219768,18.75543195262657
14958,/media/marda/TWOTB1/xBD/hurricanes/images/florence/hurricane-florence_00000418_pre_disaster.png,75,56,1,756,831,671,727,936,45.131940945389545,27.80709975358244
14959,/media/marda/TWOTB1/xBD/hurricanes/images/florence/hurricane-florence_00000418_pre_disaster.png,52,38,1,961,1013,675,713,134,15.78676281263966,11.37563121629298
14960,/media/marda/TWOTB1/xBD/hurricanes/images/florence/hurricane-florence_00000418_pre_disaster.png,26,72,1,0,26,687,759,750,41.14918658707119,24.816677020373042
14961,/media/marda/TWOTB1/xBD/hurricanes/images/florence/hurricane-florence_00000418_pre_disaster.png,55,45,1,978,1033,687,732,175,17.442997138289904,13.414453590039535
14962,/media/marda/TWOTB1/xBD/hurricanes/images/florence/hurricane-florence_00000418_pre_disaster.png,51,51,1,993,1044,713,764,188,22.82828525222013,11.269718655840228
14963,/media/marda/TWOTB1/xBD/hurricanes/images/florence/hurricane-florence_00000418_pre_disaster.png,38,47,1,547,585,726,773,221,17.71529816358832,16.729630684133515
14964,/media/marda/TWOTB1/xBD/hurricanes/images/florence/hurricane-florence_00000418_pre_disaster.png,34,50,1,413,447,736,786,253,21.350365309841294,16.190072220291636
14965,/media/marda/TWOTB1/xBD/hurricanes/images/florence/hurricane-florence_00000418_pre_disaster.png,61,63,1,867,928,738,801,589,36.31979877930284,21.531003409288374
14966,/media/marda/TWOTB1/xBD/hurricanes/images/florence/hurricane-florence_00000418_pre_disaster.png,56,58,1,841,897,750,808,433,30.115887632360494,19.214984156734005
14967,/media/marda/TWOTB1/xBD/hurricanes/images/florence/hurricane-florence_00000418_pre_disaster.png,10,46,1,0,10,754,800,96,15.802733225517429,9.057456126971658
14968,/media/marda/TWOTB1/xBD/hurricanes/images/florence/hurricane-florence_00000418_pre_disaster.png,61,62,1,801,862,764,826,639,30.815027618849346,27.20407315629624
14969,/media/marda/TWOTB1/xBD/hurricanes/images/florence/hurricane-florence_00000418_pre_disaster.png,72,84,1,319,391,809,893,1574,60.16962341740016,37.21227295785433
14970,/media/marda/TWOTB1/xBD/hurricanes/images/florence/hurricane-florence_00000418_pre_disaster.png,58,63,1,954,1012,814,877,425,31.528163768503894,17.867110283166312
14971,/media/marda/TWOTB1/xBD/hurricanes/images/florence/hurricane-florence_00000418_pre_disaster.png,69,72,1,891,960,828,900,800,39.2991590956165,27.18834298697555
14972,/media/marda/TWOTB1/xBD/hurricanes/images/florence/hurricane-florence_00000418_pre_disaster.png,62,73,1,864,926,838,911,693,41.18260913370924,22.311072193024724
14973,/media/marda/TWOTB1/xBD/hurricanes/images/florence/hurricane-florence_00000418_pre_disaster.png,64,67,1,832,896,848,915,651,34.58063335953051,24.951296559009947
14974,/media/marda/TWOTB1/xBD/hurricanes/images/florence/hurricane-florence_00000418_pre_disaster.png,53,47,1,989,1042,853,900,125,14.581119495349938,11.58753443413766
14975,/media/marda/TWOTB1/xBD/hurricanes/images/florence/hurricane-florence_00000418_pre_disaster.png,63,77,1,799,862,861,938,838,46.116872052534774,24.216541762145926
14976,/media/marda/TWOTB1/xBD/hurricanes/images/florence/hurricane-florence_00000418_pre_disaster.png,53,74,1,249,302,891,965,847,43.451672265567446,25.883813596456015
14977,/media/marda/TWOTB1/xBD/hurricanes/images/florence/hurricane-florence_00000418_pre_disaster.png,42,82,1,57,99,899,981,1063,46.532017629101844,29.99156871745203
14978,/media/marda/TWOTB1/xBD/hurricanes/images/florence/hurricane-florence_00000418_pre_disaster.png,93,96,1,662,755,901,997,2001,75.4438494021662,42.767594480197744
14979,/media/marda/TWOTB1/xBD/hurricanes/images/florence/hurricane-florence_00000418_pre_disaster.png,73,101,1,961,1034,929,1030,920,73.35999688775239,17.298176917868783
14980,/media/marda/TWOTB1/xBD/hurricanes/images/florence/hurricane-florence_00000418_pre_disaster.png,57,64,1,831,888,947,1011,456,26.04226190305382,23.177660577616013
14981,/media/marda/TWOTB1/xBD/hurricanes/images/florence/hurricane-florence_00000418_pre_disaster.png,13,63,1,0,13,951,1014,193,24.95026475382344,11.693610956586852
14982,/media/marda/TWOTB1/xBD/hurricanes/images/florence/hurricane-florence_00000418_pre_disaster.png,50,54,1,935,985,955,1009,150,17.45347345030134,11.56524669802996
14983,/media/marda/TWOTB1/xBD/hurricanes/images/florence/hurricane-florence_00000418_pre_disaster.png,78,75,1,893,971,964,1039,1071,40.24648496453051,35.15379982485922
14984,/media/marda/TWOTB1/xBD/hurricanes/images/florence/hurricane-florence_00000144_post_disaster.png,34,52,1,140,174,952,1004,220,33.25770164658124,8.874067998380463
14985,/media/marda/TWOTB1/xBD/hurricanes/images/florence/hurricane-florence_00000144_post_disaster.png,48,74,1,150,198,967,1041,1206,42.92106576523738,37.59516359248378
14986,/media/marda/TWOTB1/xBD/hurricanes/images/florence/hurricane-florence_00000144_post_disaster.png,48,31,1,822,870,281,312,196,23.87737486592897,10.980202505551704
14987,/media/marda/TWOTB1/xBD/hurricanes/images/florence/hurricane-florence_00000006_pre_disaster.png,47,29,1,0,47,0,29,1036,50.1126402403969,28.60306786507227
14988,/media/marda/TWOTB1/xBD/hurricanes/images/florence/hurricane-florence_00000006_pre_disaster.png,55,13,1,337,392,0,13,518,49.70819326665649,14.221898957491474
14989,/media/marda/TWOTB1/xBD/hurricanes/images/florence/hurricane-florence_00000006_pre_disaster.png,65,39,1,620,685,0,39,992,41.94475465000935,32.22131836685908
14990,/media/marda/TWOTB1/xBD/hurricanes/images/florence/hurricane-florence_00000006_pre_disaster.png,66,14,1,660,726,0,14,309,39.337498306656165,12.15614906124641
14991,/media/marda/TWOTB1/xBD/hurricanes/images/florence/hurricane-florence_00000006_pre_disaster.png,69,32,1,831,900,0,32,881,38.38540926442651,30.288523047330436
14992,/media/marda/TWOTB1/xBD/hurricanes/images/florence/hurricane-florence_00000006_pre_disaster.png,69,24,1,873,942,0,24,743,38.63476430899056,25.43792906479367
14993,/media/marda/TWOTB1/xBD/hurricanes/images/florence/hurricane-florence_00000006_pre_disaster.png,73,33,1,912,985,0,33,983,37.90086313811826,34.584204634714524
14994,/media/marda/TWOTB1/xBD/hurricanes/images/florence/hurricane-florence_00000006_pre_disaster.png,74,37,1,953,1027,0,37,1076,40.93128532494623,34.75747088805049
14995,/media/marda/TWOTB1/xBD/hurricanes/images/florence/hurricane-florence_00000006_pre_disaster.png,78,56,1,786,864,1,57,1380,52.5571956364318,35.103325715220016
14996,/media/marda/TWOTB1/xBD/hurricanes/images/florence/hurricane-florence_00000006_pre_disaster.png,55,39,1,989,1044,6,45,497,43.85813106392971,15.220488945733335
14997,/media/marda/TWOTB1/xBD/hurricanes/images/florence/hurricane-florence_00000006_pre_disaster.png,63,56,1,585,648,8,64,1249,50.88213514273557,32.44800968283395
14998,/media/marda/TWOTB1/xBD/hurricanes/images/florence/hurricane-florence_00000006_pre_disaster.png,84,50,1,745,829,25,75,1462,53.79294038575474,35.6719037224006
14999,/media/marda/TWOTB1/xBD/hurricanes/images/florence/hurricane-florence_00000006_pre_disaster.png,41,17,1,502,543,42,59,174,22.03856138212575,10.610300042050456
15000,/media/marda/TWOTB1/xBD/hurricanes/images/florence/hurricane-florence_00000006_pre_disaster.png,72,51,1,882,954,45,96,1704,56.416160691682464,41.3068112090501
15001,/media/marda/TWOTB1/xBD/hurricanes/images/florence/hurricane-florence_00000006_pre_disaster.png,78,42,1,713,791,47,89,1183,48.99776322827128,31.855306394752997
15002,/media/marda/TWOTB1/xBD/hurricanes/images/florence/hurricane-florence_00000006_pre_disaster.png,74,52,1,925,999,51,103,1474,53.80038434566133,36.417389958900934
15003,/media/marda/TWOTB1/xBD/hurricanes/images/florence/hurricane-florence_00000006_pre_disaster.png,73,52,1,839,912,52,104,1585,54.20663179054111,39.109063771545266
15004,/media/marda/TWOTB1/xBD/hurricanes/images/florence/hurricane-florence_00000006_pre_disaster.png,77,53,1,964,1041,57,110,1496,52.825323783421176,37.46647192322079
15005,/media/marda/TWOTB1/xBD/hurricanes/images/florence/hurricane-florence_00000006_pre_disaster.png,78,45,1,681,759,69,114,1392,53.78734173599385,34.00340587375497
15006,/media/marda/TWOTB1/xBD/hurricanes/images/florence/hurricane-florence_00000006_pre_disaster.png,81,47,1,794,875,70,117,1299,49.455109878274186,34.691410906914925
15007,/media/marda/TWOTB1/xBD/hurricanes/images/florence/hurricane-florence_00000006_pre_disaster.png,35,18,1,466,501,78,96,186,16.242653858069254,15.337238475365494
15008,/media/marda/TWOTB1/xBD/hurricanes/images/florence/hurricane-florence_00000006_pre_disaster.png,81,44,1,643,724,90,134,1356,53.347668303348215,33.894627982793054
15009,/media/marda/TWOTB1/xBD/hurricanes/images/florence/hurricane-florence_00000006_pre_disaster.png,85,48,1,759,844,92,140,1358,56.07161543157232,32.367416363037606
15010,/media/marda/TWOTB1/xBD/hurricanes/images/florence/hurricane-florence_00000006_pre_disaster.png,59,39,1,508,567,106,145,780,37.38994056379118,28.840742468970447
15011,/media/marda/TWOTB1/xBD/hurricanes/images/florence/hurricane-florence_00000006_pre_disaster.png,82,53,1,726,808,110,163,1476,53.55665319818172,36.378802938390095
15012,/media/marda/TWOTB1/xBD/hurricanes/images/florence/hurricane-florence_00000006_pre_disaster.png,80,51,1,692,772,128,179,1271,53.255814516313876,31.897475995788675
15013,/media/marda/TWOTB1/xBD/hurricanes/images/florence/hurricane-florence_00000006_pre_disaster.png,76,60,1,510,586,146,206,1705,58.58290952159082,39.22642858256807
15014,/media/marda/TWOTB1/xBD/hurricanes/images/florence/hurricane-florence_00000006_pre_disaster.png,70,55,1,905,975,154,209,1348,53.214146363929274,33.488297061572595
15015,/media/marda/TWOTB1/xBD/hurricanes/images/florence/hurricane-florence_00000006_pre_disaster.png,78,57,1,854,932,159,216,1562,53.082253622626276,39.68580108142012
15016,/media/marda/TWOTB1/xBD/hurricanes/images/florence/hurricane-florence_00000006_pre_disaster.png,74,52,1,943,1017,161,213,1246,51.193279409797256,32.30505051710533
15017,/media/marda/TWOTB1/xBD/hurricanes/images/florence/hurricane-florence_00000006_pre_disaster.png,62,53,1,982,1044,165,218,916,53.5706882707122,22.893100293029015
15018,/media/marda/TWOTB1/xBD/hurricanes/images/florence/hurricane-florence_00000006_pre_disaster.png,58,41,1,0,58,175,216,1933,64.81492365535507,39.4568294739629
15019,/media/marda/TWOTB1/xBD/hurricanes/images/florence/hurricane-florence_00000006_pre_disaster.png,103,42,1,232,335,180,222,3211,105.78072880723683,40.36525023178134
15020,/media/marda/TWOTB1/xBD/hurricanes/images/florence/hurricane-florence_00000006_pre_disaster.png,103,43,1,78,181,183,226,3601,112.54866317090791,42.469452657514275
15021,/media/marda/TWOTB1/xBD/hurricanes/images/florence/hurricane-florence_00000006_pre_disaster.png,88,50,1,806,894,185,235,1382,54.663742426870144,33.58250818659823
15022,/media/marda/TWOTB1/xBD/hurricanes/images/florence/hurricane-florence_00000006_pre_disaster.png,71,54,1,612,683,190,244,1376,53.319918278825455,34.357229850664844
15023,/media/marda/TWOTB1/xBD/hurricanes/images/florence/hurricane-florence_00000006_pre_disaster.png,73,60,1,508,581,196,256,1433,57.230855525111,33.264151553170144
15024,/media/marda/TWOTB1/xBD/hurricanes/images/florence/hurricane-florence_00000006_pre_disaster.png,84,54,1,775,859,204,258,1333,54.7372544163433,32.790312384962924
15025,/media/marda/TWOTB1/xBD/hurricanes/images/florence/hurricane-florence_00000006_pre_disaster.png,74,69,1,749,823,219,288,1458,55.72812304552983,36.36697578443248
15026,/media/marda/TWOTB1/xBD/hurricanes/images/florence/hurricane-florence_00000006_pre_disaster.png,72,58,1,914,986,222,280,1580,54.94827442170233,37.894089220819154
15027,/media/marda/TWOTB1/xBD/hurricanes/images/florence/hurricane-florence_00000006_pre_disaster.png,65,56,1,699,764,226,282,1424,52.33725611039114,36.03309701569775
15028,/media/marda/TWOTB1/xBD/hurricanes/images/florence/hurricane-florence_00000006_pre_disaster.png,77,107,1,339,416,227,334,4739,110.11543812001788,57.124243263476934
15029,/media/marda/TWOTB1/xBD/hurricanes/images/florence/hurricane-florence_00000006_pre_disaster.png,80,52,1,616,696,228,280,1364,53.12927069812543,34.27005167341094
15030,/media/marda/TWOTB1/xBD/hurricanes/images/florence/hurricane-florence_00000006_pre_disaster.png,75,58,1,956,1031,229,287,1222,48.09582487217933,33.28343928465754
15031,/media/marda/TWOTB1/xBD/hurricanes/images/florence/hurricane-florence_00000006_pre_disaster.png,83,59,1,862,945,230,289,1466,53.248614209159385,36.1721219843586
15032,/media/marda/TWOTB1/xBD/hurricanes/images/florence/hurricane-florence_00000006_pre_disaster.png,48,38,1,996,1044,238,276,128,30.274786333075145,6.451729418275876
15033,/media/marda/TWOTB1/xBD/hurricanes/images/florence/hurricane-florence_00000006_pre_disaster.png,68,59,1,516,584,239,298,1399,51.187055928268144,36.38960549675567
15034,/media/marda/TWOTB1/xBD/hurricanes/images/florence/hurricane-florence_00000006_pre_disaster.png,45,105,1,119,164,257,362,3854,109.92630304117569,46.53778642213347
15035,/media/marda/TWOTB1/xBD/hurricanes/images/florence/hurricane-florence_00000006_pre_disaster.png,75,58,1,635,710,263,321,1473,54.11549851374389,36.03017100845976
15036,/media/marda/TWOTB1/xBD/hurricanes/images/florence/hurricane-florence_00000006_pre_disaster.png,89,53,1,826,915,264,317,1463,56.214217152103096,34.629556856991044
15037,/media/marda/TWOTB1/xBD/hurricanes/images/florence/hurricane-florence_00000006_pre_disaster.png,64,108,1,268,332,265,373,4044,109.68171401628518,49.2493534386724
15038,/media/marda/TWOTB1/xBD/hurricanes/images/florence/hurricane-florence_00000006_pre_disaster.png,75,56,1,530,605,281,337,1493,51.46162450358524,38.51893906540585
15039,/media/marda/TWOTB1/xBD/hurricanes/images/florence/hurricane-florence_00000006_pre_disaster.png,72,59,1,799,871,286,345,1145,47.40758021623657,32.178847184765374
15040,/media/marda/TWOTB1/xBD/hurricanes/images/florence/hurricane-florence_00000006_pre_disaster.png,69,63,1,758,827,300,363,1503,51.75388708796218,38.085095509819865
15041,/media/marda/TWOTB1/xBD/hurricanes/images/florence/hurricane-florence_00000006_pre_disaster.png,65,65,1,667,732,301,366,1129,48.278526721458626,30.973561404155777
15042,/media/marda/TWOTB1/xBD/hurricanes/images/florence/hurricane-florence_00000006_pre_disaster.png,61,54,1,718,779,313,367,1181,46.66060588210653,33.343951570894724
15043,/media/marda/TWOTB1/xBD/hurricanes/images/florence/hurricane-florence_00000006_pre_disaster.png,75,66,1,543,618,314,380,1613,55.18671471437175,39.04122333123385
15044,/media/marda/TWOTB1/xBD/hurricanes/images/florence/hurricane-florence_00000006_pre_disaster.png,73,112,1,354,427,325,437,4342,107.14546708079426,53.87771491141075
15045,/media/marda/TWOTB1/xBD/hurricanes/images/florence/hurricane-florence_00000006_pre_disaster.png,82,63,1,943,1025,325,388,1496,53.09162464723905,37.39619291260887
15046,/media/marda/TWOTB1/xBD/hurricanes/images/florence/hurricane-florence_00000006_pre_disaster.png,87,62,1,894,981,337,399,1508,51.256871653372485,38.74411978750511
15047,/media/marda/TWOTB1/xBD/hurricanes/images/florence/hurricane-florence_00000006_pre_disaster.png,56,56,1,988,1044,341,397,463,46.36202047458474,14.116285687170334
15048,/media/marda/TWOTB1/xBD/hurricanes/images/florence/hurricane-florence_00000006_pre_disaster.png,72,64,1,566,638,352,416,1484,53.6954378353141,36.28489282661212
15049,/media/marda/TWOTB1/xBD/hurricanes/images/florence/hurricane-florence_00000006_pre_disaster.png,49,110,1,120,169,358,468,3871,108.63746462296655,47.80978887136862
15050,/media/marda/TWOTB1/xBD/hurricanes/images/florence/hurricane-florence_00000006_pre_disaster.png,90,68,1,865,955,363,431,1719,56.639007645944744,40.51398261730267
15051,/media/marda/TWOTB1/xBD/hurricanes/images/florence/hurricane-florence_00000006_pre_disaster.png,64,110,1,283,347,366,476,3853,110.10170601323841,47.02246146881895
15052,/media/marda/TWOTB1/xBD/hurricanes/images/florence/hurricane-florence_00000006_pre_disaster.png,66,54,1,841,907,390,444,1231,46.30873482417468,35.7242458874235
15053,/media/marda/TWOTB1/xBD/hurricanes/images/florence/hurricane-florence_00000006_pre_disaster.png,80,66,1,587,667,392,458,1551,55.604494512808486,37.56200842810702
15054,/media/marda/TWOTB1/xBD/hurricanes/images/florence/hurricane-florence_00000006_pre_disaster.png,68,71,1,803,871,395,466,1424,55.39358705284085,34.677072652267896
15055,/media/marda/TWOTB1/xBD/hurricanes/images/florence/hurricane-florence_00000006_pre_disaster.png,65,70,1,765,830,402,472,1374,55.3932144344125,33.50901308645176
15056,/media/marda/TWOTB1/xBD/hurricanes/images/florence/hurricane-florence_00000006_pre_disaster.png,72,76,1,628,700,406,482,1550,53.304533947924924,38.28296312174906
15057,/media/marda/TWOTB1/xBD/hurricanes/images/florence/hurricane-florence_00000006_pre_disaster.png,61,66,1,725,786,410,476,1370,54.8001846016987,33.33768842259432
15058,/media/marda/TWOTB1/xBD/hurricanes/images/florence/hurricane-florence_00000006_pre_disaster.png,61,60,1,686,747,417,477,1275,48.32370460688625,34.80490579964701
15059,/media/marda/TWOTB1/xBD/hurricanes/images/florence/hurricane-florence_00000006_pre_disaster.png,114,106,1,392,506,421,527,3806,107.03365165139655,47.57102961084997
15060,/media/marda/TWOTB1/xBD/hurricanes/images/florence/hurricane-florence_00000006_pre_disaster.png,111,106,1,470,581,491,597,3690,105.46738853076705,46.44799793764684
15061,/media/marda/TWOTB1/xBD/hurricanes/images/florence/hurricane-florence_00000006_pre_disaster.png,108,58,1,297,405,498,556,3453,110.74998875803574,41.52755058165658
15062,/media/marda/TWOTB1/xBD/hurricanes/images/florence/hurricane-florence_00000006_pre_disaster.png,99,61,1,197,296,500,561,3706,107.02312389078743,46.04291016568062
15063,/media/marda/TWOTB1/xBD/hurricanes/images/florence/hurricane-florence_00000006_pre_disaster.png,98,59,1,95,193,501,560,3460,109.35188962688424,42.12122856740315
15064,/media/marda/TWOTB1/xBD/hurricanes/images/florence/hurricane-florence_00000006_pre_disaster.png,115,110,1,543,658,559,669,3572,108.18921385109729,44.09067638046267
15065,/media/marda/TWOTB1/xBD/hurricanes/images/florence/hurricane-florence_00000006_pre_disaster.png,46,70,1,74,120,610,680,1429,48.227780957102134,39.778257972605694
15066,/media/marda/TWOTB1/xBD/hurricanes/images/florence/hurricane-florence_00000006_pre_disaster.png,46,70,1,117,163,616,686,1363,47.035417364271346,38.40179307232278
15067,/media/marda/TWOTB1/xBD/hurricanes/images/florence/hurricane-florence_00000006_pre_disaster.png,137,67,1,884,1021,632,699,3554,108.94561935593693,42.97120007094773
15068,/media/marda/TWOTB1/xBD/hurricanes/images/florence/hurricane-florence_00000006_pre_disaster.png,48,68,1,26,74,638,706,1036,45.99443933242535,30.087888809910663
15069,/media/marda/TWOTB1/xBD/hurricanes/images/florence/hurricane-florence_00000006_pre_disaster.png,127,64,1,784,911,641,705,3228,106.42344544788945,40.2416506286584
15070,/media/marda/TWOTB1/xBD/hurricanes/images/florence/hurricane-florence_00000006_pre_disaster.png,51,73,1,150,201,644,717,1223,45.2359898475408,35.861151343077196
15071,/media/marda/TWOTB1/xBD/hurricanes/images/florence/hurricane-florence_00000006_pre_disaster.png,123,67,1,684,807,644,711,3441,107.98993966083457,42.11091245455375
15072,/media/marda/TWOTB1/xBD/hurricanes/images/florence/hurricane-florence_00000006_pre_disaster.png,38,60,1,23,61,683,743,1177,40.584447269765846,40.07910013912926
15073,/media/marda/TWOTB1/xBD/hurricanes/images/florence/hurricane-florence_00000006_pre_disaster.png,48,63,1,164,212,688,751,1046,42.92679008003159,33.07762452723375
15074,/media/marda/TWOTB1/xBD/hurricanes/images/florence/hurricane-florence_00000006_pre_disaster.png,89,126,1,940,1029,701,827,3872,109.27026942499339,47.55454605261779
15075,/media/marda/TWOTB1/xBD/hurricanes/images/florence/hurricane-florence_00000006_pre_disaster.png,128,107,1,753,881,720,827,3598,105.87747669682906,45.843462743979735
15076,/media/marda/TWOTB1/xBD/hurricanes/images/florence/hurricane-florence_00000006_pre_disaster.png,48,72,1,34,82,721,793,1181,44.5701407308734,35.74713797569141
15077,/media/marda/TWOTB1/xBD/hurricanes/images/florence/hurricane-florence_00000006_pre_disaster.png,47,63,1,165,212,726,789,1254,45.663798440380454,36.33169158684251
15078,/media/marda/TWOTB1/xBD/hurricanes/images/florence/hurricane-florence_00000006_pre_disaster.png,46,60,1,85,131,736,796,1207,48.25607422831242,34.152898803371116
15079,/media/marda/TWOTB1/xBD/hurricanes/images/florence/hurricane-florence_00000006_pre_disaster.png,55,63,1,168,223,762,825,1430,52.0730331226851,37.630375107606355
15080,/media/marda/TWOTB1/xBD/hurricanes/images/florence/hurricane-florence_00000006_pre_disaster.png,52,62,1,84,136,771,833,1294,49.89719906457449,34.56568736837184
15081,/media/marda/TWOTB1/xBD/hurricanes/images/florence/hurricane-florence_00000006_pre_disaster.png,136,110,1,838,974,772,882,3777,109.84840218122618,46.39300606581411
15082,/media/marda/TWOTB1/xBD/hurricanes/images/florence/hurricane-florence_00000006_pre_disaster.png,57,66,1,168,225,805,871,1463,55.497775571195206,36.08356135710287
15083,/media/marda/TWOTB1/xBD/hurricanes/images/florence/hurricane-florence_00000006_pre_disaster.png,78,78,1,58,136,817,895,2758,82.57584651364412,46.69528216987291
15084,/media/marda/TWOTB1/xBD/hurricanes/images/florence/hurricane-florence_00000006_pre_disaster.png,30,77,1,21,51,819,896,1117,48.100394304420725,30.263238450020477
15085,/media/marda/TWOTB1/xBD/hurricanes/images/florence/hurricane-florence_00000006_pre_disaster.png,17,59,1,0,17,826,885,376,27.851346398570026,17.711139544078748
15086,/media/marda/TWOTB1/xBD/hurricanes/images/florence/hurricane-florence_00000006_pre_disaster.png,47,66,1,172,219,841,907,1153,47.43898727305814,33.98997747809362
15087,/media/marda/TWOTB1/xBD/hurricanes/images/florence/hurricane-florence_00000006_pre_disaster.png,54,67,1,172,226,882,949,1382,51.167846263468476,36.492216604212565
15088,/media/marda/TWOTB1/xBD/hurricanes/images/florence/hurricane-florence_00000006_pre_disaster.png,117,82,1,22,139,902,984,3739,125.94466307980014,41.87934259057632
15089,/media/marda/TWOTB1/xBD/hurricanes/images/florence/hurricane-florence_00000006_pre_disaster.png,21,80,1,0,21,904,984,822,48.449571385727,22.63326385371651
15090,/media/marda/TWOTB1/xBD/hurricanes/images/florence/hurricane-florence_00000006_pre_disaster.png,55,71,1,174,229,919,990,1191,53.726215252426535,32.00231999598099
15091,/media/marda/TWOTB1/xBD/hurricanes/images/florence/hurricane-florence_00000006_pre_disaster.png,80,84,1,24,104,957,1041,2463,91.59760603894776,42.347869524422116
15092,/media/marda/TWOTB1/xBD/hurricanes/images/florence/hurricane-florence_00000006_pre_disaster.png,40,81,1,102,142,958,1039,1290,47.70201371669904,35.69810835931745
15093,/media/marda/TWOTB1/xBD/hurricanes/images/florence/hurricane-florence_00000006_pre_disaster.png,50,75,1,175,225,958,1033,1343,45.94919190213571,40.4271167797721
15094,/media/marda/TWOTB1/xBD/hurricanes/images/florence/hurricane-florence_00000006_pre_disaster.png,20,74,1,0,20,967,1041,425,35.676467824299216,20.183964085667125
15095,/media/marda/TWOTB1/xBD/hurricanes/images/florence/hurricane-florence_00000006_pre_disaster.png,30,47,1,195,225,997,1044,168,27.688746209726915,8.0
15096,/media/marda/TWOTB1/xBD/hurricanes/images/florence/hurricane-florence_00000151_post_disaster.png,19,6,1,171,190,0,6,48,13.315129257002745,5.458082648938437
15097,/media/marda/TWOTB1/xBD/hurricanes/images/florence/hurricane-florence_00000151_post_disaster.png,33,28,1,99,132,22,50,489,28.813101289472478,22.671639834956967
15098,/media/marda/TWOTB1/xBD/hurricanes/images/florence/hurricane-florence_00000151_post_disaster.png,77,56,1,544,621,154,210,1293,64.4250697651311,26.385867433140152
15099,/media/marda/TWOTB1/xBD/hurricanes/images/florence/hurricane-florence_00000151_post_disaster.png,89,50,1,769,858,253,303,1242,60.03115498624527,33.38818178308082
15100,/media/marda/TWOTB1/xBD/hurricanes/images/florence/hurricane-florence_00000151_post_disaster.png,66,49,1,720,786,367,416,765,36.206426715779976,28.94853644709233
15101,/media/marda/TWOTB1/xBD/hurricanes/images/florence/hurricane-florence_00000151_post_disaster.png,58,57,1,712,770,397,454,738,41.48847306316324,23.681421638109608
15102,/media/marda/TWOTB1/xBD/hurricanes/images/florence/hurricane-florence_00000151_post_disaster.png,98,85,1,919,1017,606,691,1886,52.22732394456719,48.17770608046491
15103,/media/marda/TWOTB1/xBD/hurricanes/images/florence/hurricane-florence_00000434_pre_disaster.png,50,48,1,464,514,250,298,481,45.987050474814794,13.968711867985084
15104,/media/marda/TWOTB1/xBD/hurricanes/images/florence/hurricane-florence_00000434_pre_disaster.png,53,76,1,29,82,925,1001,1522,57.374568501545596,37.06114601989035
15105,/media/marda/TWOTB1/xBD/hurricanes/images/florence/hurricane-florence_00000533_pre_disaster.png,31,22,1,467,498,276,298,158,15.746030174179223,13.27271944337257
15106,/media/marda/TWOTB1/xBD/hurricanes/images/florence/hurricane-florence_00000533_pre_disaster.png,54,60,1,473,527,303,363,1140,45.32328726390659,33.28727567367142
15107,/media/marda/TWOTB1/xBD/hurricanes/images/florence/hurricane-florence_00000293_post_disaster.png,52,54,1,533,585,177,231,1470,55.27643986650642,35.32635278446719
15108,/media/marda/TWOTB1/xBD/hurricanes/images/florence/hurricane-florence_00000293_post_disaster.png,75,50,1,526,601,252,302,1531,62.705017296102035,36.17397342091343
15109,/media/marda/TWOTB1/xBD/hurricanes/images/florence/hurricane-florence_00000293_post_disaster.png,53,37,1,386,439,273,310,867,42.988902127321296,26.79413316199711
15110,/media/marda/TWOTB1/xBD/hurricanes/images/florence/hurricane-florence_00000293_post_disaster.png,62,38,1,209,271,284,322,1103,59.533529827219105,24.54812707407689
15111,/media/marda/TWOTB1/xBD/hurricanes/images/florence/hurricane-florence_00000293_post_disaster.png,54,25,1,759,813,289,314,332,28.007839639440007,15.877900758364788
15112,/media/marda/TWOTB1/xBD/hurricanes/images/florence/hurricane-florence_00000293_post_disaster.png,54,51,1,637,691,313,364,1013,41.12596641355317,32.59901122545871
15113,/media/marda/TWOTB1/xBD/hurricanes/images/florence/hurricane-florence_00000293_post_disaster.png,55,71,1,762,817,342,413,1228,64.80593802274905,25.687931420143048
15114,/media/marda/TWOTB1/xBD/hurricanes/images/florence/hurricane-florence_00000293_post_disaster.png,62,38,1,180,242,346,384,1094,58.9577954942606,24.21141028804997
15115,/media/marda/TWOTB1/xBD/hurricanes/images/florence/hurricane-florence_00000293_post_disaster.png,35,26,1,504,539,359,385,207,17.21485575155633,15.869768101795211
15116,/media/marda/TWOTB1/xBD/hurricanes/images/florence/hurricane-florence_00000293_post_disaster.png,50,41,1,652,702,365,406,556,31.477742780735433,25.16471094153663
15117,/media/marda/TWOTB1/xBD/hurricanes/images/florence/hurricane-florence_00000293_post_disaster.png,31,21,1,562,593,385,406,81,11.843711478326757,9.169653303382603
15118,/media/marda/TWOTB1/xBD/hurricanes/images/florence/hurricane-florence_00000293_post_disaster.png,74,58,1,651,725,392,450,1363,54.60841409505428,37.33261851606338
15119,/media/marda/TWOTB1/xBD/hurricanes/images/florence/hurricane-florence_00000293_post_disaster.png,50,62,1,491,541,398,460,896,48.071757823435796,24.839776211925926
15120,/media/marda/TWOTB1/xBD/hurricanes/images/florence/hurricane-florence_00000293_post_disaster.png,52,50,1,402,454,407,457,871,37.04000134120981,31.664590399750203
15121,/media/marda/TWOTB1/xBD/hurricanes/images/florence/hurricane-florence_00000293_post_disaster.png,56,49,1,766,822,407,456,701,34.849451518176416,26.578316258933985
15122,/media/marda/TWOTB1/xBD/hurricanes/images/florence/hurricane-florence_00000293_post_disaster.png,50,35,1,571,621,410,445,351,28.40498450555013,17.000402188873537
15123,/media/marda/TWOTB1/xBD/hurricanes/images/florence/hurricane-florence_00000293_post_disaster.png,20,48,1,0,20,421,469,488,31.553330812218203,20.34772098993075
15124,/media/marda/TWOTB1/xBD/hurricanes/images/florence/hurricane-florence_00000293_post_disaster.png,62,49,1,581,643,436,485,800,41.156029300950564,26.23367353573073
15125,/media/marda/TWOTB1/xBD/hurricanes/images/florence/hurricane-florence_00000293_post_disaster.png,50,50,1,552,602,441,491,694,33.76968338324279,27.29886075217065
15126,/media/marda/TWOTB1/xBD/hurricanes/images/florence/hurricane-florence_00000293_post_disaster.png,80,45,1,787,867,458,503,996,52.982837244646255,24.829912586029817
15127,/media/marda/TWOTB1/xBD/hurricanes/images/florence/hurricane-florence_00000293_post_disaster.png,60,68,1,885,945,484,552,814,55.860323987113404,19.46140104252079
15128,/media/marda/TWOTB1/xBD/hurricanes/images/florence/hurricane-florence_00000293_post_disaster.png,61,48,1,941,1002,497,545,472,26.31609888530838,23.7196682876437
15129,/media/marda/TWOTB1/xBD/hurricanes/images/florence/hurricane-florence_00000293_post_disaster.png,59,56,1,82,141,514,570,1319,61.422723708168554,28.371443847393113
15130,/media/marda/TWOTB1/xBD/hurricanes/images/florence/hurricane-florence_00000293_post_disaster.png,41,55,1,362,403,516,571,702,36.00419906774995,25.596467475121447
15131,/media/marda/TWOTB1/xBD/hurricanes/images/florence/hurricane-florence_00000293_post_disaster.png,56,82,1,386,442,516,598,1756,65.01183660424154,36.95423430749526
15132,/media/marda/TWOTB1/xBD/hurricanes/images/florence/hurricane-florence_00000293_post_disaster.png,67,54,1,448,515,532,586,1005,51.08857058084403,27.346209054271835
15133,/media/marda/TWOTB1/xBD/hurricanes/images/florence/hurricane-florence_00000293_post_disaster.png,26,40,1,94,120,549,589,318,22.789044475709147,18.561562672360512
15134,/media/marda/TWOTB1/xBD/hurricanes/images/florence/hurricane-florence_00000293_post_disaster.png,77,68,1,505,582,556,624,1629,56.102314738398604,40.31463600404445
15135,/media/marda/TWOTB1/xBD/hurricanes/images/florence/hurricane-florence_00000293_post_disaster.png,60,59,1,583,643,568,627,996,38.34991730818611,34.346600486122526
15136,/media/marda/TWOTB1/xBD/hurricanes/images/florence/hurricane-florence_00000293_post_disaster.png,54,61,1,657,711,568,629,786,42.04667351655049,24.948718791710085
15137,/media/marda/TWOTB1/xBD/hurricanes/images/florence/hurricane-florence_00000293_post_disaster.png,38,36,1,467,505,573,609,238,21.92249279971985,14.45370438241117
15138,/media/marda/TWOTB1/xBD/hurricanes/images/florence/hurricane-florence_00000293_post_disaster.png,14,33,1,117,131,575,608,80,13.090442049652077,8.281927731192825
15139,/media/marda/TWOTB1/xBD/hurricanes/images/florence/hurricane-florence_00000293_post_disaster.png,54,61,1,465,519,597,658,893,35.99167246803882,33.45795838881264
15140,/media/marda/TWOTB1/xBD/hurricanes/images/florence/hurricane-florence_00000293_post_disaster.png,29,54,1,340,369,600,654,299,32.3369112243373,12.381218207405823
15141,/media/marda/TWOTB1/xBD/hurricanes/images/florence/hurricane-florence_00000293_post_disaster.png,30,39,1,449,479,611,650,165,14.892252362414844,14.446021008283283
15142,/media/marda/TWOTB1/xBD/hurricanes/images/florence/hurricane-florence_00000293_post_disaster.png,56,50,1,563,619,616,666,643,35.09433471473801,24.060972107059627
15143,/media/marda/TWOTB1/xBD/hurricanes/images/florence/hurricane-florence_00000293_post_disaster.png,48,48,1,638,686,617,665,397,23.260248799083676,22.939704225960263
15144,/media/marda/TWOTB1/xBD/hurricanes/images/florence/hurricane-florence_00000293_post_disaster.png,82,54,1,873,955,632,686,925,50.58528603076982,23.93893310321479
15145,/media/marda/TWOTB1/xBD/hurricanes/images/florence/hurricane-florence_00000293_post_disaster.png,34,44,1,328,362,634,678,260,20.16521397241297,16.92608724633278
15146,/media/marda/TWOTB1/xBD/hurricanes/images/florence/hurricane-florence_00000293_post_disaster.png,51,41,1,872,923,668,709,209,17.076743217204097,16.177608921618837
15147,/media/marda/TWOTB1/xBD/hurricanes/images/florence/hurricane-florence_00000293_post_disaster.png,70,63,1,417,487,673,736,783,62.0344847069736,16.85081006304942
15148,/media/marda/TWOTB1/xBD/hurricanes/images/florence/hurricane-florence_00000293_post_disaster.png,59,67,1,985,1044,690,757,531,39.5057570205215,18.366354803795534
15149,/media/marda/TWOTB1/xBD/hurricanes/images/florence/hurricane-florence_00000293_post_disaster.png,42,63,1,504,546,693,756,459,36.733021856123514,16.704993122369082
15150,/media/marda/TWOTB1/xBD/hurricanes/images/florence/hurricane-florence_00000293_post_disaster.png,81,64,1,959,1040,749,813,1185,45.4336074538623,34.10459667146915
15151,/media/marda/TWOTB1/xBD/hurricanes/images/florence/hurricane-florence_00000293_post_disaster.png,73,50,1,971,1044,786,836,486,38.986940590757726,16.682505426150446
15152,/media/marda/TWOTB1/xBD/hurricanes/images/florence/hurricane-florence_00000504_post_disaster.png,80,66,1,866,946,100,166,1755,58.2318037355441,40.98770291689298
15153,/media/marda/TWOTB1/xBD/hurricanes/images/florence/hurricane-florence_00000414_post_disaster.png,28,77,1,0,28,374,451,1023,64.26086885430524,24.16305433123162
15154,/media/marda/TWOTB1/xBD/hurricanes/images/florence/hurricane-florence_00000414_post_disaster.png,68,64,1,278,346,459,523,1013,68.09447619322708,19.812087973583893
15155,/media/marda/TWOTB1/xBD/hurricanes/images/florence/hurricane-florence_00000414_post_disaster.png,55,76,1,2,57,549,625,1729,48.590431864098456,47.14381011971242
15156,/media/marda/TWOTB1/xBD/hurricanes/images/florence/hurricane-florence_00000390_pre_disaster.png,21,61,1,113,134,790,851,463,32.80288588948991,18.6993801525004
15157,/media/marda/TWOTB1/xBD/hurricanes/images/florence/hurricane-florence_00000390_pre_disaster.png,17,44,1,145,162,813,857,76,11.726500469245787,8.75182551829463
15158,/media/marda/TWOTB1/xBD/hurricanes/images/florence/hurricane-florence_00000390_pre_disaster.png,26,43,1,167,193,819,862,163,23.181728439737803,9.714881858747814
15159,/media/marda/TWOTB1/xBD/hurricanes/images/florence/hurricane-florence_00000390_pre_disaster.png,16,68,1,113,129,851,919,328,37.47950074138649,11.582110907083235
15160,/media/marda/TWOTB1/xBD/hurricanes/images/florence/hurricane-florence_00000390_pre_disaster.png,62,56,1,158,220,871,927,768,59.85425585652838,18.59685023995596
15161,/media/marda/TWOTB1/xBD/hurricanes/images/florence/hurricane-florence_00000390_pre_disaster.png,23,50,1,263,286,915,965,106,13.264001554728637,10.851175052924324
15162,/media/marda/TWOTB1/xBD/hurricanes/images/florence/hurricane-florence_00000308_pre_disaster.png,119,100,1,17,136,264,364,5860,109.35131946261224,76.9582887185126
15163,/media/marda/TWOTB1/xBD/hurricanes/images/florence/hurricane-florence_00000308_pre_disaster.png,14,25,1,30,44,265,290,116,16.312829155479236,9.585638767463234
15164,/media/marda/TWOTB1/xBD/hurricanes/images/florence/hurricane-florence_00000308_pre_disaster.png,61,74,1,515,576,769,843,1128,51.195352365183,30.1006662011251
15165,/media/marda/TWOTB1/xBD/hurricanes/images/florence/hurricane-florence_00000308_pre_disaster.png,61,59,1,299,360,774,833,810,52.15879975360193,20.764166994454854
15166,/media/marda/TWOTB1/xBD/hurricanes/images/florence/hurricane-florence_00000308_pre_disaster.png,56,94,1,253,309,779,873,1498,72.09712784581323,29.97953618641085
15167,/media/marda/TWOTB1/xBD/hurricanes/images/florence/hurricane-florence_00000308_pre_disaster.png,50,60,1,580,630,797,857,558,28.336428647337108,26.101022115906712
15168,/media/marda/TWOTB1/xBD/hurricanes/images/florence/hurricane-florence_00000308_pre_disaster.png,68,71,1,552,620,827,898,1113,46.652159396537726,34.09009243401015
15169,/media/marda/TWOTB1/xBD/hurricanes/images/florence/hurricane-florence_00000308_pre_disaster.png,52,58,1,568,620,872,930,482,29.613731188294775,21.581601291818814
15170,/media/marda/TWOTB1/xBD/hurricanes/images/florence/hurricane-florence_00000308_pre_disaster.png,17,41,1,266,283,879,920,62,9.243946207147804,8.541142982746502
15171,/media/marda/TWOTB1/xBD/hurricanes/images/florence/hurricane-florence_00000308_pre_disaster.png,57,71,1,619,676,889,960,760,36.73240151573282,28.765428960189695
15172,/media/marda/TWOTB1/xBD/hurricanes/images/florence/hurricane-florence_00000308_pre_disaster.png,83,85,1,279,362,945,1030,2106,80.34212014189619,34.492885890391435
15173,/media/marda/TWOTB1/xBD/hurricanes/images/florence/hurricane-florence_00000308_pre_disaster.png,22,54,1,216,238,989,1043,134,13.567887471427376,12.613158082219504
15174,/media/marda/TWOTB1/xBD/hurricanes/images/florence/hurricane-florence_00000256_pre_disaster.png,73,40,1,954,1027,0,40,868,45.93892123590374,25.287392271694312
15175,/media/marda/TWOTB1/xBD/hurricanes/images/florence/hurricane-florence_00000256_pre_disaster.png,74,52,1,970,1044,131,183,1270,45.996858070635646,36.22388450996555
15176,/media/marda/TWOTB1/xBD/hurricanes/images/florence/hurricane-florence_00000256_pre_disaster.png,58,38,1,930,988,574,612,248,21.55963540712529,15.416554557049276
15177,/media/marda/TWOTB1/xBD/hurricanes/images/florence/hurricane-florence_00000256_pre_disaster.png,54,45,1,841,895,669,714,296,21.951683972192015,17.59695397483908
15178,/media/marda/TWOTB1/xBD/hurricanes/images/florence/hurricane-florence_00000256_pre_disaster.png,101,76,1,938,1039,775,851,1537,67.2704903169036,30.43444361618064
15179,/media/marda/TWOTB1/xBD/hurricanes/images/florence/hurricane-florence_00000256_pre_disaster.png,67,64,1,883,950,840,904,615,29.619419968360354,27.540651565719987
15180,/media/marda/TWOTB1/xBD/hurricanes/images/florence/hurricane-florence_00000256_pre_disaster.png,62,54,1,823,885,874,928,318,30.000515907434,14.175762210333957
15181,/media/marda/TWOTB1/xBD/hurricanes/images/florence/hurricane-florence_00000256_pre_disaster.png,64,61,1,944,1008,910,971,439,25.620138938068795,22.560340777960707
15182,/media/marda/TWOTB1/xBD/hurricanes/images/florence/hurricane-florence_00000256_pre_disaster.png,73,85,1,971,1044,915,1000,1051,45.10472744642278,31.62488832340587
15183,/media/marda/TWOTB1/xBD/hurricanes/images/florence/hurricane-florence_00000256_pre_disaster.png,56,56,1,935,991,945,1001,260,19.194442310167382,18.040713647156473
15184,/media/marda/TWOTB1/xBD/hurricanes/images/florence/hurricane-florence_00000256_pre_disaster.png,81,81,1,784,865,961,1042,1557,50.60829271289496,41.181166226024246
15185,/media/marda/TWOTB1/xBD/hurricanes/images/florence/hurricane-florence_00000314_post_disaster.png,33,13,1,192,225,0,13,181,23.202209839505894,12.03054626886763
15186,/media/marda/TWOTB1/xBD/hurricanes/images/florence/hurricane-florence_00000314_post_disaster.png,58,19,1,891,949,21,40,202,21.91988075558653,12.3229091090442
15187,/media/marda/TWOTB1/xBD/hurricanes/images/florence/hurricane-florence_00000314_post_disaster.png,12,23,1,0,12,22,45,144,19.52775802116908,11.29391292404021
15188,/media/marda/TWOTB1/xBD/hurricanes/images/florence/hurricane-florence_00000314_post_disaster.png,72,44,1,868,940,47,91,722,45.75284766540002,25.10569278157077
15189,/media/marda/TWOTB1/xBD/hurricanes/images/florence/hurricane-florence_00000455_pre_disaster.png,54,50,1,491,545,253,303,605,46.24172508981636,17.934354230370463
15190,/media/marda/TWOTB1/xBD/hurricanes/images/florence/hurricane-florence_00000455_pre_disaster.png,13,22,1,32,45,254,276,164,15.196610883135426,14.397970903902246
15191,/media/marda/TWOTB1/xBD/hurricanes/images/florence/hurricane-florence_00000455_pre_disaster.png,42,33,1,435,477,264,297,321,24.505748018022242,17.5051867089868
15192,/media/marda/TWOTB1/xBD/hurricanes/images/florence/hurricane-florence_00000455_pre_disaster.png,30,46,1,148,178,277,323,793,40.808798317367504,25.67841357213501
15193,/media/marda/TWOTB1/xBD/hurricanes/images/florence/hurricane-florence_00000455_pre_disaster.png,25,44,1,62,87,290,334,691,38.09671564059823,24.16817155994784
15194,/media/marda/TWOTB1/xBD/hurricanes/images/florence/hurricane-florence_00000455_pre_disaster.png,11,26,1,41,52,347,373,134,14.127406107169685,12.724344147991971
15195,/media/marda/TWOTB1/xBD/hurricanes/images/florence/hurricane-florence_00000455_pre_disaster.png,56,30,1,148,204,362,392,553,56.418618568037964,13.007623954318772
15196,/media/marda/TWOTB1/xBD/hurricanes/images/florence/hurricane-florence_00000455_pre_disaster.png,49,27,1,58,107,374,401,497,54.51933526716004,12.194061205239256
15197,/media/marda/TWOTB1/xBD/hurricanes/images/florence/hurricane-florence_00000455_pre_disaster.png,37,43,1,388,425,580,623,507,26.58360273541604,25.42891337449257
15198,/media/marda/TWOTB1/xBD/hurricanes/images/florence/hurricane-florence_00000455_pre_disaster.png,61,42,1,422,483,613,655,494,50.83193426849618,12.99052127152393
15199,/media/marda/TWOTB1/xBD/hurricanes/images/florence/hurricane-florence_00000455_pre_disaster.png,68,78,1,311,379,685,763,2282,60.0625370127941,53.573988526694436
15200,/media/marda/TWOTB1/xBD/hurricanes/images/florence/hurricane-florence_00000455_pre_disaster.png,55,52,1,707,762,695,747,555,29.777756735733988,24.697963081932286
15201,/media/marda/TWOTB1/xBD/hurricanes/images/florence/hurricane-florence_00000455_pre_disaster.png,71,68,1,757,828,706,774,965,45.31073676803891,32.07607410481621
15202,/media/marda/TWOTB1/xBD/hurricanes/images/florence/hurricane-florence_00000455_pre_disaster.png,73,98,1,536,609,738,836,2203,77.89648799549288,42.55278428238685
15203,/media/marda/TWOTB1/xBD/hurricanes/images/florence/hurricane-florence_00000455_pre_disaster.png,38,60,1,327,365,761,821,599,32.54320788469453,24.594329131308676
15204,/media/marda/TWOTB1/xBD/hurricanes/images/florence/hurricane-florence_00000455_pre_disaster.png,35,55,1,308,343,783,838,453,27.201694780747047,22.253343319910346
15205,/media/marda/TWOTB1/xBD/hurricanes/images/florence/hurricane-florence_00000455_pre_disaster.png,85,88,1,926,1011,840,928,1406,56.168555387844755,33.03914877221028
15206,/media/marda/TWOTB1/xBD/hurricanes/images/florence/hurricane-florence_00000455_pre_disaster.png,41,59,1,368,409,849,908,389,26.841949810438074,19.158030018604475
15207,/media/marda/TWOTB1/xBD/hurricanes/images/florence/hurricane-florence_00000455_pre_disaster.png,61,85,1,323,384,859,944,1260,57.23525881710087,31.482367430817927
15208,/media/marda/TWOTB1/xBD/hurricanes/images/florence/hurricane-florence_00000455_pre_disaster.png,33,52,1,356,389,862,914,232,18.168834371473586,16.861086912606467
15209,/media/marda/TWOTB1/xBD/hurricanes/images/florence/hurricane-florence_00000455_pre_disaster.png,69,74,1,975,1044,896,970,712,34.1996380442209,28.565889202307126
15210,/media/marda/TWOTB1/xBD/hurricanes/images/florence/hurricane-florence_00000393_pre_disaster.png,60,9,1,585,645,0,9,189,36.2848853859413,7.777599163323771
15211,/media/marda/TWOTB1/xBD/hurricanes/images/florence/hurricane-florence_00000393_pre_disaster.png,51,46,1,638,689,18,64,604,52.52028353378615,15.31166138060679
15212,/media/marda/TWOTB1/xBD/hurricanes/images/florence/hurricane-florence_00000393_pre_disaster.png,66,52,1,728,794,93,145,1116,55.73460105245081,26.560744689040007
15213,/media/marda/TWOTB1/xBD/hurricanes/images/florence/hurricane-florence_00000393_pre_disaster.png,64,55,1,756,820,163,218,1012,55.16043131929987,24.35682011649203
15214,/media/marda/TWOTB1/xBD/hurricanes/images/florence/hurricane-florence_00000393_pre_disaster.png,52,28,1,691,743,216,244,279,24.4031184446152,15.318082146699172
15215,/media/marda/TWOTB1/xBD/hurricanes/images/florence/hurricane-florence_00000393_pre_disaster.png,64,52,1,768,832,226,278,889,46.8568373338776,25.107069788643805
15216,/media/marda/TWOTB1/xBD/hurricanes/images/florence/hurricane-florence_00000393_pre_disaster.png,47,18,1,806,853,275,293,114,16.5763128080722,9.017182029660878
15217,/media/marda/TWOTB1/xBD/hurricanes/images/florence/hurricane-florence_00000393_pre_disaster.png,44,19,1,782,826,278,297,142,15.294392112742031,12.263240389194621
15218,/media/marda/TWOTB1/xBD/hurricanes/images/florence/hurricane-florence_00000407_pre_disaster.png,68,42,1,413,481,0,42,1424,49.72235582205935,38.851315787210986
15219,/media/marda/TWOTB1/xBD/hurricanes/images/florence/hurricane-florence_00000407_pre_disaster.png,52,15,1,533,585,0,15,251,27.614520386641153,13.929066354933273
15220,/media/marda/TWOTB1/xBD/hurricanes/images/florence/hurricane-florence_00000407_pre_disaster.png,90,36,1,557,647,0,36,1539,65.57579927080751,32.00348348338317
15221,/media/marda/TWOTB1/xBD/hurricanes/images/florence/hurricane-florence_00000407_pre_disaster.png,76,56,1,598,674,17,73,1702,57.67372431183202,41.29148934789496
15222,/media/marda/TWOTB1/xBD/hurricanes/images/florence/hurricane-florence_00000407_pre_disaster.png,61,47,1,446,507,22,69,1090,42.44666773353674,35.08605464768367
15223,/media/marda/TWOTB1/xBD/hurricanes/images/florence/hurricane-florence_00000407_pre_disaster.png,36,36,1,46,82,34,70,807,35.221623577743465,30.74060137862429
15224,/media/marda/TWOTB1/xBD/hurricanes/images/florence/hurricane-florence_00000407_pre_disaster.png,68,60,1,460,528,59,119,1759,57.13121456759295,41.03130413456759
15225,/media/marda/TWOTB1/xBD/hurricanes/images/florence/hurricane-florence_00000407_pre_disaster.png,153,131,1,121,274,67,198,9757,160.09396381844013,90.06538775319433
15226,/media/marda/TWOTB1/xBD/hurricanes/images/florence/hurricane-florence_00000407_pre_disaster.png,40,41,1,80,120,80,121,910,36.6899636201543,32.582199140268195
15227,/media/marda/TWOTB1/xBD/hurricanes/images/florence/hurricane-florence_00000407_pre_disaster.png,30,26,1,157,187,83,109,346,21.83039498444147,21.17830399313375
15228,/media/marda/TWOTB1/xBD/hurricanes/images/florence/hurricane-florence_00000407_pre_disaster.png,74,48,1,476,550,103,151,1450,52.593975436546955,36.28132479327244
15229,/media/marda/TWOTB1/xBD/hurricanes/images/florence/hurricane-florence_00000407_pre_disaster.png,62,79,1,24,86,587,666,2120,56.926144643401,48.99296217798469
15230,/media/marda/TWOTB1/xBD/hurricanes/images/florence/hurricane-florence_00000407_pre_disaster.png,64,83,1,54,118,639,722,2179,55.86137620903905,50.80634163622952
15231,/media/marda/TWOTB1/xBD/hurricanes/images/florence/hurricane-florence_00000407_pre_disaster.png,92,73,1,952,1044,698,771,1941,55.762646369209754,45.44965441183553
15232,/media/marda/TWOTB1/xBD/hurricanes/images/florence/hurricane-florence_00000407_pre_disaster.png,145,170,1,80,225,870,1040,12960,136.34230059921003,128.43363054705966
15233,/media/marda/TWOTB1/xBD/hurricanes/images/florence/hurricane-florence_00000228_post_disaster.png,53,57,1,142,195,201,258,1294,47.7767003829463,37.012081936143574
15234,/media/marda/TWOTB1/xBD/hurricanes/images/florence/hurricane-florence_00000228_post_disaster.png,49,56,1,80,129,239,295,1103,51.497075189560505,29.973128767425074
15235,/media/marda/TWOTB1/xBD/hurricanes/images/florence/hurricane-florence_00000228_post_disaster.png,68,90,1,555,623,762,852,1444,63.537070158717654,37.46893824897057
15236,/media/marda/TWOTB1/xBD/hurricanes/images/florence/hurricane-florence_00000228_post_disaster.png,14,47,1,60,74,801,848,111,16.17751546664173,9.07445760603986
15237,/media/marda/TWOTB1/xBD/hurricanes/images/florence/hurricane-florence_00000228_post_disaster.png,54,69,1,530,584,812,881,733,34.46870469271281,28.206005421122875
15238,/media/marda/TWOTB1/xBD/hurricanes/images/florence/hurricane-florence_00000228_post_disaster.png,46,77,1,39,85,823,900,1221,45.32967785084249,35.68044746643466
15239,/media/marda/TWOTB1/xBD/hurricanes/images/florence/hurricane-florence_00000228_post_disaster.png,74,79,1,358,432,833,912,1324,65.2997727797916,26.7715077520423
15240,/media/marda/TWOTB1/xBD/hurricanes/images/florence/hurricane-florence_00000228_post_disaster.png,40,66,1,290,330,866,932,623,35.45113034839543,22.8700831746041
15241,/media/marda/TWOTB1/xBD/hurricanes/images/florence/hurricane-florence_00000228_post_disaster.png,5,47,1,0,5,908,955,29,10.396269590153207,4.2578435155778305
15242,/media/marda/TWOTB1/xBD/hurricanes/images/florence/hurricane-florence_00000228_post_disaster.png,44,69,1,217,261,913,982,636,32.47898723800619,26.004960020069692
15243,/media/marda/TWOTB1/xBD/hurricanes/images/florence/hurricane-florence_00000228_post_disaster.png,52,75,1,146,198,933,1008,898,51.0607144716814,23.33654795431407
15244,/media/marda/TWOTB1/xBD/hurricanes/images/florence/hurricane-florence_00000228_post_disaster.png,24,56,1,168,192,966,1022,208,19.016049227201414,14.6570788544665
15245,/media/marda/TWOTB1/xBD/hurricanes/images/florence/hurricane-florence_00000228_post_disaster.png,40,68,1,90,130,969,1037,594,34.97589623184365,23.03937236542791
15246,/media/marda/TWOTB1/xBD/hurricanes/images/florence/hurricane-florence_00000228_post_disaster.png,24,54,1,119,143,989,1043,184,19.038596754010463,13.311527616153281
15247,/media/marda/TWOTB1/xBD/hurricanes/images/florence/hurricane-florence_00000228_post_disaster.png,18,50,1,21,39,993,1043,107,16.352435833931665,9.31891787995357
15248,/media/marda/TWOTB1/xBD/hurricanes/images/florence/hurricane-florence_00000228_post_disaster.png,48,53,1,225,273,246,299,913,40.89393336412437,31.454120610536247
15249,/media/marda/TWOTB1/xBD/hurricanes/images/florence/hurricane-florence_00000353_pre_disaster.png,33,69,1,158,191,319,388,837,62.42556548902604,17.907095411802207
15250,/media/marda/TWOTB1/xBD/hurricanes/images/florence/hurricane-florence_00000353_pre_disaster.png,34,62,1,216,250,335,397,725,54.33717882234208,17.834104437870607
15251,/media/marda/TWOTB1/xBD/hurricanes/images/florence/hurricane-florence_00000353_pre_disaster.png,36,44,1,285,321,373,417,524,30.333966254938165,23.2955516596616
15252,/media/marda/TWOTB1/xBD/hurricanes/images/florence/hurricane-florence_00000353_pre_disaster.png,21,29,1,118,139,399,428,137,17.766712212556534,10.381921350647772
15253,/media/marda/TWOTB1/xBD/hurricanes/images/florence/hurricane-florence_00000353_pre_disaster.png,55,69,1,345,400,404,473,1378,55.05500438037005,34.07200435806242
15254,/media/marda/TWOTB1/xBD/hurricanes/images/florence/hurricane-florence_00000353_pre_disaster.png,25,33,1,182,207,415,448,222,19.65841257217637,14.965106479008865
15255,/media/marda/TWOTB1/xBD/hurricanes/images/florence/hurricane-florence_00000353_pre_disaster.png,116,94,1,732,848,415,509,5860,97.09966128308508,79.10577574786463
15256,/media/marda/TWOTB1/xBD/hurricanes/images/florence/hurricane-florence_00000353_pre_disaster.png,33,43,1,218,251,416,459,479,26.478936137477906,23.911882105147427
15257,/media/marda/TWOTB1/xBD/hurricanes/images/florence/hurricane-florence_00000353_pre_disaster.png,199,216,1,126,325,494,710,16817,194.2708731186312,170.93636929765708
15258,/media/marda/TWOTB1/xBD/hurricanes/images/florence/hurricane-florence_00000353_pre_disaster.png,26,55,1,98,124,607,662,470,30.914789985100978,20.32093290855458
15259,/media/marda/TWOTB1/xBD/hurricanes/images/florence/hurricane-florence_00000353_pre_disaster.png,92,80,1,461,553,646,726,2043,89.28133222365007,34.927608753261126
15260,/media/marda/TWOTB1/xBD/hurricanes/images/florence/hurricane-florence_00000353_pre_disaster.png,57,77,1,616,673,720,797,1223,50.35170359925948,32.09721878322454
15261,/media/marda/TWOTB1/xBD/hurricanes/images/florence/hurricane-florence_00000246_post_disaster.png,51,23,1,721,772,0,23,292,24.128050042478858,16.569049212388233
15262,/media/marda/TWOTB1/xBD/hurricanes/images/florence/hurricane-florence_00000246_post_disaster.png,62,76,1,511,573,712,788,1135,49.82445600027664,30.14365748279939
15263,/media/marda/TWOTB1/xBD/hurricanes/images/florence/hurricane-florence_00000312_pre_disaster.png,25,21,1,170,195,77,98,250,18.79821375087839,17.720477413892855
15264,/media/marda/TWOTB1/xBD/hurricanes/images/florence/hurricane-florence_00000312_pre_disaster.png,42,42,1,183,225,94,136,809,40.31386390684394,26.662608863763083
15265,/media/marda/TWOTB1/xBD/hurricanes/images/florence/hurricane-florence_00000312_pre_disaster.png,25,17,1,247,272,127,144,118,16.70858428562419,9.466759427909428
15266,/media/marda/TWOTB1/xBD/hurricanes/images/florence/hurricane-florence_00000312_pre_disaster.png,52,46,1,331,383,128,174,883,43.29799876793003,27.239208897516974
15267,/media/marda/TWOTB1/xBD/hurricanes/images/florence/hurricane-florence_00000312_pre_disaster.png,20,17,1,194,214,133,150,98,14.046016614452641,9.355519429573786
15268,/media/marda/TWOTB1/xBD/hurricanes/images/florence/hurricane-florence_00000312_pre_disaster.png,40,21,1,628,668,242,263,118,15.722673760292622,9.976821764283871
15269,/media/marda/TWOTB1/xBD/hurricanes/images/florence/hurricane-florence_00000312_pre_disaster.png,71,51,1,599,670,251,302,1030,49.8648550005455,29.311593558708697
15270,/media/marda/TWOTB1/xBD/hurricanes/images/florence/hurricane-florence_00000312_pre_disaster.png,69,51,1,567,636,366,417,1122,47.318989437596876,31.700319828852265
15271,/media/marda/TWOTB1/xBD/hurricanes/images/florence/hurricane-florence_00000312_pre_disaster.png,33,26,1,603,636,399,425,70,9.9945015576432,9.519161119037014
15272,/media/marda/TWOTB1/xBD/hurricanes/images/florence/hurricane-florence_00000312_pre_disaster.png,66,59,1,617,683,460,519,1206,41.4697235593055,38.652119782374776
15273,/media/marda/TWOTB1/xBD/hurricanes/images/florence/hurricane-florence_00000312_pre_disaster.png,46,40,1,657,703,474,514,336,22.032809743623,20.416684576273045
15274,/media/marda/TWOTB1/xBD/hurricanes/images/florence/hurricane-florence_00000020_pre_disaster.png,75,48,1,392,467,162,210,1443,54.96001822999467,36.06842170808738
15275,/media/marda/TWOTB1/xBD/hurricanes/images/florence/hurricane-florence_00000020_pre_disaster.png,35,45,1,346,381,199,244,488,36.60410155784289,18.115464391990617
15276,/media/marda/TWOTB1/xBD/hurricanes/images/florence/hurricane-florence_00000020_pre_disaster.png,63,24,1,931,994,261,285,160,30.182548579245687,7.114334913502044
15277,/media/marda/TWOTB1/xBD/hurricanes/images/florence/hurricane-florence_00000020_pre_disaster.png,63,34,1,979,1042,315,349,316,23.42743551257193,18.020124460098724
15278,/media/marda/TWOTB1/xBD/hurricanes/images/florence/hurricane-florence_00000020_pre_disaster.png,55,39,1,818,873,465,504,279,19.99942613243667,18.639209634723194
15279,/media/marda/TWOTB1/xBD/hurricanes/images/florence/hurricane-florence_00000020_pre_disaster.png,91,57,1,759,850,489,546,1344,58.00164204451347,33.26529548966677
15280,/media/marda/TWOTB1/xBD/hurricanes/images/florence/hurricane-florence_00000020_pre_disaster.png,58,45,1,856,914,546,591,352,22.41303175586622,21.02858678218741
15281,/media/marda/TWOTB1/xBD/hurricanes/images/florence/hurricane-florence_00000020_pre_disaster.png,62,78,1,351,413,833,911,1267,49.756523406642735,37.560170388002014
15282,/media/marda/TWOTB1/xBD/hurricanes/images/florence/hurricane-florence_00000020_pre_disaster.png,38,54,1,440,478,840,894,274,22.153880172544326,16.252935374510866
15283,/media/marda/TWOTB1/xBD/hurricanes/images/florence/hurricane-florence_00000020_pre_disaster.png,72,70,1,807,879,849,919,849,37.180961986222535,30.111572287594306
15284,/media/marda/TWOTB1/xBD/hurricanes/images/florence/hurricane-florence_00000020_pre_disaster.png,56,56,1,761,817,854,910,297,26.80160081160111,15.163385912045083
15285,/media/marda/TWOTB1/xBD/hurricanes/images/florence/hurricane-florence_00000020_pre_disaster.png,60,63,1,748,808,883,946,548,27.598825090254266,26.727769029048
15286,/media/marda/TWOTB1/xBD/hurricanes/images/florence/hurricane-florence_00000076_pre_disaster.png,60,53,1,378,438,271,324,1104,43.587270388786834,34.382069309852206
15287,/media/marda/TWOTB1/xBD/hurricanes/images/florence/hurricane-florence_00000076_pre_disaster.png,43,42,1,71,114,295,337,833,39.20344359647632,28.146658988882553
15288,/media/marda/TWOTB1/xBD/hurricanes/images/florence/hurricane-florence_00000076_pre_disaster.png,104,71,1,868,972,589,660,1761,67.41635630776351,34.99916446680731
15289,/media/marda/TWOTB1/xBD/hurricanes/images/florence/hurricane-florence_00000076_pre_disaster.png,71,57,1,431,502,717,774,1456,60.31730399242915,31.869919768834794
15290,/media/marda/TWOTB1/xBD/hurricanes/images/florence/hurricane-florence_00000076_pre_disaster.png,34,49,1,358,392,723,772,206,23.220930089405737,11.884273234850664
15291,/media/marda/TWOTB1/xBD/hurricanes/images/florence/hurricane-florence_00000076_pre_disaster.png,39,51,1,384,423,773,824,497,27.60268259054894,24.060517102550968
15292,/media/marda/TWOTB1/xBD/hurricanes/images/florence/hurricane-florence_00000076_pre_disaster.png,57,60,1,987,1044,806,866,427,30.5904723191718,18.37112626920152
15293,/media/marda/TWOTB1/xBD/hurricanes/images/florence/hurricane-florence_00000076_pre_disaster.png,74,79,1,850,924,840,919,1100,42.994047573462765,34.05783324702594
15294,/media/marda/TWOTB1/xBD/hurricanes/images/florence/hurricane-florence_00000076_pre_disaster.png,64,69,1,811,875,924,993,674,31.663653264591925,28.54816120872864
15295,/media/marda/TWOTB1/xBD/hurricanes/images/florence/hurricane-florence_00000282_post_disaster.png,82,84,1,812,894,853,937,1362,47.90775672749064,37.85326403942853
15296,/media/marda/TWOTB1/xBD/hurricanes/images/florence/hurricane-florence_00000107_pre_disaster.png,66,57,1,978,1044,474,531,963,42.46303813162227,29.918842199942528
15297,/media/marda/TWOTB1/xBD/hurricanes/images/florence/hurricane-florence_00000107_pre_disaster.png,197,80,1,765,962,494,574,5977,185.91488914343802,42.85241717601118
15298,/media/marda/TWOTB1/xBD/hurricanes/images/florence/hurricane-florence_00000107_pre_disaster.png,77,62,1,967,1044,573,635,1406,44.320615419325925,41.976586177327775
15299,/media/marda/TWOTB1/xBD/hurricanes/images/florence/hurricane-florence_00000107_pre_disaster.png,61,43,1,892,953,596,639,342,26.487319014486033,17.06495244817711
15300,/media/marda/TWOTB1/xBD/hurricanes/images/florence/hurricane-florence_00000107_pre_disaster.png,198,85,1,744,942,639,724,6188,188.54125019186364,43.62150669481349
15301,/media/marda/TWOTB1/xBD/hurricanes/images/florence/hurricane-florence_00000107_pre_disaster.png,91,68,1,953,1044,670,738,1963,59.661248014516254,43.5345674165421
15302,/media/marda/TWOTB1/xBD/hurricanes/images/florence/hurricane-florence_00000107_pre_disaster.png,105,66,1,740,845,746,812,2064,82.2155395426386,33.4125788263439
15303,/media/marda/TWOTB1/xBD/hurricanes/images/florence/hurricane-florence_00000107_pre_disaster.png,104,72,1,940,1044,767,839,2441,75.1197292162777,43.08849538138057
15304,/media/marda/TWOTB1/xBD/hurricanes/images/florence/hurricane-florence_00000446_post_disaster.png,59,53,1,77,136,159,212,1731,62.315021138324504,39.392937186481646
15305,/media/marda/TWOTB1/xBD/hurricanes/images/florence/hurricane-florence_00000446_post_disaster.png,62,32,1,981,1043,247,279,481,26.384488428537438,24.135638357121284
15306,/media/marda/TWOTB1/xBD/hurricanes/images/florence/hurricane-florence_00000446_post_disaster.png,73,43,1,776,849,286,329,952,47.68605862383984,26.44276754746
15307,/media/marda/TWOTB1/xBD/hurricanes/images/florence/hurricane-florence_00000446_post_disaster.png,44,35,1,757,801,341,376,314,24.49439706996072,17.0992148187527
15308,/media/marda/TWOTB1/xBD/hurricanes/images/florence/hurricane-florence_00000446_post_disaster.png,55,32,1,757,812,376,408,433,28.6122046707406,20.2623131806075
15309,/media/marda/TWOTB1/xBD/hurricanes/images/florence/hurricane-florence_00000446_post_disaster.png,58,39,1,749,807,420,459,578,32.55516825825895,23.743848959979207
15310,/media/marda/TWOTB1/xBD/hurricanes/images/florence/hurricane-florence_00000446_post_disaster.png,66,57,1,611,677,823,880,710,43.24983316695316,22.537849072405383
15311,/media/marda/TWOTB1/xBD/hurricanes/images/florence/hurricane-florence_00000446_post_disaster.png,56,46,1,557,613,825,871,399,38.41637016058757,13.80631186102633
15312,/media/marda/TWOTB1/xBD/hurricanes/images/florence/hurricane-florence_00000383_post_disaster.png,36,24,1,213,249,0,24,466,26.70917113165714,23.669382298361892
15313,/media/marda/TWOTB1/xBD/hurricanes/images/florence/hurricane-florence_00000383_post_disaster.png,39,25,1,195,234,31,56,525,35.7884661431138,19.616563884930052
15314,/media/marda/TWOTB1/xBD/hurricanes/images/florence/hurricane-florence_00000383_post_disaster.png,42,27,1,184,226,79,106,657,37.77067351190625,23.239786078598353
15315,/media/marda/TWOTB1/xBD/hurricanes/images/florence/hurricane-florence_00000383_post_disaster.png,51,36,1,52,103,127,163,818,53.47014029871801,20.232646181848075
15316,/media/marda/TWOTB1/xBD/hurricanes/images/florence/hurricane-florence_00000383_post_disaster.png,32,23,1,164,196,140,163,306,30.636720113548616,13.351958717378293
15317,/media/marda/TWOTB1/xBD/hurricanes/images/florence/hurricane-florence_00000383_post_disaster.png,37,32,1,174,211,173,205,541,28.51135342331551,25.60523132281111
15318,/media/marda/TWOTB1/xBD/hurricanes/images/florence/hurricane-florence_00000383_post_disaster.png,21,14,1,225,246,176,190,98,14.123883498671557,9.395265667173526
15319,/media/marda/TWOTB1/xBD/hurricanes/images/florence/hurricane-florence_00000383_post_disaster.png,55,79,1,2,57,197,276,1128,93.19166798921108,34.022345397605854
15320,/media/marda/TWOTB1/xBD/hurricanes/images/florence/hurricane-florence_00000383_post_disaster.png,40,43,1,33,73,214,257,831,37.632981821581886,31.43142363029845
15321,/media/marda/TWOTB1/xBD/hurricanes/images/florence/hurricane-florence_00000383_post_disaster.png,30,34,1,149,179,218,252,443,24.966247181817206,23.632133121645037
15322,/media/marda/TWOTB1/xBD/hurricanes/images/florence/hurricane-florence_00000383_post_disaster.png,32,61,1,250,282,220,281,810,60.53279561372289,17.841635306681848
15323,/media/marda/TWOTB1/xBD/hurricanes/images/florence/hurricane-florence_00000383_post_disaster.png,59,51,1,317,376,223,274,771,55.48196504174469,19.14063377890875
15324,/media/marda/TWOTB1/xBD/hurricanes/images/florence/hurricane-florence_00000383_post_disaster.png,34,52,1,145,179,255,307,836,44.2507578191734,25.241142973681384
15325,/media/marda/TWOTB1/xBD/hurricanes/images/florence/hurricane-florence_00000383_post_disaster.png,26,22,1,194,220,263,285,215,21.05367517412579,13.452232385217862
15326,/media/marda/TWOTB1/xBD/hurricanes/images/florence/hurricane-florence_00000383_post_disaster.png,20,18,1,208,228,278,296,77,12.088161643913285,8.620881227417849
15327,/media/marda/TWOTB1/xBD/hurricanes/images/florence/hurricane-florence_00000383_post_disaster.png,22,21,1,199,221,296,317,126,16.1245154965971,10.327955589886445
15328,/media/marda/TWOTB1/xBD/hurricanes/images/florence/hurricane-florence_00000383_post_disaster.png,23,47,1,0,23,297,344,566,34.51024540575274,21.912303769905698
15329,/media/marda/TWOTB1/xBD/hurricanes/images/florence/hurricane-florence_00000383_post_disaster.png,20,33,1,108,128,324,357,227,21.696300760598024,14.038627641412205
15330,/media/marda/TWOTB1/xBD/hurricanes/images/florence/hurricane-florence_00000383_post_disaster.png,16,46,1,0,16,344,390,342,33.17424995540114,14.637898981104406
15331,/media/marda/TWOTB1/xBD/hurricanes/images/florence/hurricane-florence_00000383_post_disaster.png,36,62,1,98,134,356,418,1020,50.5411166482599,27.2402356376945
15332,/media/marda/TWOTB1/xBD/hurricanes/images/florence/hurricane-florence_00000383_post_disaster.png,36,48,1,77,113,445,493,754,35.17094275499689,29.130638552427815
15333,/media/marda/TWOTB1/xBD/hurricanes/images/florence/hurricane-florence_00000383_post_disaster.png,65,50,1,57,122,490,540,1223,61.64716477496829,28.4306979920219
15334,/media/marda/TWOTB1/xBD/hurricanes/images/florence/hurricane-florence_00000383_post_disaster.png,55,35,1,145,200,496,531,553,57.452212025531836,12.750058087267538
15335,/media/marda/TWOTB1/xBD/hurricanes/images/florence/hurricane-florence_00000383_post_disaster.png,43,48,1,99,142,516,564,629,43.16100225644366,19.122524736648028
15336,/media/marda/TWOTB1/xBD/hurricanes/images/florence/hurricane-florence_00000383_post_disaster.png,39,60,1,26,65,576,636,895,38.09047652684486,34.623182623061375
15337,/media/marda/TWOTB1/xBD/hurricanes/images/florence/hurricane-florence_00000383_post_disaster.png,48,43,1,21,69,629,672,385,52.66557265597693,10.478038470031409
15338,/media/marda/TWOTB1/xBD/hurricanes/images/florence/hurricane-florence_00000383_post_disaster.png,23,69,1,0,23,676,745,700,45.57964090451709,20.891642902810155
15339,/media/marda/TWOTB1/xBD/hurricanes/images/florence/hurricane-florence_00000383_post_disaster.png,29,51,1,99,128,712,763,407,27.056073990599785,19.882726661364252
15340,/media/marda/TWOTB1/xBD/hurricanes/images/florence/hurricane-florence_00000383_post_disaster.png,58,68,1,498,556,798,866,1001,43.59743545986806,33.50460541630235
15341,/media/marda/TWOTB1/xBD/hurricanes/images/florence/hurricane-florence_00000383_post_disaster.png,47,58,1,68,115,820,878,461,51.74324828555259,11.921576551946774
15342,/media/marda/TWOTB1/xBD/hurricanes/images/florence/hurricane-florence_00000383_post_disaster.png,26,83,1,0,26,844,927,805,49.67556229295425,23.25019119885139
15343,/media/marda/TWOTB1/xBD/hurricanes/images/florence/hurricane-florence_00000383_post_disaster.png,65,84,1,491,556,868,952,1528,52.90715301223383,48.709889203769784
15344,/media/marda/TWOTB1/xBD/hurricanes/images/florence/hurricane-florence_00000383_post_disaster.png,80,71,1,762,842,874,945,591,60.70449328659107,13.004079908835944
15345,/media/marda/TWOTB1/xBD/hurricanes/images/florence/hurricane-florence_00000383_post_disaster.png,81,55,1,701,782,882,937,1144,60.06101346477551,25.32249030157231
15346,/media/marda/TWOTB1/xBD/hurricanes/images/florence/hurricane-florence_00000383_post_disaster.png,72,52,1,363,435,892,944,749,66.3667541938229,15.120848535699782
15347,/media/marda/TWOTB1/xBD/hurricanes/images/florence/hurricane-florence_00000383_post_disaster.png,72,53,1,587,659,894,947,625,57.37844220631439,14.55824989676435
15348,/media/marda/TWOTB1/xBD/hurricanes/images/florence/hurricane-florence_00000383_post_disaster.png,43,71,1,844,887,904,975,367,40.40132352608264,12.101336727881458
15349,/media/marda/TWOTB1/xBD/hurricanes/images/florence/hurricane-florence_00000383_post_disaster.png,42,69,1,14,56,966,1035,892,43.444179665521375,27.185503919482546
15350,/media/marda/TWOTB1/xBD/hurricanes/images/florence/hurricane-florence_00000383_post_disaster.png,50,52,1,129,179,991,1043,333,47.49559311579971,10.163438056517137
15351,/media/marda/TWOTB1/xBD/hurricanes/images/florence/hurricane-florence_00000166_pre_disaster.png,61,53,1,545,606,381,434,863,37.799621070099185,30.365336644509387
15352,/media/marda/TWOTB1/xBD/hurricanes/images/florence/hurricane-florence_00000166_pre_disaster.png,62,48,1,715,777,484,532,658,30.851595151131885,27.984602113106643
15353,/media/marda/TWOTB1/xBD/hurricanes/images/florence/hurricane-florence_00000166_pre_disaster.png,78,63,1,722,800,552,615,1154,47.90374468622935,31.57762362837368
15354,/media/marda/TWOTB1/xBD/hurricanes/images/florence/hurricane-florence_00000166_pre_disaster.png,83,59,1,839,922,606,665,552,57.11236880521427,12.926206027176748
15355,/media/marda/TWOTB1/xBD/hurricanes/images/florence/hurricane-florence_00000166_pre_disaster.png,75,62,1,913,988,670,732,786,34.55284163126286,30.65122651407892
15356,/media/marda/TWOTB1/xBD/hurricanes/images/florence/hurricane-florence_00000454_pre_disaster.png,41,27,1,0,41,0,27,1053,46.779977425835995,30.03212420353691
15357,/media/marda/TWOTB1/xBD/hurricanes/images/florence/hurricane-florence_00000454_pre_disaster.png,14,28,1,0,14,281,309,232,20.505894933776286,15.198486906176646
15358,/media/marda/TWOTB1/xBD/hurricanes/images/florence/hurricane-florence_00000454_pre_disaster.png,38,53,1,198,236,401,454,874,38.17030801461362,30.60284280311358
15359,/media/marda/TWOTB1/xBD/hurricanes/images/florence/hurricane-florence_00000454_pre_disaster.png,14,32,1,79,93,417,449,184,17.23083959464783,14.447131979741732
15360,/media/marda/TWOTB1/xBD/hurricanes/images/florence/hurricane-florence_00000454_pre_disaster.png,37,34,1,102,139,421,455,419,35.312078782528886,16.294986385199365
15361,/media/marda/TWOTB1/xBD/hurricanes/images/florence/hurricane-florence_00000454_pre_disaster.png,13,30,1,141,154,424,454,106,13.83295812005685,10.273923594800952
15362,/media/marda/TWOTB1/xBD/hurricanes/images/florence/hurricane-florence_00000454_pre_disaster.png,49,37,1,148,197,438,475,726,50.4140513916526,19.245189302330456
15363,/media/marda/TWOTB1/xBD/hurricanes/images/florence/hurricane-florence_00000454_pre_disaster.png,69,39,1,726,795,441,480,725,44.661276073579934,21.409687461993958
15364,/media/marda/TWOTB1/xBD/hurricanes/images/florence/hurricane-florence_00000454_pre_disaster.png,38,60,1,37,75,453,513,788,43.72850481940232,24.223364918271624
15365,/media/marda/TWOTB1/xBD/hurricanes/images/florence/hurricane-florence_00000454_pre_disaster.png,19,34,1,144,163,492,526,123,13.483157630427579,12.25489762108817
15366,/media/marda/TWOTB1/xBD/hurricanes/images/florence/hurricane-florence_00000454_pre_disaster.png,14,31,1,158,172,492,523,69,10.849788807813656,8.642458025668533
15367,/media/marda/TWOTB1/xBD/hurricanes/images/florence/hurricane-florence_00000454_pre_disaster.png,41,67,1,137,178,506,573,980,43.13694328850686,31.486593016723443
15368,/media/marda/TWOTB1/xBD/hurricanes/images/florence/hurricane-florence_00000454_pre_disaster.png,71,64,1,673,744,511,575,1387,48.98531687473381,40.367645760202755
15369,/media/marda/TWOTB1/xBD/hurricanes/images/florence/hurricane-florence_00000454_pre_disaster.png,45,70,1,80,125,522,592,1105,54.07819953762964,26.94318919429106
15370,/media/marda/TWOTB1/xBD/hurricanes/images/florence/hurricane-florence_00000454_pre_disaster.png,50,38,1,745,795,569,607,287,22.004093306026135,16.928574750037512
15371,/media/marda/TWOTB1/xBD/hurricanes/images/florence/hurricane-florence_00000454_pre_disaster.png,24,79,1,0,24,912,991,987,48.56440991379622,27.123712244049532
15372,/media/marda/TWOTB1/xBD/hurricanes/images/florence/hurricane-florence_00000454_pre_disaster.png,42,59,1,296,338,938,997,504,32.558242340467714,20.567713425248925
15373,/media/marda/TWOTB1/xBD/hurricanes/images/florence/hurricane-florence_00000454_pre_disaster.png,51,83,1,247,298,959,1042,1399,54.00496425083138,37.15659046517955
15374,/media/marda/TWOTB1/xBD/hurricanes/images/florence/hurricane-florence_00000454_pre_disaster.png,20,45,1,313,333,966,1011,51,9.072047589439572,7.725698577447143
15375,/media/marda/TWOTB1/xBD/hurricanes/images/florence/hurricane-florence_00000111_post_disaster.png,73,49,1,522,595,285,334,1014,58.08130823688171,23.209306667103643
15376,/media/marda/TWOTB1/xBD/hurricanes/images/florence/hurricane-florence_00000111_post_disaster.png,19,28,1,56,75,350,378,241,20.01069155576004,15.577363835344807
15377,/media/marda/TWOTB1/xBD/hurricanes/images/florence/hurricane-florence_00000111_post_disaster.png,35,26,1,509,544,373,399,114,13.573734686029754,11.301893520844123
15378,/media/marda/TWOTB1/xBD/hurricanes/images/florence/hurricane-florence_00000111_post_disaster.png,37,36,1,120,157,427,463,336,35.164880607337096,12.772840623213511
15379,/media/marda/TWOTB1/xBD/hurricanes/images/florence/hurricane-florence_00000211_pre_disaster.png,38,34,1,364,402,0,34,600,37.8241651404286,21.19665797259946
15380,/media/marda/TWOTB1/xBD/hurricanes/images/florence/hurricane-florence_00000211_pre_disaster.png,48,16,1,598,646,0,16,267,22.273247545618695,16.374787680783815
15381,/media/marda/TWOTB1/xBD/hurricanes/images/florence/hurricane-florence_00000211_pre_disaster.png,52,23,1,441,493,11,34,395,38.80617854344343,13.601941264591575
15382,/media/marda/TWOTB1/xBD/hurricanes/images/florence/hurricane-florence_00000211_pre_disaster.png,10,19,1,0,10,12,31,99,16.33413555589898,9.369546636486692
15383,/media/marda/TWOTB1/xBD/hurricanes/images/florence/hurricane-florence_00000211_pre_disaster.png,46,24,1,625,671,52,76,370,23.55864217410047,20.67966519947119
15384,/media/marda/TWOTB1/xBD/hurricanes/images/florence/hurricane-florence_00000211_pre_disaster.png,32,35,1,98,130,76,111,652,33.17685135508252,25.917312511437455
15385,/media/marda/TWOTB1/xBD/hurricanes/images/florence/hurricane-florence_00000211_pre_disaster.png,69,35,1,595,664,78,113,979,44.30577828568143,29.131518589583102
15386,/media/marda/TWOTB1/xBD/hurricanes/images/florence/hurricane-florence_00000211_pre_disaster.png,32,36,1,88,120,128,164,469,30.44019054312081,20.57341409836538
15387,/media/marda/TWOTB1/xBD/hurricanes/images/florence/hurricane-florence_00000211_pre_disaster.png,39,28,1,267,306,133,161,350,26.833523503886422,17.42769154801937
15388,/media/marda/TWOTB1/xBD/hurricanes/images/florence/hurricane-florence_00000211_pre_disaster.png,38,18,1,575,613,145,163,123,14.9224488059333,11.092464870606216
15389,/media/marda/TWOTB1/xBD/hurricanes/images/florence/hurricane-florence_00000211_pre_disaster.png,51,42,1,264,315,173,215,855,40.122318993441596,29.02584302042991
15390,/media/marda/TWOTB1/xBD/hurricanes/images/florence/hurricane-florence_00000211_pre_disaster.png,32,29,1,41,73,217,246,506,36.072259951553974,18.727168071390583
15391,/media/marda/TWOTB1/xBD/hurricanes/images/florence/hurricane-florence_00000211_pre_disaster.png,41,22,1,593,634,217,239,216,19.185130955498,15.014499937802055
15392,/media/marda/TWOTB1/xBD/hurricanes/images/florence/hurricane-florence_00000211_pre_disaster.png,38,19,1,603,641,248,267,131,15.25120518867732,11.488496624781543
15393,/media/marda/TWOTB1/xBD/hurricanes/images/florence/hurricane-florence_00000211_pre_disaster.png,77,35,1,580,657,267,302,1097,60.447606878950864,24.486566456511667
15394,/media/marda/TWOTB1/xBD/hurricanes/images/florence/hurricane-florence_00000211_pre_disaster.png,49,33,1,486,535,275,308,456,32.61877363356993,18.67243847895244
15395,/media/marda/TWOTB1/xBD/hurricanes/images/florence/hurricane-florence_00000211_pre_disaster.png,32,37,1,103,135,284,321,578,31.94654364663368,25.05516140696337
15396,/media/marda/TWOTB1/xBD/hurricanes/images/florence/hurricane-florence_00000211_pre_disaster.png,38,30,1,159,197,324,354,297,38.226558146157046,10.408923496937087
15397,/media/marda/TWOTB1/xBD/hurricanes/images/florence/hurricane-florence_00000211_pre_disaster.png,23,31,1,112,135,328,359,246,18.95609283469325,17.40697331529433
15398,/media/marda/TWOTB1/xBD/hurricanes/images/florence/hurricane-florence_00000211_pre_disaster.png,87,48,1,688,775,350,398,1192,61.56062245016585,27.087277040622524
15399,/media/marda/TWOTB1/xBD/hurricanes/images/florence/hurricane-florence_00000211_pre_disaster.png,58,45,1,254,312,359,404,554,55.718305733771636,13.244896880852746
15400,/media/marda/TWOTB1/xBD/hurricanes/images/florence/hurricane-florence_00000211_pre_disaster.png,52,31,1,883,935,416,447,147,16.772190451550937,11.80840027986532
15401,/media/marda/TWOTB1/xBD/hurricanes/images/florence/hurricane-florence_00000211_pre_disaster.png,87,45,1,858,945,453,498,1020,56.28069791574041,23.949866841006628
15402,/media/marda/TWOTB1/xBD/hurricanes/images/florence/hurricane-florence_00000211_pre_disaster.png,65,41,1,979,1044,461,502,549,30.14261513153999,24.225582889089633
15403,/media/marda/TWOTB1/xBD/hurricanes/images/florence/hurricane-florence_00000211_pre_disaster.png,85,49,1,761,846,475,524,1154,59.18645185259806,25.867667658986566
15404,/media/marda/TWOTB1/xBD/hurricanes/images/florence/hurricane-florence_00000211_pre_disaster.png,89,102,1,462,551,526,628,2568,86.5696401308846,42.6587295294691
15405,/media/marda/TWOTB1/xBD/hurricanes/images/florence/hurricane-florence_00000211_pre_disaster.png,77,63,1,935,1012,568,631,850,41.809003122405045,27.135455983003784
15406,/media/marda/TWOTB1/xBD/hurricanes/images/florence/hurricane-florence_00000211_pre_disaster.png,60,62,1,409,469,578,640,682,53.14850137540078,17.121589441679554
15407,/media/marda/TWOTB1/xBD/hurricanes/images/florence/hurricane-florence_00000211_pre_disaster.png,65,62,1,566,631,655,717,621,51.60165769352865,16.37557467121413
15408,/media/marda/TWOTB1/xBD/hurricanes/images/florence/hurricane-florence_00000211_pre_disaster.png,43,60,1,463,506,686,746,402,31.91249539299744,16.83859944332876
15409,/media/marda/TWOTB1/xBD/hurricanes/images/florence/hurricane-florence_00000211_pre_disaster.png,61,69,1,798,859,686,755,592,45.337357816705754,17.383700471424223
15410,/media/marda/TWOTB1/xBD/hurricanes/images/florence/hurricane-florence_00000211_pre_disaster.png,57,70,1,795,852,762,832,601,45.08013132756153,17.8063216097592
15411,/media/marda/TWOTB1/xBD/hurricanes/images/florence/hurricane-florence_00000211_pre_disaster.png,89,67,1,898,987,785,852,1149,53.845332644893475,28.248624998438387
15412,/media/marda/TWOTB1/xBD/hurricanes/images/florence/hurricane-florence_00000211_pre_disaster.png,39,54,1,642,681,791,845,305,24.336095861639638,16.751064694315552
15413,/media/marda/TWOTB1/xBD/hurricanes/images/florence/hurricane-florence_00000211_pre_disaster.png,55,88,1,683,738,803,891,1082,60.08400991117183,24.094057500877184
15414,/media/marda/TWOTB1/xBD/hurricanes/images/florence/hurricane-florence_00000211_pre_disaster.png,62,58,1,660,722,908,966,578,36.81158646913663,20.72179355158942
15415,/media/marda/TWOTB1/xBD/hurricanes/images/florence/hurricane-florence_00000479_pre_disaster.png,39,11,1,385,424,0,11,143,24.260558708969338,9.03192207273337
15416,/media/marda/TWOTB1/xBD/hurricanes/images/florence/hurricane-florence_00000479_pre_disaster.png,73,68,1,587,660,15,83,2131,69.00150918263635,42.285230491589935
15417,/media/marda/TWOTB1/xBD/hurricanes/images/florence/hurricane-florence_00000479_pre_disaster.png,52,33,1,123,175,18,51,645,53.378329758316234,18.977949772224655
15418,/media/marda/TWOTB1/xBD/hurricanes/images/florence/hurricane-florence_00000479_pre_disaster.png,27,21,1,247,274,28,49,203,19.961844184100457,14.485883619408735
15419,/media/marda/TWOTB1/xBD/hurricanes/images/florence/hurricane-florence_00000479_pre_disaster.png,105,49,1,654,759,28,77,1835,86.30766130432087,33.168470688707664
15420,/media/marda/TWOTB1/xBD/hurricanes/images/florence/hurricane-florence_00000479_pre_disaster.png,44,20,1,637,681,36,56,249,18.692921906646337,17.86015260488431
15421,/media/marda/TWOTB1/xBD/hurricanes/images/florence/hurricane-florence_00000479_pre_disaster.png,27,12,1,232,259,61,73,118,21.086940804897804,7.534613578660388
15422,/media/marda/TWOTB1/xBD/hurricanes/images/florence/hurricane-florence_00000479_pre_disaster.png,102,41,1,471,573,98,139,1874,88.51213713456356,28.64060123405027
15423,/media/marda/TWOTB1/xBD/hurricanes/images/florence/hurricane-florence_00000479_pre_disaster.png,69,54,1,519,588,196,250,1522,49.60955843562421,42.00869320913006
15424,/media/marda/TWOTB1/xBD/hurricanes/images/florence/hurricane-florence_00000479_pre_disaster.png,46,34,1,569,615,246,280,375,24.006531603439992,20.68997939786669
15425,/media/marda/TWOTB1/xBD/hurricanes/images/florence/hurricane-florence_00000479_pre_disaster.png,51,40,1,378,429,255,295,665,35.98936190425249,24.469053027279898
15426,/media/marda/TWOTB1/xBD/hurricanes/images/florence/hurricane-florence_00000479_pre_disaster.png,40,24,1,598,638,262,286,146,16.15115951767317,12.123166212413667
15427,/media/marda/TWOTB1/xBD/hurricanes/images/florence/hurricane-florence_00000479_pre_disaster.png,57,67,1,295,352,294,361,1508,52.07848487311026,38.53327198307925
15428,/media/marda/TWOTB1/xBD/hurricanes/images/florence/hurricane-florence_00000479_pre_disaster.png,42,34,1,660,702,307,341,218,21.710932968420945,13.441794909027614
15429,/media/marda/TWOTB1/xBD/hurricanes/images/florence/hurricane-florence_00000479_pre_disaster.png,59,58,1,578,637,426,484,1079,40.39559776768699,35.10437240177691
15430,/media/marda/TWOTB1/xBD/hurricanes/images/florence/hurricane-florence_00000479_pre_disaster.png,51,44,1,643,694,473,517,643,29.715011783414248,28.919834165268504
15431,/media/marda/TWOTB1/xBD/hurricanes/images/florence/hurricane-florence_00000015_pre_disaster.png,15,28,1,0,15,0,28,270,27.91065294820017,13.533692372527389
15432,/media/marda/TWOTB1/xBD/hurricanes/images/florence/hurricane-florence_00000015_pre_disaster.png,51,57,1,10,61,0,57,1756,54.281394297490735,44.738968337330185
15433,/media/marda/TWOTB1/xBD/hurricanes/images/florence/hurricane-florence_00000015_pre_disaster.png,59,20,1,110,169,0,20,628,55.76390907855716,17.55718875773887
15434,/media/marda/TWOTB1/xBD/hurricanes/images/florence/hurricane-florence_00000015_pre_disaster.png,80,31,1,590,670,0,31,981,51.85692182287899,27.645747448571058
15435,/media/marda/TWOTB1/xBD/hurricanes/images/florence/hurricane-florence_00000015_pre_disaster.png,56,12,1,831,887,0,12,150,20.573996971735557,11.183808919162983
15436,/media/marda/TWOTB1/xBD/hurricanes/images/florence/hurricane-florence_00000015_pre_disaster.png,97,42,1,906,1003,0,42,1400,58.782935950807044,31.8900738216495
15437,/media/marda/TWOTB1/xBD/hurricanes/images/florence/hurricane-florence_00000015_pre_disaster.png,52,57,1,70,122,14,71,1760,55.17111524452672,43.806987445841436
15438,/media/marda/TWOTB1/xBD/hurricanes/images/florence/hurricane-florence_00000015_pre_disaster.png,83,51,1,650,733,16,67,1337,61.1041249955149,29.444784999453
15439,/media/marda/TWOTB1/xBD/hurricanes/images/florence/hurricane-florence_00000015_pre_disaster.png,90,31,1,842,932,40,71,1340,59.76698292284172,30.19212815252867
15440,/media/marda/TWOTB1/xBD/hurricanes/images/florence/hurricane-florence_00000015_pre_disaster.png,90,61,1,691,781,46,107,1834,55.13703741741297,47.358972700454345
15441,/media/marda/TWOTB1/xBD/hurricanes/images/florence/hurricane-florence_00000015_pre_disaster.png,101,42,1,448,549,50,92,2654,86.6362385135783,40.116497627182646
15442,/media/marda/TWOTB1/xBD/hurricanes/images/florence/hurricane-florence_00000015_pre_disaster.png,69,68,1,975,1044,98,166,1104,57.698969607403356,28.277010849837904
15443,/media/marda/TWOTB1/xBD/hurricanes/images/florence/hurricane-florence_00000015_pre_disaster.png,67,65,1,767,834,102,167,1588,65.02734805177745,33.40367354101086
15444,/media/marda/TWOTB1/xBD/hurricanes/images/florence/hurricane-florence_00000015_pre_disaster.png,66,81,1,354,420,104,185,2096,83.43746102521555,33.959579156597485
15445,/media/marda/TWOTB1/xBD/hurricanes/images/florence/hurricane-florence_00000015_pre_disaster.png,77,72,1,543,620,120,192,2103,67.52691415624878,44.69871593158367
15446,/media/marda/TWOTB1/xBD/hurricanes/images/florence/hurricane-florence_00000015_pre_disaster.png,96,56,1,926,1022,150,206,1596,54.836479950162115,41.80990558100065
15447,/media/marda/TWOTB1/xBD/hurricanes/images/florence/hurricane-florence_00000015_pre_disaster.png,87,53,1,694,781,170,223,1448,53.21819214772163,38.053467762682764
15448,/media/marda/TWOTB1/xBD/hurricanes/images/florence/hurricane-florence_00000015_pre_disaster.png,88,53,1,874,962,180,233,1443,49.138997231972354,38.49967256908815
15449,/media/marda/TWOTB1/xBD/hurricanes/images/florence/hurricane-florence_00000015_pre_disaster.png,79,59,1,578,657,183,242,1664,55.51220702433363,40.26942806476018
15450,/media/marda/TWOTB1/xBD/hurricanes/images/florence/hurricane-florence_00000015_pre_disaster.png,69,70,1,390,459,185,255,1699,60.27852435270705,46.49890208647236
15451,/media/marda/TWOTB1/xBD/hurricanes/images/florence/hurricane-florence_00000015_pre_disaster.png,81,103,1,642,723,201,304,2436,90.35257695233415,43.47812159219787
15452,/media/marda/TWOTB1/xBD/hurricanes/images/florence/hurricane-florence_00000015_pre_disaster.png,92,81,1,840,932,222,303,2071,66.40359265656443,43.983484815841486
15453,/media/marda/TWOTB1/xBD/hurricanes/images/florence/hurricane-florence_00000015_pre_disaster.png,70,56,1,459,529,250,306,1460,48.09739087288065,40.71256494847169
15454,/media/marda/TWOTB1/xBD/hurricanes/images/florence/hurricane-florence_00000015_pre_disaster.png,84,72,1,787,871,258,330,1570,62.1346440275099,36.321667895855015
15455,/media/marda/TWOTB1/xBD/hurricanes/images/florence/hurricane-florence_00000015_pre_disaster.png,67,67,1,260,327,285,352,1722,56.32588042900121,49.67544994903261
15456,/media/marda/TWOTB1/xBD/hurricanes/images/florence/hurricane-florence_00000015_pre_disaster.png,75,61,1,509,584,293,354,1563,53.69603458809636,39.546650289367946
15457,/media/marda/TWOTB1/xBD/hurricanes/images/florence/hurricane-florence_00000015_pre_disaster.png,81,86,1,159,240,301,387,2415,82.5282492796787,40.21716728322478
15458,/media/marda/TWOTB1/xBD/hurricanes/images/florence/hurricane-florence_00000015_pre_disaster.png,78,67,1,749,827,312,379,1308,48.10098976517097,38.60139369863134
15459,/media/marda/TWOTB1/xBD/hurricanes/images/florence/hurricane-florence_00000015_pre_disaster.png,66,64,1,601,667,345,409,1021,56.126992363636944,24.28457777041661
15460,/media/marda/TWOTB1/xBD/hurricanes/images/florence/hurricane-florence_00000015_pre_disaster.png,69,70,1,308,377,349,419,1609,59.83892773822774,35.888125998377646
15461,/media/marda/TWOTB1/xBD/hurricanes/images/florence/hurricane-florence_00000015_pre_disaster.png,85,68,1,709,794,376,444,1703,52.32136877546066,45.66077827621157
15462,/media/marda/TWOTB1/xBD/hurricanes/images/florence/hurricane-florence_00000015_pre_disaster.png,78,68,1,542,620,388,456,1472,56.50267439797148,36.59722955483766
15463,/media/marda/TWOTB1/xBD/hurricanes/images/florence/hurricane-florence_00000015_pre_disaster.png,52,65,1,36,88,394,459,1208,48.916090593331425,33.63583696419966
15464,/media/marda/TWOTB1/xBD/hurricanes/images/florence/hurricane-florence_00000015_pre_disaster.png,71,73,1,361,432,401,474,1546,59.822878131275125,36.393490210589306
15465,/media/marda/TWOTB1/xBD/hurricanes/images/florence/hurricane-florence_00000015_pre_disaster.png,53,76,1,170,223,406,482,1322,57.3130215745438,34.19756930229845
15466,/media/marda/TWOTB1/xBD/hurricanes/images/florence/hurricane-florence_00000015_pre_disaster.png,48,71,1,63,111,419,490,1255,47.37846011644794,36.38973068108715
15467,/media/marda/TWOTB1/xBD/hurricanes/images/florence/hurricane-florence_00000015_pre_disaster.png,77,80,1,677,754,420,500,1603,62.28437151208736,35.405601205905064
15468,/media/marda/TWOTB1/xBD/hurricanes/images/florence/hurricane-florence_00000015_pre_disaster.png,56,60,1,89,145,452,512,1186,47.307235423079476,34.30913478289473
15469,/media/marda/TWOTB1/xBD/hurricanes/images/florence/hurricane-florence_00000015_pre_disaster.png,92,73,1,504,596,452,525,1981,68.9748662442961,42.739473268042424
15470,/media/marda/TWOTB1/xBD/hurricanes/images/florence/hurricane-florence_00000015_pre_disaster.png,57,73,1,430,487,454,527,1070,53.96277254751471,33.0754975586854
15471,/media/marda/TWOTB1/xBD/hurricanes/images/florence/hurricane-florence_00000015_pre_disaster.png,73,69,1,230,303,456,525,1680,60.712268382072736,38.64885017475434
15472,/media/marda/TWOTB1/xBD/hurricanes/images/florence/hurricane-florence_00000015_pre_disaster.png,19,50,1,0,19,464,514,337,31.18480324245533,15.544998407407904
15473,/media/marda/TWOTB1/xBD/hurricanes/images/florence/hurricane-florence_00000015_pre_disaster.png,48,70,1,121,169,476,546,1193,48.60083831242679,34.34673172886419
15474,/media/marda/TWOTB1/xBD/hurricanes/images/florence/hurricane-florence_00000015_pre_disaster.png,77,65,1,651,728,479,544,1410,46.373267992243576,41.23444085160455
15475,/media/marda/TWOTB1/xBD/hurricanes/images/florence/hurricane-florence_00000015_pre_disaster.png,62,65,1,281,343,494,559,1206,45.886622039667216,37.33049076354807
15476,/media/marda/TWOTB1/xBD/hurricanes/images/florence/hurricane-florence_00000015_pre_disaster.png,64,75,1,477,541,506,581,1325,53.07228899502265,35.22709518796602
15477,/media/marda/TWOTB1/xBD/hurricanes/images/florence/hurricane-florence_00000015_pre_disaster.png,62,59,1,143,205,509,568,1169,50.25587454064806,31.418663200597123
15478,/media/marda/TWOTB1/xBD/hurricanes/images/florence/hurricane-florence_00000015_pre_disaster.png,100,80,1,717,817,517,597,1987,67.5722100859591,44.78916490983234
15479,/media/marda/TWOTB1/xBD/hurricanes/images/florence/hurricane-florence_00000015_pre_disaster.png,53,63,1,177,230,538,601,1045,42.66287548341812,32.578712842170326
15480,/media/marda/TWOTB1/xBD/hurricanes/images/florence/hurricane-florence_00000015_pre_disaster.png,60,68,1,337,397,541,609,1121,47.25001752424581,33.467487547600975
15481,/media/marda/TWOTB1/xBD/hurricanes/images/florence/hurricane-florence_00000015_pre_disaster.png,48,65,1,211,259,565,630,936,39.00903329809772,34.89113277414419
15482,/media/marda/TWOTB1/xBD/hurricanes/images/florence/hurricane-florence_00000015_pre_disaster.png,49,67,1,91,140,575,642,1063,48.254683415198905,29.565056269715402
15483,/media/marda/TWOTB1/xBD/hurricanes/images/florence/hurricane-florence_00000015_pre_disaster.png,89,68,1,584,673,579,647,1693,63.15987473279804,39.79820017036135
15484,/media/marda/TWOTB1/xBD/hurricanes/images/florence/hurricane-florence_00000015_pre_disaster.png,95,73,1,775,870,583,656,1567,61.30548694975055,39.23922224522748
15485,/media/marda/TWOTB1/xBD/hurricanes/images/florence/hurricane-florence_00000015_pre_disaster.png,52,74,1,236,288,588,662,1137,45.223897406494046,34.330924432705544
15486,/media/marda/TWOTB1/xBD/hurricanes/images/florence/hurricane-florence_00000015_pre_disaster.png,63,88,1,416,479,600,688,1545,62.48920200431445,35.44554358894103
15487,/media/marda/TWOTB1/xBD/hurricanes/images/florence/hurricane-florence_00000015_pre_disaster.png,47,78,1,45,92,603,681,1246,49.16820289863066,34.93390547974349
15488,/media/marda/TWOTB1/xBD/hurricanes/images/florence/hurricane-florence_00000015_pre_disaster.png,45,69,1,119,164,609,678,1002,40.91928843828814,32.60856953291832
15489,/media/marda/TWOTB1/xBD/hurricanes/images/florence/hurricane-florence_00000015_pre_disaster.png,57,68,1,265,322,617,685,1075,44.52094415193386,32.84455388855807
15490,/media/marda/TWOTB1/xBD/hurricanes/images/florence/hurricane-florence_00000015_pre_disaster.png,83,87,1,640,723,624,711,1722,56.52095238216518,46.01197199256846
15491,/media/marda/TWOTB1/xBD/hurricanes/images/florence/hurricane-florence_00000015_pre_disaster.png,85,70,1,819,904,628,698,1224,49.37872074741399,33.78394134979811
15492,/media/marda/TWOTB1/xBD/hurricanes/images/florence/hurricane-florence_00000015_pre_disaster.png,79,88,1,533,612,631,719,1742,67.49415952909501,38.251826211412165
15493,/media/marda/TWOTB1/xBD/hurricanes/images/florence/hurricane-florence_00000015_pre_disaster.png,38,63,1,154,192,637,700,668,36.12666691133911,25.419547730898262
15494,/media/marda/TWOTB1/xBD/hurricanes/images/florence/hurricane-florence_00000015_pre_disaster.png,54,66,1,70,124,647,713,1225,47.00605473973161,35.14656166655139
15495,/media/marda/TWOTB1/xBD/hurricanes/images/florence/hurricane-florence_00000015_pre_disaster.png,67,61,1,285,352,656,717,1278,56.16068572089863,30.825608047977063
15496,/media/marda/TWOTB1/xBD/hurricanes/images/florence/hurricane-florence_00000015_pre_disaster.png,52,76,1,380,432,659,735,1006,48.091251572779285,30.20264381236155
15497,/media/marda/TWOTB1/xBD/hurricanes/images/florence/hurricane-florence_00000015_pre_disaster.png,49,70,1,169,218,674,744,1057,47.40839555530809,29.28438116461212
15498,/media/marda/TWOTB1/xBD/hurricanes/images/florence/hurricane-florence_00000015_pre_disaster.png,48,64,1,94,142,681,745,944,40.24918384672625,32.40527546886587
15499,/media/marda/TWOTB1/xBD/hurricanes/images/florence/hurricane-florence_00000015_pre_disaster.png,86,77,1,860,946,682,759,1225,60.35080427057972,26.90413238883511
15500,/media/marda/TWOTB1/xBD/hurricanes/images/florence/hurricane-florence_00000015_pre_disaster.png,79,84,1,687,766,683,767,1656,60.80003553022665,36.138176489589696
15501,/media/marda/TWOTB1/xBD/hurricanes/images/florence/hurricane-florence_00000015_pre_disaster.png,56,70,1,270,326,693,763,964,39.854631374303366,32.39291686516981
15502,/media/marda/TWOTB1/xBD/hurricanes/images/florence/hurricane-florence_00000015_pre_disaster.png,67,82,1,498,565,696,778,1515,51.73426218271972,40.20242368337575
15503,/media/marda/TWOTB1/xBD/hurricanes/images/florence/hurricane-florence_00000015_pre_disaster.png,11,46,1,0,11,700,746,103,16.42859601039724,9.003366439475641
15504,/media/marda/TWOTB1/xBD/hurricanes/images/florence/hurricane-florence_00000015_pre_disaster.png,45,68,1,0,45,709,777,1058,48.72695972554941,28.511856833367013
15505,/media/marda/TWOTB1/xBD/hurricanes/images/florence/hurricane-florence_00000015_pre_disaster.png,46,64,1,127,173,713,777,1104,49.61823957186944,31.517117824878405
15506,/media/marda/TWOTB1/xBD/hurricanes/images/florence/hurricane-florence_00000015_pre_disaster.png,62,85,1,348,410,717,802,1395,56.19833335386909,34.35039713009011
15507,/media/marda/TWOTB1/xBD/hurricanes/images/florence/hurricane-florence_00000015_pre_disaster.png,51,72,1,249,300,719,791,935,40.178475076947635,31.319887099778004
15508,/media/marda/TWOTB1/xBD/hurricanes/images/florence/hurricane-florence_00000015_pre_disaster.png,43,77,1,17,60,731,808,1185,48.31862836897154,32.89931450946752
15509,/media/marda/TWOTB1/xBD/hurricanes/images/florence/hurricane-florence_00000015_pre_disaster.png,76,83,1,587,663,733,816,1447,57.33857923183217,34.8445283094422
15510,/media/marda/TWOTB1/xBD/hurricanes/images/florence/hurricane-florence_00000015_pre_disaster.png,93,89,1,731,824,736,825,1841,55.32425900546038,50.47769103701007
15511,/media/marda/TWOTB1/xBD/hurricanes/images/florence/hurricane-florence_00000015_pre_disaster.png,101,71,1,892,993,740,811,1519,61.40848989600858,34.62874732778475
15512,/media/marda/TWOTB1/xBD/hurricanes/images/florence/hurricane-florence_00000015_pre_disaster.png,77,101,1,202,279,743,844,2290,93.27342312730512,41.157934078374694
15513,/media/marda/TWOTB1/xBD/hurricanes/images/florence/hurricane-florence_00000015_pre_disaster.png,39,56,1,295,334,761,817,399,26.510026909114732,20.112774016712017
15514,/media/marda/TWOTB1/xBD/hurricanes/images/florence/hurricane-florence_00000015_pre_disaster.png,43,72,1,37,80,763,835,1058,42.65420373359498,32.89992580793352
15515,/media/marda/TWOTB1/xBD/hurricanes/images/florence/hurricane-florence_00000015_pre_disaster.png,93,92,1,942,1035,771,863,1635,62.63415536411067,36.25586577690629
15516,/media/marda/TWOTB1/xBD/hurricanes/images/florence/hurricane-florence_00000015_pre_disaster.png,65,83,1,296,361,773,856,1432,58.904937678872486,31.967618680925803
15517,/media/marda/TWOTB1/xBD/hurricanes/images/florence/hurricane-florence_00000015_pre_disaster.png,90,88,1,780,870,776,864,1820,59.44642447270167,43.97262291023856
15518,/media/marda/TWOTB1/xBD/hurricanes/images/florence/hurricane-florence_00000015_pre_disaster.png,38,77,1,59,97,792,869,876,43.493096292757286,28.43883012881701
15519,/media/marda/TWOTB1/xBD/hurricanes/images/florence/hurricane-florence_00000015_pre_disaster.png,80,90,1,440,520,792,882,1807,57.90054208190578,44.02050535621283
15520,/media/marda/TWOTB1/xBD/hurricanes/images/florence/hurricane-florence_00000015_pre_disaster.png,79,87,1,643,722,811,898,1248,62.33442997606257,26.779319058197856
15521,/media/marda/TWOTB1/xBD/hurricanes/images/florence/hurricane-florence_00000015_pre_disaster.png,61,72,1,208,269,816,888,1321,51.8561567560756,35.703221683318965
15522,/media/marda/TWOTB1/xBD/hurricanes/images/florence/hurricane-florence_00000015_pre_disaster.png,55,81,1,77,132,818,899,1415,46.98329815420816,40.12822829041732
15523,/media/marda/TWOTB1/xBD/hurricanes/images/florence/hurricane-florence_00000015_pre_disaster.png,81,90,1,823,904,823,913,1406,54.232854444222106,35.16080336690529
15524,/media/marda/TWOTB1/xBD/hurricanes/images/florence/hurricane-florence_00000015_pre_disaster.png,59,80,1,985,1044,827,907,493,42.81566418004275,17.119002397995583
15525,/media/marda/TWOTB1/xBD/hurricanes/images/florence/hurricane-florence_00000015_pre_disaster.png,72,97,1,392,464,844,941,1861,60.52549033459649,43.689260294811795
15526,/media/marda/TWOTB1/xBD/hurricanes/images/florence/hurricane-florence_00000015_pre_disaster.png,45,83,1,103,148,846,929,1154,48.7852941206939,32.230701107425254
15527,/media/marda/TWOTB1/xBD/hurricanes/images/florence/hurricane-florence_00000015_pre_disaster.png,48,77,1,131,179,871,948,1089,41.96134893860842,35.11918507812916
15528,/media/marda/TWOTB1/xBD/hurricanes/images/florence/hurricane-florence_00000015_pre_disaster.png,89,93,1,867,956,875,968,1529,63.47254075078494,34.609451380911054
15529,/media/marda/TWOTB1/xBD/hurricanes/images/florence/hurricane-florence_00000015_pre_disaster.png,71,69,1,593,664,896,965,1119,49.42192950908542,30.354306879816026
15530,/media/marda/TWOTB1/xBD/hurricanes/images/florence/hurricane-florence_00000015_pre_disaster.png,44,78,1,148,192,904,982,896,37.21492510197518,32.4266693093627
15531,/media/marda/TWOTB1/xBD/hurricanes/images/florence/hurricane-florence_00000015_pre_disaster.png,91,96,1,906,997,924,1020,1520,64.86947785431964,31.18631035745104
15532,/media/marda/TWOTB1/xBD/hurricanes/images/florence/hurricane-florence_00000015_pre_disaster.png,50,86,1,162,212,940,1026,1153,47.146436516663684,33.6433621025695
15533,/media/marda/TWOTB1/xBD/hurricanes/images/florence/hurricane-florence_00000015_pre_disaster.png,90,64,1,938,1028,978,1042,780,44.33131111603839,26.22836084450732
15534,/media/marda/TWOTB1/xBD/hurricanes/images/florence/hurricane-florence_00000197_post_disaster.png,40,39,1,734,774,402,441,230,26.698225911331694,11.469636405503598
15535,/media/marda/TWOTB1/xBD/hurricanes/images/florence/hurricane-florence_00000197_post_disaster.png,59,69,1,774,833,435,504,1288,59.254687228952065,29.92126248690128
15536,/media/marda/TWOTB1/xBD/hurricanes/images/florence/hurricane-florence_00000197_post_disaster.png,39,25,1,801,840,453,478,57,9.418308044861673,8.047699319587153
15537,/media/marda/TWOTB1/xBD/hurricanes/images/florence/hurricane-florence_00000197_post_disaster.png,37,30,1,665,702,478,508,152,14.69323779199841,13.856607723112534
15538,/media/marda/TWOTB1/xBD/hurricanes/images/florence/hurricane-florence_00000197_post_disaster.png,41,30,1,792,833,515,545,90,11.489125293076057,10.327955589886445
15539,/media/marda/TWOTB1/xBD/hurricanes/images/florence/hurricane-florence_00000197_post_disaster.png,52,68,1,647,699,516,584,949,49.38618530270488,25.08649159251831
15540,/media/marda/TWOTB1/xBD/hurricanes/images/florence/hurricane-florence_00000197_post_disaster.png,80,60,1,558,638,519,579,1536,60.25790876618426,33.65152364929682
15541,/media/marda/TWOTB1/xBD/hurricanes/images/florence/hurricane-florence_00000197_post_disaster.png,58,49,1,676,734,525,574,470,31.335571564961533,19.866447688049085
15542,/media/marda/TWOTB1/xBD/hurricanes/images/florence/hurricane-florence_00000197_post_disaster.png,48,53,1,517,565,556,609,411,35.266625691060106,15.565580246603423
15543,/media/marda/TWOTB1/xBD/hurricanes/images/florence/hurricane-florence_00000314_pre_disaster.png,33,13,1,192,225,0,13,181,23.202209839505894,12.03054626886763
15544,/media/marda/TWOTB1/xBD/hurricanes/images/florence/hurricane-florence_00000314_pre_disaster.png,12,25,1,0,12,21,46,156,21.602468994692867,11.06789755755402
15545,/media/marda/TWOTB1/xBD/hurricanes/images/florence/hurricane-florence_00000314_pre_disaster.png,58,19,1,891,949,21,40,202,21.91988075558653,12.3229091090442
15546,/media/marda/TWOTB1/xBD/hurricanes/images/florence/hurricane-florence_00000314_pre_disaster.png,72,44,1,868,940,47,91,722,45.75284766540002,25.10569278157077
15547,/media/marda/TWOTB1/xBD/hurricanes/images/florence/hurricane-florence_00000136_post_disaster.png,70,57,1,973,1043,550,607,799,36.830760869723925,28.961222644699923
15548,/media/marda/TWOTB1/xBD/hurricanes/images/florence/hurricane-florence_00000136_post_disaster.png,67,47,1,900,967,569,616,446,30.924250133141182,19.172071619085795
15549,/media/marda/TWOTB1/xBD/hurricanes/images/florence/hurricane-florence_00000337_post_disaster.png,52,58,1,422,474,340,398,923,47.22762701965762,26.09414194447562
15550,/media/marda/TWOTB1/xBD/hurricanes/images/florence/hurricane-florence_00000337_post_disaster.png,36,38,1,147,183,386,424,459,34.830860326340385,18.101978410143634
15551,/media/marda/TWOTB1/xBD/hurricanes/images/florence/hurricane-florence_00000337_post_disaster.png,61,48,1,269,330,398,446,865,55.03800164173448,20.982974339488607
15552,/media/marda/TWOTB1/xBD/hurricanes/images/florence/hurricane-florence_00000337_post_disaster.png,58,46,1,477,535,408,454,782,39.35289926083516,27.142161483554602
15553,/media/marda/TWOTB1/xBD/hurricanes/images/florence/hurricane-florence_00000337_post_disaster.png,34,59,1,167,201,412,471,803,45.00220880081479,23.770887101113175
15554,/media/marda/TWOTB1/xBD/hurricanes/images/florence/hurricane-florence_00000337_post_disaster.png,51,51,1,490,541,440,491,726,32.81315921907853,29.206521577461757
15555,/media/marda/TWOTB1/xBD/hurricanes/images/florence/hurricane-florence_00000337_post_disaster.png,38,34,1,420,458,460,494,289,23.372854799755896,16.580449944649413
15556,/media/marda/TWOTB1/xBD/hurricanes/images/florence/hurricane-florence_00000337_post_disaster.png,60,71,1,499,559,522,593,1129,52.49219002287832,29.314184007990672
15557,/media/marda/TWOTB1/xBD/hurricanes/images/florence/hurricane-florence_00000337_post_disaster.png,47,86,1,283,330,568,654,1362,71.75659600692273,25.996652754473892
15558,/media/marda/TWOTB1/xBD/hurricanes/images/florence/hurricane-florence_00000337_post_disaster.png,47,68,1,528,575,586,654,596,53.88929500992743,14.786196268903145
15559,/media/marda/TWOTB1/xBD/hurricanes/images/florence/hurricane-florence_00000337_post_disaster.png,44,46,1,635,679,801,847,150,21.19261606668809,9.532361362162199
15560,/media/marda/TWOTB1/xBD/hurricanes/images/florence/hurricane-florence_00000337_post_disaster.png,61,51,1,634,695,812,863,460,39.61294910428876,15.308570641790059
15561,/media/marda/TWOTB1/xBD/hurricanes/images/florence/hurricane-florence_00000337_post_disaster.png,54,97,1,351,405,825,922,1446,70.71035565499116,27.956500574675978
15562,/media/marda/TWOTB1/xBD/hurricanes/images/florence/hurricane-florence_00000216_pre_disaster.png,26,18,1,400,426,91,109,150,18.16518364929213,11.103175356063236
15563,/media/marda/TWOTB1/xBD/hurricanes/images/florence/hurricane-florence_00000216_pre_disaster.png,65,38,1,564,629,114,152,776,43.81110770945383,24.085936896935245
15564,/media/marda/TWOTB1/xBD/hurricanes/images/florence/hurricane-florence_00000216_pre_disaster.png,35,48,1,3,38,138,186,876,39.42404111677091,31.888066990468076
15565,/media/marda/TWOTB1/xBD/hurricanes/images/florence/hurricane-florence_00000216_pre_disaster.png,42,46,1,406,448,140,186,775,44.083977823743616,23.478186492211197
15566,/media/marda/TWOTB1/xBD/hurricanes/images/florence/hurricane-florence_00000216_pre_disaster.png,38,30,1,539,577,167,197,235,29.830727883505734,14.258812397237635
15567,/media/marda/TWOTB1/xBD/hurricanes/images/florence/hurricane-florence_00000216_pre_disaster.png,64,62,1,573,637,192,254,1569,60.32210431392044,34.64604968537675
15568,/media/marda/TWOTB1/xBD/hurricanes/images/florence/hurricane-florence_00000216_pre_disaster.png,41,64,1,103,144,317,381,792,57.8847841095469,19.91744371711002
15569,/media/marda/TWOTB1/xBD/hurricanes/images/florence/hurricane-florence_00000216_pre_disaster.png,34,32,1,164,198,479,511,293,32.34711113292184,12.129636746176587
15570,/media/marda/TWOTB1/xBD/hurricanes/images/florence/hurricane-florence_00000216_pre_disaster.png,42,43,1,343,385,484,527,537,29.66104973908296,24.192446641495717
15571,/media/marda/TWOTB1/xBD/hurricanes/images/florence/hurricane-florence_00000216_pre_disaster.png,44,32,1,67,111,505,537,369,48.96401154839759,10.129817601625872
15572,/media/marda/TWOTB1/xBD/hurricanes/images/florence/hurricane-florence_00000216_pre_disaster.png,53,79,1,426,479,521,600,1257,61.618680705212945,27.2207595706022
15573,/media/marda/TWOTB1/xBD/hurricanes/images/florence/hurricane-florence_00000216_pre_disaster.png,40,40,1,266,306,524,564,306,32.84250409621125,12.466320242020966
15574,/media/marda/TWOTB1/xBD/hurricanes/images/florence/hurricane-florence_00000216_pre_disaster.png,47,49,1,152,199,562,611,821,46.16105955800494,23.730009391561634
15575,/media/marda/TWOTB1/xBD/hurricanes/images/florence/hurricane-florence_00000216_pre_disaster.png,44,41,1,395,439,568,609,333,28.02635150484179,15.919106101418413
15576,/media/marda/TWOTB1/xBD/hurricanes/images/florence/hurricane-florence_00000216_pre_disaster.png,59,57,1,318,377,623,680,921,49.14940831126117,25.01243869569053
15577,/media/marda/TWOTB1/xBD/hurricanes/images/florence/hurricane-florence_00000216_pre_disaster.png,53,39,1,229,282,668,707,437,50.24202983284251,11.601939396916036
15578,/media/marda/TWOTB1/xBD/hurricanes/images/florence/hurricane-florence_00000216_pre_disaster.png,45,47,1,415,460,765,812,420,31.986453632222837,17.605617259566557
15579,/media/marda/TWOTB1/xBD/hurricanes/images/florence/hurricane-florence_00000216_pre_disaster.png,51,76,1,484,535,767,843,956,51.860991524091006,24.601814437543677
15580,/media/marda/TWOTB1/xBD/hurricanes/images/florence/hurricane-florence_00000216_pre_disaster.png,55,51,1,52,107,833,884,511,60.8951236410068,11.233004241276394
15581,/media/marda/TWOTB1/xBD/hurricanes/images/florence/hurricane-florence_00000216_pre_disaster.png,40,67,1,293,333,975,1042,617,35.28657594167387,23.415298570182905
15582,/media/marda/TWOTB1/xBD/hurricanes/images/florence/hurricane-florence_00000419_post_disaster.png,22,47,1,19,41,70,117,1024,53.75404742802571,25.35959411196346
15583,/media/marda/TWOTB1/xBD/hurricanes/images/florence/hurricane-florence_00000419_post_disaster.png,24,27,1,276,300,110,137,329,24.377609211930086,17.748948495214478
15584,/media/marda/TWOTB1/xBD/hurricanes/images/florence/hurricane-florence_00000419_post_disaster.png,19,37,1,246,265,114,151,346,38.09364405428395,12.099908206507576
15585,/media/marda/TWOTB1/xBD/hurricanes/images/florence/hurricane-florence_00000419_post_disaster.png,20,38,1,258,278,114,152,397,38.19216883234985,13.834425240986231
15586,/media/marda/TWOTB1/xBD/hurricanes/images/florence/hurricane-florence_00000419_post_disaster.png,17,39,1,2,19,189,228,562,39.323940164607976,19.066154117619774
15587,/media/marda/TWOTB1/xBD/hurricanes/images/florence/hurricane-florence_00000419_post_disaster.png,42,30,1,281,323,283,313,617,36.459315551244295,22.62323334046466
15588,/media/marda/TWOTB1/xBD/hurricanes/images/florence/hurricane-florence_00000106_post_disaster.png,36,33,1,173,209,29,62,492,29.94899888690166,21.97241884824649
15589,/media/marda/TWOTB1/xBD/hurricanes/images/florence/hurricane-florence_00000106_post_disaster.png,35,37,1,111,146,62,99,603,35.07225259107344,22.821453328631122
15590,/media/marda/TWOTB1/xBD/hurricanes/images/florence/hurricane-florence_00000106_post_disaster.png,15,15,1,51,66,70,85,124,14.129095524095195,11.813909240994192
15591,/media/marda/TWOTB1/xBD/hurricanes/images/florence/hurricane-florence_00000106_post_disaster.png,55,57,1,43,98,106,163,1610,50.396480521818454,46.08545388596618
15592,/media/marda/TWOTB1/xBD/hurricanes/images/florence/hurricane-florence_00000106_post_disaster.png,89,57,1,491,580,240,297,1976,72.01471989859016,37.55866880185762
15593,/media/marda/TWOTB1/xBD/hurricanes/images/florence/hurricane-florence_00000106_post_disaster.png,70,60,1,593,663,269,329,1299,44.171285197407094,38.94334571592166
15594,/media/marda/TWOTB1/xBD/hurricanes/images/florence/hurricane-florence_00000106_post_disaster.png,84,67,1,834,918,314,381,1441,56.16910243539477,35.255869342551875
15595,/media/marda/TWOTB1/xBD/hurricanes/images/florence/hurricane-florence_00000106_post_disaster.png,44,48,1,349,393,475,523,534,29.765131426767518,24.209706600389854
15596,/media/marda/TWOTB1/xBD/hurricanes/images/florence/hurricane-florence_00000106_post_disaster.png,75,88,1,278,353,485,573,2573,68.78196226847982,50.39633585532013
15597,/media/marda/TWOTB1/xBD/hurricanes/images/florence/hurricane-florence_00000106_post_disaster.png,59,69,1,451,510,552,621,1116,47.56437629274488,31.435912352680436
15598,/media/marda/TWOTB1/xBD/hurricanes/images/florence/hurricane-florence_00000106_post_disaster.png,37,43,1,402,439,582,625,261,23.38054382929062,14.875173346857492
15599,/media/marda/TWOTB1/xBD/hurricanes/images/florence/hurricane-florence_00000106_post_disaster.png,40,58,1,361,401,697,755,454,28.63427438779038,20.97293504427
15600,/media/marda/TWOTB1/xBD/hurricanes/images/florence/hurricane-florence_00000350_pre_disaster.png,86,29,1,953,1039,0,29,894,52.151972491354485,24.858737498067537
15601,/media/marda/TWOTB1/xBD/hurricanes/images/florence/hurricane-florence_00000350_pre_disaster.png,59,18,1,928,987,31,49,295,24.65480429886255,16.01192814827688
15602,/media/marda/TWOTB1/xBD/hurricanes/images/florence/hurricane-florence_00000350_pre_disaster.png,89,48,1,823,912,46,94,1576,60.477244571159495,34.767186955990496
15603,/media/marda/TWOTB1/xBD/hurricanes/images/florence/hurricane-florence_00000350_pre_disaster.png,56,18,1,881,937,56,74,266,22.4252175394813,15.779925573914856
15604,/media/marda/TWOTB1/xBD/hurricanes/images/florence/hurricane-florence_00000350_pre_disaster.png,88,36,1,912,1000,70,106,1312,55.03677064469585,33.06646106229974
15605,/media/marda/TWOTB1/xBD/hurricanes/images/florence/hurricane-florence_00000350_pre_disaster.png,56,26,1,857,913,116,142,270,19.916897910961602,18.127086133143614
15606,/media/marda/TWOTB1/xBD/hurricanes/images/florence/hurricane-florence_00000350_pre_disaster.png,53,20,1,888,941,125,145,241,18.916875136410727,17.01688269948171
15607,/media/marda/TWOTB1/xBD/hurricanes/images/florence/hurricane-florence_00000350_pre_disaster.png,64,27,1,960,1024,127,154,522,27.68827137154094,25.135300191528998
15608,/media/marda/TWOTB1/xBD/hurricanes/images/florence/hurricane-florence_00000350_pre_disaster.png,43,17,1,694,737,170,187,181,17.362951257540384,13.898902512096015
15609,/media/marda/TWOTB1/xBD/hurricanes/images/florence/hurricane-florence_00000350_pre_disaster.png,78,22,1,953,1031,172,194,590,45.21253321308984,17.42790650654894
15610,/media/marda/TWOTB1/xBD/hurricanes/images/florence/hurricane-florence_00000350_pre_disaster.png,169,55,1,722,891,175,230,5828,160.2274434525232,48.511343871482936
15611,/media/marda/TWOTB1/xBD/hurricanes/images/florence/hurricane-florence_00000350_pre_disaster.png,171,101,1,554,725,178,279,6307,160.9678556485118,52.17050196420993
15612,/media/marda/TWOTB1/xBD/hurricanes/images/florence/hurricane-florence_00000350_pre_disaster.png,76,32,1,953,1029,197,229,895,41.02678562536708,28.4852433204177
15613,/media/marda/TWOTB1/xBD/hurricanes/images/florence/hurricane-florence_00000350_pre_disaster.png,56,47,1,342,398,236,283,1173,44.812639214790785,34.625393792110536
15614,/media/marda/TWOTB1/xBD/hurricanes/images/florence/hurricane-florence_00000350_pre_disaster.png,65,41,1,958,1023,238,279,795,36.67613553379303,28.888119860584883
15615,/media/marda/TWOTB1/xBD/hurricanes/images/florence/hurricane-florence_00000350_pre_disaster.png,36,27,1,458,494,251,278,326,22.300337194297523,19.549414917007557
15616,/media/marda/TWOTB1/xBD/hurricanes/images/florence/hurricane-florence_00000350_pre_disaster.png,158,59,1,755,913,276,335,5473,143.4063524998317,50.615206035625945
15617,/media/marda/TWOTB1/xBD/hurricanes/images/florence/hurricane-florence_00000350_pre_disaster.png,50,59,1,455,505,279,338,1486,56.04192463642901,35.27335398142633
15618,/media/marda/TWOTB1/xBD/hurricanes/images/florence/hurricane-florence_00000350_pre_disaster.png,69,62,1,619,688,297,359,1264,52.12083660622499,32.64010050007239
15619,/media/marda/TWOTB1/xBD/hurricanes/images/florence/hurricane-florence_00000350_pre_disaster.png,81,42,1,950,1031,325,367,1053,47.94333863975516,29.66825817789545
15620,/media/marda/TWOTB1/xBD/hurricanes/images/florence/hurricane-florence_00000350_pre_disaster.png,59,50,1,918,977,338,388,764,40.94896545878365,24.820729382240966
15621,/media/marda/TWOTB1/xBD/hurricanes/images/florence/hurricane-florence_00000350_pre_disaster.png,32,39,1,8,40,402,441,596,34.96824021017449,23.46454000729472
15622,/media/marda/TWOTB1/xBD/hurricanes/images/florence/hurricane-florence_00000350_pre_disaster.png,34,39,1,84,118,414,453,724,36.36884968056355,26.523555826598066
15623,/media/marda/TWOTB1/xBD/hurricanes/images/florence/hurricane-florence_00000350_pre_disaster.png,59,50,1,856,915,431,481,809,37.62504225873571,28.741569045972792
15624,/media/marda/TWOTB1/xBD/hurricanes/images/florence/hurricane-florence_00000350_pre_disaster.png,66,49,1,894,960,440,489,870,38.603516830168,30.732514926016954
15625,/media/marda/TWOTB1/xBD/hurricanes/images/florence/hurricane-florence_00000350_pre_disaster.png,96,94,1,931,1027,480,574,2199,102.75307305495433,41.82120238084831
15626,/media/marda/TWOTB1/xBD/hurricanes/images/florence/hurricane-florence_00000350_pre_disaster.png,33,43,1,0,33,485,528,698,37.48662821216214,24.87336920609106
15627,/media/marda/TWOTB1/xBD/hurricanes/images/florence/hurricane-florence_00000350_pre_disaster.png,73,61,1,485,558,492,553,1310,61.734381640354705,33.044486020425246
15628,/media/marda/TWOTB1/xBD/hurricanes/images/florence/hurricane-florence_00000350_pre_disaster.png,37,44,1,538,575,528,572,358,26.737459427181676,17.874271658127224
15629,/media/marda/TWOTB1/xBD/hurricanes/images/florence/hurricane-florence_00000350_pre_disaster.png,42,60,1,514,556,808,868,561,30.132636684458795,24.886864170893976
15630,/media/marda/TWOTB1/xBD/hurricanes/images/florence/hurricane-florence_00000350_pre_disaster.png,55,53,1,848,903,819,872,425,25.830438295330612,21.803862155039468
15631,/media/marda/TWOTB1/xBD/hurricanes/images/florence/hurricane-florence_00000350_pre_disaster.png,60,82,1,372,432,826,908,1621,50.986003995839525,42.51721415999727
15632,/media/marda/TWOTB1/xBD/hurricanes/images/florence/hurricane-florence_00000350_pre_disaster.png,78,83,1,778,856,833,916,1791,56.55076499877427,45.15873956967123
15633,/media/marda/TWOTB1/xBD/hurricanes/images/florence/hurricane-florence_00000350_pre_disaster.png,63,73,1,437,500,834,907,1243,51.16212408970563,34.86024388179701
15634,/media/marda/TWOTB1/xBD/hurricanes/images/florence/hurricane-florence_00000350_pre_disaster.png,76,66,1,685,761,834,900,1278,55.669866297136416,31.97308308827953
15635,/media/marda/TWOTB1/xBD/hurricanes/images/florence/hurricane-florence_00000350_pre_disaster.png,69,68,1,869,938,839,907,1107,38.98834370419151,37.44485553248967
15636,/media/marda/TWOTB1/xBD/hurricanes/images/florence/hurricane-florence_00000350_pre_disaster.png,44,69,1,526,570,840,909,697,40.038547098072975,23.444538986876644
15637,/media/marda/TWOTB1/xBD/hurricanes/images/florence/hurricane-florence_00000350_pre_disaster.png,34,51,1,262,296,880,931,285,23.838072391112167,16.01777160050847
15638,/media/marda/TWOTB1/xBD/hurricanes/images/florence/hurricane-florence_00000350_pre_disaster.png,58,83,1,253,311,898,981,1189,46.286287781727566,34.327110346690816
15639,/media/marda/TWOTB1/xBD/hurricanes/images/florence/hurricane-florence_00000350_pre_disaster.png,61,86,1,205,266,955,1041,1397,50.44127966714347,37.73427651292897
15640,/media/marda/TWOTB1/xBD/hurricanes/images/florence/hurricane-florence_00000350_pre_disaster.png,78,73,1,526,604,969,1042,1801,63.27773056887828,38.01998671048413
15641,/media/marda/TWOTB1/xBD/hurricanes/images/florence/hurricane-florence_00000350_pre_disaster.png,86,63,1,669,755,979,1042,1296,64.45854817923102,26.972088403238743
15642,/media/marda/TWOTB1/xBD/hurricanes/images/florence/hurricane-florence_00000280_pre_disaster.png,29,68,1,0,29,403,471,856,47.19749554366468,26.433102109112962
15643,/media/marda/TWOTB1/xBD/hurricanes/images/florence/hurricane-florence_00000280_pre_disaster.png,58,52,1,727,785,452,504,1014,40.39153284723116,33.403778180184446
15644,/media/marda/TWOTB1/xBD/hurricanes/images/florence/hurricane-florence_00000280_pre_disaster.png,36,27,1,681,717,456,483,96,11.752700572540675,10.93140233593018
15645,/media/marda/TWOTB1/xBD/hurricanes/images/florence/hurricane-florence_00000280_pre_disaster.png,39,28,1,768,807,460,488,122,12.9082512688463,12.597163354905101
15646,/media/marda/TWOTB1/xBD/hurricanes/images/florence/hurricane-florence_00000280_pre_disaster.png,65,49,1,671,736,488,537,1191,41.81577137144599,38.11371621023872
15647,/media/marda/TWOTB1/xBD/hurricanes/images/florence/hurricane-florence_00000280_pre_disaster.png,49,48,1,709,758,538,586,449,29.25551136535532,20.158532005871237
15648,/media/marda/TWOTB1/xBD/hurricanes/images/florence/hurricane-florence_00000280_pre_disaster.png,60,63,1,740,800,538,601,972,46.44673331061703,27.777503509954197
15649,/media/marda/TWOTB1/xBD/hurricanes/images/florence/hurricane-florence_00000280_pre_disaster.png,13,37,1,63,76,619,656,115,13.216075877301542,11.608262002685356
15650,/media/marda/TWOTB1/xBD/hurricanes/images/florence/hurricane-florence_00000280_pre_disaster.png,11,51,1,0,11,621,672,157,23.659260672492106,10.146967787761517
15651,/media/marda/TWOTB1/xBD/hurricanes/images/florence/hurricane-florence_00000280_pre_disaster.png,31,54,1,57,88,639,693,601,30.33225971535496,25.95684671787274
15652,/media/marda/TWOTB1/xBD/hurricanes/images/florence/hurricane-florence_00000280_pre_disaster.png,37,82,1,0,37,674,756,1292,51.54234163436742,34.88248006761774
15653,/media/marda/TWOTB1/xBD/hurricanes/images/florence/hurricane-florence_00000280_pre_disaster.png,60,99,1,0,60,742,841,2439,69.43998486193777,47.52179228391349
15654,/media/marda/TWOTB1/xBD/hurricanes/images/florence/hurricane-florence_00000280_pre_disaster.png,85,116,1,0,85,811,927,3600,99.92750184221948,48.38756645997915
15655,/media/marda/TWOTB1/xBD/hurricanes/images/florence/hurricane-florence_00000280_pre_disaster.png,111,131,1,0,111,882,1013,4737,132.78763565060478,47.75062117288389
15656,/media/marda/TWOTB1/xBD/hurricanes/images/florence/hurricane-florence_00000135_pre_disaster.png,40,48,1,221,261,382,430,648,33.7708196703203,25.6340217169401
15657,/media/marda/TWOTB1/xBD/hurricanes/images/florence/hurricane-florence_00000135_pre_disaster.png,42,44,1,544,586,740,784,163,23.958010946439323,9.046794555139162
15658,/media/marda/TWOTB1/xBD/hurricanes/images/florence/hurricane-florence_00000135_pre_disaster.png,82,97,1,565,647,761,858,1604,82.33235866796134,28.171917857295977
15659,/media/marda/TWOTB1/xBD/hurricanes/images/florence/hurricane-florence_00000135_pre_disaster.png,25,44,1,144,169,883,927,150,21.814531249700092,9.262032637498118
15660,/media/marda/TWOTB1/xBD/hurricanes/images/florence/hurricane-florence_00000135_pre_disaster.png,82,87,1,636,718,906,993,1291,63.59434517174845,26.91164198023773
15661,/media/marda/TWOTB1/xBD/hurricanes/images/florence/hurricane-florence_00000380_pre_disaster.png,69,32,1,627,696,71,103,1045,48.45379618134195,28.787262493037094
15662,/media/marda/TWOTB1/xBD/hurricanes/images/florence/hurricane-florence_00000380_pre_disaster.png,145,56,1,818,963,118,174,3087,112.02518009158909,38.573382162521426
15663,/media/marda/TWOTB1/xBD/hurricanes/images/florence/hurricane-florence_00000380_pre_disaster.png,55,22,1,721,776,133,155,256,27.97443883905233,12.260801605732008
15664,/media/marda/TWOTB1/xBD/hurricanes/images/florence/hurricane-florence_00000380_pre_disaster.png,78,54,1,607,685,141,195,1806,59.82213872323104,43.05958418311077
15665,/media/marda/TWOTB1/xBD/hurricanes/images/florence/hurricane-florence_00000380_pre_disaster.png,50,20,1,924,974,147,167,173,16.74828249271996,13.636835228488502
15666,/media/marda/TWOTB1/xBD/hurricanes/images/florence/hurricane-florence_00000380_pre_disaster.png,48,17,1,676,724,151,168,178,26.042564859389966,9.477110305143494
15667,/media/marda/TWOTB1/xBD/hurricanes/images/florence/hurricane-florence_00000380_pre_disaster.png,95,51,1,667,762,196,247,1345,76.03607394092704,25.906212772173614
15668,/media/marda/TWOTB1/xBD/hurricanes/images/florence/hurricane-florence_00000380_pre_disaster.png,54,54,1,612,666,245,299,1197,51.95494550255286,30.777464358966814
15669,/media/marda/TWOTB1/xBD/hurricanes/images/florence/hurricane-florence_00000380_pre_disaster.png,57,54,1,664,721,351,405,985,45.793519844074986,29.574223692769767
15670,/media/marda/TWOTB1/xBD/hurricanes/images/florence/hurricane-florence_00000380_pre_disaster.png,31,28,1,365,396,431,459,138,20.03468111164143,9.274836971827426
15671,/media/marda/TWOTB1/xBD/hurricanes/images/florence/hurricane-florence_00000380_pre_disaster.png,40,31,1,716,756,437,468,110,14.07598897563531,10.408043082350984
15672,/media/marda/TWOTB1/xBD/hurricanes/images/florence/hurricane-florence_00000380_pre_disaster.png,38,36,1,438,476,443,479,295,21.229353061461048,18.614246823174856
15673,/media/marda/TWOTB1/xBD/hurricanes/images/florence/hurricane-florence_00000380_pre_disaster.png,51,63,1,658,709,447,510,729,52.849970377762126,18.254412250132482
15674,/media/marda/TWOTB1/xBD/hurricanes/images/florence/hurricane-florence_00000380_pre_disaster.png,37,28,1,361,398,453,481,209,27.96086694627007,10.054017105958778
15675,/media/marda/TWOTB1/xBD/hurricanes/images/florence/hurricane-florence_00000380_pre_disaster.png,38,35,1,434,472,461,496,292,21.8192463804403,17.90456171830317
15676,/media/marda/TWOTB1/xBD/hurricanes/images/florence/hurricane-florence_00000380_pre_disaster.png,41,43,1,323,364,474,517,450,30.7378820159662,21.511101739832633
15677,/media/marda/TWOTB1/xBD/hurricanes/images/florence/hurricane-florence_00000380_pre_disaster.png,72,51,1,367,439,495,546,1135,64.02006971276333,23.66852650402384
15678,/media/marda/TWOTB1/xBD/hurricanes/images/florence/hurricane-florence_00000380_pre_disaster.png,67,64,1,594,661,602,666,1134,44.40089432565902,33.62397193353251
15679,/media/marda/TWOTB1/xBD/hurricanes/images/florence/hurricane-florence_00000380_pre_disaster.png,43,37,1,654,697,646,683,165,20.201435915350988,10.627247401151278
15680,/media/marda/TWOTB1/xBD/hurricanes/images/florence/hurricane-florence_00000380_pre_disaster.png,79,64,1,879,958,652,716,1047,47.81959050347839,29.75444825025534
15681,/media/marda/TWOTB1/xBD/hurricanes/images/florence/hurricane-florence_00000380_pre_disaster.png,42,52,1,588,630,661,713,446,28.813992531088296,20.744937668125953
15682,/media/marda/TWOTB1/xBD/hurricanes/images/florence/hurricane-florence_00000380_pre_disaster.png,48,47,1,875,923,697,744,224,19.04824052200747,15.390329336872064
15683,/media/marda/TWOTB1/xBD/hurricanes/images/florence/hurricane-florence_00000380_pre_disaster.png,77,82,1,963,1040,705,787,1209,53.02904027871851,31.76441829594295
15684,/media/marda/TWOTB1/xBD/hurricanes/images/florence/hurricane-florence_00000380_pre_disaster.png,69,84,1,870,939,796,880,1482,57.2807024437954,36.49091183898176
15685,/media/marda/TWOTB1/xBD/hurricanes/images/florence/hurricane-florence_00000380_pre_disaster.png,60,51,1,984,1044,951,1002,217,21.03180859073479,13.526922946647607
15686,/media/marda/TWOTB1/xBD/hurricanes/images/florence/hurricane-florence_00000380_pre_disaster.png,71,71,1,924,995,971,1042,1048,38.14799527606403,36.69251130556049
15687,/media/marda/TWOTB1/xBD/hurricanes/images/florence/hurricane-florence_00000495_post_disaster.png,65,57,1,463,528,67,124,1885,55.288831745668574,45.32570511178117
15688,/media/marda/TWOTB1/xBD/hurricanes/images/florence/hurricane-florence_00000495_post_disaster.png,82,74,1,832,914,445,519,1653,56.123706312698886,39.41878087965462
15689,/media/marda/TWOTB1/xBD/hurricanes/images/florence/hurricane-florence_00000495_post_disaster.png,69,79,1,974,1043,799,878,772,48.67734701058772,22.18732850169021
15690,/media/marda/TWOTB1/xBD/hurricanes/images/florence/hurricane-florence_00000208_post_disaster.png,74,42,1,969,1043,0,42,954,42.48390063171863,29.813944132635683
15691,/media/marda/TWOTB1/xBD/hurricanes/images/florence/hurricane-florence_00000274_pre_disaster.png,45,36,1,264,309,70,106,648,34.14278438846311,25.058389423762517
15692,/media/marda/TWOTB1/xBD/hurricanes/images/florence/hurricane-florence_00000274_pre_disaster.png,41,42,1,119,160,111,153,726,36.266403151636005,26.416620697366653
15693,/media/marda/TWOTB1/xBD/hurricanes/images/florence/hurricane-florence_00000274_pre_disaster.png,69,50,1,423,492,243,293,1164,48.12336126512312,35.3427296526307
15694,/media/marda/TWOTB1/xBD/hurricanes/images/florence/hurricane-florence_00000274_pre_disaster.png,63,60,1,260,323,305,365,1256,53.956845009446845,30.72870783041602
15695,/media/marda/TWOTB1/xBD/hurricanes/images/florence/hurricane-florence_00000274_pre_disaster.png,19,22,1,238,257,331,353,57,10.195220163005034,7.51996975034319
15696,/media/marda/TWOTB1/xBD/hurricanes/images/florence/hurricane-florence_00000274_pre_disaster.png,42,38,1,362,404,425,463,288,32.22696010523263,11.944832452320805
15697,/media/marda/TWOTB1/xBD/hurricanes/images/florence/hurricane-florence_00000274_pre_disaster.png,46,34,1,817,863,546,580,95,13.523931473797543,9.43033990548726
15698,/media/marda/TWOTB1/xBD/hurricanes/images/florence/hurricane-florence_00000274_pre_disaster.png,63,50,1,784,847,554,604,525,27.53885607567244,25.23314408151332
15699,/media/marda/TWOTB1/xBD/hurricanes/images/florence/hurricane-florence_00000274_pre_disaster.png,98,91,1,776,874,599,690,1988,83.02895546645368,32.479672886158816
15700,/media/marda/TWOTB1/xBD/hurricanes/images/florence/hurricane-florence_00000176_pre_disaster.png,61,29,1,645,706,15,44,773,38.96807518668243,25.987417267836815
15701,/media/marda/TWOTB1/xBD/hurricanes/images/florence/hurricane-florence_00000176_pre_disaster.png,56,32,1,780,836,31,63,518,34.46292741119022,20.491518901656345
15702,/media/marda/TWOTB1/xBD/hurricanes/images/florence/hurricane-florence_00000176_pre_disaster.png,43,32,1,547,590,57,89,601,34.40040260869919,23.19678929953419
15703,/media/marda/TWOTB1/xBD/hurricanes/images/florence/hurricane-florence_00000176_pre_disaster.png,54,15,1,838,892,109,124,196,25.10317394031513,10.45683717135934
15704,/media/marda/TWOTB1/xBD/hurricanes/images/florence/hurricane-florence_00000176_pre_disaster.png,68,29,1,769,837,133,162,726,40.860530675788276,23.328375756390482
15705,/media/marda/TWOTB1/xBD/hurricanes/images/florence/hurricane-florence_00000176_pre_disaster.png,61,24,1,582,643,141,165,626,42.93066147479184,19.28404869159349
15706,/media/marda/TWOTB1/xBD/hurricanes/images/florence/hurricane-florence_00000176_pre_disaster.png,45,50,1,381,426,146,196,1208,50.53035518661537,31.716538910042274
15707,/media/marda/TWOTB1/xBD/hurricanes/images/florence/hurricane-florence_00000176_pre_disaster.png,51,22,1,799,850,156,178,206,17.398923453025706,15.892716367869228
15708,/media/marda/TWOTB1/xBD/hurricanes/images/florence/hurricane-florence_00000176_pre_disaster.png,72,23,1,596,668,202,225,578,55.62737076569181,13.88947158837281
15709,/media/marda/TWOTB1/xBD/hurricanes/images/florence/hurricane-florence_00000176_pre_disaster.png,45,49,1,393,438,227,276,783,42.68659120834122,24.445832503191262
15710,/media/marda/TWOTB1/xBD/hurricanes/images/florence/hurricane-florence_00000176_pre_disaster.png,39,51,1,452,491,291,342,725,45.71817271239724,21.087424452652176
15711,/media/marda/TWOTB1/xBD/hurricanes/images/florence/hurricane-florence_00000176_pre_disaster.png,24,16,1,487,511,295,311,43,8.303775093795453,6.87218129189696
15712,/media/marda/TWOTB1/xBD/hurricanes/images/florence/hurricane-florence_00000266_post_disaster.png,61,49,1,982,1043,242,291,705,41.91806688771856,22.41881117683447
15713,/media/marda/TWOTB1/xBD/hurricanes/images/florence/hurricane-florence_00000266_post_disaster.png,66,30,1,950,1016,261,291,424,29.771569233925113,18.760815283230755
15714,/media/marda/TWOTB1/xBD/hurricanes/images/florence/hurricane-florence_00000000_post_disaster.png,53,46,1,76,129,0,46,1243,56.28680808824067,29.590512824986057
15715,/media/marda/TWOTB1/xBD/hurricanes/images/florence/hurricane-florence_00000000_post_disaster.png,33,9,1,287,320,0,9,107,20.501474954000585,8.004678999023062
15716,/media/marda/TWOTB1/xBD/hurricanes/images/florence/hurricane-florence_00000000_post_disaster.png,88,38,1,844,932,0,38,1614,54.26935349866437,41.72576432583845
15717,/media/marda/TWOTB1/xBD/hurricanes/images/florence/hurricane-florence_00000000_post_disaster.png,80,37,1,940,1020,0,37,1223,47.65977787375216,35.29135980001713
15718,/media/marda/TWOTB1/xBD/hurricanes/images/florence/hurricane-florence_00000000_post_disaster.png,60,9,1,984,1044,0,9,154,22.24138020987402,9.146326882818046
15719,/media/marda/TWOTB1/xBD/hurricanes/images/florence/hurricane-florence_00000000_post_disaster.png,31,21,1,196,227,3,24,242,22.85742229419172,14.149072804529846
15720,/media/marda/TWOTB1/xBD/hurricanes/images/florence/hurricane-florence_00000000_post_disaster.png,94,44,1,830,924,39,83,1808,59.15344158216963,44.93457267425698
15721,/media/marda/TWOTB1/xBD/hurricanes/images/florence/hurricane-florence_00000000_post_disaster.png,95,66,1,196,291,50,116,2311,96.82638063670221,32.86487366546616
15722,/media/marda/TWOTB1/xBD/hurricanes/images/florence/hurricane-florence_00000000_post_disaster.png,36,63,1,57,93,55,118,1319,65.56631652620047,27.806278522899806
15723,/media/marda/TWOTB1/xBD/hurricanes/images/florence/hurricane-florence_00000000_post_disaster.png,93,42,1,831,924,85,127,1583,58.426626812145095,38.457454201348426
15724,/media/marda/TWOTB1/xBD/hurricanes/images/florence/hurricane-florence_00000000_post_disaster.png,78,46,1,932,1010,86,132,1495,52.04434138452571,39.538057544294574
15725,/media/marda/TWOTB1/xBD/hurricanes/images/florence/hurricane-florence_00000000_post_disaster.png,68,54,1,976,1044,99,153,1216,53.50052264710795,30.358238754600123
15726,/media/marda/TWOTB1/xBD/hurricanes/images/florence/hurricane-florence_00000000_post_disaster.png,40,31,1,202,242,118,149,392,36.81068209962591,14.081230602779149
15727,/media/marda/TWOTB1/xBD/hurricanes/images/florence/hurricane-florence_00000000_post_disaster.png,76,51,1,88,164,120,171,1493,71.76227861749979,33.469309374804695
15728,/media/marda/TWOTB1/xBD/hurricanes/images/florence/hurricane-florence_00000000_post_disaster.png,80,47,1,840,920,133,180,1511,50.205837141946844,42.46303247184912
15729,/media/marda/TWOTB1/xBD/hurricanes/images/florence/hurricane-florence_00000000_post_disaster.png,89,50,1,796,885,169,219,1520,54.665186908752595,38.412963002842375
15730,/media/marda/TWOTB1/xBD/hurricanes/images/florence/hurricane-florence_00000000_post_disaster.png,28,34,1,161,189,171,205,304,33.03673527915549,12.299655770276757
15731,/media/marda/TWOTB1/xBD/hurricanes/images/florence/hurricane-florence_00000000_post_disaster.png,56,50,1,175,231,175,225,1153,48.93364727643555,34.12154857403795
15732,/media/marda/TWOTB1/xBD/hurricanes/images/florence/hurricane-florence_00000000_post_disaster.png,87,47,1,927,1014,175,222,1890,56.482832159149496,44.79878489565828
15733,/media/marda/TWOTB1/xBD/hurricanes/images/florence/hurricane-florence_00000000_post_disaster.png,19,19,1,139,158,176,195,113,12.320211468131099,12.320211468131099
15734,/media/marda/TWOTB1/xBD/hurricanes/images/florence/hurricane-florence_00000000_post_disaster.png,93,52,1,756,849,216,268,1921,60.9177834430747,43.236692391105095
15735,/media/marda/TWOTB1/xBD/hurricanes/images/florence/hurricane-florence_00000000_post_disaster.png,78,58,1,920,998,238,296,1405,51.276191287778616,38.33135640780579
15736,/media/marda/TWOTB1/xBD/hurricanes/images/florence/hurricane-florence_00000000_post_disaster.png,34,31,1,99,133,242,273,247,33.78594406590345,9.794468331311919
15737,/media/marda/TWOTB1/xBD/hurricanes/images/florence/hurricane-florence_00000000_post_disaster.png,71,64,1,973,1044,245,309,1117,54.318620747285095,29.217556199597414
15738,/media/marda/TWOTB1/xBD/hurricanes/images/florence/hurricane-florence_00000000_post_disaster.png,139,122,1,302,441,246,368,6524,123.30092926605603,92.31606725151947
15739,/media/marda/TWOTB1/xBD/hurricanes/images/florence/hurricane-florence_00000000_post_disaster.png,81,61,1,781,862,254,315,1554,53.73769297224632,39.382962688668535
15740,/media/marda/TWOTB1/xBD/hurricanes/images/florence/hurricane-florence_00000000_post_disaster.png,29,28,1,132,161,275,303,148,30.644744503392616,6.479252688610709
15741,/media/marda/TWOTB1/xBD/hurricanes/images/florence/hurricane-florence_00000000_post_disaster.png,99,71,1,804,903,281,352,2090,70.34238455976947,41.130553223801975
15742,/media/marda/TWOTB1/xBD/hurricanes/images/florence/hurricane-florence_00000000_post_disaster.png,50,32,1,994,1044,301,333,132,20.948594609567596,9.00123968860655
15743,/media/marda/TWOTB1/xBD/hurricanes/images/florence/hurricane-florence_00000000_post_disaster.png,85,76,1,659,744,302,378,1791,71.63892161981619,32.975919763387516
15744,/media/marda/TWOTB1/xBD/hurricanes/images/florence/hurricane-florence_00000000_post_disaster.png,90,74,1,445,535,305,379,2263,63.90857878075711,49.3790381093213
15745,/media/marda/TWOTB1/xBD/hurricanes/images/florence/hurricane-florence_00000000_post_disaster.png,8,20,1,63,71,329,349,45,7.853950298295041,7.33376483719105
15746,/media/marda/TWOTB1/xBD/hurricanes/images/florence/hurricane-florence_00000000_post_disaster.png,50,59,1,64,114,339,398,1140,45.839430277381865,33.418639719797454
15747,/media/marda/TWOTB1/xBD/hurricanes/images/florence/hurricane-florence_00000000_post_disaster.png,97,66,1,796,893,339,405,1986,61.74049982285901,43.72698280762563
15748,/media/marda/TWOTB1/xBD/hurricanes/images/florence/hurricane-florence_00000000_post_disaster.png,53,35,1,991,1044,345,380,166,20.499210060239903,12.005253987213576
15749,/media/marda/TWOTB1/xBD/hurricanes/images/florence/hurricane-florence_00000000_post_disaster.png,59,42,1,985,1044,364,406,334,28.527644115252603,15.888051534581704
15750,/media/marda/TWOTB1/xBD/hurricanes/images/florence/hurricane-florence_00000000_post_disaster.png,103,65,1,926,1029,367,432,1747,62.181789733382324,39.864382205690966
15751,/media/marda/TWOTB1/xBD/hurricanes/images/florence/hurricane-florence_00000000_post_disaster.png,89,57,1,779,868,389,446,1437,52.615662975032905,36.99248898597855
15752,/media/marda/TWOTB1/xBD/hurricanes/images/florence/hurricane-florence_00000000_post_disaster.png,81,67,1,895,976,392,459,1494,52.5219399773742,39.101311405482626
15753,/media/marda/TWOTB1/xBD/hurricanes/images/florence/hurricane-florence_00000000_post_disaster.png,85,63,1,588,673,396,459,1389,63.54205317865002,29.475997437551527
15754,/media/marda/TWOTB1/xBD/hurricanes/images/florence/hurricane-florence_00000000_post_disaster.png,61,57,1,511,572,406,463,672,48.371170866066194,19.165126467794444
15755,/media/marda/TWOTB1/xBD/hurricanes/images/florence/hurricane-florence_00000000_post_disaster.png,92,66,1,752,844,419,485,1651,53.41733000802122,42.676145097741916
15756,/media/marda/TWOTB1/xBD/hurricanes/images/florence/hurricane-florence_00000000_post_disaster.png,49,46,1,519,568,445,491,414,30.309214642301914,18.234617249094576
15757,/media/marda/TWOTB1/xBD/hurricanes/images/florence/hurricane-florence_00000000_post_disaster.png,95,66,1,855,950,446,512,1646,53.03507402418286,42.51420975017325
15758,/media/marda/TWOTB1/xBD/hurricanes/images/florence/hurricane-florence_00000000_post_disaster.png,32,25,1,564,596,454,479,95,13.728033565991018,9.167873432551843
15759,/media/marda/TWOTB1/xBD/hurricanes/images/florence/hurricane-florence_00000000_post_disaster.png,92,68,1,724,816,461,529,1751,54.618484894767164,44.979754575176806
15760,/media/marda/TWOTB1/xBD/hurricanes/images/florence/hurricane-florence_00000000_post_disaster.png,90,74,1,837,927,477,551,1708,54.72577746182739,44.17671177542711
15761,/media/marda/TWOTB1/xBD/hurricanes/images/florence/hurricane-florence_00000000_post_disaster.png,81,71,1,705,786,504,575,1548,49.37026283576375,43.621565926520695
15762,/media/marda/TWOTB1/xBD/hurricanes/images/florence/hurricane-florence_00000000_post_disaster.png,85,73,1,815,900,515,588,1701,55.05343746374975,42.90230516390338
15763,/media/marda/TWOTB1/xBD/hurricanes/images/florence/hurricane-florence_00000000_post_disaster.png,56,62,1,988,1044,530,592,534,45.1193877980816,15.9762135658967
15764,/media/marda/TWOTB1/xBD/hurricanes/images/florence/hurricane-florence_00000000_post_disaster.png,85,76,1,793,878,556,632,1734,53.688801129343666,45.5931832437089
15765,/media/marda/TWOTB1/xBD/hurricanes/images/florence/hurricane-florence_00000000_post_disaster.png,84,65,1,686,770,557,622,1554,53.842494014219355,39.881105365881645
15766,/media/marda/TWOTB1/xBD/hurricanes/images/florence/hurricane-florence_00000000_post_disaster.png,93,74,1,947,1040,571,645,1715,57.528655017009456,41.25096063819041
15767,/media/marda/TWOTB1/xBD/hurricanes/images/florence/hurricane-florence_00000000_post_disaster.png,55,62,1,182,237,583,645,1105,44.20910747658626,34.608086834395095
15768,/media/marda/TWOTB1/xBD/hurricanes/images/florence/hurricane-florence_00000000_post_disaster.png,85,69,1,676,761,600,669,1733,56.82653980212536,44.04071549063293
15769,/media/marda/TWOTB1/xBD/hurricanes/images/florence/hurricane-florence_00000000_post_disaster.png,72,80,1,207,279,601,681,2003,62.697043425496986,43.18237006584026
15770,/media/marda/TWOTB1/xBD/hurricanes/images/florence/hurricane-florence_00000000_post_disaster.png,101,75,1,930,1031,608,683,1823,57.26599733110981,44.02521685443428
15771,/media/marda/TWOTB1/xBD/hurricanes/images/florence/hurricane-florence_00000000_post_disaster.png,78,73,1,779,857,609,682,1568,53.80155532200992,40.188941518148994
15772,/media/marda/TWOTB1/xBD/hurricanes/images/florence/hurricane-florence_00000000_post_disaster.png,58,71,1,355,413,613,684,1287,51.16484247669216,35.170773669838354
15773,/media/marda/TWOTB1/xBD/hurricanes/images/florence/hurricane-florence_00000000_post_disaster.png,54,47,1,510,564,636,683,517,36.457736441775225,18.894832311664953
15774,/media/marda/TWOTB1/xBD/hurricanes/images/florence/hurricane-florence_00000000_post_disaster.png,83,69,1,669,752,643,712,1719,55.304594262300355,42.354408637934554
15775,/media/marda/TWOTB1/xBD/hurricanes/images/florence/hurricane-florence_00000000_post_disaster.png,71,71,1,246,317,644,715,1539,58.42223964176893,37.27928840527829
15776,/media/marda/TWOTB1/xBD/hurricanes/images/florence/hurricane-florence_00000000_post_disaster.png,79,68,1,769,848,656,724,1456,51.54040688528789,39.457089737663914
15777,/media/marda/TWOTB1/xBD/hurricanes/images/florence/hurricane-florence_00000000_post_disaster.png,65,81,1,373,438,661,742,1482,50.510498265714766,41.865732019234024
15778,/media/marda/TWOTB1/xBD/hurricanes/images/florence/hurricane-florence_00000000_post_disaster.png,91,68,1,920,1011,661,729,1557,51.090347477306494,41.50469309074306
15779,/media/marda/TWOTB1/xBD/hurricanes/images/florence/hurricane-florence_00000000_post_disaster.png,82,72,1,660,742,687,759,1738,55.599332271878104,42.824700795903034
15780,/media/marda/TWOTB1/xBD/hurricanes/images/florence/hurricane-florence_00000000_post_disaster.png,63,87,1,425,488,688,775,1623,54.96061562009949,41.22763412720288
15781,/media/marda/TWOTB1/xBD/hurricanes/images/florence/hurricane-florence_00000000_post_disaster.png,67,74,1,269,336,692,766,1347,52.797800215710694,37.03526185642854
15782,/media/marda/TWOTB1/xBD/hurricanes/images/florence/hurricane-florence_00000000_post_disaster.png,40,74,1,73,113,696,770,717,52.41591306416925,19.42937639985086
15783,/media/marda/TWOTB1/xBD/hurricanes/images/florence/hurricane-florence_00000000_post_disaster.png,83,76,1,760,843,697,773,1725,57.54845862964356,42.3104808762782
15784,/media/marda/TWOTB1/xBD/hurricanes/images/florence/hurricane-florence_00000000_post_disaster.png,65,82,1,468,533,710,792,1470,51.599928063270205,39.874410517400065
15785,/media/marda/TWOTB1/xBD/hurricanes/images/florence/hurricane-florence_00000000_post_disaster.png,90,71,1,911,1001,710,781,1404,52.65440957466388,36.551629876009365
15786,/media/marda/TWOTB1/xBD/hurricanes/images/florence/hurricane-florence_00000000_post_disaster.png,67,76,1,294,361,729,805,1411,51.89411041520879,37.26428622941942
15787,/media/marda/TWOTB1/xBD/hurricanes/images/florence/hurricane-florence_00000000_post_disaster.png,81,74,1,650,731,733,807,1640,51.20134923750951,46.28960363162339
15788,/media/marda/TWOTB1/xBD/hurricanes/images/florence/hurricane-florence_00000000_post_disaster.png,37,62,1,54,91,743,805,632,36.80767645122357,22.868526616766545
15789,/media/marda/TWOTB1/xBD/hurricanes/images/florence/hurricane-florence_00000000_post_disaster.png,75,73,1,750,825,745,818,1548,49.90969135137225,43.37812197675115
15790,/media/marda/TWOTB1/xBD/hurricanes/images/florence/hurricane-florence_00000000_post_disaster.png,100,72,1,890,990,752,824,1747,61.62368976455926,41.19369236268396
15791,/media/marda/TWOTB1/xBD/hurricanes/images/florence/hurricane-florence_00000000_post_disaster.png,71,80,1,325,396,766,846,1620,54.496629224023245,42.57455836225677
15792,/media/marda/TWOTB1/xBD/hurricanes/images/florence/hurricane-florence_00000000_post_disaster.png,86,81,1,616,702,776,857,1735,52.50940498882464,45.22430025564072
15793,/media/marda/TWOTB1/xBD/hurricanes/images/florence/hurricane-florence_00000000_post_disaster.png,70,87,1,370,440,784,871,1977,59.37078301420751,47.01390355577223
15794,/media/marda/TWOTB1/xBD/hurricanes/images/florence/hurricane-florence_00000000_post_disaster.png,51,52,1,993,1044,789,841,165,19.06504696033809,11.474450358515611
15795,/media/marda/TWOTB1/xBD/hurricanes/images/florence/hurricane-florence_00000000_post_disaster.png,86,78,1,724,810,794,872,1762,57.03604024636372,43.12471644430702
15796,/media/marda/TWOTB1/xBD/hurricanes/images/florence/hurricane-florence_00000000_post_disaster.png,91,76,1,891,982,798,874,1459,54.39197037283987,37.95199081548048
15797,/media/marda/TWOTB1/xBD/hurricanes/images/florence/hurricane-florence_00000000_post_disaster.png,67,87,1,413,480,799,886,1502,48.487678410507996,42.74826464524523
15798,/media/marda/TWOTB1/xBD/hurricanes/images/florence/hurricane-florence_00000000_post_disaster.png,60,75,1,984,1044,835,910,568,48.17913981011403,18.934355668744967
15799,/media/marda/TWOTB1/xBD/hurricanes/images/florence/hurricane-florence_00000000_post_disaster.png,78,79,1,710,788,836,915,1535,52.42639131473799,40.67980593988527
15800,/media/marda/TWOTB1/xBD/hurricanes/images/florence/hurricane-florence_00000000_post_disaster.png,101,87,1,869,970,839,926,2009,58.55379942056755,46.50781136066058
15801,/media/marda/TWOTB1/xBD/hurricanes/images/florence/hurricane-florence_00000000_post_disaster.png,75,74,1,569,644,858,932,1192,47.573731546652745,35.07762211875245
15802,/media/marda/TWOTB1/xBD/hurricanes/images/florence/hurricane-florence_00000000_post_disaster.png,55,81,1,334,389,862,943,961,53.741787258346136,23.735140563061588
15803,/media/marda/TWOTB1/xBD/hurricanes/images/florence/hurricane-florence_00000000_post_disaster.png,72,85,1,972,1044,880,965,1245,51.48740693168752,33.80051198177517
15804,/media/marda/TWOTB1/xBD/hurricanes/images/florence/hurricane-florence_00000000_post_disaster.png,94,89,1,846,940,887,976,1669,52.04085276680314,43.95159083646157
15805,/media/marda/TWOTB1/xBD/hurricanes/images/florence/hurricane-florence_00000000_post_disaster.png,76,86,1,601,677,888,974,1364,47.74669343087945,40.08636253900536
15806,/media/marda/TWOTB1/xBD/hurricanes/images/florence/hurricane-florence_00000000_post_disaster.png,74,88,1,722,796,890,978,1434,51.248986206334145,38.37809557889668
15807,/media/marda/TWOTB1/xBD/hurricanes/images/florence/hurricane-florence_00000000_post_disaster.png,82,91,1,944,1026,924,1015,1489,52.08188380289371,39.24970095174807
15808,/media/marda/TWOTB1/xBD/hurricanes/images/florence/hurricane-florence_00000000_post_disaster.png,89,87,1,811,900,926,1013,1629,56.286165304575746,40.0985946557966
15809,/media/marda/TWOTB1/xBD/hurricanes/images/florence/hurricane-florence_00000000_post_disaster.png,78,82,1,626,704,934,1016,1444,52.09734144920226,37.92863020748994
15810,/media/marda/TWOTB1/xBD/hurricanes/images/florence/hurricane-florence_00000000_post_disaster.png,81,90,1,756,837,939,1029,1515,49.278776826395685,42.17876534788307
15811,/media/marda/TWOTB1/xBD/hurricanes/images/florence/hurricane-florence_00000000_post_disaster.png,25,61,1,33,58,956,1017,314,21.654951655251505,19.39691305954243
15812,/media/marda/TWOTB1/xBD/hurricanes/images/florence/hurricane-florence_00000000_post_disaster.png,72,85,1,380,452,956,1041,1527,50.48699304115313,41.196009687354305
15813,/media/marda/TWOTB1/xBD/hurricanes/images/florence/hurricane-florence_00000000_post_disaster.png,81,74,1,918,999,967,1041,1063,45.29746337276047,33.20423895244379
15814,/media/marda/TWOTB1/xBD/hurricanes/images/florence/hurricane-florence_00000000_post_disaster.png,85,64,1,650,735,977,1041,1078,58.80220923973825,26.191228411801422
15815,/media/marda/TWOTB1/xBD/hurricanes/images/florence/hurricane-florence_00000000_post_disaster.png,24,55,1,268,292,983,1038,119,13.652046121732107,11.70035219340214
15816,/media/marda/TWOTB1/xBD/hurricanes/images/florence/hurricane-florence_00000000_post_disaster.png,67,59,1,425,492,984,1043,548,51.22024039035368,17.487495851143688
15817,/media/marda/TWOTB1/xBD/hurricanes/images/florence/hurricane-florence_00000160_post_disaster.png,29,22,1,311,340,73,95,223,21.34349231059104,13.881168203325766
15818,/media/marda/TWOTB1/xBD/hurricanes/images/florence/hurricane-florence_00000160_post_disaster.png,68,39,1,270,338,147,186,1248,63.624505668250364,25.896817331138365
15819,/media/marda/TWOTB1/xBD/hurricanes/images/florence/hurricane-florence_00000160_post_disaster.png,29,29,1,310,339,277,306,235,19.324906397793043,16.442121981136353
15820,/media/marda/TWOTB1/xBD/hurricanes/images/florence/hurricane-florence_00000160_post_disaster.png,19,35,1,203,222,599,634,58,11.325919526786082,6.954198974499322
15821,/media/marda/TWOTB1/xBD/hurricanes/images/florence/hurricane-florence_00000175_post_disaster.png,64,9,1,540,604,0,9,205,41.10957224955031,7.664777624851214
15822,/media/marda/TWOTB1/xBD/hurricanes/images/florence/hurricane-florence_00000175_post_disaster.png,98,61,1,696,794,0,61,3019,68.15642440315538,59.160100153604155
15823,/media/marda/TWOTB1/xBD/hurricanes/images/florence/hurricane-florence_00000175_post_disaster.png,32,24,1,516,548,348,372,144,13.808210118138652,13.808210118138652
15824,/media/marda/TWOTB1/xBD/hurricanes/images/florence/hurricane-florence_00000175_post_disaster.png,55,68,1,197,252,758,826,1235,46.57963301741336,35.44402998413383
15825,/media/marda/TWOTB1/xBD/hurricanes/images/florence/hurricane-florence_00000175_post_disaster.png,64,84,1,158,222,875,959,1569,51.79289592356359,42.703998782679754
15826,/media/marda/TWOTB1/xBD/hurricanes/images/florence/hurricane-florence_00000399_pre_disaster.png,63,25,1,483,546,3,28,626,50.39683680482901,16.380287783482196
15827,/media/marda/TWOTB1/xBD/hurricanes/images/florence/hurricane-florence_00000399_pre_disaster.png,33,16,1,524,557,47,63,127,14.954759807410865,11.40922971691673
15828,/media/marda/TWOTB1/xBD/hurricanes/images/florence/hurricane-florence_00000399_pre_disaster.png,51,52,1,580,631,52,104,849,54.363878514867594,22.183641292101168
15829,/media/marda/TWOTB1/xBD/hurricanes/images/florence/hurricane-florence_00000399_pre_disaster.png,59,27,1,515,574,99,126,532,42.925648735567385,16.715593540904706
15830,/media/marda/TWOTB1/xBD/hurricanes/images/florence/hurricane-florence_00000399_pre_disaster.png,55,24,1,620,675,125,149,338,33.195635484432955,13.62931907348007
15831,/media/marda/TWOTB1/xBD/hurricanes/images/florence/hurricane-florence_00000399_pre_disaster.png,49,23,1,541,590,142,165,307,31.301094140156398,13.005694248565922
15832,/media/marda/TWOTB1/xBD/hurricanes/images/florence/hurricane-florence_00000399_pre_disaster.png,46,23,1,646,692,170,193,234,22.38279611528793,13.987852255118513
15833,/media/marda/TWOTB1/xBD/hurricanes/images/florence/hurricane-florence_00000399_pre_disaster.png,62,29,1,543,605,184,213,483,46.995062119496005,13.722856682659293
15834,/media/marda/TWOTB1/xBD/hurricanes/images/florence/hurricane-florence_00000399_pre_disaster.png,53,34,1,664,717,199,233,346,28.419350739185862,18.894229592555256
15835,/media/marda/TWOTB1/xBD/hurricanes/images/florence/hurricane-florence_00000399_pre_disaster.png,66,37,1,668,734,249,286,520,43.898716408904484,15.715423378646415
15836,/media/marda/TWOTB1/xBD/hurricanes/images/florence/hurricane-florence_00000399_pre_disaster.png,43,26,1,571,614,266,292,236,21.67113286174578,14.640027335140218
15837,/media/marda/TWOTB1/xBD/hurricanes/images/florence/hurricane-florence_00000399_pre_disaster.png,67,35,1,570,637,273,308,599,50.29739974079067,15.901774506355281
15838,/media/marda/TWOTB1/xBD/hurricanes/images/florence/hurricane-florence_00000399_pre_disaster.png,65,38,1,592,657,310,348,597,43.035108054360826,21.722681912894426
15839,/media/marda/TWOTB1/xBD/hurricanes/images/florence/hurricane-florence_00000399_pre_disaster.png,71,64,1,467,538,355,419,1350,56.20947057630778,31.82073769254878
15840,/media/marda/TWOTB1/xBD/hurricanes/images/florence/hurricane-florence_00000399_pre_disaster.png,100,66,1,802,902,358,424,1849,66.57296470928907,39.66423855644848
15841,/media/marda/TWOTB1/xBD/hurricanes/images/florence/hurricane-florence_00000399_pre_disaster.png,117,152,1,226,343,371,523,8091,151.17468569373833,72.75701028528383
15842,/media/marda/TWOTB1/xBD/hurricanes/images/florence/hurricane-florence_00000399_pre_disaster.png,84,43,1,912,996,382,425,821,49.65327427624447,21.870956010017522
15843,/media/marda/TWOTB1/xBD/hurricanes/images/florence/hurricane-florence_00000399_pre_disaster.png,61,44,1,874,935,410,454,386,25.361049936408953,20.299810531229515
15844,/media/marda/TWOTB1/xBD/hurricanes/images/florence/hurricane-florence_00000399_pre_disaster.png,141,82,1,53,194,423,505,4828,146.25098181280643,44.95885837911889
15845,/media/marda/TWOTB1/xBD/hurricanes/images/florence/hurricane-florence_00000399_pre_disaster.png,84,70,1,890,974,431,501,1117,60.1175599559584,24.907831980485888
15846,/media/marda/TWOTB1/xBD/hurricanes/images/florence/hurricane-florence_00000399_pre_disaster.png,78,132,1,155,233,473,605,4717,126.07135409122712,53.73488237968185
15847,/media/marda/TWOTB1/xBD/hurricanes/images/florence/hurricane-florence_00000399_pre_disaster.png,67,121,1,85,152,491,612,3417,106.0975045841823,44.252696979794806
15848,/media/marda/TWOTB1/xBD/hurricanes/images/florence/hurricane-florence_00000399_pre_disaster.png,63,55,1,533,596,494,549,578,47.92699804282183,16.29050668063794
15849,/media/marda/TWOTB1/xBD/hurricanes/images/florence/hurricane-florence_00000399_pre_disaster.png,58,56,1,567,625,536,592,704,31.992839487447107,29.856518038127348
15850,/media/marda/TWOTB1/xBD/hurricanes/images/florence/hurricane-florence_00000399_pre_disaster.png,63,56,1,533,596,558,614,636,47.206226469422305,17.987412968098237
15851,/media/marda/TWOTB1/xBD/hurricanes/images/florence/hurricane-florence_00000399_pre_disaster.png,71,67,1,465,536,589,656,1223,52.76706717767353,30.946312121080656
15852,/media/marda/TWOTB1/xBD/hurricanes/images/florence/hurricane-florence_00000399_pre_disaster.png,71,61,1,83,154,617,678,1261,75.04419380419048,22.344129819529687
15853,/media/marda/TWOTB1/xBD/hurricanes/images/florence/hurricane-florence_00000399_pre_disaster.png,62,59,1,335,397,631,690,844,52.90193005132212,21.158830835124338
15854,/media/marda/TWOTB1/xBD/hurricanes/images/florence/hurricane-florence_00000399_pre_disaster.png,48,63,1,105,153,678,741,796,45.35028812399225,23.432746767171206
15855,/media/marda/TWOTB1/xBD/hurricanes/images/florence/hurricane-florence_00000399_pre_disaster.png,73,68,1,634,707,688,756,1320,49.94596007120273,35.36980286949302
15856,/media/marda/TWOTB1/xBD/hurricanes/images/florence/hurricane-florence_00000399_pre_disaster.png,20,51,1,98,118,725,776,194,23.852640390704078,10.882692207846441
15857,/media/marda/TWOTB1/xBD/hurricanes/images/florence/hurricane-florence_00000399_pre_disaster.png,33,62,1,320,353,935,997,314,27.622416894448822,15.080877059764875
15858,/media/marda/TWOTB1/xBD/hurricanes/images/florence/hurricane-florence_00000399_pre_disaster.png,45,80,1,285,330,953,1033,794,46.802598480975114,23.27722424939061
15859,/media/marda/TWOTB1/xBD/hurricanes/images/florence/hurricane-florence_00000406_post_disaster.png,51,43,1,265,316,12,55,612,53.4507134876837,15.289082068952055
15860,/media/marda/TWOTB1/xBD/hurricanes/images/florence/hurricane-florence_00000406_post_disaster.png,55,39,1,384,439,17,56,546,51.08714000518594,14.299618674067531
15861,/media/marda/TWOTB1/xBD/hurricanes/images/florence/hurricane-florence_00000406_post_disaster.png,45,39,1,319,364,91,130,485,45.910575276805574,14.05411894738955
15862,/media/marda/TWOTB1/xBD/hurricanes/images/florence/hurricane-florence_00000406_post_disaster.png,58,18,1,653,711,108,126,382,38.01965849246505,13.294860417396116
15863,/media/marda/TWOTB1/xBD/hurricanes/images/florence/hurricane-florence_00000406_post_disaster.png,39,15,1,635,674,112,127,159,16.740331301835106,12.623701630345726
15864,/media/marda/TWOTB1/xBD/hurricanes/images/florence/hurricane-florence_00000406_post_disaster.png,58,27,1,595,653,115,142,687,38.62826781038599,23.85430269582813
15865,/media/marda/TWOTB1/xBD/hurricanes/images/florence/hurricane-florence_00000406_post_disaster.png,46,18,1,811,857,115,133,99,12.105007688969527,10.99023135043489
15866,/media/marda/TWOTB1/xBD/hurricanes/images/florence/hurricane-florence_00000406_post_disaster.png,50,41,1,655,705,127,168,811,40.51897402950432,26.602849890570788
15867,/media/marda/TWOTB1/xBD/hurricanes/images/florence/hurricane-florence_00000406_post_disaster.png,65,49,1,821,886,129,178,534,54.515683702744894,13.048753631516703
15868,/media/marda/TWOTB1/xBD/hurricanes/images/florence/hurricane-florence_00000406_post_disaster.png,50,46,1,218,268,147,193,757,47.91578430972283,24.88204648352526
15869,/media/marda/TWOTB1/xBD/hurricanes/images/florence/hurricane-florence_00000406_post_disaster.png,62,50,1,781,843,153,203,647,50.859852620854404,17.486333641651928
15870,/media/marda/TWOTB1/xBD/hurricanes/images/florence/hurricane-florence_00000406_post_disaster.png,48,48,1,647,695,226,274,693,44.191913301362895,20.887272030320084
15871,/media/marda/TWOTB1/xBD/hurricanes/images/florence/hurricane-florence_00000406_post_disaster.png,50,48,1,129,179,228,276,584,56.61617271692135,13.764385273459327
15872,/media/marda/TWOTB1/xBD/hurricanes/images/florence/hurricane-florence_00000406_post_disaster.png,36,22,1,668,704,292,314,98,13.913576553443127,9.521411946274634
15873,/media/marda/TWOTB1/xBD/hurricanes/images/florence/hurricane-florence_00000406_post_disaster.png,63,65,1,700,763,371,436,1064,54.14894227793499,26.130285192958056
15874,/media/marda/TWOTB1/xBD/hurricanes/images/florence/hurricane-florence_00000406_post_disaster.png,44,33,1,679,723,382,415,271,22.311713713416292,16.1833235868904
15875,/media/marda/TWOTB1/xBD/hurricanes/images/florence/hurricane-florence_00000406_post_disaster.png,48,33,1,707,755,425,458,207,21.13629415587012,13.033017960646987
15876,/media/marda/TWOTB1/xBD/hurricanes/images/florence/hurricane-florence_00000406_post_disaster.png,76,53,1,967,1043,639,692,487,46.67677552173137,13.857250947612831
15877,/media/marda/TWOTB1/xBD/hurricanes/images/florence/hurricane-florence_00000406_post_disaster.png,42,48,1,567,609,689,737,346,24.17828472649092,19.003081852837948
15878,/media/marda/TWOTB1/xBD/hurricanes/images/florence/hurricane-florence_00000406_post_disaster.png,27,52,1,444,471,698,750,209,26.552254912210355,10.753276889260853
15879,/media/marda/TWOTB1/xBD/hurricanes/images/florence/hurricane-florence_00000406_post_disaster.png,53,56,1,990,1043,702,758,200,26.245536653302164,11.398745798559272
15880,/media/marda/TWOTB1/xBD/hurricanes/images/florence/hurricane-florence_00000406_post_disaster.png,49,88,1,267,316,711,799,2121,67.13994249279331,42.156231107000806
15881,/media/marda/TWOTB1/xBD/hurricanes/images/florence/hurricane-florence_00000406_post_disaster.png,67,59,1,576,643,716,775,1003,47.58827764871156,28.768356937504088
15882,/media/marda/TWOTB1/xBD/hurricanes/images/florence/hurricane-florence_00000406_post_disaster.png,69,44,1,382,451,734,778,644,61.8237716355514,13.860593098751554
15883,/media/marda/TWOTB1/xBD/hurricanes/images/florence/hurricane-florence_00000406_post_disaster.png,67,68,1,976,1043,852,920,601,33.42477650267174,24.74857654104802
15884,/media/marda/TWOTB1/xBD/hurricanes/images/florence/hurricane-florence_00000406_post_disaster.png,64,77,1,836,900,862,939,1234,50.315482133184574,32.660954243573784
15885,/media/marda/TWOTB1/xBD/hurricanes/images/florence/hurricane-florence_00000406_post_disaster.png,60,71,1,687,747,865,936,1150,41.49204454037,36.47007648472032
15886,/media/marda/TWOTB1/xBD/hurricanes/images/florence/hurricane-florence_00000406_post_disaster.png,84,88,1,571,655,866,954,2812,67.45705403575654,55.66084851111188
15887,/media/marda/TWOTB1/xBD/hurricanes/images/florence/hurricane-florence_00000406_post_disaster.png,66,55,1,754,820,883,938,710,39.91561359004403,23.647166117870228
15888,/media/marda/TWOTB1/xBD/hurricanes/images/florence/hurricane-florence_00000406_post_disaster.png,62,91,1,840,902,916,1007,1290,58.27806628964866,29.10455284435206
15889,/media/marda/TWOTB1/xBD/hurricanes/images/florence/hurricane-florence_00000473_post_disaster.png,42,23,1,491,533,81,104,269,22.18944096416541,16.24626381395434
15890,/media/marda/TWOTB1/xBD/hurricanes/images/florence/hurricane-florence_00000473_post_disaster.png,68,55,1,494,562,107,162,1273,46.28737346115965,39.71124150200342
15891,/media/marda/TWOTB1/xBD/hurricanes/images/florence/hurricane-florence_00000473_post_disaster.png,40,27,1,441,481,123,150,268,22.145949208679497,16.207753144862398
15892,/media/marda/TWOTB1/xBD/hurricanes/images/florence/hurricane-florence_00000473_post_disaster.png,30,22,1,546,576,324,346,49,9.453244276508485,7.00037038733998
15893,/media/marda/TWOTB1/xBD/hurricanes/images/florence/hurricane-florence_00000473_post_disaster.png,65,65,1,459,524,425,490,1177,55.11678206796301,29.761723343951665
15894,/media/marda/TWOTB1/xBD/hurricanes/images/florence/hurricane-florence_00000473_post_disaster.png,28,27,1,408,436,433,460,62,11.724167133333351,7.163665163731003
15895,/media/marda/TWOTB1/xBD/hurricanes/images/florence/hurricane-florence_00000473_post_disaster.png,38,48,1,296,334,657,705,307,24.98976183411362,16.41454533957603
15896,/media/marda/TWOTB1/xBD/hurricanes/images/florence/hurricane-florence_00000473_post_disaster.png,91,73,1,762,853,665,738,1464,65.63652874699021,31.438128413868416
15897,/media/marda/TWOTB1/xBD/hurricanes/images/florence/hurricane-florence_00000473_post_disaster.png,57,53,1,833,890,669,722,313,31.19911364210211,13.437179762136752
15898,/media/marda/TWOTB1/xBD/hurricanes/images/florence/hurricane-florence_00000473_post_disaster.png,33,52,1,292,325,684,736,321,26.471443962923267,16.355033135436635
15899,/media/marda/TWOTB1/xBD/hurricanes/images/florence/hurricane-florence_00000473_post_disaster.png,65,81,1,340,405,714,795,1375,52.09485975139187,40.19701735300583
15900,/media/marda/TWOTB1/xBD/hurricanes/images/florence/hurricane-florence_00000473_post_disaster.png,70,82,1,201,271,740,822,1626,60.21366630599287,37.14112179202971
15901,/media/marda/TWOTB1/xBD/hurricanes/images/florence/hurricane-florence_00000473_post_disaster.png,32,51,1,9,41,741,792,333,34.7647212929958,12.697828830425843
15902,/media/marda/TWOTB1/xBD/hurricanes/images/florence/hurricane-florence_00000473_post_disaster.png,53,38,1,968,1021,745,783,136,17.386180019647735,10.426675117839974
15903,/media/marda/TWOTB1/xBD/hurricanes/images/florence/hurricane-florence_00000473_post_disaster.png,37,61,1,57,94,753,814,547,38.83513835357139,18.81714633116823
15904,/media/marda/TWOTB1/xBD/hurricanes/images/florence/hurricane-florence_00000473_post_disaster.png,91,47,1,887,978,770,817,684,62.10387358466054,14.689846546860771
15905,/media/marda/TWOTB1/xBD/hurricanes/images/florence/hurricane-florence_00000473_post_disaster.png,86,56,1,762,848,793,849,1178,64.7878736341532,24.27414913468387
15906,/media/marda/TWOTB1/xBD/hurricanes/images/florence/hurricane-florence_00000473_post_disaster.png,37,63,1,96,133,798,861,639,33.42696566380032,26.24515033552071
15907,/media/marda/TWOTB1/xBD/hurricanes/images/florence/hurricane-florence_00000473_post_disaster.png,52,73,1,459,511,809,882,901,39.62879006256287,30.297005332455246
15908,/media/marda/TWOTB1/xBD/hurricanes/images/florence/hurricane-florence_00000473_post_disaster.png,59,91,1,137,196,815,906,1574,56.30607918964654,40.12205591300753
15909,/media/marda/TWOTB1/xBD/hurricanes/images/florence/hurricane-florence_00000473_post_disaster.png,77,56,1,787,864,820,876,930,48.94715446843678,25.321781565394563
15910,/media/marda/TWOTB1/xBD/hurricanes/images/florence/hurricane-florence_00000473_post_disaster.png,62,98,1,27,89,840,938,2263,57.92071472993919,51.142677523654655
15911,/media/marda/TWOTB1/xBD/hurricanes/images/florence/hurricane-florence_00000473_post_disaster.png,54,78,1,97,151,856,934,1224,43.38556523789437,37.81747063430078
15912,/media/marda/TWOTB1/xBD/hurricanes/images/florence/hurricane-florence_00000473_post_disaster.png,63,90,1,980,1043,903,993,708,52.4171925654252,20.044046988911827
15913,/media/marda/TWOTB1/xBD/hurricanes/images/florence/hurricane-florence_00000473_post_disaster.png,77,82,1,938,1015,911,993,882,45.67838062838501,25.8858945056025
15914,/media/marda/TWOTB1/xBD/hurricanes/images/florence/hurricane-florence_00000473_post_disaster.png,80,84,1,862,942,946,1030,1017,54.91306709785069,24.468402814644335
15915,/media/marda/TWOTB1/xBD/hurricanes/images/florence/hurricane-florence_00000473_post_disaster.png,73,67,1,616,689,401,468,1277,45.4610556240116,37.24899967831642
15916,/media/marda/TWOTB1/xBD/hurricanes/images/florence/hurricane-florence_00000473_post_disaster.png,82,62,1,784,866,179,241,1491,59.91970613219296,32.949048954057
15917,/media/marda/TWOTB1/xBD/hurricanes/images/florence/hurricane-florence_00000473_post_disaster.png,55,29,1,770,825,192,221,319,22.664250913141128,18.836300456223185
15918,/media/marda/TWOTB1/xBD/hurricanes/images/florence/hurricane-florence_00000473_post_disaster.png,44,23,1,701,745,226,249,121,13.51544339039049,11.99522187566951
15919,/media/marda/TWOTB1/xBD/hurricanes/images/florence/hurricane-florence_00000473_post_disaster.png,46,24,1,717,763,235,259,152,17.45232294737266,11.533322668418268
15920,/media/marda/TWOTB1/xBD/hurricanes/images/florence/hurricane-florence_00000473_post_disaster.png,57,35,1,724,781,265,300,390,26.13196329198929,19.964894109592517
15921,/media/marda/TWOTB1/xBD/hurricanes/images/florence/hurricane-florence_00000441_post_disaster.png,43,53,1,50,93,514,567,1021,43.101620035048555,31.36833546555397
15922,/media/marda/TWOTB1/xBD/hurricanes/images/florence/hurricane-florence_00000441_post_disaster.png,18,37,1,9,27,528,565,212,18.545205553189884,15.135082524005176
15923,/media/marda/TWOTB1/xBD/hurricanes/images/florence/hurricane-florence_00000441_post_disaster.png,47,36,1,891,938,667,703,132,13.808210118138652,12.649110640673518
15924,/media/marda/TWOTB1/xBD/hurricanes/images/florence/hurricane-florence_00000441_post_disaster.png,58,43,1,895,953,682,725,272,25.64964343964302,15.050361963268728
15925,/media/marda/TWOTB1/xBD/hurricanes/images/florence/hurricane-florence_00000441_post_disaster.png,57,43,1,930,987,685,728,379,23.104394556159328,21.571015440261746
15926,/media/marda/TWOTB1/xBD/hurricanes/images/florence/hurricane-florence_00000441_post_disaster.png,21,76,1,98,119,782,858,647,53.425855126252294,16.162680236815625
15927,/media/marda/TWOTB1/xBD/hurricanes/images/florence/hurricane-florence_00000441_post_disaster.png,49,84,1,883,932,795,879,637,57.51701159458987,14.825426761127634
15928,/media/marda/TWOTB1/xBD/hurricanes/images/florence/hurricane-florence_00000441_post_disaster.png,51,48,1,982,1033,811,859,158,17.498075114467504,12.076123112934447
15929,/media/marda/TWOTB1/xBD/hurricanes/images/florence/hurricane-florence_00000441_post_disaster.png,76,58,1,922,998,830,888,758,43.44122175077989,23.91936343352667
15930,/media/marda/TWOTB1/xBD/hurricanes/images/florence/hurricane-florence_00000441_post_disaster.png,23,89,1,58,81,865,954,762,63.44742107747638,16.01950101577741
15931,/media/marda/TWOTB1/xBD/hurricanes/images/florence/hurricane-florence_00000441_post_disaster.png,34,85,1,109,143,910,995,1018,53.001273851991066,25.63558544652514
15932,/media/marda/TWOTB1/xBD/hurricanes/images/florence/hurricane-florence_00000242_pre_disaster.png,65,66,1,14,79,0,66,2136,77.67535584600284,37.89726113189327
15933,/media/marda/TWOTB1/xBD/hurricanes/images/florence/hurricane-florence_00000242_pre_disaster.png,58,9,1,155,213,0,9,337,58.70198762630937,7.850361855934815
15934,/media/marda/TWOTB1/xBD/hurricanes/images/florence/hurricane-florence_00000242_pre_disaster.png,48,35,1,303,351,109,144,873,38.948406910497766,30.871650981126933
15935,/media/marda/TWOTB1/xBD/hurricanes/images/florence/hurricane-florence_00000242_pre_disaster.png,44,17,1,431,475,129,146,310,32.49854867537916,12.751691037528795
15936,/media/marda/TWOTB1/xBD/hurricanes/images/florence/hurricane-florence_00000242_pre_disaster.png,46,65,1,0,46,177,242,1775,55.03776742452291,44.03087873545933
15937,/media/marda/TWOTB1/xBD/hurricanes/images/florence/hurricane-florence_00000242_pre_disaster.png,25,33,1,371,396,393,426,129,16.810447272874963,10.328307251961789
15938,/media/marda/TWOTB1/xBD/hurricanes/images/florence/hurricane-florence_00000242_pre_disaster.png,63,52,1,386,449,419,471,1175,52.06345849021989,30.37837262817862
15939,/media/marda/TWOTB1/xBD/hurricanes/images/florence/hurricane-florence_00000242_pre_disaster.png,23,27,1,363,386,421,448,74,10.477126781232585,9.627716560555156
15940,/media/marda/TWOTB1/xBD/hurricanes/images/florence/hurricane-florence_00000242_pre_disaster.png,13,33,1,38,51,541,574,84,11.291169973129106,10.022613995136396
15941,/media/marda/TWOTB1/xBD/hurricanes/images/florence/hurricane-florence_00000242_pre_disaster.png,35,69,1,17,52,960,1029,598,30.782387879880616,25.761124251254472
15942,/media/marda/TWOTB1/xBD/hurricanes/images/florence/hurricane-florence_00000172_pre_disaster.png,58,64,1,478,536,609,673,919,35.742877299712426,34.316214150049326
15943,/media/marda/TWOTB1/xBD/hurricanes/images/florence/hurricane-florence_00000172_pre_disaster.png,47,49,1,555,602,620,669,435,28.506691955468295,20.471429328781756
15944,/media/marda/TWOTB1/xBD/hurricanes/images/florence/hurricane-florence_00000172_pre_disaster.png,52,67,1,8,60,674,741,1428,47.73133466086197,40.32071678200391
15945,/media/marda/TWOTB1/xBD/hurricanes/images/florence/hurricane-florence_00000172_pre_disaster.png,49,74,1,195,244,729,803,1117,47.157792214422194,32.17306675697212
15946,/media/marda/TWOTB1/xBD/hurricanes/images/florence/hurricane-florence_00000172_pre_disaster.png,43,57,1,158,201,875,932,826,42.3168511210042,26.08063694391253
15947,/media/marda/TWOTB1/xBD/hurricanes/images/florence/hurricane-florence_00000172_pre_disaster.png,49,64,1,184,233,921,985,890,45.14279558116185,26.49856411794304
15948,/media/marda/TWOTB1/xBD/hurricanes/images/florence/hurricane-florence_00000172_pre_disaster.png,37,55,1,413,450,983,1038,166,21.62419456883461,10.309393683917994
15949,/media/marda/TWOTB1/xBD/hurricanes/images/florence/hurricane-florence_00000172_pre_disaster.png,32,51,1,371,403,993,1044,186,21.539613025218575,11.52366056285941
15950,/media/marda/TWOTB1/xBD/hurricanes/images/florence/hurricane-florence_00000172_pre_disaster.png,42,50,1,602,644,994,1044,95,16.693485815390368,8.70686658857217
15951,/media/marda/TWOTB1/xBD/hurricanes/images/florence/hurricane-florence_00000371_pre_disaster.png,325,242,1,148,473,87,329,42427,318.44074670095,177.2960470339887
15952,/media/marda/TWOTB1/xBD/hurricanes/images/florence/hurricane-florence_00000371_pre_disaster.png,31,19,1,378,409,118,137,169,16.20708424828682,13.44575331800368
15953,/media/marda/TWOTB1/xBD/hurricanes/images/florence/hurricane-florence_00000371_pre_disaster.png,66,34,1,665,731,295,329,463,42.252091609585726,15.400762134326907
15954,/media/marda/TWOTB1/xBD/hurricanes/images/florence/hurricane-florence_00000371_pre_disaster.png,63,47,1,710,773,300,347,675,31.229713567946003,29.049572323744197
15955,/media/marda/TWOTB1/xBD/hurricanes/images/florence/hurricane-florence_00000371_pre_disaster.png,84,73,1,631,715,349,422,2099,55.88607557347026,52.224314338888135
15956,/media/marda/TWOTB1/xBD/hurricanes/images/florence/hurricane-florence_00000371_pre_disaster.png,57,55,1,124,181,717,772,1016,58.37976805183797,23.980912467555513
15957,/media/marda/TWOTB1/xBD/hurricanes/images/florence/hurricane-florence_00000371_pre_disaster.png,45,91,1,41,86,718,809,2035,66.35221387043218,45.00560528167658
15958,/media/marda/TWOTB1/xBD/hurricanes/images/florence/hurricane-florence_00000371_pre_disaster.png,60,90,1,203,263,721,811,1689,59.279883761286435,42.91088909270536
15959,/media/marda/TWOTB1/xBD/hurricanes/images/florence/hurricane-florence_00000371_pre_disaster.png,14,44,1,95,109,775,819,163,16.708531860628767,12.851503582314109
15960,/media/marda/TWOTB1/xBD/hurricanes/images/florence/hurricane-florence_00000371_pre_disaster.png,36,64,1,107,143,784,848,907,36.606290532933706,33.01751402243961
15961,/media/marda/TWOTB1/xBD/hurricanes/images/florence/hurricane-florence_00000371_pre_disaster.png,19,45,1,14,33,785,830,240,19.132720476409425,16.073169723155456
15962,/media/marda/TWOTB1/xBD/hurricanes/images/florence/hurricane-florence_00000046_pre_disaster.png,63,51,1,156,219,0,51,1641,58.462887711000164,39.1596033840621
15963,/media/marda/TWOTB1/xBD/hurricanes/images/florence/hurricane-florence_00000046_pre_disaster.png,65,43,1,279,344,0,43,1361,46.76232315866169,38.664823013313494
15964,/media/marda/TWOTB1/xBD/hurricanes/images/florence/hurricane-florence_00000046_pre_disaster.png,105,64,1,512,617,0,64,2864,81.27859528481962,49.308770100091394
15965,/media/marda/TWOTB1/xBD/hurricanes/images/florence/hurricane-florence_00000046_pre_disaster.png,69,27,1,624,693,0,27,635,39.715264024265565,24.16777295180027
15966,/media/marda/TWOTB1/xBD/hurricanes/images/florence/hurricane-florence_00000046_pre_disaster.png,114,80,1,656,770,0,80,3596,95.7739089050019,50.54261742898856
15967,/media/marda/TWOTB1/xBD/hurricanes/images/florence/hurricane-florence_00000046_pre_disaster.png,52,11,1,737,789,0,11,153,21.54332328795979,10.493241988559669
15968,/media/marda/TWOTB1/xBD/hurricanes/images/florence/hurricane-florence_00000046_pre_disaster.png,53,6,1,849,902,0,6,69,19.121284378007218,6.096652716580893
15969,/media/marda/TWOTB1/xBD/hurricanes/images/florence/hurricane-florence_00000046_pre_disaster.png,55,40,1,34,89,14,54,1691,55.60492963663846,40.97209067266034
15970,/media/marda/TWOTB1/xBD/hurricanes/images/florence/hurricane-florence_00000046_pre_disaster.png,56,44,1,324,380,26,70,1034,37.3174602296682,36.97283872903689
15971,/media/marda/TWOTB1/xBD/hurricanes/images/florence/hurricane-florence_00000046_pre_disaster.png,58,62,1,194,252,40,102,1707,57.91149041325545,39.759034012140894
15972,/media/marda/TWOTB1/xBD/hurricanes/images/florence/hurricane-florence_00000046_pre_disaster.png,65,50,1,370,435,40,90,1430,48.553134809515555,38.75647671709741
15973,/media/marda/TWOTB1/xBD/hurricanes/images/florence/hurricane-florence_00000046_pre_disaster.png,107,89,1,568,675,48,137,3515,92.92187584385073,52.01891968452766
15974,/media/marda/TWOTB1/xBD/hurricanes/images/florence/hurricane-florence_00000046_pre_disaster.png,121,93,1,714,835,51,144,3730,98.09270465476106,52.48727224079897
15975,/media/marda/TWOTB1/xBD/hurricanes/images/florence/hurricane-florence_00000046_pre_disaster.png,61,54,1,414,475,62,116,1224,47.57323942620407,35.465956839818574
15976,/media/marda/TWOTB1/xBD/hurricanes/images/florence/hurricane-florence_00000046_pre_disaster.png,58,46,1,44,102,63,109,1774,58.15766211995271,40.422063281549626
15977,/media/marda/TWOTB1/xBD/hurricanes/images/florence/hurricane-florence_00000046_pre_disaster.png,55,54,1,229,284,81,135,1305,48.91006505839199,37.71290324613034
15978,/media/marda/TWOTB1/xBD/hurricanes/images/florence/hurricane-florence_00000046_pre_disaster.png,81,61,1,443,524,85,146,1797,58.072197158497254,41.98419793914811
15979,/media/marda/TWOTB1/xBD/hurricanes/images/florence/hurricane-florence_00000046_pre_disaster.png,57,59,1,272,329,106,165,1368,49.98788628738083,38.84436571752966
15980,/media/marda/TWOTB1/xBD/hurricanes/images/florence/hurricane-florence_00000046_pre_disaster.png,64,57,1,58,122,107,164,1855,61.82184254922008,40.31383856943901
15981,/media/marda/TWOTB1/xBD/hurricanes/images/florence/hurricane-florence_00000046_pre_disaster.png,109,94,1,625,734,120,214,3524,93.00565436821991,51.961855872799674
15982,/media/marda/TWOTB1/xBD/hurricanes/images/florence/hurricane-florence_00000046_pre_disaster.png,83,62,1,470,553,125,187,1780,58.22667831964517,42.01309754578546
15983,/media/marda/TWOTB1/xBD/hurricanes/images/florence/hurricane-florence_00000046_pre_disaster.png,56,57,1,323,379,137,194,1250,48.79422974389069,35.56449918922539
15984,/media/marda/TWOTB1/xBD/hurricanes/images/florence/hurricane-florence_00000046_pre_disaster.png,14,34,1,0,14,148,182,246,26.799792207047126,13.960965434472872
15985,/media/marda/TWOTB1/xBD/hurricanes/images/florence/hurricane-florence_00000046_pre_disaster.png,65,56,1,81,146,158,214,1630,54.893278364582834,39.979097542387535
15986,/media/marda/TWOTB1/xBD/hurricanes/images/florence/hurricane-florence_00000046_pre_disaster.png,48,31,1,586,634,161,192,416,24.567442974150232,22.646880674648287
15987,/media/marda/TWOTB1/xBD/hurricanes/images/florence/hurricane-florence_00000046_pre_disaster.png,59,58,1,364,423,172,230,1365,50.81555215255753,36.39696842558751
15988,/media/marda/TWOTB1/xBD/hurricanes/images/florence/hurricane-florence_00000046_pre_disaster.png,85,59,1,819,904,181,240,1506,58.66760476605589,36.24882115314608
15989,/media/marda/TWOTB1/xBD/hurricanes/images/florence/hurricane-florence_00000046_pre_disaster.png,21,52,1,0,21,186,238,708,46.77711711649655,20.61291075005072
15990,/media/marda/TWOTB1/xBD/hurricanes/images/florence/hurricane-florence_00000046_pre_disaster.png,64,56,1,111,175,202,258,1453,51.14370635231942,38.284993781316054
15991,/media/marda/TWOTB1/xBD/hurricanes/images/florence/hurricane-florence_00000046_pre_disaster.png,88,60,1,776,864,210,270,1545,53.84947023762592,41.93805743561336
15992,/media/marda/TWOTB1/xBD/hurricanes/images/florence/hurricane-florence_00000046_pre_disaster.png,62,59,1,395,457,219,278,1410,52.111235998978415,37.854763806114505
15993,/media/marda/TWOTB1/xBD/hurricanes/images/florence/hurricane-florence_00000046_pre_disaster.png,52,60,1,0,52,230,290,1503,47.82405899813127,41.534922446290814
15994,/media/marda/TWOTB1/xBD/hurricanes/images/florence/hurricane-florence_00000046_pre_disaster.png,67,67,1,151,218,233,300,1833,58.64454038912104,42.21807634883081
15995,/media/marda/TWOTB1/xBD/hurricanes/images/florence/hurricane-florence_00000046_pre_disaster.png,89,56,1,738,827,239,295,1423,51.87364291015818,38.6940334511559
15996,/media/marda/TWOTB1/xBD/hurricanes/images/florence/hurricane-florence_00000046_pre_disaster.png,57,69,1,193,250,261,330,1633,54.43242616939496,39.86809635971552
15997,/media/marda/TWOTB1/xBD/hurricanes/images/florence/hurricane-florence_00000046_pre_disaster.png,52,64,1,34,86,264,328,1445,48.38406463933416,41.25426880311347
15998,/media/marda/TWOTB1/xBD/hurricanes/images/florence/hurricane-florence_00000046_pre_disaster.png,90,61,1,706,796,266,327,1695,54.39357064512418,41.89602282023767
15999,/media/marda/TWOTB1/xBD/hurricanes/images/florence/hurricane-florence_00000046_pre_disaster.png,50,20,1,994,1044,266,286,120,13.808210118138652,11.489125293076057
16000,/media/marda/TWOTB1/xBD/hurricanes/images/florence/hurricane-florence_00000046_pre_disaster.png,69,56,1,405,474,274,330,1590,56.824028530079104,37.71748798007889
16001,/media/marda/TWOTB1/xBD/hurricanes/images/florence/hurricane-florence_00000046_pre_disaster.png,66,49,1,978,1044,291,340,735,37.54546894566727,26.89533284338072
16002,/media/marda/TWOTB1/xBD/hurricanes/images/florence/hurricane-florence_00000046_pre_disaster.png,54,69,1,68,122,295,364,1587,52.427646126889385,41.06057118840121
16003,/media/marda/TWOTB1/xBD/hurricanes/images/florence/hurricane-florence_00000046_pre_disaster.png,56,60,1,241,297,295,355,1405,43.40165227965317,42.88366693187351
16004,/media/marda/TWOTB1/xBD/hurricanes/images/florence/hurricane-florence_00000046_pre_disaster.png,58,72,1,343,401,307,379,1908,57.66196802328264,44.7965645773539
16005,/media/marda/TWOTB1/xBD/hurricanes/images/florence/hurricane-florence_00000046_pre_disaster.png,92,64,1,674,766,309,373,1706,62.33961006124893,39.23049226061157
16006,/media/marda/TWOTB1/xBD/hurricanes/images/florence/hurricane-florence_00000046_pre_disaster.png,57,53,1,295,352,319,372,1439,47.98178494155948,40.164255171190675
16007,/media/marda/TWOTB1/xBD/hurricanes/images/florence/hurricane-florence_00000046_pre_disaster.png,77,59,1,419,496,322,381,1746,59.003429740190256,39.99969679080688
16008,/media/marda/TWOTB1/xBD/hurricanes/images/florence/hurricane-florence_00000046_pre_disaster.png,87,62,1,955,1042,323,385,1299,47.834443561546706,36.60877187522758
16009,/media/marda/TWOTB1/xBD/hurricanes/images/florence/hurricane-florence_00000046_pre_disaster.png,58,64,1,103,161,329,393,1506,47.5135339553263,41.8433634134734
16010,/media/marda/TWOTB1/xBD/hurricanes/images/florence/hurricane-florence_00000046_pre_disaster.png,91,67,1,638,729,339,406,1826,58.17218146059503,43.65693997063399
16011,/media/marda/TWOTB1/xBD/hurricanes/images/florence/hurricane-florence_00000046_pre_disaster.png,59,69,1,142,201,356,425,1769,52.29389873071354,44.55993859797961
16012,/media/marda/TWOTB1/xBD/hurricanes/images/florence/hurricane-florence_00000046_pre_disaster.png,81,68,1,600,681,361,429,1727,55.157213021310746,42.179534043444484
16013,/media/marda/TWOTB1/xBD/hurricanes/images/florence/hurricane-florence_00000046_pre_disaster.png,51,67,1,197,248,383,450,1359,49.05391464263227,37.42043389213061
16014,/media/marda/TWOTB1/xBD/hurricanes/images/florence/hurricane-florence_00000046_pre_disaster.png,27,70,1,0,27,387,457,967,52.79353675420044,25.450371455516176
16015,/media/marda/TWOTB1/xBD/hurricanes/images/florence/hurricane-florence_00000046_pre_disaster.png,76,61,1,561,637,389,450,1369,53.66404951938019,36.92392840881803
16016,/media/marda/TWOTB1/xBD/hurricanes/images/florence/hurricane-florence_00000046_pre_disaster.png,91,64,1,887,978,390,454,1440,53.34011415675129,36.3013360357344
16017,/media/marda/TWOTB1/xBD/hurricanes/images/florence/hurricane-florence_00000046_pre_disaster.png,70,71,1,518,588,399,470,1749,54.041582175032005,43.39861887734448
16018,/media/marda/TWOTB1/xBD/hurricanes/images/florence/hurricane-florence_00000046_pre_disaster.png,55,70,1,238,293,407,477,1470,47.39640077896992,41.90296223929658
16019,/media/marda/TWOTB1/xBD/hurricanes/images/florence/hurricane-florence_00000046_pre_disaster.png,71,71,1,471,542,411,482,2034,58.733361511198716,45.82817751282708
16020,/media/marda/TWOTB1/xBD/hurricanes/images/florence/hurricane-florence_00000046_pre_disaster.png,57,72,1,288,345,413,485,1768,58.97450862480284,40.49886854125594
16021,/media/marda/TWOTB1/xBD/hurricanes/images/florence/hurricane-florence_00000046_pre_disaster.png,87,62,1,852,939,417,479,1407,50.378749461799416,37.69196869411527
16022,/media/marda/TWOTB1/xBD/hurricanes/images/florence/hurricane-florence_00000046_pre_disaster.png,55,68,1,336,391,424,492,1758,52.92990071061564,44.62662464190747
16023,/media/marda/TWOTB1/xBD/hurricanes/images/florence/hurricane-florence_00000046_pre_disaster.png,51,63,1,387,438,424,487,1560,52.13869678202111,39.21085198331041
16024,/media/marda/TWOTB1/xBD/hurricanes/images/florence/hurricane-florence_00000046_pre_disaster.png,48,74,1,7,55,429,503,1452,51.52043411262275,37.62390314936602
16025,/media/marda/TWOTB1/xBD/hurricanes/images/florence/hurricane-florence_00000046_pre_disaster.png,79,65,1,821,900,433,498,1241,48.5598335444609,33.82266096030129
16026,/media/marda/TWOTB1/xBD/hurricanes/images/florence/hurricane-florence_00000046_pre_disaster.png,74,67,1,790,864,450,517,1161,44.181295856125416,35.438661567392174
16027,/media/marda/TWOTB1/xBD/hurricanes/images/florence/hurricane-florence_00000046_pre_disaster.png,82,66,1,749,831,470,536,1487,54.57669593030415,36.21546222645178
16028,/media/marda/TWOTB1/xBD/hurricanes/images/florence/hurricane-florence_00000046_pre_disaster.png,55,79,1,32,87,473,552,1693,54.99248827361415,41.73422066987932
16029,/media/marda/TWOTB1/xBD/hurricanes/images/florence/hurricane-florence_00000046_pre_disaster.png,75,73,1,714,789,490,563,1390,50.88750733557552,36.388260066637706
16030,/media/marda/TWOTB1/xBD/hurricanes/images/florence/hurricane-florence_00000046_pre_disaster.png,77,77,1,452,529,493,570,1904,59.99352459266521,43.072119886349206
16031,/media/marda/TWOTB1/xBD/hurricanes/images/florence/hurricane-florence_00000046_pre_disaster.png,75,75,1,325,400,498,573,1858,55.32693415117079,44.912673753069704
16032,/media/marda/TWOTB1/xBD/hurricanes/images/florence/hurricane-florence_00000046_pre_disaster.png,56,70,1,82,138,499,569,1620,51.59575213350816,42.1183729937436
16033,/media/marda/TWOTB1/xBD/hurricanes/images/florence/hurricane-florence_00000046_pre_disaster.png,84,70,1,960,1044,500,570,1327,52.01370020612295,33.83102214277945
16034,/media/marda/TWOTB1/xBD/hurricanes/images/florence/hurricane-florence_00000046_pre_disaster.png,56,83,1,129,185,504,587,1822,59.581637222105975,41.10204926399009
16035,/media/marda/TWOTB1/xBD/hurricanes/images/florence/hurricane-florence_00000046_pre_disaster.png,79,73,1,673,752,512,585,1636,54.458739529965804,39.43987863285498
16036,/media/marda/TWOTB1/xBD/hurricanes/images/florence/hurricane-florence_00000046_pre_disaster.png,80,77,1,873,953,519,596,1538,51.76436577575511,38.906716863636824
16037,/media/marda/TWOTB1/xBD/hurricanes/images/florence/hurricane-florence_00000046_pre_disaster.png,58,82,1,174,232,529,611,1737,54.86429965562378,42.598227558115944
16038,/media/marda/TWOTB1/xBD/hurricanes/images/florence/hurricane-florence_00000046_pre_disaster.png,69,72,1,287,356,531,603,1731,55.65725474358447,42.00916145896886
16039,/media/marda/TWOTB1/xBD/hurricanes/images/florence/hurricane-florence_00000046_pre_disaster.png,77,73,1,640,717,536,609,1417,48.52151464580903,39.84782640527304
16040,/media/marda/TWOTB1/xBD/hurricanes/images/florence/hurricane-florence_00000046_pre_disaster.png,52,77,1,242,294,538,615,2196,61.86532115544921,46.81087624292124
16041,/media/marda/TWOTB1/xBD/hurricanes/images/florence/hurricane-florence_00000046_pre_disaster.png,84,75,1,430,514,541,616,1823,59.05841125780364,41.320191558689345
16042,/media/marda/TWOTB1/xBD/hurricanes/images/florence/hurricane-florence_00000046_pre_disaster.png,79,72,1,840,919,541,613,1306,51.867104821818394,33.100507340218385
16043,/media/marda/TWOTB1/xBD/hurricanes/images/florence/hurricane-florence_00000046_pre_disaster.png,61,54,1,983,1044,543,597,426,31.027108315841392,19.966184727811793
16044,/media/marda/TWOTB1/xBD/hurricanes/images/florence/hurricane-florence_00000046_pre_disaster.png,80,75,1,803,883,558,633,1524,51.08615047571984,39.09131064117712
16045,/media/marda/TWOTB1/xBD/hurricanes/images/florence/hurricane-florence_00000046_pre_disaster.png,78,74,1,605,683,564,638,1553,52.17209916226178,39.24643445187101
16046,/media/marda/TWOTB1/xBD/hurricanes/images/florence/hurricane-florence_00000046_pre_disaster.png,74,83,1,396,470,578,661,1867,55.6220698968124,45.107702954175664
16047,/media/marda/TWOTB1/xBD/hurricanes/images/florence/hurricane-florence_00000046_pre_disaster.png,77,75,1,770,847,578,653,1360,51.80221961475588,34.893667935826734
16048,/media/marda/TWOTB1/xBD/hurricanes/images/florence/hurricane-florence_00000046_pre_disaster.png,44,87,1,30,74,589,676,1767,59.1577788095734,40.69115389207784
16049,/media/marda/TWOTB1/xBD/hurricanes/images/florence/hurricane-florence_00000046_pre_disaster.png,73,73,1,578,651,597,670,1383,48.49732905421502,37.50056527775069
16050,/media/marda/TWOTB1/xBD/hurricanes/images/florence/hurricane-florence_00000046_pre_disaster.png,45,75,1,78,123,603,678,1419,50.04556648013508,37.25964533880742
16051,/media/marda/TWOTB1/xBD/hurricanes/images/florence/hurricane-florence_00000046_pre_disaster.png,77,72,1,723,800,603,675,1294,43.246436937756144,39.500730508223086
16052,/media/marda/TWOTB1/xBD/hurricanes/images/florence/hurricane-florence_00000046_pre_disaster.png,73,91,1,357,430,608,699,2241,60.289830465056625,48.792847518127886
16053,/media/marda/TWOTB1/xBD/hurricanes/images/florence/hurricane-florence_00000046_pre_disaster.png,51,76,1,115,166,625,701,1525,52.21786024328682,38.53928677283014
16054,/media/marda/TWOTB1/xBD/hurricanes/images/florence/hurricane-florence_00000046_pre_disaster.png,73,70,1,554,627,628,698,1298,48.37924447963544,35.99479866966903
16055,/media/marda/TWOTB1/xBD/hurricanes/images/florence/hurricane-florence_00000046_pre_disaster.png,80,81,1,687,767,630,711,1672,52.463445105464096,41.65582570861059
16056,/media/marda/TWOTB1/xBD/hurricanes/images/florence/hurricane-florence_00000046_pre_disaster.png,61,89,1,319,380,632,721,2068,61.72778826855625,43.79561608622786
16057,/media/marda/TWOTB1/xBD/hurricanes/images/florence/hurricane-florence_00000046_pre_disaster.png,56,87,1,160,216,642,729,1879,60.21306057472064,42.576169500962465
16058,/media/marda/TWOTB1/xBD/hurricanes/images/florence/hurricane-florence_00000046_pre_disaster.png,56,84,1,272,328,648,732,2037,58.9034994987437,45.93369732596659
16059,/media/marda/TWOTB1/xBD/hurricanes/images/florence/hurricane-florence_00000046_pre_disaster.png,49,73,1,222,271,650,723,1663,50.17692095075354,43.14100036964766
16060,/media/marda/TWOTB1/xBD/hurricanes/images/florence/hurricane-florence_00000046_pre_disaster.png,80,71,1,653,733,663,734,1254,46.3403418494433,36.65188351968124
16061,/media/marda/TWOTB1/xBD/hurricanes/images/florence/hurricane-florence_00000046_pre_disaster.png,77,74,1,524,601,664,738,1597,55.86169514793392,37.4611922277424
16062,/media/marda/TWOTB1/xBD/hurricanes/images/florence/hurricane-florence_00000046_pre_disaster.png,60,80,1,32,92,687,767,1874,60.633952927050736,41.53289888776287
16063,/media/marda/TWOTB1/xBD/hurricanes/images/florence/hurricane-florence_00000046_pre_disaster.png,80,77,1,627,707,698,775,1460,51.89997630539484,36.99400705289098
16064,/media/marda/TWOTB1/xBD/hurricanes/images/florence/hurricane-florence_00000046_pre_disaster.png,72,76,1,501,573,700,776,1339,46.24379671217656,38.074552604454304
16065,/media/marda/TWOTB1/xBD/hurricanes/images/florence/hurricane-florence_00000046_pre_disaster.png,75,75,1,921,996,710,785,1456,49.91793775087763,38.21409805925217
16066,/media/marda/TWOTB1/xBD/hurricanes/images/florence/hurricane-florence_00000046_pre_disaster.png,75,69,1,965,1040,712,781,1308,44.21284532919951,38.83186846571722
16067,/media/marda/TWOTB1/xBD/hurricanes/images/florence/hurricane-florence_00000046_pre_disaster.png,74,76,1,883,957,717,793,1323,52.07180100266897,33.56136910969168
16068,/media/marda/TWOTB1/xBD/hurricanes/images/florence/hurricane-florence_00000046_pre_disaster.png,74,81,1,466,540,723,804,1437,61.12651684117387,31.403206015616284
16069,/media/marda/TWOTB1/xBD/hurricanes/images/florence/hurricane-florence_00000046_pre_disaster.png,78,79,1,840,918,729,808,1582,50.9172482373693,40.76878306954132
16070,/media/marda/TWOTB1/xBD/hurricanes/images/florence/hurricane-florence_00000046_pre_disaster.png,71,77,1,604,675,730,807,1236,49.25804049278821,34.19538762460413
16071,/media/marda/TWOTB1/xBD/hurricanes/images/florence/hurricane-florence_00000046_pre_disaster.png,59,76,1,74,133,738,814,1770,59.588784900253565,40.620690938226716
16072,/media/marda/TWOTB1/xBD/hurricanes/images/florence/hurricane-florence_00000046_pre_disaster.png,73,80,1,804,877,740,820,1274,47.827632731284766,36.30273031976512
16073,/media/marda/TWOTB1/xBD/hurricanes/images/florence/hurricane-florence_00000046_pre_disaster.png,68,79,1,429,497,755,834,1404,52.42316878733705,35.69983546178169
16074,/media/marda/TWOTB1/xBD/hurricanes/images/florence/hurricane-florence_00000046_pre_disaster.png,76,78,1,765,841,757,835,1317,52.055495713631856,33.60792437405784
16075,/media/marda/TWOTB1/xBD/hurricanes/images/florence/hurricane-florence_00000046_pre_disaster.png,72,73,1,729,801,783,856,1207,42.830091277768545,37.05598367701834
16076,/media/marda/TWOTB1/xBD/hurricanes/images/florence/hurricane-florence_00000046_pre_disaster.png,74,90,1,690,764,787,877,1495,54.49193504789328,36.09701676863597
16077,/media/marda/TWOTB1/xBD/hurricanes/images/florence/hurricane-florence_00000046_pre_disaster.png,60,75,1,391,451,788,863,1223,46.11835057522391,35.425277968287375
16078,/media/marda/TWOTB1/xBD/hurricanes/images/florence/hurricane-florence_00000046_pre_disaster.png,64,85,1,355,419,793,878,1409,54.80670122874743,34.09386714845191
16079,/media/marda/TWOTB1/xBD/hurricanes/images/florence/hurricane-florence_00000046_pre_disaster.png,72,85,1,548,620,794,879,1498,52.16384801962603,37.37062962622628
16080,/media/marda/TWOTB1/xBD/hurricanes/images/florence/hurricane-florence_00000046_pre_disaster.png,56,92,1,56,112,797,889,1605,53.27590667100416,40.63453430481085
16081,/media/marda/TWOTB1/xBD/hurricanes/images/florence/hurricane-florence_00000046_pre_disaster.png,75,85,1,658,733,807,892,1500,51.6979180472612,38.20482427100884
16082,/media/marda/TWOTB1/xBD/hurricanes/images/florence/hurricane-florence_00000046_pre_disaster.png,64,82,1,980,1044,808,890,1171,54.06830769130675,28.776277901029296
16083,/media/marda/TWOTB1/xBD/hurricanes/images/florence/hurricane-florence_00000046_pre_disaster.png,76,80,1,934,1010,814,894,1503,50.26748507970808,39.170031179579475
16084,/media/marda/TWOTB1/xBD/hurricanes/images/florence/hurricane-florence_00000046_pre_disaster.png,63,83,1,322,385,816,899,1403,48.45909893927253,38.11965731642147
16085,/media/marda/TWOTB1/xBD/hurricanes/images/florence/hurricane-florence_00000046_pre_disaster.png,40,92,1,0,40,820,912,1856,60.49638959970955,40.62132209566032
16086,/media/marda/TWOTB1/xBD/hurricanes/images/florence/hurricane-florence_00000046_pre_disaster.png,77,84,1,892,969,821,905,1447,49.704797620495235,38.10893862724328
16087,/media/marda/TWOTB1/xBD/hurricanes/images/florence/hurricane-florence_00000046_pre_disaster.png,65,81,1,516,581,822,903,1112,43.844617809634215,34.36527073501828
16088,/media/marda/TWOTB1/xBD/hurricanes/images/florence/hurricane-florence_00000046_pre_disaster.png,78,83,1,852,930,834,917,1457,50.34616992758186,37.82696064036706
16089,/media/marda/TWOTB1/xBD/hurricanes/images/florence/hurricane-florence_00000046_pre_disaster.png,63,84,1,293,356,838,922,1504,52.52787088045973,37.3712873741722
16090,/media/marda/TWOTB1/xBD/hurricanes/images/florence/hurricane-florence_00000046_pre_disaster.png,67,85,1,481,548,845,930,1312,49.73622457047805,35.13060558781964
16091,/media/marda/TWOTB1/xBD/hurricanes/images/florence/hurricane-florence_00000046_pre_disaster.png,83,83,1,808,891,852,935,1636,54.016796493995905,39.50221218250083
16092,/media/marda/TWOTB1/xBD/hurricanes/images/florence/hurricane-florence_00000046_pre_disaster.png,78,77,1,583,661,868,945,1350,52.88066252929453,34.049138784985686
16093,/media/marda/TWOTB1/xBD/hurricanes/images/florence/hurricane-florence_00000046_pre_disaster.png,76,88,1,773,849,868,956,1400,50.026604526595776,38.022673777263996
16094,/media/marda/TWOTB1/xBD/hurricanes/images/florence/hurricane-florence_00000046_pre_disaster.png,61,79,1,264,325,869,948,1274,46.877783986359944,35.8612001386257
16095,/media/marda/TWOTB1/xBD/hurricanes/images/florence/hurricane-florence_00000046_pre_disaster.png,93,104,1,405,498,871,975,2688,81.94964703813406,47.52939922375557
16096,/media/marda/TWOTB1/xBD/hurricanes/images/florence/hurricane-florence_00000046_pre_disaster.png,74,89,1,739,813,884,973,1500,51.71119363297917,37.837005069218804
16097,/media/marda/TWOTB1/xBD/hurricanes/images/florence/hurricane-florence_00000046_pre_disaster.png,61,91,1,232,293,886,977,1600,56.983384835284134,36.93443950385479
16098,/media/marda/TWOTB1/xBD/hurricanes/images/florence/hurricane-florence_00000046_pre_disaster.png,74,78,1,599,673,899,977,1096,48.26569422239514,30.944706285834318
16099,/media/marda/TWOTB1/xBD/hurricanes/images/florence/hurricane-florence_00000046_pre_disaster.png,73,90,1,703,776,902,992,1317,47.975076297996836,37.2118245249142
16100,/media/marda/TWOTB1/xBD/hurricanes/images/florence/hurricane-florence_00000046_pre_disaster.png,66,89,1,373,439,908,997,1560,50.85615169350571,39.920062473057875
16101,/media/marda/TWOTB1/xBD/hurricanes/images/florence/hurricane-florence_00000046_pre_disaster.png,60,87,1,212,272,916,1003,1390,50.6508653629491,37.29680312302092
16102,/media/marda/TWOTB1/xBD/hurricanes/images/florence/hurricane-florence_00000046_pre_disaster.png,74,78,1,935,1009,930,1008,1128,41.5559668020259,35.89476601320427
16103,/media/marda/TWOTB1/xBD/hurricanes/images/florence/hurricane-florence_00000046_pre_disaster.png,71,82,1,623,694,931,1013,1223,49.26776291987764,33.52065766802149
16104,/media/marda/TWOTB1/xBD/hurricanes/images/florence/hurricane-florence_00000046_pre_disaster.png,78,85,1,885,963,931,1016,1182,43.11791978101963,37.36127127332628
16105,/media/marda/TWOTB1/xBD/hurricanes/images/florence/hurricane-florence_00000046_pre_disaster.png,63,88,1,340,403,932,1020,1462,49.377337986370065,38.834978283743716
16106,/media/marda/TWOTB1/xBD/hurricanes/images/florence/hurricane-florence_00000046_pre_disaster.png,61,84,1,184,245,947,1031,1445,51.04660612332376,37.03632758110568
16107,/media/marda/TWOTB1/xBD/hurricanes/images/florence/hurricane-florence_00000046_pre_disaster.png,76,82,1,851,927,948,1030,1118,42.23845042042217,34.81914989833996
16108,/media/marda/TWOTB1/xBD/hurricanes/images/florence/hurricane-florence_00000046_pre_disaster.png,68,80,1,976,1044,951,1031,791,38.779190504162585,26.90068683382375
16109,/media/marda/TWOTB1/xBD/hurricanes/images/florence/hurricane-florence_00000046_pre_disaster.png,112,84,1,785,897,958,1042,1862,73.60367688812585,40.56262134054555
16110,/media/marda/TWOTB1/xBD/hurricanes/images/florence/hurricane-florence_00000046_pre_disaster.png,69,82,1,305,374,960,1042,1521,53.0020793309688,37.494033551371274
16111,/media/marda/TWOTB1/xBD/hurricanes/images/florence/hurricane-florence_00000046_pre_disaster.png,77,75,1,630,707,967,1042,1333,54.93470548280779,31.96104914303366
16112,/media/marda/TWOTB1/xBD/hurricanes/images/florence/hurricane-florence_00000046_pre_disaster.png,62,62,1,160,222,980,1042,811,49.86758027871637,23.837144664412566
16113,/media/marda/TWOTB1/xBD/hurricanes/images/florence/hurricane-florence_00000046_pre_disaster.png,44,55,1,289,333,989,1044,284,31.651060895240523,13.33758454533396
16114,/media/marda/TWOTB1/xBD/hurricanes/images/florence/hurricane-florence_00000046_pre_disaster.png,65,50,1,746,811,994,1044,208,40.345309890078084,8.990032747909135
16115,/media/marda/TWOTB1/xBD/hurricanes/images/florence/hurricane-florence_00000114_pre_disaster.png,59,17,1,985,1044,0,17,281,20.2911120003565,18.54380090170219
16116,/media/marda/TWOTB1/xBD/hurricanes/images/florence/hurricane-florence_00000114_pre_disaster.png,66,34,1,978,1044,48,82,510,33.6185971824954,20.181476455312417
16117,/media/marda/TWOTB1/xBD/hurricanes/images/florence/hurricane-florence_00000114_pre_disaster.png,44,39,1,430,474,51,90,698,40.05444376975696,23.180574999430466
16118,/media/marda/TWOTB1/xBD/hurricanes/images/florence/hurricane-florence_00000114_pre_disaster.png,36,25,1,491,527,61,86,319,25.0057039107069,16.734052613801097
16119,/media/marda/TWOTB1/xBD/hurricanes/images/florence/hurricane-florence_00000114_pre_disaster.png,34,16,1,457,491,63,79,136,17.403009510955457,10.458037773848446
16120,/media/marda/TWOTB1/xBD/hurricanes/images/florence/hurricane-florence_00000114_pre_disaster.png,41,30,1,316,357,70,100,707,32.14888627895113,28.89545330069105
16121,/media/marda/TWOTB1/xBD/hurricanes/images/florence/hurricane-florence_00000114_pre_disaster.png,66,28,1,687,753,169,197,716,41.756308466515755,22.418267951711123
16122,/media/marda/TWOTB1/xBD/hurricanes/images/florence/hurricane-florence_00000114_pre_disaster.png,56,44,1,500,556,245,289,686,37.18362385819848,24.263746773235916
16123,/media/marda/TWOTB1/xBD/hurricanes/images/florence/hurricane-florence_00000114_pre_disaster.png,33,41,1,107,140,346,387,642,34.37354153021851,26.272078451385447
16124,/media/marda/TWOTB1/xBD/hurricanes/images/florence/hurricane-florence_00000114_pre_disaster.png,46,48,1,372,418,364,412,749,34.3225676923177,28.867049115628344
16125,/media/marda/TWOTB1/xBD/hurricanes/images/florence/hurricane-florence_00000114_pre_disaster.png,45,41,1,186,231,391,432,854,40.929820343851816,27.721003869497466
16126,/media/marda/TWOTB1/xBD/hurricanes/images/florence/hurricane-florence_00000026_pre_disaster.png,72,15,1,937,1009,0,15,325,42.02076568373016,12.154004643237483
16127,/media/marda/TWOTB1/xBD/hurricanes/images/florence/hurricane-florence_00000026_pre_disaster.png,62,56,1,950,1012,78,134,827,61.08370598746097,18.417968893850215
16128,/media/marda/TWOTB1/xBD/hurricanes/images/florence/hurricane-florence_00000026_pre_disaster.png,47,24,1,741,788,119,143,274,19.38975346203623,18.940039173400258
16129,/media/marda/TWOTB1/xBD/hurricanes/images/florence/hurricane-florence_00000026_pre_disaster.png,81,26,1,767,848,120,146,660,57.39011786791823,16.114468005349543
16130,/media/marda/TWOTB1/xBD/hurricanes/images/florence/hurricane-florence_00000026_pre_disaster.png,65,54,1,434,499,159,213,805,64.11692795564436,16.751288804421666
16131,/media/marda/TWOTB1/xBD/hurricanes/images/florence/hurricane-florence_00000026_pre_disaster.png,54,18,1,932,986,163,181,181,18.79767402815377,13.014502769334179
16132,/media/marda/TWOTB1/xBD/hurricanes/images/florence/hurricane-florence_00000026_pre_disaster.png,63,24,1,884,947,165,189,382,28.490294864715185,17.842346100218027
16133,/media/marda/TWOTB1/xBD/hurricanes/images/florence/hurricane-florence_00000026_pre_disaster.png,31,39,1,349,380,177,216,511,37.96570809773614,18.005254189500036
16134,/media/marda/TWOTB1/xBD/hurricanes/images/florence/hurricane-florence_00000026_pre_disaster.png,67,56,1,592,659,177,233,1212,47.24614113872681,35.23894568710623
16135,/media/marda/TWOTB1/xBD/hurricanes/images/florence/hurricane-florence_00000026_pre_disaster.png,58,51,1,242,300,276,327,692,61.36728077899422,15.051800538016835
16136,/media/marda/TWOTB1/xBD/hurricanes/images/florence/hurricane-florence_00000026_pre_disaster.png,89,63,1,713,802,346,409,1694,63.92063803908711,38.81852213306648
16137,/media/marda/TWOTB1/xBD/hurricanes/images/florence/hurricane-florence_00000026_pre_disaster.png,58,35,1,622,680,382,417,618,37.20510506359476,22.18963873380097
16138,/media/marda/TWOTB1/xBD/hurricanes/images/florence/hurricane-florence_00000026_pre_disaster.png,62,60,1,756,818,451,511,1123,48.129566951916466,31.448343889450832
16139,/media/marda/TWOTB1/xBD/hurricanes/images/florence/hurricane-florence_00000026_pre_disaster.png,41,29,1,771,812,503,532,112,14.419855277207477,10.306349257078447
16140,/media/marda/TWOTB1/xBD/hurricanes/images/florence/hurricane-florence_00000026_pre_disaster.png,25,53,1,255,280,552,605,391,36.05132084610336,15.483067270802803
16141,/media/marda/TWOTB1/xBD/hurricanes/images/florence/hurricane-florence_00000026_pre_disaster.png,23,73,1,30,53,888,961,433,40.55487908946226,14.256449585621402
16142,/media/marda/TWOTB1/xBD/hurricanes/images/florence/hurricane-florence_00000026_pre_disaster.png,24,52,1,251,275,888,940,118,16.785973568813773,9.423948738124006
16143,/media/marda/TWOTB1/xBD/hurricanes/images/florence/hurricane-florence_00000026_pre_disaster.png,74,111,1,294,368,922,1033,1868,87.60886862700382,34.01385917176033
16144,/media/marda/TWOTB1/xBD/hurricanes/images/florence/hurricane-florence_00000026_pre_disaster.png,41,62,1,247,288,928,990,413,33.81342390866452,16.316612085456562
16145,/media/marda/TWOTB1/xBD/hurricanes/images/florence/hurricane-florence_00000026_pre_disaster.png,47,42,1,989,1036,931,973,36,8.160260731786414,5.8754792060202
16146,/media/marda/TWOTB1/xBD/hurricanes/images/florence/hurricane-florence_00000026_pre_disaster.png,80,96,1,953,1033,941,1037,1791,64.14922774454175,40.463129393711704
16147,/media/marda/TWOTB1/xBD/hurricanes/images/florence/hurricane-florence_00000026_pre_disaster.png,39,59,1,249,288,948,1007,361,32.831480094013216,14.64343617037318
16148,/media/marda/TWOTB1/xBD/hurricanes/images/florence/hurricane-florence_00000026_pre_disaster.png,66,80,1,820,886,962,1042,833,44.67744861659751,30.402201614927556
16149,/media/marda/TWOTB1/xBD/hurricanes/images/florence/hurricane-florence_00000026_pre_disaster.png,61,69,1,747,808,973,1042,807,41.60018251648879,26.75421387135346
16150,/media/marda/TWOTB1/xBD/hurricanes/images/florence/hurricane-florence_00000026_pre_disaster.png,43,55,1,666,709,989,1044,219,19.494934640124672,15.087343383598682
16151,/media/marda/TWOTB1/xBD/hurricanes/images/florence/hurricane-florence_00000516_pre_disaster.png,43,48,1,405,448,614,662,409,26.77038395428104,20.299572668109995
16152,/media/marda/TWOTB1/xBD/hurricanes/images/florence/hurricane-florence_00000516_pre_disaster.png,41,50,1,257,298,652,702,573,32.59074656177618,23.505983014415275
16153,/media/marda/TWOTB1/xBD/hurricanes/images/florence/hurricane-florence_00000516_pre_disaster.png,42,51,1,429,471,697,748,395,27.41055488786438,19.200767678859314
16154,/media/marda/TWOTB1/xBD/hurricanes/images/florence/hurricane-florence_00000516_pre_disaster.png,31,50,1,271,302,762,812,333,22.79982118162068,19.44339566975916
16155,/media/marda/TWOTB1/xBD/hurricanes/images/florence/hurricane-florence_00000516_pre_disaster.png,32,46,1,392,424,809,855,116,14.206053510986589,10.968018837605
16156,/media/marda/TWOTB1/xBD/hurricanes/images/florence/hurricane-florence_00000516_pre_disaster.png,24,43,1,371,395,813,856,93,12.494889354398172,10.112390579088094
16157,/media/marda/TWOTB1/xBD/hurricanes/images/florence/hurricane-florence_00000516_pre_disaster.png,31,45,1,414,445,841,886,135,15.980995022832953,11.38365280420165
16158,/media/marda/TWOTB1/xBD/hurricanes/images/florence/hurricane-florence_00000516_pre_disaster.png,26,40,1,473,499,843,883,80,11.489125293076057,9.16515138991168
16159,/media/marda/TWOTB1/xBD/hurricanes/images/florence/hurricane-florence_00000516_pre_disaster.png,34,44,1,526,560,853,897,85,12.329467184312398,9.253179581990683
16160,/media/marda/TWOTB1/xBD/hurricanes/images/florence/hurricane-florence_00000516_pre_disaster.png,41,52,1,520,561,871,923,219,19.65762118019865,14.728616867984192
16161,/media/marda/TWOTB1/xBD/hurricanes/images/florence/hurricane-florence_00000516_pre_disaster.png,79,62,1,324,403,879,941,1435,74.38553750421636,25.765188424769153
16162,/media/marda/TWOTB1/xBD/hurricanes/images/florence/hurricane-florence_00000516_pre_disaster.png,42,52,1,539,581,879,931,225,19.910580995931568,14.920489647395259
16163,/media/marda/TWOTB1/xBD/hurricanes/images/florence/hurricane-florence_00000516_pre_disaster.png,45,61,1,546,591,896,957,331,21.24252425734204,20.800734867576672
16164,/media/marda/TWOTB1/xBD/hurricanes/images/florence/hurricane-florence_00000516_pre_disaster.png,56,58,1,785,841,936,994,536,29.494457300588575,24.258234262010195
16165,/media/marda/TWOTB1/xBD/hurricanes/images/florence/hurricane-florence_00000516_pre_disaster.png,33,48,1,552,585,937,985,138,14.51877838798582,12.735505559098298
16166,/media/marda/TWOTB1/xBD/hurricanes/images/florence/hurricane-florence_00000516_pre_disaster.png,43,59,1,501,544,940,999,338,26.773721078501488,17.77963569591478
16167,/media/marda/TWOTB1/xBD/hurricanes/images/florence/hurricane-florence_00000516_pre_disaster.png,35,56,1,379,414,953,1009,242,20.93607871429652,15.22135869260961
16168,/media/marda/TWOTB1/xBD/hurricanes/images/florence/hurricane-florence_00000516_pre_disaster.png,30,45,1,498,528,954,999,67,11.38107194928195,7.6079184951775085
16169,/media/marda/TWOTB1/xBD/hurricanes/images/florence/hurricane-florence_00000516_pre_disaster.png,48,68,1,457,505,960,1028,562,27.902528641857128,26.866954368282112
16170,/media/marda/TWOTB1/xBD/hurricanes/images/florence/hurricane-florence_00000516_pre_disaster.png,47,67,1,347,394,975,1042,752,33.86211968766968,30.037133026364838
16171,/media/marda/TWOTB1/xBD/hurricanes/images/florence/hurricane-florence_00000509_pre_disaster.png,65,61,1,0,65,491,552,1954,74.16325162444535,35.175509986396065
16172,/media/marda/TWOTB1/xBD/hurricanes/images/florence/hurricane-florence_00000509_pre_disaster.png,134,100,1,724,858,830,930,3081,118.82402432475256,35.07384348958979
16173,/media/marda/TWOTB1/xBD/hurricanes/images/florence/hurricane-florence_00000509_pre_disaster.png,140,98,1,703,843,883,981,2990,119.85833406043159,33.61841677133411
16174,/media/marda/TWOTB1/xBD/hurricanes/images/florence/hurricane-florence_00000509_pre_disaster.png,47,63,1,647,694,917,980,293,28.676023072421405,13.640317513706234
16175,/media/marda/TWOTB1/xBD/hurricanes/images/florence/hurricane-florence_00000509_pre_disaster.png,54,78,1,614,668,931,1009,470,47.559122463878424,13.194598189935022
16176,/media/marda/TWOTB1/xBD/hurricanes/images/florence/hurricane-florence_00000509_pre_disaster.png,132,80,1,677,809,962,1042,2032,99.41326708212922,31.04249569462263
16177,/media/marda/TWOTB1/xBD/hurricanes/images/florence/hurricane-florence_00000509_pre_disaster.png,33,45,1,605,638,974,1019,67,9.475813673564893,8.957611621975428
16178,/media/marda/TWOTB1/xBD/hurricanes/images/florence/hurricane-florence_00000395_pre_disaster.png,55,24,1,127,182,1,25,597,56.37727074337616,14.154894179068354
16179,/media/marda/TWOTB1/xBD/hurricanes/images/florence/hurricane-florence_00000395_pre_disaster.png,16,15,1,0,16,38,53,165,16.301021410831364,13.742593876517413
16180,/media/marda/TWOTB1/xBD/hurricanes/images/florence/hurricane-florence_00000395_pre_disaster.png,74,39,1,814,888,76,115,1156,44.69190505744348,34.2090743809288
16181,/media/marda/TWOTB1/xBD/hurricanes/images/florence/hurricane-florence_00000395_pre_disaster.png,96,75,1,602,698,143,218,3696,72.66916525965249,67.75724274756698
16182,/media/marda/TWOTB1/xBD/hurricanes/images/florence/hurricane-florence_00000395_pre_disaster.png,52,59,1,145,197,185,244,1605,62.04128481666582,37.18812543266331
16183,/media/marda/TWOTB1/xBD/hurricanes/images/florence/hurricane-florence_00000395_pre_disaster.png,70,39,1,806,876,189,228,746,46.415554267508234,23.989584545660563
16184,/media/marda/TWOTB1/xBD/hurricanes/images/florence/hurricane-florence_00000395_pre_disaster.png,42,26,1,560,602,193,219,369,22.733955665718057,21.209987454882132
16185,/media/marda/TWOTB1/xBD/hurricanes/images/florence/hurricane-florence_00000395_pre_disaster.png,40,21,1,540,580,197,218,248,20.49221560135793,15.990954286666039
16186,/media/marda/TWOTB1/xBD/hurricanes/images/florence/hurricane-florence_00000395_pre_disaster.png,55,59,1,330,385,198,257,1341,52.6186495240165,35.45398240182038
16187,/media/marda/TWOTB1/xBD/hurricanes/images/florence/hurricane-florence_00000395_pre_disaster.png,64,39,1,896,960,209,248,653,30.46985406103482,28.440283256478867
16188,/media/marda/TWOTB1/xBD/hurricanes/images/florence/hurricane-florence_00000395_pre_disaster.png,55,24,1,952,1007,230,254,181,17.748262017343876,13.700591028840982
16189,/media/marda/TWOTB1/xBD/hurricanes/images/florence/hurricane-florence_00000395_pre_disaster.png,36,32,1,280,316,242,274,450,27.775723092960092,21.432998021603687
16190,/media/marda/TWOTB1/xBD/hurricanes/images/florence/hurricane-florence_00000395_pre_disaster.png,48,30,1,333,381,255,285,514,38.70653418164042,17.516115728342555
16191,/media/marda/TWOTB1/xBD/hurricanes/images/florence/hurricane-florence_00000395_pre_disaster.png,27,26,1,11,38,264,290,293,27.420837263677804,14.300737999424683
16192,/media/marda/TWOTB1/xBD/hurricanes/images/florence/hurricane-florence_00000395_pre_disaster.png,37,38,1,280,317,265,303,638,31.792752917070132,26.810907799065568
16193,/media/marda/TWOTB1/xBD/hurricanes/images/florence/hurricane-florence_00000395_pre_disaster.png,39,51,1,70,109,290,341,1108,42.06250686081947,34.803797039471405
16194,/media/marda/TWOTB1/xBD/hurricanes/images/florence/hurricane-florence_00000395_pre_disaster.png,60,60,1,713,773,524,584,904,38.91006412551568,30.412469427868462
16195,/media/marda/TWOTB1/xBD/hurricanes/images/florence/hurricane-florence_00000395_pre_disaster.png,63,58,1,672,735,526,584,1095,41.66352443427491,34.87101727848831
16196,/media/marda/TWOTB1/xBD/hurricanes/images/florence/hurricane-florence_00000395_pre_disaster.png,61,72,1,746,807,561,633,1246,56.313623509180054,29.537092902068483
16197,/media/marda/TWOTB1/xBD/hurricanes/images/florence/hurricane-florence_00000167_post_disaster.png,50,40,1,500,550,566,606,360,29.96862490014229,15.709301030870916
16198,/media/marda/TWOTB1/xBD/hurricanes/images/florence/hurricane-florence_00000167_post_disaster.png,50,59,1,479,529,593,652,606,37.03604337025236,21.89579576544291
16199,/media/marda/TWOTB1/xBD/hurricanes/images/florence/hurricane-florence_00000167_post_disaster.png,59,73,1,437,496,637,710,991,50.84597848813588,26.1115433945049
16200,/media/marda/TWOTB1/xBD/hurricanes/images/florence/hurricane-florence_00000167_post_disaster.png,52,67,1,495,547,833,900,655,33.599208277428254,26.021489842504355
16201,/media/marda/TWOTB1/xBD/hurricanes/images/florence/hurricane-florence_00000275_pre_disaster.png,67,27,1,838,905,0,27,784,38.12166110074372,27.57523817140127
16202,/media/marda/TWOTB1/xBD/hurricanes/images/florence/hurricane-florence_00000007_pre_disaster.png,75,37,1,62,137,0,37,1434,74.03572481216295,29.370318622577035
16203,/media/marda/TWOTB1/xBD/hurricanes/images/florence/hurricane-florence_00000007_pre_disaster.png,98,72,1,541,639,157,229,2877,69.91449641773096,54.40420356197186
16204,/media/marda/TWOTB1/xBD/hurricanes/images/florence/hurricane-florence_00000007_pre_disaster.png,97,86,1,453,550,235,321,3173,69.59894248529406,61.31446941726855
16205,/media/marda/TWOTB1/xBD/hurricanes/images/florence/hurricane-florence_00000007_pre_disaster.png,89,85,1,511,600,273,358,2697,66.77900670061824,55.917626108235964
16206,/media/marda/TWOTB1/xBD/hurricanes/images/florence/hurricane-florence_00000007_pre_disaster.png,118,96,1,754,872,414,510,3431,79.48973244530225,65.39437542962871
16207,/media/marda/TWOTB1/xBD/hurricanes/images/florence/hurricane-florence_00000007_pre_disaster.png,70,80,1,335,405,489,569,1807,67.71999919104275,35.316455133372244
16208,/media/marda/TWOTB1/xBD/hurricanes/images/florence/hurricane-florence_00000007_pre_disaster.png,77,105,1,967,1044,536,641,1577,73.4561012725015,35.403307632960086
16209,/media/marda/TWOTB1/xBD/hurricanes/images/florence/hurricane-florence_00000007_pre_disaster.png,87,100,1,477,564,542,642,2658,82.69277886140232,42.8716324532392
16210,/media/marda/TWOTB1/xBD/hurricanes/images/florence/hurricane-florence_00000007_pre_disaster.png,69,85,1,569,638,593,678,1215,68.18983015199133,23.592961263472194
16211,/media/marda/TWOTB1/xBD/hurricanes/images/florence/hurricane-florence_00000007_pre_disaster.png,67,49,1,959,1026,600,649,380,26.48504309577543,19.11265912300834
16212,/media/marda/TWOTB1/xBD/hurricanes/images/florence/hurricane-florence_00000007_pre_disaster.png,123,101,1,620,743,660,761,3117,106.68232263680568,38.967881235297476
16213,/media/marda/TWOTB1/xBD/hurricanes/images/florence/hurricane-florence_00000007_pre_disaster.png,98,102,1,760,858,730,832,2579,81.99379536356253,43.23174993430077
16214,/media/marda/TWOTB1/xBD/hurricanes/images/florence/hurricane-florence_00000007_pre_disaster.png,89,84,1,606,695,735,819,1784,64.63168534136081,36.769560355861934
16215,/media/marda/TWOTB1/xBD/hurricanes/images/florence/hurricane-florence_00000007_pre_disaster.png,128,134,1,869,997,820,954,4820,99.79243084454588,64.41958941764425
16216,/media/marda/TWOTB1/xBD/hurricanes/images/florence/hurricane-florence_00000007_pre_disaster.png,285,170,1,176,461,870,1040,15382,263.79495942552,85.76551211707996
16217,/media/marda/TWOTB1/xBD/hurricanes/images/florence/hurricane-florence_00000007_pre_disaster.png,68,92,1,976,1044,880,972,1029,56.47868256798674,27.198443683658304
16218,/media/marda/TWOTB1/xBD/hurricanes/images/florence/hurricane-florence_00000321_post_disaster.png,18,34,1,0,18,0,34,467,36.001283433605515,17.54449384574341
16219,/media/marda/TWOTB1/xBD/hurricanes/images/florence/hurricane-florence_00000321_post_disaster.png,56,43,1,271,327,0,43,1282,49.68084510201215,34.199460121984764
16220,/media/marda/TWOTB1/xBD/hurricanes/images/florence/hurricane-florence_00000321_post_disaster.png,35,6,1,423,458,0,6,74,19.89338127365119,5.119098663691625
16221,/media/marda/TWOTB1/xBD/hurricanes/images/florence/hurricane-florence_00000321_post_disaster.png,22,14,1,294,316,42,56,113,12.829987601049007,11.867124712846678
16222,/media/marda/TWOTB1/xBD/hurricanes/images/florence/hurricane-florence_00000321_post_disaster.png,40,33,1,333,373,44,77,497,30.92514879647632,21.343706293954877
16223,/media/marda/TWOTB1/xBD/hurricanes/images/florence/hurricane-florence_00000321_post_disaster.png,35,30,1,242,277,73,103,595,30.966260796339913,25.660613637729227
16224,/media/marda/TWOTB1/xBD/hurricanes/images/florence/hurricane-florence_00000321_post_disaster.png,39,39,1,40,79,125,164,838,38.09342379590995,28.920851481256992
16225,/media/marda/TWOTB1/xBD/hurricanes/images/florence/hurricane-florence_00000321_post_disaster.png,27,23,1,160,187,187,210,255,22.501803691380335,15.18546812984027
16226,/media/marda/TWOTB1/xBD/hurricanes/images/florence/hurricane-florence_00000321_post_disaster.png,20,28,1,83,103,303,331,155,16.121156195293626,12.892083024738408
16227,/media/marda/TWOTB1/xBD/hurricanes/images/florence/hurricane-florence_00000321_post_disaster.png,62,53,1,109,171,376,429,1425,62.832858615928345,30.840433753638973
16228,/media/marda/TWOTB1/xBD/hurricanes/images/florence/hurricane-florence_00000321_post_disaster.png,50,50,1,233,283,381,431,960,41.123024178671805,34.47820024483002
16229,/media/marda/TWOTB1/xBD/hurricanes/images/florence/hurricane-florence_00000321_post_disaster.png,26,69,1,0,26,549,618,913,47.63386185309406,26.01740811030004
16230,/media/marda/TWOTB1/xBD/hurricanes/images/florence/hurricane-florence_00000321_post_disaster.png,54,72,1,2,56,654,726,1462,53.398367953082506,38.33702414251542
16231,/media/marda/TWOTB1/xBD/hurricanes/images/florence/hurricane-florence_00000321_post_disaster.png,60,82,1,260,320,814,896,1437,48.71990047857914,40.519537728132846
16232,/media/marda/TWOTB1/xBD/hurricanes/images/florence/hurricane-florence_00000321_post_disaster.png,26,46,1,301,327,837,883,122,13.176564067268837,12.488071503357235
16233,/media/marda/TWOTB1/xBD/hurricanes/images/florence/hurricane-florence_00000321_post_disaster.png,57,73,1,90,147,913,986,1168,53.89052553305672,30.486611649986045
16234,/media/marda/TWOTB1/xBD/hurricanes/images/florence/hurricane-florence_00000321_post_disaster.png,29,63,1,44,73,914,977,474,28.44112434503341,22.057675959134656
16235,/media/marda/TWOTB1/xBD/hurricanes/images/florence/hurricane-florence_00000321_post_disaster.png,32,61,1,62,94,944,1005,523,33.56284928398324,20.38426118464931
16236,/media/marda/TWOTB1/xBD/hurricanes/images/florence/hurricane-florence_00000321_post_disaster.png,18,51,1,39,57,964,1015,158,16.884388333670664,12.462818821037887
16237,/media/marda/TWOTB1/xBD/hurricanes/images/florence/hurricane-florence_00000321_post_disaster.png,30,51,1,387,417,979,1030,119,13.652046121732107,11.70035219340214
16238,/media/marda/TWOTB1/xBD/hurricanes/images/florence/hurricane-florence_00000321_post_disaster.png,37,34,1,103,140,150,184,619,31.287236565425285,26.43598796147956
16239,/media/marda/TWOTB1/xBD/hurricanes/images/florence/hurricane-florence_00000321_post_disaster.png,34,31,1,170,204,381,412,337,29.187367686459908,15.200171146853455
16240,/media/marda/TWOTB1/xBD/hurricanes/images/florence/hurricane-florence_00000350_post_disaster.png,86,29,1,953,1039,0,29,894,52.151972491354485,24.858737498067537
16241,/media/marda/TWOTB1/xBD/hurricanes/images/florence/hurricane-florence_00000350_post_disaster.png,59,18,1,928,987,31,49,295,24.65480429886255,16.01192814827688
16242,/media/marda/TWOTB1/xBD/hurricanes/images/florence/hurricane-florence_00000350_post_disaster.png,89,48,1,823,912,46,94,1576,60.477244571159495,34.767186955990496
16243,/media/marda/TWOTB1/xBD/hurricanes/images/florence/hurricane-florence_00000350_post_disaster.png,56,18,1,881,937,56,74,266,22.4252175394813,15.779925573914856
16244,/media/marda/TWOTB1/xBD/hurricanes/images/florence/hurricane-florence_00000350_post_disaster.png,88,36,1,912,1000,70,106,1312,55.03677064469585,33.06646106229974
16245,/media/marda/TWOTB1/xBD/hurricanes/images/florence/hurricane-florence_00000350_post_disaster.png,56,26,1,857,913,116,142,270,19.916897910961602,18.127086133143614
16246,/media/marda/TWOTB1/xBD/hurricanes/images/florence/hurricane-florence_00000350_post_disaster.png,53,20,1,888,941,125,145,241,18.916875136410727,17.01688269948171
16247,/media/marda/TWOTB1/xBD/hurricanes/images/florence/hurricane-florence_00000350_post_disaster.png,64,27,1,960,1024,127,154,522,27.68827137154094,25.135300191528998
16248,/media/marda/TWOTB1/xBD/hurricanes/images/florence/hurricane-florence_00000350_post_disaster.png,43,17,1,694,737,170,187,181,17.362951257540384,13.898902512096015
16249,/media/marda/TWOTB1/xBD/hurricanes/images/florence/hurricane-florence_00000350_post_disaster.png,78,22,1,953,1031,172,194,590,45.21253321308984,17.42790650654894
16250,/media/marda/TWOTB1/xBD/hurricanes/images/florence/hurricane-florence_00000350_post_disaster.png,169,55,1,722,891,175,230,5828,160.2274434525232,48.511343871482936
16251,/media/marda/TWOTB1/xBD/hurricanes/images/florence/hurricane-florence_00000350_post_disaster.png,171,101,1,554,725,178,279,6307,160.9678556485118,52.17050196420993
16252,/media/marda/TWOTB1/xBD/hurricanes/images/florence/hurricane-florence_00000350_post_disaster.png,76,32,1,953,1029,197,229,895,41.02678562536708,28.4852433204177
16253,/media/marda/TWOTB1/xBD/hurricanes/images/florence/hurricane-florence_00000350_post_disaster.png,56,47,1,342,398,236,283,1173,44.812639214790785,34.625393792110536
16254,/media/marda/TWOTB1/xBD/hurricanes/images/florence/hurricane-florence_00000350_post_disaster.png,65,41,1,958,1023,238,279,795,36.67613553379303,28.888119860584883
16255,/media/marda/TWOTB1/xBD/hurricanes/images/florence/hurricane-florence_00000350_post_disaster.png,36,27,1,458,494,251,278,326,22.300337194297523,19.549414917007557
16256,/media/marda/TWOTB1/xBD/hurricanes/images/florence/hurricane-florence_00000350_post_disaster.png,158,59,1,755,913,276,335,5473,143.4063524998317,50.615206035625945
16257,/media/marda/TWOTB1/xBD/hurricanes/images/florence/hurricane-florence_00000350_post_disaster.png,50,59,1,455,505,279,338,1486,56.04192463642901,35.27335398142633
16258,/media/marda/TWOTB1/xBD/hurricanes/images/florence/hurricane-florence_00000350_post_disaster.png,69,62,1,619,688,297,359,1264,52.12083660622499,32.64010050007239
16259,/media/marda/TWOTB1/xBD/hurricanes/images/florence/hurricane-florence_00000350_post_disaster.png,81,42,1,950,1031,325,367,1053,47.94333863975516,29.66825817789545
16260,/media/marda/TWOTB1/xBD/hurricanes/images/florence/hurricane-florence_00000350_post_disaster.png,59,50,1,918,977,338,388,764,40.94896545878365,24.820729382240966
16261,/media/marda/TWOTB1/xBD/hurricanes/images/florence/hurricane-florence_00000350_post_disaster.png,32,39,1,8,40,402,441,596,34.96824021017449,23.46454000729472
16262,/media/marda/TWOTB1/xBD/hurricanes/images/florence/hurricane-florence_00000350_post_disaster.png,34,39,1,84,118,414,453,724,36.36884968056355,26.523555826598066
16263,/media/marda/TWOTB1/xBD/hurricanes/images/florence/hurricane-florence_00000350_post_disaster.png,59,50,1,856,915,431,481,809,37.62504225873571,28.741569045972792
16264,/media/marda/TWOTB1/xBD/hurricanes/images/florence/hurricane-florence_00000350_post_disaster.png,66,49,1,894,960,440,489,870,38.603516830168,30.732514926016954
16265,/media/marda/TWOTB1/xBD/hurricanes/images/florence/hurricane-florence_00000350_post_disaster.png,96,94,1,931,1027,480,574,2199,102.75307305495433,41.82120238084831
16266,/media/marda/TWOTB1/xBD/hurricanes/images/florence/hurricane-florence_00000350_post_disaster.png,33,43,1,0,33,485,528,698,37.48662821216214,24.87336920609106
16267,/media/marda/TWOTB1/xBD/hurricanes/images/florence/hurricane-florence_00000350_post_disaster.png,73,61,1,485,558,492,553,1310,61.734381640354705,33.044486020425246
16268,/media/marda/TWOTB1/xBD/hurricanes/images/florence/hurricane-florence_00000350_post_disaster.png,37,44,1,538,575,528,572,358,26.737459427181676,17.874271658127224
16269,/media/marda/TWOTB1/xBD/hurricanes/images/florence/hurricane-florence_00000350_post_disaster.png,42,60,1,514,556,808,868,561,30.132636684458795,24.886864170893976
16270,/media/marda/TWOTB1/xBD/hurricanes/images/florence/hurricane-florence_00000350_post_disaster.png,55,53,1,848,903,819,872,425,25.830438295330612,21.803862155039468
16271,/media/marda/TWOTB1/xBD/hurricanes/images/florence/hurricane-florence_00000350_post_disaster.png,60,82,1,372,432,826,908,1621,50.986003995839525,42.51721415999727
16272,/media/marda/TWOTB1/xBD/hurricanes/images/florence/hurricane-florence_00000350_post_disaster.png,78,83,1,778,856,833,916,1791,56.55076499877427,45.15873956967123
16273,/media/marda/TWOTB1/xBD/hurricanes/images/florence/hurricane-florence_00000350_post_disaster.png,63,73,1,437,500,834,907,1242,51.124353603139845,34.85763241902976
16274,/media/marda/TWOTB1/xBD/hurricanes/images/florence/hurricane-florence_00000350_post_disaster.png,76,66,1,685,761,834,900,1278,55.669866297136416,31.97308308827953
16275,/media/marda/TWOTB1/xBD/hurricanes/images/florence/hurricane-florence_00000350_post_disaster.png,69,68,1,869,938,839,907,1107,38.98834370419151,37.44485553248967
16276,/media/marda/TWOTB1/xBD/hurricanes/images/florence/hurricane-florence_00000350_post_disaster.png,44,69,1,526,570,840,909,697,40.038547098072975,23.444538986876644
16277,/media/marda/TWOTB1/xBD/hurricanes/images/florence/hurricane-florence_00000350_post_disaster.png,34,51,1,262,296,880,931,285,23.838072391112167,16.01777160050847
16278,/media/marda/TWOTB1/xBD/hurricanes/images/florence/hurricane-florence_00000350_post_disaster.png,58,83,1,253,311,898,981,1189,46.286287781727566,34.327110346690816
16279,/media/marda/TWOTB1/xBD/hurricanes/images/florence/hurricane-florence_00000350_post_disaster.png,61,86,1,205,266,955,1041,1397,50.44127966714347,37.73427651292897
16280,/media/marda/TWOTB1/xBD/hurricanes/images/florence/hurricane-florence_00000350_post_disaster.png,78,72,1,526,604,969,1041,1762,63.41462169835216,37.00556301853108
16281,/media/marda/TWOTB1/xBD/hurricanes/images/florence/hurricane-florence_00000350_post_disaster.png,86,62,1,669,755,979,1041,1239,64.32924445704197,25.901776485613528
16282,/media/marda/TWOTB1/xBD/hurricanes/images/florence/hurricane-florence_00000461_pre_disaster.png,69,47,1,975,1044,485,532,517,36.426707548106556,20.594328047880587
16283,/media/marda/TWOTB1/xBD/hurricanes/images/florence/hurricane-florence_00000461_pre_disaster.png,61,55,1,983,1044,511,566,508,32.459154533858936,21.623728386005723
16284,/media/marda/TWOTB1/xBD/hurricanes/images/florence/hurricane-florence_00000461_pre_disaster.png,22,47,1,216,238,784,831,235,20.973855893423007,14.970990025497503
16285,/media/marda/TWOTB1/xBD/hurricanes/images/florence/hurricane-florence_00000461_pre_disaster.png,185,130,1,481,666,795,925,4776,195.93603742405833,32.523296660246075
16286,/media/marda/TWOTB1/xBD/hurricanes/images/florence/hurricane-florence_00000461_pre_disaster.png,60,73,1,402,462,806,879,1029,40.81059731618093,33.62421172068552
16287,/media/marda/TWOTB1/xBD/hurricanes/images/florence/hurricane-florence_00000461_pre_disaster.png,40,58,1,490,530,806,864,306,25.98543859823516,15.734691298818518
16288,/media/marda/TWOTB1/xBD/hurricanes/images/florence/hurricane-florence_00000461_pre_disaster.png,29,46,1,475,504,832,878,88,13.337867977313683,8.887266690310852
16289,/media/marda/TWOTB1/xBD/hurricanes/images/florence/hurricane-florence_00000461_pre_disaster.png,186,133,1,500,686,840,973,5092,194.82949710105504,34.78529737018642
16290,/media/marda/TWOTB1/xBD/hurricanes/images/florence/hurricane-florence_00000461_pre_disaster.png,29,46,1,410,439,857,903,111,13.431642648187653,11.009924662527329
16291,/media/marda/TWOTB1/xBD/hurricanes/images/florence/hurricane-florence_00000461_pre_disaster.png,34,58,1,460,494,906,964,225,22.35190884512848,13.281934751087805
16292,/media/marda/TWOTB1/xBD/hurricanes/images/florence/hurricane-florence_00000461_pre_disaster.png,13,57,1,0,13,935,992,205,21.103400584689858,13.174722502975325
16293,/media/marda/TWOTB1/xBD/hurricanes/images/florence/hurricane-florence_00000461_pre_disaster.png,43,54,1,4,47,990,1044,330,51.597600754644944,13.158613935309264
16294,/media/marda/TWOTB1/xBD/hurricanes/images/florence/hurricane-florence_00000265_post_disaster.png,78,29,1,773,851,0,29,784,50.56466437430754,21.362600439903147
16295,/media/marda/TWOTB1/xBD/hurricanes/images/florence/hurricane-florence_00000265_post_disaster.png,69,22,1,940,1009,0,22,525,31.988928554780653,21.66135591708358
16296,/media/marda/TWOTB1/xBD/hurricanes/images/florence/hurricane-florence_00000265_post_disaster.png,69,65,1,749,818,2,67,1041,73.62600855833065,19.1315370872448
16297,/media/marda/TWOTB1/xBD/hurricanes/images/florence/hurricane-florence_00000265_post_disaster.png,48,16,1,723,771,13,29,176,21.050963589550463,11.206965907148223
16298,/media/marda/TWOTB1/xBD/hurricanes/images/florence/hurricane-florence_00000265_post_disaster.png,55,14,1,976,1031,18,32,129,16.181563423129973,10.540214961643528
16299,/media/marda/TWOTB1/xBD/hurricanes/images/florence/hurricane-florence_00000265_post_disaster.png,58,23,1,730,788,24,47,447,29.745750354509127,19.75408395337139
16300,/media/marda/TWOTB1/xBD/hurricanes/images/florence/hurricane-florence_00000265_post_disaster.png,45,44,1,262,307,27,71,904,45.229011270866295,26.728601230995796
16301,/media/marda/TWOTB1/xBD/hurricanes/images/florence/hurricane-florence_00000265_post_disaster.png,57,27,1,488,545,32,59,755,41.0888911989066,24.452034194122735
16302,/media/marda/TWOTB1/xBD/hurricanes/images/florence/hurricane-florence_00000265_post_disaster.png,84,42,1,938,1022,55,97,1136,40.913418779244964,36.708665939607485
16303,/media/marda/TWOTB1/xBD/hurricanes/images/florence/hurricane-florence_00000265_post_disaster.png,35,13,1,496,531,62,75,143,15.58288918776134,12.270338702728136
16304,/media/marda/TWOTB1/xBD/hurricanes/images/florence/hurricane-florence_00000265_post_disaster.png,48,23,1,522,570,87,110,354,29.054516476813863,16.092280903510783
16305,/media/marda/TWOTB1/xBD/hurricanes/images/florence/hurricane-florence_00000265_post_disaster.png,58,27,1,862,920,103,130,295,20.01096582969684,19.538209526708425
16306,/media/marda/TWOTB1/xBD/hurricanes/images/florence/hurricane-florence_00000265_post_disaster.png,63,37,1,461,524,125,162,1058,46.197064178125984,30.54190508057429
16307,/media/marda/TWOTB1/xBD/hurricanes/images/florence/hurricane-florence_00000265_post_disaster.png,58,31,1,719,777,210,241,335,30.33810747292848,16.74529492566484
16308,/media/marda/TWOTB1/xBD/hurricanes/images/florence/hurricane-florence_00000265_post_disaster.png,38,25,1,495,533,226,251,269,20.765757895656968,17.230906464612502
16309,/media/marda/TWOTB1/xBD/hurricanes/images/florence/hurricane-florence_00000265_post_disaster.png,50,63,1,514,564,245,308,1584,62.10860503477553,33.887072658877685
16310,/media/marda/TWOTB1/xBD/hurricanes/images/florence/hurricane-florence_00000265_post_disaster.png,29,29,1,286,315,260,289,278,19.803929329458942,18.718108998484585
16311,/media/marda/TWOTB1/xBD/hurricanes/images/florence/hurricane-florence_00000265_post_disaster.png,46,62,1,300,346,268,330,1226,55.917330486530815,29.05851577183613
16312,/media/marda/TWOTB1/xBD/hurricanes/images/florence/hurricane-florence_00000265_post_disaster.png,39,37,1,219,258,350,387,479,32.48242068942381,19.296867860995306
16313,/media/marda/TWOTB1/xBD/hurricanes/images/florence/hurricane-florence_00000265_post_disaster.png,56,70,1,271,327,371,441,1643,55.58454695705548,40.76216614517348
16314,/media/marda/TWOTB1/xBD/hurricanes/images/florence/hurricane-florence_00000265_post_disaster.png,70,66,1,556,626,392,458,1649,47.53638463205592,45.55950349554956
16315,/media/marda/TWOTB1/xBD/hurricanes/images/florence/hurricane-florence_00000265_post_disaster.png,39,37,1,670,709,420,457,241,21.390857184217953,14.966342068103845
16316,/media/marda/TWOTB1/xBD/hurricanes/images/florence/hurricane-florence_00000265_post_disaster.png,31,40,1,180,211,426,466,353,23.158164279127025,20.276573565745075
16317,/media/marda/TWOTB1/xBD/hurricanes/images/florence/hurricane-florence_00000265_post_disaster.png,58,62,1,253,311,437,499,1319,47.227108495960316,37.183675299724214
16318,/media/marda/TWOTB1/xBD/hurricanes/images/florence/hurricane-florence_00000265_post_disaster.png,64,91,1,214,278,497,588,2180,66.5661834471848,47.55625622637454
16319,/media/marda/TWOTB1/xBD/hurricanes/images/florence/hurricane-florence_00000265_post_disaster.png,60,81,1,392,452,535,616,1344,64.42464861453468,27.77542788823351
16320,/media/marda/TWOTB1/xBD/hurricanes/images/florence/hurricane-florence_00000265_post_disaster.png,37,39,1,470,507,561,600,213,19.677333008438293,14.337575897406916
16321,/media/marda/TWOTB1/xBD/hurricanes/images/florence/hurricane-florence_00000265_post_disaster.png,50,73,1,179,229,584,657,1191,53.45831187694395,29.614208801393065
16322,/media/marda/TWOTB1/xBD/hurricanes/images/florence/hurricane-florence_00000265_post_disaster.png,59,71,1,357,416,615,686,1158,46.38767718321946,33.46997867751409
16323,/media/marda/TWOTB1/xBD/hurricanes/images/florence/hurricane-florence_00000265_post_disaster.png,41,45,1,439,480,635,680,254,26.915808901294117,12.533039625913519
16324,/media/marda/TWOTB1/xBD/hurricanes/images/florence/hurricane-florence_00000265_post_disaster.png,29,52,1,113,142,664,716,392,26.40770551790553,19.73178172549526
16325,/media/marda/TWOTB1/xBD/hurricanes/images/florence/hurricane-florence_00000265_post_disaster.png,54,85,1,136,190,675,760,1597,63.28325581853081,33.25613091178655
16326,/media/marda/TWOTB1/xBD/hurricanes/images/florence/hurricane-florence_00000265_post_disaster.png,81,85,1,315,396,690,775,1968,66.70634473435344,44.55504978193251
16327,/media/marda/TWOTB1/xBD/hurricanes/images/florence/hurricane-florence_00000265_post_disaster.png,36,50,1,386,422,737,787,279,20.2494176599735,18.211864483935734
16328,/media/marda/TWOTB1/xBD/hurricanes/images/florence/hurricane-florence_00000265_post_disaster.png,54,81,1,278,332,765,846,1205,55.04161448483268,29.138651330212898
16329,/media/marda/TWOTB1/xBD/hurricanes/images/florence/hurricane-florence_00000265_post_disaster.png,29,48,1,350,379,815,863,156,17.00783647401656,12.149562459894021
16330,/media/marda/TWOTB1/xBD/hurricanes/images/florence/hurricane-florence_00000265_post_disaster.png,52,80,1,239,291,844,924,1160,44.118841046952724,34.80125522546923
16331,/media/marda/TWOTB1/xBD/hurricanes/images/florence/hurricane-florence_00000265_post_disaster.png,38,61,1,304,342,866,927,399,28.437404329650406,18.9397130980473
16332,/media/marda/TWOTB1/xBD/hurricanes/images/florence/hurricane-florence_00000265_post_disaster.png,34,67,1,32,66,869,936,632,31.44066381739381,26.77593639673041
16333,/media/marda/TWOTB1/xBD/hurricanes/images/florence/hurricane-florence_00000265_post_disaster.png,50,101,1,26,76,900,1001,1785,64.55615635700127,37.78794832122698
16334,/media/marda/TWOTB1/xBD/hurricanes/images/florence/hurricane-florence_00000265_post_disaster.png,52,89,1,198,250,915,1004,1171,55.02274778826092,28.24676305763912
16335,/media/marda/TWOTB1/xBD/hurricanes/images/florence/hurricane-florence_00000265_post_disaster.png,13,65,1,0,13,962,1027,197,26.402186655579982,11.419328044322356
16336,/media/marda/TWOTB1/xBD/hurricanes/images/florence/hurricane-florence_00000265_post_disaster.png,29,55,1,257,286,963,1018,217,18.420297467352118,15.695711675251886
16337,/media/marda/TWOTB1/xBD/hurricanes/images/florence/hurricane-florence_00000265_post_disaster.png,49,52,1,520,569,991,1043,180,25.65443889269563,10.761930487463458
16338,/media/marda/TWOTB1/xBD/hurricanes/images/florence/hurricane-florence_00000265_post_disaster.png,29,50,1,175,204,993,1043,120,20.37713901221863,9.017697729652742
16339,/media/marda/TWOTB1/xBD/hurricanes/images/florence/hurricane-florence_00000257_post_disaster.png,29,29,1,455,484,0,29,347,33.56850248762653,13.782272301300774
16340,/media/marda/TWOTB1/xBD/hurricanes/images/florence/hurricane-florence_00000257_post_disaster.png,32,29,1,16,48,18,47,361,37.55200488294909,12.861317058878175
16341,/media/marda/TWOTB1/xBD/hurricanes/images/florence/hurricane-florence_00000257_post_disaster.png,80,48,1,626,706,32,80,2000,55.618762067112286,48.541491593501235
16342,/media/marda/TWOTB1/xBD/hurricanes/images/florence/hurricane-florence_00000257_post_disaster.png,34,30,1,452,486,36,66,523,33.53730150979881,20.785269567115456
16343,/media/marda/TWOTB1/xBD/hurricanes/images/florence/hurricane-florence_00000257_post_disaster.png,15,13,1,38,53,38,51,91,15.421726052078416,7.809382215549011
16344,/media/marda/TWOTB1/xBD/hurricanes/images/florence/hurricane-florence_00000257_post_disaster.png,37,14,1,400,437,43,57,228,22.786956543689772,13.453781131794498
16345,/media/marda/TWOTB1/xBD/hurricanes/images/florence/hurricane-florence_00000257_post_disaster.png,30,19,1,333,363,67,86,322,21.914395530182023,19.63707989575584
16346,/media/marda/TWOTB1/xBD/hurricanes/images/florence/hurricane-florence_00000257_post_disaster.png,60,42,1,428,488,87,129,1241,43.705318718940234,37.63119556737223
16347,/media/marda/TWOTB1/xBD/hurricanes/images/florence/hurricane-florence_00000257_post_disaster.png,38,34,1,330,368,120,154,485,29.126933699807097,22.840679691144736
16348,/media/marda/TWOTB1/xBD/hurricanes/images/florence/hurricane-florence_00000257_post_disaster.png,31,37,1,94,125,138,175,550,32.8236143698073,22.394448822181065
16349,/media/marda/TWOTB1/xBD/hurricanes/images/florence/hurricane-florence_00000257_post_disaster.png,17,28,1,0,17,152,180,243,23.67334966505702,13.730066138997817
16350,/media/marda/TWOTB1/xBD/hurricanes/images/florence/hurricane-florence_00000257_post_disaster.png,57,43,1,51,108,173,216,1189,57.90996464633551,27.079462861731226
16351,/media/marda/TWOTB1/xBD/hurricanes/images/florence/hurricane-florence_00000257_post_disaster.png,48,21,1,996,1044,184,205,78,15.363832817128518,7.421558554046317
16352,/media/marda/TWOTB1/xBD/hurricanes/images/florence/hurricane-florence_00000257_post_disaster.png,82,47,1,916,998,197,244,822,51.68671689761268,21.226869586322525
16353,/media/marda/TWOTB1/xBD/hurricanes/images/florence/hurricane-florence_00000257_post_disaster.png,79,49,1,942,1021,216,265,870,37.9445349845969,30.31558829955143
16354,/media/marda/TWOTB1/xBD/hurricanes/images/florence/hurricane-florence_00000257_post_disaster.png,84,54,1,910,994,240,294,1150,48.528987630978364,31.164201773473284
16355,/media/marda/TWOTB1/xBD/hurricanes/images/florence/hurricane-florence_00000257_post_disaster.png,66,46,1,57,123,259,305,1191,70.93792178323983,22.384439719115925
16356,/media/marda/TWOTB1/xBD/hurricanes/images/florence/hurricane-florence_00000257_post_disaster.png,25,40,1,88,113,285,325,484,30.57986731600633,20.948869127198314
16357,/media/marda/TWOTB1/xBD/hurricanes/images/florence/hurricane-florence_00000257_post_disaster.png,53,47,1,16,69,290,337,1180,51.81877814843374,30.819539512265223
16358,/media/marda/TWOTB1/xBD/hurricanes/images/florence/hurricane-florence_00000257_post_disaster.png,81,95,1,106,187,341,436,3940,80.92105253737668,64.98208308010011
16359,/media/marda/TWOTB1/xBD/hurricanes/images/florence/hurricane-florence_00000257_post_disaster.png,57,97,1,197,254,438,535,2166,78.02199656618625,37.88546040266483
16360,/media/marda/TWOTB1/xBD/hurricanes/images/florence/hurricane-florence_00000257_post_disaster.png,84,63,1,920,1004,471,534,1396,45.5153737896928,41.37401591937258
16361,/media/marda/TWOTB1/xBD/hurricanes/images/florence/hurricane-florence_00000257_post_disaster.png,84,68,1,826,910,499,567,900,62.606392735536645,19.184893324009412
16362,/media/marda/TWOTB1/xBD/hurricanes/images/florence/hurricane-florence_00000257_post_disaster.png,68,74,1,225,293,548,622,2012,60.35883722475688,46.22888736498492
16363,/media/marda/TWOTB1/xBD/hurricanes/images/florence/hurricane-florence_00000257_post_disaster.png,62,40,1,917,979,548,588,351,27.61296049417042,17.015639206948567
16364,/media/marda/TWOTB1/xBD/hurricanes/images/florence/hurricane-florence_00000257_post_disaster.png,67,60,1,761,828,551,611,688,42.438292026166955,21.484958867000447
16365,/media/marda/TWOTB1/xBD/hurricanes/images/florence/hurricane-florence_00000257_post_disaster.png,57,51,1,821,878,595,646,320,26.57913815403623,16.094599520915562
16366,/media/marda/TWOTB1/xBD/hurricanes/images/florence/hurricane-florence_00000257_post_disaster.png,65,95,1,183,248,624,719,2106,75.91988225571056,45.481509328426554
16367,/media/marda/TWOTB1/xBD/hurricanes/images/florence/hurricane-florence_00000257_post_disaster.png,40,45,1,463,503,651,696,305,22.305695941384517,18.260229672553237
16368,/media/marda/TWOTB1/xBD/hurricanes/images/florence/hurricane-florence_00000257_post_disaster.png,65,68,1,400,465,717,785,920,47.81439974251014,25.682937366691633
16369,/media/marda/TWOTB1/xBD/hurricanes/images/florence/hurricane-florence_00000257_post_disaster.png,62,65,1,261,323,783,848,1044,49.89078648457865,27.953712332358755
16370,/media/marda/TWOTB1/xBD/hurricanes/images/florence/hurricane-florence_00000257_post_disaster.png,70,78,1,480,550,814,892,1088,49.03488846127378,34.36005721347503
16371,/media/marda/TWOTB1/xBD/hurricanes/images/florence/hurricane-florence_00000257_post_disaster.png,48,59,1,535,583,841,900,426,27.32138078754564,20.335369478326506
16372,/media/marda/TWOTB1/xBD/hurricanes/images/florence/hurricane-florence_00000257_post_disaster.png,12,56,1,0,12,934,990,143,18.15361564290722,11.405581849780889
16373,/media/marda/TWOTB1/xBD/hurricanes/images/florence/hurricane-florence_00000289_post_disaster.png,43,71,1,413,456,673,744,683,51.261937299385124,17.792117562036637
16374,/media/marda/TWOTB1/xBD/hurricanes/images/florence/hurricane-florence_00000289_post_disaster.png,47,68,1,286,333,814,882,831,35.0706950473814,31.86412450114632
16375,/media/marda/TWOTB1/xBD/hurricanes/images/florence/hurricane-florence_00000289_post_disaster.png,36,55,1,249,285,850,905,361,28.343936151849423,17.041306808491427
16376,/media/marda/TWOTB1/xBD/hurricanes/images/florence/hurricane-florence_00000289_post_disaster.png,24,43,1,358,382,919,962,73,13.953948823668437,6.968283061301865
16377,/media/marda/TWOTB1/xBD/hurricanes/images/florence/hurricane-florence_00000289_post_disaster.png,20,42,1,347,367,939,981,48,9.16515138991168,6.831300510639732
16378,/media/marda/TWOTB1/xBD/hurricanes/images/florence/hurricane-florence_00000289_post_disaster.png,37,66,1,261,298,944,1010,644,30.288493195817292,28.42224807160215
16379,/media/marda/TWOTB1/xBD/hurricanes/images/florence/hurricane-florence_00000289_post_disaster.png,57,62,1,339,396,968,1030,991,48.66953706261651,26.79911143501178
16380,/media/marda/TWOTB1/xBD/hurricanes/images/florence/hurricane-florence_00000289_post_disaster.png,49,62,1,286,335,974,1036,840,41.963430464355206,26.371860738495826
16381,/media/marda/TWOTB1/xBD/hurricanes/images/florence/hurricane-florence_00000289_post_disaster.png,58,57,1,155,213,986,1043,785,58.935968353392816,17.695663177654858
16382,/media/marda/TWOTB1/xBD/hurricanes/images/florence/hurricane-florence_00000461_post_disaster.png,68,47,1,975,1043,485,532,496,35.78493673130609,20.283813749460162
16383,/media/marda/TWOTB1/xBD/hurricanes/images/florence/hurricane-florence_00000461_post_disaster.png,60,55,1,983,1043,511,566,478,32.32176346015367,20.659795366340525
16384,/media/marda/TWOTB1/xBD/hurricanes/images/florence/hurricane-florence_00000461_post_disaster.png,22,47,1,216,238,784,831,235,20.973855893423007,14.970990025497503
16385,/media/marda/TWOTB1/xBD/hurricanes/images/florence/hurricane-florence_00000461_post_disaster.png,185,130,1,481,666,795,925,4776,195.93603742405833,32.523296660246075
16386,/media/marda/TWOTB1/xBD/hurricanes/images/florence/hurricane-florence_00000461_post_disaster.png,60,73,1,402,462,806,879,1029,40.81059731618093,33.62421172068552
16387,/media/marda/TWOTB1/xBD/hurricanes/images/florence/hurricane-florence_00000461_post_disaster.png,40,58,1,490,530,806,864,306,25.98543859823516,15.734691298818518
16388,/media/marda/TWOTB1/xBD/hurricanes/images/florence/hurricane-florence_00000461_post_disaster.png,29,46,1,475,504,832,878,88,13.337867977313683,8.887266690310852
16389,/media/marda/TWOTB1/xBD/hurricanes/images/florence/hurricane-florence_00000461_post_disaster.png,186,133,1,500,686,840,973,5092,194.82949710105504,34.78529737018642
16390,/media/marda/TWOTB1/xBD/hurricanes/images/florence/hurricane-florence_00000461_post_disaster.png,29,46,1,410,439,857,903,111,13.431642648187653,11.009924662527329
16391,/media/marda/TWOTB1/xBD/hurricanes/images/florence/hurricane-florence_00000461_post_disaster.png,34,58,1,460,494,906,964,225,22.35190884512848,13.281934751087805
16392,/media/marda/TWOTB1/xBD/hurricanes/images/florence/hurricane-florence_00000461_post_disaster.png,13,57,1,0,13,935,992,205,21.103400584689858,13.174722502975325
16393,/media/marda/TWOTB1/xBD/hurricanes/images/florence/hurricane-florence_00000461_post_disaster.png,43,53,1,4,47,990,1043,291,52.10678280924753,12.25286393173445
16394,/media/marda/TWOTB1/xBD/hurricanes/images/florence/hurricane-florence_00000040_pre_disaster.png,33,9,1,458,491,0,9,143,18.45299126089959,10.290408753891674
16395,/media/marda/TWOTB1/xBD/hurricanes/images/florence/hurricane-florence_00000040_pre_disaster.png,61,29,1,502,563,0,29,722,36.43065466019972,27.40182465167993
16396,/media/marda/TWOTB1/xBD/hurricanes/images/florence/hurricane-florence_00000040_pre_disaster.png,67,25,1,787,854,29,54,604,36.574972960236614,21.75089836541014
16397,/media/marda/TWOTB1/xBD/hurricanes/images/florence/hurricane-florence_00000040_pre_disaster.png,81,44,1,633,714,73,117,1361,59.84151453947617,30.456022378126043
16398,/media/marda/TWOTB1/xBD/hurricanes/images/florence/hurricane-florence_00000040_pre_disaster.png,43,13,1,565,608,75,88,163,25.047898333619198,8.718591171368338
16399,/media/marda/TWOTB1/xBD/hurricanes/images/florence/hurricane-florence_00000040_pre_disaster.png,42,35,1,705,747,80,115,426,39.39827001039264,14.442535427231842
16400,/media/marda/TWOTB1/xBD/hurricanes/images/florence/hurricane-florence_00000040_pre_disaster.png,58,47,1,518,576,232,279,903,38.5709170318062,32.450376294382295
16401,/media/marda/TWOTB1/xBD/hurricanes/images/florence/hurricane-florence_00000040_pre_disaster.png,49,60,1,450,499,234,294,1030,55.69810695497962,24.50561357976079
16402,/media/marda/TWOTB1/xBD/hurricanes/images/florence/hurricane-florence_00000075_post_disaster.png,53,24,1,771,824,199,223,224,22.975124631411255,12.791068819237383
16403,/media/marda/TWOTB1/xBD/hurricanes/images/florence/hurricane-florence_00000075_post_disaster.png,72,55,1,810,882,202,257,1021,49.67894459868116,27.971346858521823
16404,/media/marda/TWOTB1/xBD/hurricanes/images/florence/hurricane-florence_00000075_post_disaster.png,63,59,1,877,940,294,353,915,49.022385496131974,24.86240106494802
16405,/media/marda/TWOTB1/xBD/hurricanes/images/florence/hurricane-florence_00000075_post_disaster.png,55,24,1,818,873,303,327,186,24.582452190129036,10.08352005069515
16406,/media/marda/TWOTB1/xBD/hurricanes/images/florence/hurricane-florence_00000075_post_disaster.png,43,28,1,828,871,328,356,112,15.688139257333985,9.63013133345746
16407,/media/marda/TWOTB1/xBD/hurricanes/images/florence/hurricane-florence_00000075_post_disaster.png,62,62,1,890,952,354,416,709,55.79145823017785,16.826106971524784
16408,/media/marda/TWOTB1/xBD/hurricanes/images/florence/hurricane-florence_00000075_post_disaster.png,71,62,1,923,994,423,485,1291,47.731075937406374,36.005952435302206
16409,/media/marda/TWOTB1/xBD/hurricanes/images/florence/hurricane-florence_00000075_post_disaster.png,59,31,1,882,941,459,490,211,22.92473419526419,12.873929845996459
16410,/media/marda/TWOTB1/xBD/hurricanes/images/florence/hurricane-florence_00000075_post_disaster.png,63,55,1,883,946,485,540,867,39.66373362319443,28.89043351943513
16411,/media/marda/TWOTB1/xBD/hurricanes/images/florence/hurricane-florence_00000075_post_disaster.png,54,42,1,858,912,490,532,422,25.366214467093155,22.258618868821948
16412,/media/marda/TWOTB1/xBD/hurricanes/images/florence/hurricane-florence_00000075_post_disaster.png,70,68,1,952,1022,510,578,1109,49.82599060038498,29.638397739028836
16413,/media/marda/TWOTB1/xBD/hurricanes/images/florence/hurricane-florence_00000075_post_disaster.png,52,47,1,839,891,515,562,409,26.753763220779994,20.37242514711102
16414,/media/marda/TWOTB1/xBD/hurricanes/images/florence/hurricane-florence_00000075_post_disaster.png,66,43,1,951,1017,609,652,398,32.56455508393733,16.186129915877334
16415,/media/marda/TWOTB1/xBD/hurricanes/images/florence/hurricane-florence_00000075_post_disaster.png,79,48,1,759,838,714,762,519,55.24709847916999,12.558740279421194
16416,/media/marda/TWOTB1/xBD/hurricanes/images/florence/hurricane-florence_00000075_post_disaster.png,60,43,1,813,873,756,799,276,31.9756886742517,11.610893278900969
16417,/media/marda/TWOTB1/xBD/hurricanes/images/florence/hurricane-florence_00000075_post_disaster.png,43,60,1,691,734,760,820,422,34.844330468735606,16.203552037763817
16418,/media/marda/TWOTB1/xBD/hurricanes/images/florence/hurricane-florence_00000075_post_disaster.png,65,57,1,917,982,760,817,385,30.735530843892334,16.748669440430113
16419,/media/marda/TWOTB1/xBD/hurricanes/images/florence/hurricane-florence_00000075_post_disaster.png,58,70,1,723,781,773,843,533,44.95428998625442,16.29746723274371
16420,/media/marda/TWOTB1/xBD/hurricanes/images/florence/hurricane-florence_00000075_post_disaster.png,48,39,1,884,932,782,821,97,12.915490910832396,10.159016270798155
16421,/media/marda/TWOTB1/xBD/hurricanes/images/florence/hurricane-florence_00000075_post_disaster.png,73,49,1,784,857,796,845,434,48.233004486008944,12.017016377395636
16422,/media/marda/TWOTB1/xBD/hurricanes/images/florence/hurricane-florence_00000075_post_disaster.png,57,76,1,521,578,812,888,901,44.82244705724254,32.320270740470264
16423,/media/marda/TWOTB1/xBD/hurricanes/images/florence/hurricane-florence_00000075_post_disaster.png,55,47,1,734,789,824,871,267,30.42935951309428,11.786559866243268
16424,/media/marda/TWOTB1/xBD/hurricanes/images/florence/hurricane-florence_00000075_post_disaster.png,48,46,1,640,688,825,871,253,26.279637953508402,12.904460201506394
16425,/media/marda/TWOTB1/xBD/hurricanes/images/florence/hurricane-florence_00000075_post_disaster.png,88,74,1,949,1037,967,1041,1344,47.615794073464336,39.328731963684675
16426,/media/marda/TWOTB1/xBD/hurricanes/images/florence/hurricane-florence_00000075_post_disaster.png,11,45,1,85,96,973,1018,79,12.913033362661182,8.257740504251675
16427,/media/marda/TWOTB1/xBD/hurricanes/images/florence/hurricane-florence_00000304_pre_disaster.png,90,60,1,792,882,0,60,2121,66.87898059734498,42.56344399877967
16428,/media/marda/TWOTB1/xBD/hurricanes/images/florence/hurricane-florence_00000304_pre_disaster.png,72,33,1,871,943,69,102,559,47.68589391106164,17.028138663507203
16429,/media/marda/TWOTB1/xBD/hurricanes/images/florence/hurricane-florence_00000304_pre_disaster.png,53,28,1,692,745,93,121,403,26.525454000174648,20.305118993437713
16430,/media/marda/TWOTB1/xBD/hurricanes/images/florence/hurricane-florence_00000304_pre_disaster.png,54,18,1,960,1014,95,113,222,18.24691129488253,15.891314420294457
16431,/media/marda/TWOTB1/xBD/hurricanes/images/florence/hurricane-florence_00000304_pre_disaster.png,61,44,1,812,873,108,152,660,42.301867614787646,20.877691046788406
16432,/media/marda/TWOTB1/xBD/hurricanes/images/florence/hurricane-florence_00000304_pre_disaster.png,52,16,1,974,1026,134,150,134,13.815184113321989,12.337033448460042
16433,/media/marda/TWOTB1/xBD/hurricanes/images/florence/hurricane-florence_00000304_pre_disaster.png,89,81,1,906,995,138,219,2226,81.63176739821904,36.87919803404353
16434,/media/marda/TWOTB1/xBD/hurricanes/images/florence/hurricane-florence_00000304_pre_disaster.png,97,99,1,813,910,146,245,3683,94.57342273678569,51.58518890548951
16435,/media/marda/TWOTB1/xBD/hurricanes/images/florence/hurricane-florence_00000304_pre_disaster.png,63,34,1,856,919,234,268,505,28.604439603548325,23.289470445962472
16436,/media/marda/TWOTB1/xBD/hurricanes/images/florence/hurricane-florence_00000304_pre_disaster.png,65,37,1,712,777,288,325,574,37.818321403270566,20.292842438724783
16437,/media/marda/TWOTB1/xBD/hurricanes/images/florence/hurricane-florence_00000304_pre_disaster.png,88,49,1,670,758,321,370,1253,64.33696869352619,28.4649815886124
16438,/media/marda/TWOTB1/xBD/hurricanes/images/florence/hurricane-florence_00000145_pre_disaster.png,36,59,1,332,368,972,1031,393,24.112318094951842,21.473159201072043
16439,/media/marda/TWOTB1/xBD/hurricanes/images/florence/hurricane-florence_00000160_pre_disaster.png,29,22,1,311,340,73,95,223,21.34349231059104,13.881168203325766
16440,/media/marda/TWOTB1/xBD/hurricanes/images/florence/hurricane-florence_00000160_pre_disaster.png,68,39,1,270,338,147,186,1248,63.624505668250364,25.896817331138365
16441,/media/marda/TWOTB1/xBD/hurricanes/images/florence/hurricane-florence_00000160_pre_disaster.png,31,30,1,310,341,277,307,277,20.705317833815432,18.091318595569167
16442,/media/marda/TWOTB1/xBD/hurricanes/images/florence/hurricane-florence_00000160_pre_disaster.png,19,35,1,203,222,599,634,58,11.325919526786082,6.954198974499322
16443,/media/marda/TWOTB1/xBD/hurricanes/images/florence/hurricane-florence_00000231_pre_disaster.png,69,44,1,741,810,307,351,695,43.57382738828363,26.617664135692873
16444,/media/marda/TWOTB1/xBD/hurricanes/images/florence/hurricane-florence_00000231_pre_disaster.png,66,50,1,624,690,350,400,838,43.92531776321063,25.25621772874852
16445,/media/marda/TWOTB1/xBD/hurricanes/images/florence/hurricane-florence_00000231_pre_disaster.png,62,60,1,488,550,454,514,1127,40.476335650916354,37.871523891682926
16446,/media/marda/TWOTB1/xBD/hurricanes/images/florence/hurricane-florence_00000231_pre_disaster.png,77,41,1,762,839,491,532,872,54.356158978737646,21.42246030856606
16447,/media/marda/TWOTB1/xBD/hurricanes/images/florence/hurricane-florence_00000231_pre_disaster.png,51,78,1,32,83,766,844,1309,52.16264329084071,33.05820940738078
16448,/media/marda/TWOTB1/xBD/hurricanes/images/florence/hurricane-florence_00000231_pre_disaster.png,30,71,1,149,179,928,999,438,37.16068428024569,15.583421160353312
16449,/media/marda/TWOTB1/xBD/hurricanes/images/florence/hurricane-florence_00000231_pre_disaster.png,45,55,1,303,348,956,1011,307,36.821126552162035,11.148319256524774
16450,/media/marda/TWOTB1/xBD/hurricanes/images/florence/hurricane-florence_00000231_pre_disaster.png,40,54,1,235,275,982,1036,363,36.49855841258269,13.340591876859587
16451,/media/marda/TWOTB1/xBD/hurricanes/images/florence/hurricane-florence_00000231_pre_disaster.png,22,47,1,98,120,997,1044,123,20.308135460715658,7.973037237251417
16452,/media/marda/TWOTB1/xBD/hurricanes/images/florence/hurricane-florence_00000235_pre_disaster.png,93,123,1,0,93,753,876,2348,141.62619555568762,29.102889559502444
16453,/media/marda/TWOTB1/xBD/hurricanes/images/florence/hurricane-florence_00000235_pre_disaster.png,17,45,1,19,36,780,825,139,17.18593849984292,10.836073841428135
16454,/media/marda/TWOTB1/xBD/hurricanes/images/florence/hurricane-florence_00000235_pre_disaster.png,33,62,1,34,67,827,889,478,32.10531177426295,19.88261696713308
16455,/media/marda/TWOTB1/xBD/hurricanes/images/florence/hurricane-florence_00000235_pre_disaster.png,58,77,1,91,149,831,908,817,63.821080597911916,21.81898025345388
16456,/media/marda/TWOTB1/xBD/hurricanes/images/florence/hurricane-florence_00000235_pre_disaster.png,45,78,1,57,102,878,956,1165,47.35177555378277,32.06609520916615
16457,/media/marda/TWOTB1/xBD/hurricanes/images/florence/hurricane-florence_00000235_pre_disaster.png,28,63,1,0,28,979,1042,485,26.706466910249905,24.190923107367436
16458,/media/marda/TWOTB1/xBD/hurricanes/images/florence/hurricane-florence_00000064_pre_disaster.png,24,9,1,290,314,0,9,77,13.076385134757574,8.347460885364447
16459,/media/marda/TWOTB1/xBD/hurricanes/images/florence/hurricane-florence_00000064_pre_disaster.png,40,15,1,671,711,0,15,191,16.822092529412508,15.214361131245267
16460,/media/marda/TWOTB1/xBD/hurricanes/images/florence/hurricane-florence_00000064_pre_disaster.png,66,55,1,757,823,0,55,1320,60.3721618516207,37.14167015597333
16461,/media/marda/TWOTB1/xBD/hurricanes/images/florence/hurricane-florence_00000064_pre_disaster.png,48,5,1,829,877,0,5,41,15.748735194754344,3.9918051202027924
16462,/media/marda/TWOTB1/xBD/hurricanes/images/florence/hurricane-florence_00000064_pre_disaster.png,68,21,1,694,762,24,45,435,43.556893148049625,13.312614410365716
16463,/media/marda/TWOTB1/xBD/hurricanes/images/florence/hurricane-florence_00000064_pre_disaster.png,48,36,1,344,392,37,73,677,33.84155349593644,26.589371540869283
16464,/media/marda/TWOTB1/xBD/hurricanes/images/florence/hurricane-florence_00000064_pre_disaster.png,28,8,1,557,585,41,49,33,6.986461569054317,6.434326513521269
16465,/media/marda/TWOTB1/xBD/hurricanes/images/florence/hurricane-florence_00000064_pre_disaster.png,19,9,1,295,314,69,78,64,9.902139414813304,8.67886138900725
16466,/media/marda/TWOTB1/xBD/hurricanes/images/florence/hurricane-florence_00000064_pre_disaster.png,62,48,1,452,514,72,120,1126,51.724701285301975,29.54730057596612
16467,/media/marda/TWOTB1/xBD/hurricanes/images/florence/hurricane-florence_00000064_pre_disaster.png,71,55,1,596,667,73,128,1142,62.50007076314971,27.30672627974142
16468,/media/marda/TWOTB1/xBD/hurricanes/images/florence/hurricane-florence_00000064_pre_disaster.png,60,33,1,286,346,77,110,1100,53.006477363407406,27.510591958721495
16469,/media/marda/TWOTB1/xBD/hurricanes/images/florence/hurricane-florence_00000064_pre_disaster.png,52,40,1,155,207,117,157,1053,46.100380949550264,30.520955234216974
16470,/media/marda/TWOTB1/xBD/hurricanes/images/florence/hurricane-florence_00000064_pre_disaster.png,22,19,1,212,234,164,183,104,12.820195361644421,10.929195973038524
16471,/media/marda/TWOTB1/xBD/hurricanes/images/florence/hurricane-florence_00000064_pre_disaster.png,79,40,1,705,784,280,320,1163,52.545255165702564,30.221637369834244
16472,/media/marda/TWOTB1/xBD/hurricanes/images/florence/hurricane-florence_00000064_pre_disaster.png,60,51,1,779,839,333,384,801,40.283627054941135,26.44985159613002
16473,/media/marda/TWOTB1/xBD/hurricanes/images/florence/hurricane-florence_00000064_pre_disaster.png,66,49,1,687,753,399,448,780,39.9299525391341,25.504878444648163
16474,/media/marda/TWOTB1/xBD/hurricanes/images/florence/hurricane-florence_00000064_pre_disaster.png,43,38,1,638,681,406,444,252,20.059400864571362,16.858058402424586
16475,/media/marda/TWOTB1/xBD/hurricanes/images/florence/hurricane-florence_00000064_pre_disaster.png,47,39,1,663,710,434,473,295,20.74035985333261,19.28213367678908
16476,/media/marda/TWOTB1/xBD/hurricanes/images/florence/hurricane-florence_00000064_pre_disaster.png,42,33,1,637,679,448,481,196,17.203133470277198,15.297689232257506
16477,/media/marda/TWOTB1/xBD/hurricanes/images/florence/hurricane-florence_00000064_pre_disaster.png,80,48,1,854,934,480,528,936,44.80078177311371,27.48590120663895
16478,/media/marda/TWOTB1/xBD/hurricanes/images/florence/hurricane-florence_00000064_pre_disaster.png,96,51,1,935,1031,612,663,743,64.8904151819559,15.290755091607284
16479,/media/marda/TWOTB1/xBD/hurricanes/images/florence/hurricane-florence_00000064_pre_disaster.png,81,85,1,639,720,613,698,2106,66.31430848953083,53.808236515558136
16480,/media/marda/TWOTB1/xBD/hurricanes/images/florence/hurricane-florence_00000064_pre_disaster.png,55,76,1,839,894,622,698,795,59.06042844961491,17.91361206937909
16481,/media/marda/TWOTB1/xBD/hurricanes/images/florence/hurricane-florence_00000064_pre_disaster.png,39,68,1,359,398,648,716,532,48.61729258929912,14.620957394133507
16482,/media/marda/TWOTB1/xBD/hurricanes/images/florence/hurricane-florence_00000064_pre_disaster.png,50,46,1,526,576,665,711,450,31.581622496288222,19.056350343210422
16483,/media/marda/TWOTB1/xBD/hurricanes/images/florence/hurricane-florence_00000064_pre_disaster.png,44,58,1,507,551,708,766,705,34.643909781820724,27.111958705124422
16484,/media/marda/TWOTB1/xBD/hurricanes/images/florence/hurricane-florence_00000064_pre_disaster.png,41,67,1,69,110,733,800,1234,40.82358246015579,40.07000094280159
16485,/media/marda/TWOTB1/xBD/hurricanes/images/florence/hurricane-florence_00000064_pre_disaster.png,76,74,1,574,650,793,867,1198,57.88477798310225,35.52182430117143
16486,/media/marda/TWOTB1/xBD/hurricanes/images/florence/hurricane-florence_00000064_pre_disaster.png,47,54,1,526,573,828,882,405,27.455297077338656,19.323820846878476
16487,/media/marda/TWOTB1/xBD/hurricanes/images/florence/hurricane-florence_00000064_pre_disaster.png,50,63,1,673,723,895,958,594,30.51531877868014,25.926723182322174
16488,/media/marda/TWOTB1/xBD/hurricanes/images/florence/hurricane-florence_00000064_pre_disaster.png,41,49,1,619,660,972,1021,183,19.509893085709063,12.482983610127748
16489,/media/marda/TWOTB1/xBD/hurricanes/images/florence/hurricane-florence_00000064_post_disaster.png,24,9,1,290,314,0,9,77,13.076385134757574,8.347460885364447
16490,/media/marda/TWOTB1/xBD/hurricanes/images/florence/hurricane-florence_00000064_post_disaster.png,40,15,1,671,711,0,15,191,16.822092529412508,15.214361131245267
16491,/media/marda/TWOTB1/xBD/hurricanes/images/florence/hurricane-florence_00000064_post_disaster.png,66,55,1,757,823,0,55,1320,60.3721618516207,37.14167015597333
16492,/media/marda/TWOTB1/xBD/hurricanes/images/florence/hurricane-florence_00000064_post_disaster.png,48,5,1,829,877,0,5,41,15.748735194754344,3.9918051202027924
16493,/media/marda/TWOTB1/xBD/hurricanes/images/florence/hurricane-florence_00000064_post_disaster.png,68,21,1,694,762,24,45,435,43.556893148049625,13.312614410365716
16494,/media/marda/TWOTB1/xBD/hurricanes/images/florence/hurricane-florence_00000064_post_disaster.png,48,36,1,344,392,37,73,677,33.84155349593644,26.589371540869283
16495,/media/marda/TWOTB1/xBD/hurricanes/images/florence/hurricane-florence_00000064_post_disaster.png,28,8,1,557,585,41,49,33,6.986461569054317,6.434326513521269
16496,/media/marda/TWOTB1/xBD/hurricanes/images/florence/hurricane-florence_00000064_post_disaster.png,19,9,1,295,314,69,78,64,9.902139414813304,8.67886138900725
16497,/media/marda/TWOTB1/xBD/hurricanes/images/florence/hurricane-florence_00000064_post_disaster.png,62,48,1,452,514,72,120,1126,51.724701285301975,29.54730057596612
16498,/media/marda/TWOTB1/xBD/hurricanes/images/florence/hurricane-florence_00000064_post_disaster.png,71,55,1,596,667,73,128,1142,62.50007076314971,27.30672627974142
16499,/media/marda/TWOTB1/xBD/hurricanes/images/florence/hurricane-florence_00000064_post_disaster.png,60,33,1,286,346,77,110,1100,53.006477363407406,27.510591958721495
16500,/media/marda/TWOTB1/xBD/hurricanes/images/florence/hurricane-florence_00000064_post_disaster.png,52,40,1,155,207,117,157,1053,46.100380949550264,30.520955234216974
16501,/media/marda/TWOTB1/xBD/hurricanes/images/florence/hurricane-florence_00000064_post_disaster.png,22,19,1,212,234,164,183,104,12.820195361644421,10.929195973038524
16502,/media/marda/TWOTB1/xBD/hurricanes/images/florence/hurricane-florence_00000064_post_disaster.png,79,40,1,705,784,280,320,1163,52.545255165702564,30.221637369834244
16503,/media/marda/TWOTB1/xBD/hurricanes/images/florence/hurricane-florence_00000064_post_disaster.png,60,51,1,779,839,333,384,801,40.283627054941135,26.44985159613002
16504,/media/marda/TWOTB1/xBD/hurricanes/images/florence/hurricane-florence_00000064_post_disaster.png,66,49,1,687,753,399,448,780,39.9299525391341,25.504878444648163
16505,/media/marda/TWOTB1/xBD/hurricanes/images/florence/hurricane-florence_00000064_post_disaster.png,43,38,1,638,681,406,444,252,20.059400864571362,16.858058402424586
16506,/media/marda/TWOTB1/xBD/hurricanes/images/florence/hurricane-florence_00000064_post_disaster.png,47,39,1,663,710,434,473,295,20.74035985333261,19.28213367678908
16507,/media/marda/TWOTB1/xBD/hurricanes/images/florence/hurricane-florence_00000064_post_disaster.png,42,33,1,637,679,448,481,196,17.203133470277198,15.297689232257506
16508,/media/marda/TWOTB1/xBD/hurricanes/images/florence/hurricane-florence_00000064_post_disaster.png,80,48,1,854,934,480,528,936,44.80078177311371,27.48590120663895
16509,/media/marda/TWOTB1/xBD/hurricanes/images/florence/hurricane-florence_00000064_post_disaster.png,96,51,1,935,1031,612,663,743,64.8904151819559,15.290755091607284
16510,/media/marda/TWOTB1/xBD/hurricanes/images/florence/hurricane-florence_00000064_post_disaster.png,81,85,1,639,720,613,698,2106,66.31430848953083,53.808236515558136
16511,/media/marda/TWOTB1/xBD/hurricanes/images/florence/hurricane-florence_00000064_post_disaster.png,55,76,1,839,894,622,698,795,59.06042844961491,17.91361206937909
16512,/media/marda/TWOTB1/xBD/hurricanes/images/florence/hurricane-florence_00000064_post_disaster.png,39,68,1,359,398,648,716,532,48.61729258929912,14.620957394133507
16513,/media/marda/TWOTB1/xBD/hurricanes/images/florence/hurricane-florence_00000064_post_disaster.png,50,46,1,526,576,665,711,450,31.581622496288222,19.056350343210422
16514,/media/marda/TWOTB1/xBD/hurricanes/images/florence/hurricane-florence_00000064_post_disaster.png,44,58,1,507,551,708,766,705,34.643909781820724,27.111958705124422
16515,/media/marda/TWOTB1/xBD/hurricanes/images/florence/hurricane-florence_00000064_post_disaster.png,41,67,1,69,110,733,800,1234,40.82358246015579,40.07000094280159
16516,/media/marda/TWOTB1/xBD/hurricanes/images/florence/hurricane-florence_00000064_post_disaster.png,76,74,1,574,650,793,867,1198,57.88477798310225,35.52182430117143
16517,/media/marda/TWOTB1/xBD/hurricanes/images/florence/hurricane-florence_00000064_post_disaster.png,47,54,1,526,573,828,882,405,27.455297077338656,19.323820846878476
16518,/media/marda/TWOTB1/xBD/hurricanes/images/florence/hurricane-florence_00000064_post_disaster.png,50,63,1,673,723,895,958,594,30.51531877868014,25.926723182322174
16519,/media/marda/TWOTB1/xBD/hurricanes/images/florence/hurricane-florence_00000064_post_disaster.png,41,49,1,619,660,972,1021,183,19.509893085709063,12.482983610127748
16520,/media/marda/TWOTB1/xBD/hurricanes/images/florence/hurricane-florence_00000529_post_disaster.png,74,69,1,813,887,33,102,1385,74.8901244493018,30.290865893159683
16521,/media/marda/TWOTB1/xBD/hurricanes/images/florence/hurricane-florence_00000529_post_disaster.png,58,28,1,762,820,69,97,465,26.759401202126163,22.95898244911498
16522,/media/marda/TWOTB1/xBD/hurricanes/images/florence/hurricane-florence_00000529_post_disaster.png,52,29,1,840,892,175,204,365,23.652127606709495,20.427791924417722
16523,/media/marda/TWOTB1/xBD/hurricanes/images/florence/hurricane-florence_00000529_post_disaster.png,79,68,1,896,975,293,361,1920,64.08597194354766,39.891979159551624
16524,/media/marda/TWOTB1/xBD/hurricanes/images/florence/hurricane-florence_00000529_post_disaster.png,50,26,1,961,1011,315,341,163,16.441962608315443,13.324286353367958
16525,/media/marda/TWOTB1/xBD/hurricanes/images/florence/hurricane-florence_00000529_post_disaster.png,71,28,1,938,1009,410,438,273,38.47560662002221,9.557576443238515
16526,/media/marda/TWOTB1/xBD/hurricanes/images/florence/hurricane-florence_00000529_post_disaster.png,73,31,1,938,1011,423,454,335,41.11523767944516,10.85287408560726
16527,/media/marda/TWOTB1/xBD/hurricanes/images/florence/hurricane-florence_00000529_post_disaster.png,64,59,1,421,485,607,666,1192,52.03947214928022,32.83837683449851
16528,/media/marda/TWOTB1/xBD/hurricanes/images/florence/hurricane-florence_00000529_post_disaster.png,29,34,1,472,501,629,663,130,14.966629547095765,11.489125293076057
16529,/media/marda/TWOTB1/xBD/hurricanes/images/florence/hurricane-florence_00000529_post_disaster.png,70,59,1,816,886,676,735,871,42.6433970644379,26.829472314503253
16530,/media/marda/TWOTB1/xBD/hurricanes/images/florence/hurricane-florence_00000529_post_disaster.png,46,47,1,358,404,682,729,599,36.057785114583965,21.986431207646906
16531,/media/marda/TWOTB1/xBD/hurricanes/images/florence/hurricane-florence_00000529_post_disaster.png,58,59,1,489,547,805,864,740,41.58012912535587,23.957141668759103
16532,/media/marda/TWOTB1/xBD/hurricanes/images/florence/hurricane-florence_00000529_post_disaster.png,76,55,1,888,964,820,875,699,41.87967136253219,22.145083757041867
16533,/media/marda/TWOTB1/xBD/hurricanes/images/florence/hurricane-florence_00000529_post_disaster.png,56,53,1,914,970,858,911,365,24.671438764692123,20.297910628847315
16534,/media/marda/TWOTB1/xBD/hurricanes/images/florence/hurricane-florence_00000529_post_disaster.png,49,42,1,877,926,865,907,140,16.91513794336374,10.879814026670472
16535,/media/marda/TWOTB1/xBD/hurricanes/images/florence/hurricane-florence_00000529_post_disaster.png,95,121,1,686,781,874,995,2604,100.8228236877787,39.23023740012819
16536,/media/marda/TWOTB1/xBD/hurricanes/images/florence/hurricane-florence_00000529_post_disaster.png,50,66,1,259,309,915,981,671,42.14638623057001,21.078126818983996
16537,/media/marda/TWOTB1/xBD/hurricanes/images/florence/hurricane-florence_00000529_post_disaster.png,30,72,1,76,106,932,1004,814,39.61149805564076,27.23233064827914
16538,/media/marda/TWOTB1/xBD/hurricanes/images/florence/hurricane-florence_00000529_post_disaster.png,92,81,1,785,877,473,554,3593,71.32544981685156,67.07787845602515
16539,/media/marda/TWOTB1/xBD/hurricanes/images/florence/hurricane-florence_00000219_pre_disaster.png,47,59,1,623,670,692,751,464,30.141299099644915,20.259455419358016
16540,/media/marda/TWOTB1/xBD/hurricanes/images/florence/hurricane-florence_00000219_pre_disaster.png,44,50,1,616,660,728,778,285,20.419523032225925,18.69153405697185
16541,/media/marda/TWOTB1/xBD/hurricanes/images/florence/hurricane-florence_00000219_pre_disaster.png,45,46,1,627,672,756,802,242,21.38436009913766,15.1758054939504
16542,/media/marda/TWOTB1/xBD/hurricanes/images/florence/hurricane-florence_00000219_pre_disaster.png,41,49,1,559,600,838,887,253,21.208231322435005,16.013279264529505
16543,/media/marda/TWOTB1/xBD/hurricanes/images/florence/hurricane-florence_00000208_pre_disaster.png,75,42,1,969,1044,0,42,977,42.8977405729735,30.069050581366813
16544,/media/marda/TWOTB1/xBD/hurricanes/images/florence/hurricane-florence_00000018_pre_disaster.png,65,53,1,403,468,98,151,1345,47.83864271354518,37.42090232512065
16545,/media/marda/TWOTB1/xBD/hurricanes/images/florence/hurricane-florence_00000018_pre_disaster.png,69,48,1,602,671,114,162,1079,42.17832846606157,34.05236939712167
16546,/media/marda/TWOTB1/xBD/hurricanes/images/florence/hurricane-florence_00000018_pre_disaster.png,58,50,1,392,450,152,202,918,52.02482039182227,23.41845286594732
16547,/media/marda/TWOTB1/xBD/hurricanes/images/florence/hurricane-florence_00000018_pre_disaster.png,57,43,1,460,517,152,195,711,40.04286399727664,23.69626844453166
16548,/media/marda/TWOTB1/xBD/hurricanes/images/florence/hurricane-florence_00000018_pre_disaster.png,52,30,1,656,708,173,203,353,25.87953374818254,18.235836885327178
16549,/media/marda/TWOTB1/xBD/hurricanes/images/florence/hurricane-florence_00000018_pre_disaster.png,37,24,1,430,467,184,208,259,19.383646675356225,17.906656763365877
16550,/media/marda/TWOTB1/xBD/hurricanes/images/florence/hurricane-florence_00000018_pre_disaster.png,31,14,1,569,600,184,198,54,9.208793051854947,7.949725185697178
16551,/media/marda/TWOTB1/xBD/hurricanes/images/florence/hurricane-florence_00000018_pre_disaster.png,54,38,1,628,682,227,265,406,33.35005701579282,16.282953196977857
16552,/media/marda/TWOTB1/xBD/hurricanes/images/florence/hurricane-florence_00000018_pre_disaster.png,85,74,1,237,322,241,315,2376,67.49830427619068,49.05587054771685
16553,/media/marda/TWOTB1/xBD/hurricanes/images/florence/hurricane-florence_00000018_pre_disaster.png,22,25,1,248,270,309,334,131,14.13075593425988,12.043259931661462
16554,/media/marda/TWOTB1/xBD/hurricanes/images/florence/hurricane-florence_00000018_pre_disaster.png,62,55,1,340,402,315,370,1168,42.42969123705715,36.20811928564565
16555,/media/marda/TWOTB1/xBD/hurricanes/images/florence/hurricane-florence_00000018_pre_disaster.png,30,32,1,286,316,371,403,186,21.29450617608943,11.69348344607311
16556,/media/marda/TWOTB1/xBD/hurricanes/images/florence/hurricane-florence_00000018_pre_disaster.png,105,119,1,369,474,382,501,3059,129.4332241886801,60.908843083245685
16557,/media/marda/TWOTB1/xBD/hurricanes/images/florence/hurricane-florence_00000018_pre_disaster.png,52,65,1,314,366,440,505,850,53.505893728336204,21.193546073168648
16558,/media/marda/TWOTB1/xBD/hurricanes/images/florence/hurricane-florence_00000018_pre_disaster.png,29,44,1,53,82,458,502,422,24.43233495713518,22.8640128088072
16559,/media/marda/TWOTB1/xBD/hurricanes/images/florence/hurricane-florence_00000018_pre_disaster.png,10,35,1,0,10,459,494,97,16.548042195973657,9.038956769701173
16560,/media/marda/TWOTB1/xBD/hurricanes/images/florence/hurricane-florence_00000018_pre_disaster.png,22,34,1,257,279,463,497,145,17.69189659569606,11.002513196119741
16561,/media/marda/TWOTB1/xBD/hurricanes/images/florence/hurricane-florence_00000018_pre_disaster.png,46,42,1,392,438,467,509,361,32.70867515135926,14.747012362498435
16562,/media/marda/TWOTB1/xBD/hurricanes/images/florence/hurricane-florence_00000018_pre_disaster.png,30,40,1,278,308,473,513,241,23.496549564380196,13.711036761881331
16563,/media/marda/TWOTB1/xBD/hurricanes/images/florence/hurricane-florence_00000018_pre_disaster.png,56,61,1,323,379,488,549,1136,40.198209613964224,38.407648482860225
16564,/media/marda/TWOTB1/xBD/hurricanes/images/florence/hurricane-florence_00000018_pre_disaster.png,34,58,1,0,34,499,557,644,41.842517865678374,20.692602350139094
16565,/media/marda/TWOTB1/xBD/hurricanes/images/florence/hurricane-florence_00000018_pre_disaster.png,67,79,1,196,263,531,610,1937,72.86663420129067,40.36538110521835
16566,/media/marda/TWOTB1/xBD/hurricanes/images/florence/hurricane-florence_00000018_pre_disaster.png,22,30,1,295,317,552,582,64,10.632682984345912,7.866361694226938
16567,/media/marda/TWOTB1/xBD/hurricanes/images/florence/hurricane-florence_00000018_pre_disaster.png,21,68,1,0,21,663,731,469,45.21571064331727,13.901070386187834
16568,/media/marda/TWOTB1/xBD/hurricanes/images/florence/hurricane-florence_00000018_pre_disaster.png,34,70,1,37,71,683,753,641,50.798915796718134,18.453753116248294
16569,/media/marda/TWOTB1/xBD/hurricanes/images/florence/hurricane-florence_00000018_pre_disaster.png,35,75,1,91,126,708,783,633,52.73060302762472,16.0207702399282
16570,/media/marda/TWOTB1/xBD/hurricanes/images/florence/hurricane-florence_00000018_pre_disaster.png,28,71,1,139,167,729,800,559,45.90633784094953,16.282838039201106
16571,/media/marda/TWOTB1/xBD/hurricanes/images/florence/hurricane-florence_00000018_pre_disaster.png,45,61,1,185,230,761,822,481,45.909318378163725,13.978650799881908
16572,/media/marda/TWOTB1/xBD/hurricanes/images/florence/hurricane-florence_00000018_pre_disaster.png,47,78,1,244,291,794,872,700,55.99126450152841,16.513225297438595
16573,/media/marda/TWOTB1/xBD/hurricanes/images/florence/hurricane-florence_00000018_pre_disaster.png,45,72,1,324,369,848,920,528,45.684545869051334,15.43553050827466
16574,/media/marda/TWOTB1/xBD/hurricanes/images/florence/hurricane-florence_00000018_pre_disaster.png,41,53,1,390,431,868,921,250,30.221050129714094,11.020568454363323
16575,/media/marda/TWOTB1/xBD/hurricanes/images/florence/hurricane-florence_00000018_pre_disaster.png,25,41,1,435,460,868,909,41,8.067491238838764,6.85019001599384
16576,/media/marda/TWOTB1/xBD/hurricanes/images/florence/hurricane-florence_00000018_pre_disaster.png,29,43,1,422,451,874,917,77,14.172378244832196,7.143978270640563
16577,/media/marda/TWOTB1/xBD/hurricanes/images/florence/hurricane-florence_00000018_pre_disaster.png,32,43,1,443,475,880,923,110,17.239598611323817,8.579403072231411
16578,/media/marda/TWOTB1/xBD/hurricanes/images/florence/hurricane-florence_00000018_pre_disaster.png,52,53,1,417,469,893,946,301,41.435466321613276,10.571848358254725
16579,/media/marda/TWOTB1/xBD/hurricanes/images/florence/hurricane-florence_00000018_pre_disaster.png,27,52,1,350,377,894,946,130,13.544564419881048,12.996619250935945
16580,/media/marda/TWOTB1/xBD/hurricanes/images/florence/hurricane-florence_00000018_pre_disaster.png,41,43,1,845,886,898,941,63,10.327955589886445,8.0
16581,/media/marda/TWOTB1/xBD/hurricanes/images/florence/hurricane-florence_00000018_pre_disaster.png,33,43,1,774,807,902,945,28,7.2389395959971035,5.202609083970016
16582,/media/marda/TWOTB1/xBD/hurricanes/images/florence/hurricane-florence_00000018_pre_disaster.png,71,85,1,718,789,908,993,1088,49.79984723071808,30.020685037743164
16583,/media/marda/TWOTB1/xBD/hurricanes/images/florence/hurricane-florence_00000018_pre_disaster.png,62,60,1,893,955,912,972,430,27.432627411193558,21.824189752391213
16584,/media/marda/TWOTB1/xBD/hurricanes/images/florence/hurricane-florence_00000018_pre_disaster.png,103,76,1,800,903,914,990,1621,70.6974871939443,33.65331272693204
16585,/media/marda/TWOTB1/xBD/hurricanes/images/florence/hurricane-florence_00000018_pre_disaster.png,60,53,1,969,1029,927,980,249,21.499056197223062,15.410668918957118
16586,/media/marda/TWOTB1/xBD/hurricanes/images/florence/hurricane-florence_00000327_pre_disaster.png,56,38,1,587,643,0,38,654,40.79889592822801,21.98909175525582
16587,/media/marda/TWOTB1/xBD/hurricanes/images/florence/hurricane-florence_00000327_pre_disaster.png,73,23,1,951,1024,31,54,350,41.578852237943416,11.184629104620361
16588,/media/marda/TWOTB1/xBD/hurricanes/images/florence/hurricane-florence_00000327_pre_disaster.png,47,48,1,384,431,82,130,638,54.64466626779234,15.559335324277043
16589,/media/marda/TWOTB1/xBD/hurricanes/images/florence/hurricane-florence_00000327_pre_disaster.png,41,31,1,451,492,143,174,375,24.390766620420052,20.523074853588106
16590,/media/marda/TWOTB1/xBD/hurricanes/images/florence/hurricane-florence_00000327_pre_disaster.png,74,66,1,544,618,252,318,1806,55.72063955493165,42.50627080029859
16591,/media/marda/TWOTB1/xBD/hurricanes/images/florence/hurricane-florence_00000327_pre_disaster.png,58,49,1,469,527,275,324,889,36.47962107907664,32.104671838409985
16592,/media/marda/TWOTB1/xBD/hurricanes/images/florence/hurricane-florence_00000327_pre_disaster.png,58,48,1,271,329,323,371,926,50.376490887414235,23.920758385213777
16593,/media/marda/TWOTB1/xBD/hurricanes/images/florence/hurricane-florence_00000327_pre_disaster.png,49,41,1,501,550,366,407,425,26.37873373427257,21.47114180596326
16594,/media/marda/TWOTB1/xBD/hurricanes/images/florence/hurricane-florence_00000327_pre_disaster.png,34,34,1,278,312,376,410,290,22.852884345834372,16.995156140745873
16595,/media/marda/TWOTB1/xBD/hurricanes/images/florence/hurricane-florence_00000327_pre_disaster.png,28,38,1,214,242,401,439,216,20.921085705919076,13.810701305640743
16596,/media/marda/TWOTB1/xBD/hurricanes/images/florence/hurricane-florence_00000327_pre_disaster.png,29,37,1,353,382,403,440,175,21.113962838725943,11.102127107276527
16597,/media/marda/TWOTB1/xBD/hurricanes/images/florence/hurricane-florence_00000327_pre_disaster.png,38,44,1,332,370,442,486,377,26.719717416969548,18.854398165159605
16598,/media/marda/TWOTB1/xBD/hurricanes/images/florence/hurricane-florence_00000327_pre_disaster.png,25,30,1,372,397,451,481,137,13.39205904839086,13.082197194420493
16599,/media/marda/TWOTB1/xBD/hurricanes/images/florence/hurricane-florence_00000327_pre_disaster.png,45,58,1,341,386,483,541,711,39.01032025041729,24.73982032927558
16600,/media/marda/TWOTB1/xBD/hurricanes/images/florence/hurricane-florence_00000327_pre_disaster.png,31,44,1,322,353,558,602,251,23.55537344266493,14.278238153741658
16601,/media/marda/TWOTB1/xBD/hurricanes/images/florence/hurricane-florence_00000107_post_disaster.png,65,58,1,978,1043,474,532,928,42.53711194851969,28.808709126342155
16602,/media/marda/TWOTB1/xBD/hurricanes/images/florence/hurricane-florence_00000107_post_disaster.png,197,80,1,765,962,494,574,5977,185.91488914343802,42.85241717601118
16603,/media/marda/TWOTB1/xBD/hurricanes/images/florence/hurricane-florence_00000107_post_disaster.png,76,63,1,967,1043,573,636,1386,44.063924461529545,41.663410992614594
16604,/media/marda/TWOTB1/xBD/hurricanes/images/florence/hurricane-florence_00000107_post_disaster.png,61,43,1,892,953,596,639,342,26.487319014486033,17.06495244817711
16605,/media/marda/TWOTB1/xBD/hurricanes/images/florence/hurricane-florence_00000107_post_disaster.png,198,85,1,744,942,639,724,6188,188.54125019186364,43.62150669481349
16606,/media/marda/TWOTB1/xBD/hurricanes/images/florence/hurricane-florence_00000107_post_disaster.png,90,69,1,953,1043,670,739,1927,58.58737887354555,43.532857463975716
16607,/media/marda/TWOTB1/xBD/hurricanes/images/florence/hurricane-florence_00000107_post_disaster.png,105,66,1,740,845,746,812,2064,82.2155395426386,33.4125788263439
16608,/media/marda/TWOTB1/xBD/hurricanes/images/florence/hurricane-florence_00000107_post_disaster.png,103,73,1,940,1043,767,840,2405,74.0210306738983,43.09415001249492
16609,/media/marda/TWOTB1/xBD/hurricanes/images/florence/hurricane-florence_00000482_pre_disaster.png,20,13,1,204,224,8,21,114,13.505096903004997,11.381659905384993
16610,/media/marda/TWOTB1/xBD/hurricanes/images/florence/hurricane-florence_00000482_pre_disaster.png,26,19,1,244,270,262,281,134,19.00533931741563,9.325767766684834
16611,/media/marda/TWOTB1/xBD/hurricanes/images/florence/hurricane-florence_00000482_pre_disaster.png,24,28,1,293,317,300,328,212,18.59683519256848,15.329547595125295
16612,/media/marda/TWOTB1/xBD/hurricanes/images/florence/hurricane-florence_00000482_pre_disaster.png,19,30,1,223,242,331,361,151,17.716439175202826,11.396717159500824
16613,/media/marda/TWOTB1/xBD/hurricanes/images/florence/hurricane-florence_00000482_pre_disaster.png,26,47,1,353,379,556,603,331,29.62751500083267,14.800840939968833
16614,/media/marda/TWOTB1/xBD/hurricanes/images/florence/hurricane-florence_00000456_pre_disaster.png,41,19,1,499,540,65,84,213,18.26261771608995,15.632244613561317
16615,/media/marda/TWOTB1/xBD/hurricanes/images/florence/hurricane-florence_00000456_pre_disaster.png,43,22,1,392,435,100,122,298,30.97916585884332,13.496213381576494
16616,/media/marda/TWOTB1/xBD/hurricanes/images/florence/hurricane-florence_00000456_pre_disaster.png,66,47,1,277,343,116,163,1372,57.27114750616543,31.530946215996956
16617,/media/marda/TWOTB1/xBD/hurricanes/images/florence/hurricane-florence_00000456_pre_disaster.png,57,35,1,353,410,171,206,690,46.202683358458145,19.950787343672296
16618,/media/marda/TWOTB1/xBD/hurricanes/images/florence/hurricane-florence_00000456_pre_disaster.png,31,29,1,319,350,174,203,348,23.77579884614406,18.891679689995012
16619,/media/marda/TWOTB1/xBD/hurricanes/images/florence/hurricane-florence_00000456_pre_disaster.png,90,55,1,336,426,242,297,1532,85.07045518349575,24.031551693459342
16620,/media/marda/TWOTB1/xBD/hurricanes/images/florence/hurricane-florence_00000039_post_disaster.png,47,51,1,222,269,252,303,825,41.38513830251083,26.5970155613926
16621,/media/marda/TWOTB1/xBD/hurricanes/images/florence/hurricane-florence_00000039_post_disaster.png,25,30,1,151,176,285,315,236,18.900699406905666,16.72866724196843
16622,/media/marda/TWOTB1/xBD/hurricanes/images/florence/hurricane-florence_00000039_post_disaster.png,22,26,1,213,235,307,333,142,14.468194526142934,13.249728251952678
16623,/media/marda/TWOTB1/xBD/hurricanes/images/florence/hurricane-florence_00000039_post_disaster.png,23,28,1,213,236,356,384,137,14.13166883291293,13.049189149396653
16624,/media/marda/TWOTB1/xBD/hurricanes/images/florence/hurricane-florence_00000517_pre_disaster.png,89,47,1,891,980,0,47,1400,52.94582258021037,35.16275026215616
16625,/media/marda/TWOTB1/xBD/hurricanes/images/florence/hurricane-florence_00000517_pre_disaster.png,95,62,1,869,964,37,99,2205,55.10648678603302,52.94309004291405
16626,/media/marda/TWOTB1/xBD/hurricanes/images/florence/hurricane-florence_00000517_pre_disaster.png,52,24,1,866,918,211,235,208,18.395221273326975,14.452997375005186
16627,/media/marda/TWOTB1/xBD/hurricanes/images/florence/hurricane-florence_00000517_pre_disaster.png,141,57,1,780,921,243,300,3426,121.19654662710381,37.48722784551398
16628,/media/marda/TWOTB1/xBD/hurricanes/images/florence/hurricane-florence_00000517_pre_disaster.png,140,60,1,771,911,296,356,3364,121.37117894383962,36.8687147915013
16629,/media/marda/TWOTB1/xBD/hurricanes/images/florence/hurricane-florence_00000517_pre_disaster.png,50,26,1,830,880,348,374,161,18.832761819263848,11.344647467654644
16630,/media/marda/TWOTB1/xBD/hurricanes/images/florence/hurricane-florence_00000517_pre_disaster.png,79,87,1,783,862,559,646,1580,71.54547887681589,29.473404855408653
16631,/media/marda/TWOTB1/xBD/hurricanes/images/florence/hurricane-florence_00000517_pre_disaster.png,68,163,1,570,638,607,770,4563,156.68283856452092,38.84740261092108
16632,/media/marda/TWOTB1/xBD/hurricanes/images/florence/hurricane-florence_00000517_pre_disaster.png,83,70,1,703,786,611,681,1745,53.8974901040949,43.611799014523086
16633,/media/marda/TWOTB1/xBD/hurricanes/images/florence/hurricane-florence_00000517_pre_disaster.png,61,41,1,914,975,657,698,335,28.367105351686106,15.928131516873703
16634,/media/marda/TWOTB1/xBD/hurricanes/images/florence/hurricane-florence_00000517_pre_disaster.png,60,49,1,761,821,667,716,605,31.491371932261714,25.402494494176036
16635,/media/marda/TWOTB1/xBD/hurricanes/images/florence/hurricane-florence_00000517_pre_disaster.png,89,66,1,907,996,682,748,1600,58.447762910089224,39.364559943634575
16636,/media/marda/TWOTB1/xBD/hurricanes/images/florence/hurricane-florence_00000517_pre_disaster.png,47,41,1,692,739,687,728,215,20.734967005945265,13.688444276179029
16637,/media/marda/TWOTB1/xBD/hurricanes/images/florence/hurricane-florence_00000517_pre_disaster.png,64,62,1,675,739,708,770,944,40.413758630932165,32.45910515716674
16638,/media/marda/TWOTB1/xBD/hurricanes/images/florence/hurricane-florence_00000517_pre_disaster.png,40,37,1,779,819,709,746,77,11.082329117375982,9.303524535662277
16639,/media/marda/TWOTB1/xBD/hurricanes/images/florence/hurricane-florence_00000517_pre_disaster.png,57,56,1,422,479,832,888,825,46.32338539900673,23.795322403725088
16640,/media/marda/TWOTB1/xBD/hurricanes/images/florence/hurricane-florence_00000517_pre_disaster.png,58,67,1,13,71,835,902,1538,63.274573719008195,34.03968802395768
16641,/media/marda/TWOTB1/xBD/hurricanes/images/florence/hurricane-florence_00000063_post_disaster.png,32,35,1,344,376,0,35,363,40.004339431860636,12.1170382592631
16642,/media/marda/TWOTB1/xBD/hurricanes/images/florence/hurricane-florence_00000063_post_disaster.png,35,26,1,390,425,0,26,345,28.739403648522632,16.081295737354942
16643,/media/marda/TWOTB1/xBD/hurricanes/images/florence/hurricane-florence_00000063_post_disaster.png,31,7,1,446,477,0,7,66,15.146972296366496,6.1171522499347555
16644,/media/marda/TWOTB1/xBD/hurricanes/images/florence/hurricane-florence_00000063_post_disaster.png,40,47,1,289,329,4,51,649,49.93421892677449,20.04351374174079
16645,/media/marda/TWOTB1/xBD/hurricanes/images/florence/hurricane-florence_00000063_post_disaster.png,30,44,1,249,279,15,59,539,48.90048017854826,14.710337783980737
16646,/media/marda/TWOTB1/xBD/hurricanes/images/florence/hurricane-florence_00000063_post_disaster.png,48,47,1,539,587,34,81,608,52.51632712905231,15.392353240090209
16647,/media/marda/TWOTB1/xBD/hurricanes/images/florence/hurricane-florence_00000063_post_disaster.png,66,48,1,887,953,37,85,1013,48.783255621390275,27.566464678521797
16648,/media/marda/TWOTB1/xBD/hurricanes/images/florence/hurricane-florence_00000063_post_disaster.png,56,25,1,706,762,43,68,503,29.343444767870725,22.664471037287456
16649,/media/marda/TWOTB1/xBD/hurricanes/images/florence/hurricane-florence_00000063_post_disaster.png,80,61,1,759,839,43,104,1863,59.66774618185656,44.36801122898492
16650,/media/marda/TWOTB1/xBD/hurricanes/images/florence/hurricane-florence_00000063_post_disaster.png,46,46,1,492,538,45,91,589,49.96096458727048,15.784353170150142
16651,/media/marda/TWOTB1/xBD/hurricanes/images/florence/hurricane-florence_00000063_post_disaster.png,40,48,1,450,490,53,101,509,52.41151619364833,12.98345201637725
16652,/media/marda/TWOTB1/xBD/hurricanes/images/florence/hurricane-florence_00000063_post_disaster.png,39,42,1,398,437,74,116,546,46.07929602375257,15.842948124225439
16653,/media/marda/TWOTB1/xBD/hurricanes/images/florence/hurricane-florence_00000063_post_disaster.png,37,43,1,349,386,83,126,596,45.80317871955641,17.401177931702243
16654,/media/marda/TWOTB1/xBD/hurricanes/images/florence/hurricane-florence_00000063_post_disaster.png,36,48,1,301,337,94,142,648,52.44810383334266,16.504735103300423
16655,/media/marda/TWOTB1/xBD/hurricanes/images/florence/hurricane-florence_00000063_post_disaster.png,31,48,1,270,301,109,157,534,47.041115031065516,15.168112002833446
16656,/media/marda/TWOTB1/xBD/hurricanes/images/florence/hurricane-florence_00000063_post_disaster.png,62,49,1,824,886,165,214,798,46.633018990813355,22.84517979626492
16657,/media/marda/TWOTB1/xBD/hurricanes/images/florence/hurricane-florence_00000063_post_disaster.png,52,36,1,929,981,290,326,364,29.970856289863512,16.152531569081365
16658,/media/marda/TWOTB1/xBD/hurricanes/images/florence/hurricane-florence_00000063_post_disaster.png,84,37,1,947,1031,325,362,537,52.37694854611532,13.631155294258773
16659,/media/marda/TWOTB1/xBD/hurricanes/images/florence/hurricane-florence_00000063_post_disaster.png,56,40,1,796,852,332,372,438,26.182645785143222,22.213563248363467
16660,/media/marda/TWOTB1/xBD/hurricanes/images/florence/hurricane-florence_00000063_post_disaster.png,72,48,1,837,909,335,383,714,42.794038915460106,24.67448613330363
16661,/media/marda/TWOTB1/xBD/hurricanes/images/florence/hurricane-florence_00000063_post_disaster.png,86,36,1,947,1033,369,405,563,53.55160191127071,14.047409462306412
16662,/media/marda/TWOTB1/xBD/hurricanes/images/florence/hurricane-florence_00000063_post_disaster.png,74,33,1,966,1040,412,445,328,40.18771864221245,10.913001960862287
16663,/media/marda/TWOTB1/xBD/hurricanes/images/florence/hurricane-florence_00000063_post_disaster.png,81,42,1,857,938,421,463,523,53.01690352423947,13.173886116551976
16664,/media/marda/TWOTB1/xBD/hurricanes/images/florence/hurricane-florence_00000268_post_disaster.png,46,81,1,19,65,933,1014,822,59.83444758257235,18.171821423662454
16665,/media/marda/TWOTB1/xBD/hurricanes/images/florence/hurricane-florence_00000268_post_disaster.png,92,73,1,947,1039,780,853,1624,53.870813528366554,40.7995074368864
16666,/media/marda/TWOTB1/xBD/hurricanes/images/florence/hurricane-florence_00000268_post_disaster.png,53,68,1,626,679,965,1033,492,31.444540016999202,20.78622295645812
16667,/media/marda/TWOTB1/xBD/hurricanes/images/florence/hurricane-florence_00000268_post_disaster.png,44,56,1,654,698,987,1043,165,20.20565392774975,11.21420362497761
16668,/media/marda/TWOTB1/xBD/hurricanes/images/florence/hurricane-florence_00000268_post_disaster.png,74,60,1,687,761,578,638,910,50.432855003034966,24.074819011255588
16669,/media/marda/TWOTB1/xBD/hurricanes/images/florence/hurricane-florence_00000268_post_disaster.png,82,75,1,712,794,640,715,1520,50.30918088728711,40.08633812218065
16670,/media/marda/TWOTB1/xBD/hurricanes/images/florence/hurricane-florence_00000268_post_disaster.png,62,67,1,734,796,687,754,694,39.71573597196206,23.145877202485334
16671,/media/marda/TWOTB1/xBD/hurricanes/images/florence/hurricane-florence_00000268_post_disaster.png,48,57,1,662,710,696,753,360,26.819781018597993,19.64956790756369
16672,/media/marda/TWOTB1/xBD/hurricanes/images/florence/hurricane-florence_00000268_post_disaster.png,52,54,1,718,770,712,766,325,25.134283659252468,17.289772818282838
16673,/media/marda/TWOTB1/xBD/hurricanes/images/florence/hurricane-florence_00000268_post_disaster.png,60,68,1,749,809,734,802,621,44.70776941747337,18.34137116503024
16674,/media/marda/TWOTB1/xBD/hurricanes/images/florence/hurricane-florence_00000268_post_disaster.png,49,44,1,904,953,821,865,128,13.226415373186827,12.328013024243898
16675,/media/marda/TWOTB1/xBD/hurricanes/images/florence/hurricane-florence_00000268_post_disaster.png,95,86,1,737,832,874,960,1770,73.25264318295683,32.675742868950095
16676,/media/marda/TWOTB1/xBD/hurricanes/images/florence/hurricane-florence_00000268_post_disaster.png,69,99,1,624,693,909,1008,1631,60.95468375742688,37.806483725928466
16677,/media/marda/TWOTB1/xBD/hurricanes/images/florence/hurricane-florence_00000268_post_disaster.png,59,88,1,223,282,944,1032,1305,58.93958748357612,31.664508515829194
16678,/media/marda/TWOTB1/xBD/hurricanes/images/florence/hurricane-florence_00000268_post_disaster.png,28,56,1,290,318,959,1015,196,18.44960228921482,14.061340496883629
16679,/media/marda/TWOTB1/xBD/hurricanes/images/florence/hurricane-florence_00000268_post_disaster.png,54,79,1,349,403,962,1041,1109,41.11241578148726,36.500471449154695
16680,/media/marda/TWOTB1/xBD/hurricanes/images/florence/hurricane-florence_00000268_post_disaster.png,28,49,1,391,419,970,1019,97,12.239002848542608,10.551564615303135
16681,/media/marda/TWOTB1/xBD/hurricanes/images/florence/hurricane-florence_00000268_post_disaster.png,36,49,1,616,652,970,1019,86,12.692462701138727,9.117248144470434
16682,/media/marda/TWOTB1/xBD/hurricanes/images/florence/hurricane-florence_00000268_post_disaster.png,39,59,1,408,447,976,1035,300,20.531158180062555,19.47565743881678
16683,/media/marda/TWOTB1/xBD/hurricanes/images/florence/hurricane-florence_00000268_post_disaster.png,34,51,1,520,554,992,1043,92,12.68934925846425,9.882737785348393
16684,/media/marda/TWOTB1/xBD/hurricanes/images/florence/hurricane-florence_00000268_post_disaster.png,28,46,1,491,519,997,1043,43,10.52244550445535,5.524285435490871
16685,/media/marda/TWOTB1/xBD/hurricanes/images/florence/hurricane-florence_00000088_post_disaster.png,19,71,1,0,19,882,953,433,38.82386923512283,17.095422671881348
16686,/media/marda/TWOTB1/xBD/hurricanes/images/florence/hurricane-florence_00000084_pre_disaster.png,71,23,1,973,1044,1,24,461,37.363827605236246,16.48170756752697
16687,/media/marda/TWOTB1/xBD/hurricanes/images/florence/hurricane-florence_00000084_pre_disaster.png,58,35,1,703,761,7,42,686,33.68513306770596,27.18846602599181
16688,/media/marda/TWOTB1/xBD/hurricanes/images/florence/hurricane-florence_00000084_pre_disaster.png,87,45,1,589,676,29,74,1836,68.9276607267094,35.19753568577127
16689,/media/marda/TWOTB1/xBD/hurricanes/images/florence/hurricane-florence_00000084_pre_disaster.png,45,23,1,713,758,39,62,251,22.423598660302964,14.991566143198924
16690,/media/marda/TWOTB1/xBD/hurricanes/images/florence/hurricane-florence_00000084_pre_disaster.png,51,38,1,476,527,51,89,829,37.97400869639612,29.033185865697778
16691,/media/marda/TWOTB1/xBD/hurricanes/images/florence/hurricane-florence_00000084_pre_disaster.png,82,44,1,896,978,68,112,1113,48.43484539445335,33.183733787932965
16692,/media/marda/TWOTB1/xBD/hurricanes/images/florence/hurricane-florence_00000084_pre_disaster.png,52,19,1,883,935,98,117,175,18.44631410387024,12.742086221944986
16693,/media/marda/TWOTB1/xBD/hurricanes/images/florence/hurricane-florence_00000084_pre_disaster.png,82,34,1,614,696,103,137,914,64.04681009872421,19.64622727809014
16694,/media/marda/TWOTB1/xBD/hurricanes/images/florence/hurricane-florence_00000084_pre_disaster.png,53,42,1,490,543,108,150,769,35.23244466724881,29.634543377661362
16695,/media/marda/TWOTB1/xBD/hurricanes/images/florence/hurricane-florence_00000084_pre_disaster.png,75,44,1,438,513,136,180,1387,63.05973533443626,29.622576799031616
16696,/media/marda/TWOTB1/xBD/hurricanes/images/florence/hurricane-florence_00000084_pre_disaster.png,60,51,1,181,241,141,192,1524,52.61091497390468,38.07724674134124
16697,/media/marda/TWOTB1/xBD/hurricanes/images/florence/hurricane-florence_00000084_pre_disaster.png,97,51,1,339,436,157,208,2111,92.46792468505322,30.308809193830996
16698,/media/marda/TWOTB1/xBD/hurricanes/images/florence/hurricane-florence_00000084_pre_disaster.png,76,39,1,968,1044,157,196,837,44.17900860816078,26.352806076585754
16699,/media/marda/TWOTB1/xBD/hurricanes/images/florence/hurricane-florence_00000084_pre_disaster.png,53,20,1,805,858,167,187,219,22.45941578082016,12.900350273850425
16700,/media/marda/TWOTB1/xBD/hurricanes/images/florence/hurricane-florence_00000084_pre_disaster.png,76,38,1,917,993,174,212,848,42.595879709148,26.27681602256408
16701,/media/marda/TWOTB1/xBD/hurricanes/images/florence/hurricane-florence_00000084_pre_disaster.png,75,41,1,868,943,185,226,993,41.14941707001024,33.34190577604985
16702,/media/marda/TWOTB1/xBD/hurricanes/images/florence/hurricane-florence_00000084_pre_disaster.png,72,39,1,816,888,201,240,810,42.88158669047891,25.060045311702996
16703,/media/marda/TWOTB1/xBD/hurricanes/images/florence/hurricane-florence_00000084_pre_disaster.png,48,24,1,732,780,202,226,193,20.08714217311694,12.670425669446505
16704,/media/marda/TWOTB1/xBD/hurricanes/images/florence/hurricane-florence_00000084_pre_disaster.png,19,49,1,0,19,245,294,397,35.52176509274098,17.197129088904838
16705,/media/marda/TWOTB1/xBD/hurricanes/images/florence/hurricane-florence_00000084_pre_disaster.png,173,162,1,871,1044,335,497,7945,150.12103134709835,119.65150841796778
16706,/media/marda/TWOTB1/xBD/hurricanes/images/florence/hurricane-florence_00000084_pre_disaster.png,64,53,1,209,273,341,394,1128,64.70735241829894,23.027926803987874
16707,/media/marda/TWOTB1/xBD/hurricanes/images/florence/hurricane-florence_00000084_pre_disaster.png,21,35,1,17,38,432,467,276,21.272666194600596,17.17377335615493
16708,/media/marda/TWOTB1/xBD/hurricanes/images/florence/hurricane-florence_00000084_pre_disaster.png,7,35,1,0,7,453,488,78,19.872816869178028,6.5144969914518045
16709,/media/marda/TWOTB1/xBD/hurricanes/images/florence/hurricane-florence_00000084_pre_disaster.png,47,45,1,402,449,557,602,480,29.919664650714772,21.253187354943364
16710,/media/marda/TWOTB1/xBD/hurricanes/images/florence/hurricane-florence_00000084_pre_disaster.png,33,62,1,65,98,581,643,759,41.580132643187255,24.3797860745175
16711,/media/marda/TWOTB1/xBD/hurricanes/images/florence/hurricane-florence_00000084_pre_disaster.png,64,66,1,371,435,590,656,1375,49.31904774944977,37.16761107142769
16712,/media/marda/TWOTB1/xBD/hurricanes/images/florence/hurricane-florence_00000084_pre_disaster.png,23,42,1,74,97,633,675,244,24.505812955136346,13.131196188779237
16713,/media/marda/TWOTB1/xBD/hurricanes/images/florence/hurricane-florence_00000084_pre_disaster.png,78,63,1,939,1017,639,702,1048,41.41047365390784,35.60358963174352
16714,/media/marda/TWOTB1/xBD/hurricanes/images/florence/hurricane-florence_00000084_pre_disaster.png,78,55,1,831,909,673,728,847,50.23400512249365,22.279680863381355
16715,/media/marda/TWOTB1/xBD/hurricanes/images/florence/hurricane-florence_00000084_pre_disaster.png,68,64,1,965,1033,685,749,778,40.57932928610642,25.54702682138477
16716,/media/marda/TWOTB1/xBD/hurricanes/images/florence/hurricane-florence_00000084_pre_disaster.png,44,64,1,312,356,686,750,677,36.764924691648815,24.53680610263913
16717,/media/marda/TWOTB1/xBD/hurricanes/images/florence/hurricane-florence_00000084_pre_disaster.png,62,69,1,856,918,714,783,689,43.17975516573681,21.29263704672977
16718,/media/marda/TWOTB1/xBD/hurricanes/images/florence/hurricane-florence_00000084_pre_disaster.png,65,65,1,979,1044,737,802,713,36.16034188708705,25.736181129766475
16719,/media/marda/TWOTB1/xBD/hurricanes/images/florence/hurricane-florence_00000084_pre_disaster.png,26,39,1,303,329,738,777,92,13.902414728731426,8.914251819659482
16720,/media/marda/TWOTB1/xBD/hurricanes/images/florence/hurricane-florence_00000084_pre_disaster.png,59,64,1,342,401,752,816,1045,49.01596602746695,27.984222713462263
16721,/media/marda/TWOTB1/xBD/hurricanes/images/florence/hurricane-florence_00000084_pre_disaster.png,81,70,1,854,935,764,834,1300,46.41743972247241,37.385670224450315
16722,/media/marda/TWOTB1/xBD/hurricanes/images/florence/hurricane-florence_00000084_pre_disaster.png,64,59,1,646,710,766,825,799,42.36292008181368,24.948702619463734
16723,/media/marda/TWOTB1/xBD/hurricanes/images/florence/hurricane-florence_00000084_pre_disaster.png,53,48,1,818,871,781,829,264,19.836348787990673,17.847416789130232
16724,/media/marda/TWOTB1/xBD/hurricanes/images/florence/hurricane-florence_00000084_pre_disaster.png,63,65,1,981,1044,789,854,614,33.86910892570671,24.053439144630445
16725,/media/marda/TWOTB1/xBD/hurricanes/images/florence/hurricane-florence_00000084_pre_disaster.png,67,71,1,883,950,815,886,783,38.44143130924345,27.188353213602305
16726,/media/marda/TWOTB1/xBD/hurricanes/images/florence/hurricane-florence_00000084_pre_disaster.png,54,54,1,828,882,828,882,318,21.36097090988266,19.932977025680817
16727,/media/marda/TWOTB1/xBD/hurricanes/images/florence/hurricane-florence_00000084_pre_disaster.png,72,68,1,893,965,868,936,838,36.46220258048931,30.76137316842149
16728,/media/marda/TWOTB1/xBD/hurricanes/images/florence/hurricane-florence_00000084_pre_disaster.png,63,63,1,697,760,955,1018,656,36.37563362054145,23.884087921890362
16729,/media/marda/TWOTB1/xBD/hurricanes/images/florence/hurricane-florence_00000084_pre_disaster.png,59,83,1,588,647,958,1041,1044,48.63751231255953,28.42118281356161
16730,/media/marda/TWOTB1/xBD/hurricanes/images/florence/hurricane-florence_00000084_pre_disaster.png,49,60,1,531,580,963,1023,432,30.03184613282712,19.116123582388767
16731,/media/marda/TWOTB1/xBD/hurricanes/images/florence/hurricane-florence_00000084_pre_disaster.png,60,57,1,646,706,987,1044,432,36.34603045406597,16.504811419671338
16732,/media/marda/TWOTB1/xBD/hurricanes/images/florence/hurricane-florence_00000084_pre_disaster.png,36,50,1,529,565,994,1044,107,15.579039550622767,9.448138627173256
16733,/media/marda/TWOTB1/xBD/hurricanes/images/florence/hurricane-florence_00000358_pre_disaster.png,62,44,1,484,546,99,143,972,41.30142508382255,32.938871941964436
16734,/media/marda/TWOTB1/xBD/hurricanes/images/florence/hurricane-florence_00000358_pre_disaster.png,37,21,1,531,568,134,155,164,14.936956014171788,14.635805332724924
16735,/media/marda/TWOTB1/xBD/hurricanes/images/florence/hurricane-florence_00000358_pre_disaster.png,52,36,1,533,585,154,190,602,30.869380027023837,25.849428075051883
16736,/media/marda/TWOTB1/xBD/hurricanes/images/florence/hurricane-florence_00000358_pre_disaster.png,90,91,1,634,724,347,438,3793,80.8857552694572,61.67979741709931
16737,/media/marda/TWOTB1/xBD/hurricanes/images/florence/hurricane-florence_00000358_pre_disaster.png,106,74,1,909,1015,365,439,2233,72.60796934422694,40.70631525124849
16738,/media/marda/TWOTB1/xBD/hurricanes/images/florence/hurricane-florence_00000358_pre_disaster.png,84,48,1,898,982,473,521,1244,54.29245793369357,30.948504334207016
16739,/media/marda/TWOTB1/xBD/hurricanes/images/florence/hurricane-florence_00000358_pre_disaster.png,368,85,1,524,892,481,566,9686,419.27169627386536,42.706564637792425
16740,/media/marda/TWOTB1/xBD/hurricanes/images/florence/hurricane-florence_00000358_pre_disaster.png,58,39,1,974,1032,514,553,291,20.430764438040438,18.980140275325024
16741,/media/marda/TWOTB1/xBD/hurricanes/images/florence/hurricane-florence_00000358_pre_disaster.png,71,57,1,463,534,553,610,1543,57.80902575369349,35.28082165429324
16742,/media/marda/TWOTB1/xBD/hurricanes/images/florence/hurricane-florence_00000358_pre_disaster.png,71,59,1,471,542,592,651,1447,58.214075694588885,33.58031077715929
16743,/media/marda/TWOTB1/xBD/hurricanes/images/florence/hurricane-florence_00000358_pre_disaster.png,94,74,1,719,813,594,668,2337,65.53434479599555,47.71775974408024
16744,/media/marda/TWOTB1/xBD/hurricanes/images/florence/hurricane-florence_00000358_pre_disaster.png,33,52,1,34,67,605,657,424,33.390549113436755,16.97544018651091
16745,/media/marda/TWOTB1/xBD/hurricanes/images/florence/hurricane-florence_00000358_pre_disaster.png,23,37,1,88,111,632,669,131,21.857811822809595,9.148405328482577
16746,/media/marda/TWOTB1/xBD/hurricanes/images/florence/hurricane-florence_00000358_pre_disaster.png,42,66,1,0,42,670,736,722,53.35607366924691,18.156534762419202
16747,/media/marda/TWOTB1/xBD/hurricanes/images/florence/hurricane-florence_00000397_pre_disaster.png,25,22,1,260,285,99,121,188,18.19734328107228,13.452033135317974
16748,/media/marda/TWOTB1/xBD/hurricanes/images/florence/hurricane-florence_00000397_pre_disaster.png,36,24,1,568,604,291,315,128,13.51390863960617,12.693473649099278
16749,/media/marda/TWOTB1/xBD/hurricanes/images/florence/hurricane-florence_00000397_pre_disaster.png,62,29,1,489,551,295,324,444,50.79524778389715,11.693822687331352
16750,/media/marda/TWOTB1/xBD/hurricanes/images/florence/hurricane-florence_00000397_pre_disaster.png,35,28,1,570,605,305,333,120,13.175070703760273,12.227281007640524
16751,/media/marda/TWOTB1/xBD/hurricanes/images/florence/hurricane-florence_00000397_pre_disaster.png,41,47,1,286,327,377,424,570,35.99068590592028,20.922672455895206
16752,/media/marda/TWOTB1/xBD/hurricanes/images/florence/hurricane-florence_00000397_pre_disaster.png,41,60,1,354,395,437,497,567,48.43011466062795,17.30893205030234
16753,/media/marda/TWOTB1/xBD/hurricanes/images/florence/hurricane-florence_00000397_pre_disaster.png,33,48,1,74,107,438,486,630,31.61247286444082,27.127535075900497
16754,/media/marda/TWOTB1/xBD/hurricanes/images/florence/hurricane-florence_00000397_pre_disaster.png,37,60,1,154,191,439,499,858,43.42053267270516,25.98467824177049
16755,/media/marda/TWOTB1/xBD/hurricanes/images/florence/hurricane-florence_00000397_pre_disaster.png,33,40,1,180,213,497,537,259,27.96702148995527,12.387652876996928
16756,/media/marda/TWOTB1/xBD/hurricanes/images/florence/hurricane-florence_00000397_pre_disaster.png,54,62,1,256,310,501,563,959,44.61292866780315,28.978463267502296
16757,/media/marda/TWOTB1/xBD/hurricanes/images/florence/hurricane-florence_00000397_pre_disaster.png,50,61,1,295,345,511,572,915,43.68897733929841,27.29553245343941
16758,/media/marda/TWOTB1/xBD/hurricanes/images/florence/hurricane-florence_00000397_pre_disaster.png,45,52,1,393,438,553,605,536,29.359873488531218,24.022963012145453
16759,/media/marda/TWOTB1/xBD/hurricanes/images/florence/hurricane-florence_00000397_pre_disaster.png,89,65,1,892,981,554,619,1206,54.010670512889,30.08736228869229
16760,/media/marda/TWOTB1/xBD/hurricanes/images/florence/hurricane-florence_00000397_pre_disaster.png,52,71,1,281,333,580,651,1020,54.424830440678946,24.97885872521454
16761,/media/marda/TWOTB1/xBD/hurricanes/images/florence/hurricane-florence_00000397_pre_disaster.png,53,38,1,882,935,589,627,160,16.535641732383528,12.802345585800134
16762,/media/marda/TWOTB1/xBD/hurricanes/images/florence/hurricane-florence_00000397_pre_disaster.png,63,59,1,440,503,590,649,610,56.169946273594434,14.45707322773836
16763,/media/marda/TWOTB1/xBD/hurricanes/images/florence/hurricane-florence_00000397_pre_disaster.png,182,293,1,0,182,593,886,31229,248.59872928852423,172.43443243942218
16764,/media/marda/TWOTB1/xBD/hurricanes/images/florence/hurricane-florence_00000397_pre_disaster.png,47,48,1,452,499,614,662,424,32.976309716112176,17.08819717621214
16765,/media/marda/TWOTB1/xBD/hurricanes/images/florence/hurricane-florence_00000397_pre_disaster.png,48,67,1,457,505,639,706,488,50.80328406413628,12.851962055457534
16766,/media/marda/TWOTB1/xBD/hurricanes/images/florence/hurricane-florence_00000397_pre_disaster.png,74,78,1,750,824,645,723,842,64.32391695434463,17.493688894649125
16767,/media/marda/TWOTB1/xBD/hurricanes/images/florence/hurricane-florence_00000397_pre_disaster.png,53,73,1,500,553,699,772,845,43.013028931138265,28.693745158627678
16768,/media/marda/TWOTB1/xBD/hurricanes/images/florence/hurricane-florence_00000397_pre_disaster.png,78,63,1,689,767,701,764,745,54.52620797545306,19.3354135808187
16769,/media/marda/TWOTB1/xBD/hurricanes/images/florence/hurricane-florence_00000397_pre_disaster.png,42,41,1,674,716,723,764,116,14.030798276767502,10.93804650881068
16770,/media/marda/TWOTB1/xBD/hurricanes/images/florence/hurricane-florence_00000397_pre_disaster.png,65,77,1,833,898,735,812,850,48.84726231756758,23.460689422133072
16771,/media/marda/TWOTB1/xBD/hurricanes/images/florence/hurricane-florence_00000397_pre_disaster.png,59,68,1,584,643,761,829,698,35.68448437531636,31.245734939230054
16772,/media/marda/TWOTB1/xBD/hurricanes/images/florence/hurricane-florence_00000397_pre_disaster.png,55,63,1,394,449,900,963,599,35.718335051772165,22.963159327898676
16773,/media/marda/TWOTB1/xBD/hurricanes/images/florence/hurricane-florence_00000397_pre_disaster.png,45,69,1,368,413,962,1031,442,38.13378257934068,15.449546341987782
16774,/media/marda/TWOTB1/xBD/hurricanes/images/florence/hurricane-florence_00000163_pre_disaster.png,55,46,1,889,944,701,747,180,16.147806746822514,14.807036748359655
16775,/media/marda/TWOTB1/xBD/hurricanes/images/florence/hurricane-florence_00000096_pre_disaster.png,7,18,1,0,7,0,18,84,16.19476278938256,7.745202489089008
16776,/media/marda/TWOTB1/xBD/hurricanes/images/florence/hurricane-florence_00000096_pre_disaster.png,32,23,1,28,60,0,23,553,32.128878012060554,23.16633677213635
16777,/media/marda/TWOTB1/xBD/hurricanes/images/florence/hurricane-florence_00000096_pre_disaster.png,41,16,1,138,179,0,16,322,39.927407849671106,12.604013903726866
16778,/media/marda/TWOTB1/xBD/hurricanes/images/florence/hurricane-florence_00000096_pre_disaster.png,96,20,1,880,976,0,20,806,61.44289889194978,18.130093164389375
16779,/media/marda/TWOTB1/xBD/hurricanes/images/florence/hurricane-florence_00000096_pre_disaster.png,63,68,1,467,530,15,83,1901,69.62246246545962,36.28507549034344
16780,/media/marda/TWOTB1/xBD/hurricanes/images/florence/hurricane-florence_00000096_pre_disaster.png,47,17,1,756,803,15,32,181,18.729467240982466,12.93811818514702
16781,/media/marda/TWOTB1/xBD/hurricanes/images/florence/hurricane-florence_00000096_pre_disaster.png,98,80,1,268,366,21,101,3762,84.77687509127122,67.32437047727774
16782,/media/marda/TWOTB1/xBD/hurricanes/images/florence/hurricane-florence_00000096_pre_disaster.png,84,53,1,781,865,31,84,1728,59.100574348474034,39.743077125585785
16783,/media/marda/TWOTB1/xBD/hurricanes/images/florence/hurricane-florence_00000096_pre_disaster.png,14,32,1,0,14,34,66,330,32.889586781879544,13.662180394965468
16784,/media/marda/TWOTB1/xBD/hurricanes/images/florence/hurricane-florence_00000096_pre_disaster.png,49,32,1,581,630,35,67,587,30.90423577407456,25.293675998398214
16785,/media/marda/TWOTB1/xBD/hurricanes/images/florence/hurricane-florence_00000096_pre_disaster.png,86,75,1,636,722,38,113,2126,86.07270845555863,35.17976687139267
16786,/media/marda/TWOTB1/xBD/hurricanes/images/florence/hurricane-florence_00000096_pre_disaster.png,44,31,1,169,213,55,86,833,37.67071854291256,29.174240337211945
16787,/media/marda/TWOTB1/xBD/hurricanes/images/florence/hurricane-florence_00000096_pre_disaster.png,65,60,1,588,653,70,130,1538,61.80256047134128,33.847165484493004
16788,/media/marda/TWOTB1/xBD/hurricanes/images/florence/hurricane-florence_00000096_pre_disaster.png,39,20,1,408,447,72,92,281,23.667154555770672,15.891315947290703
16789,/media/marda/TWOTB1/xBD/hurricanes/images/florence/hurricane-florence_00000096_pre_disaster.png,20,18,1,98,118,73,91,154,16.586615008239114,12.4615680878732
16790,/media/marda/TWOTB1/xBD/hurricanes/images/florence/hurricane-florence_00000096_pre_disaster.png,146,79,1,417,563,80,159,6025,146.39811977899103,72.55915786130295
16791,/media/marda/TWOTB1/xBD/hurricanes/images/florence/hurricane-florence_00000096_pre_disaster.png,30,39,1,0,30,81,120,820,36.94509246865523,29.83723144723909
16792,/media/marda/TWOTB1/xBD/hurricanes/images/florence/hurricane-florence_00000096_pre_disaster.png,87,44,1,910,997,99,143,1604,52.63806542576178,40.37790969063339
16793,/media/marda/TWOTB1/xBD/hurricanes/images/florence/hurricane-florence_00000096_pre_disaster.png,82,79,1,284,366,107,186,2994,77.20542647408077,62.19354204833152
16794,/media/marda/TWOTB1/xBD/hurricanes/images/florence/hurricane-florence_00000096_pre_disaster.png,54,56,1,0,54,114,170,1775,61.430163750269486,38.52072543582072
16795,/media/marda/TWOTB1/xBD/hurricanes/images/florence/hurricane-florence_00000096_pre_disaster.png,90,39,1,954,1044,121,160,945,61.301786188880406,21.66933464854492
16796,/media/marda/TWOTB1/xBD/hurricanes/images/florence/hurricane-florence_00000096_pre_disaster.png,45,33,1,199,244,131,164,658,34.8418931119125,25.3923025693248
16797,/media/marda/TWOTB1/xBD/hurricanes/images/florence/hurricane-florence_00000096_pre_disaster.png,89,52,1,786,875,144,196,1867,56.00177789019113,43.42591639519934
16798,/media/marda/TWOTB1/xBD/hurricanes/images/florence/hurricane-florence_00000096_pre_disaster.png,65,51,1,700,765,153,204,1227,49.836750272284476,32.523981764789184
16799,/media/marda/TWOTB1/xBD/hurricanes/images/florence/hurricane-florence_00000096_pre_disaster.png,64,54,1,8,72,163,217,2101,63.70233423219724,44.25583016194863
16800,/media/marda/TWOTB1/xBD/hurricanes/images/florence/hurricane-florence_00000096_pre_disaster.png,84,58,1,928,1012,165,223,2010,54.4409712902449,48.82634660112723
16801,/media/marda/TWOTB1/xBD/hurricanes/images/florence/hurricane-florence_00000096_pre_disaster.png,53,32,1,753,806,184,216,473,26.926839798930544,23.258312058341968
16802,/media/marda/TWOTB1/xBD/hurricanes/images/florence/hurricane-florence_00000096_pre_disaster.png,42,22,1,686,728,192,214,180,18.50257174731255,12.983295030409748
16803,/media/marda/TWOTB1/xBD/hurricanes/images/florence/hurricane-florence_00000096_pre_disaster.png,78,40,1,816,894,193,233,1233,47.10413396785174,34.65527978003239
16804,/media/marda/TWOTB1/xBD/hurricanes/images/florence/hurricane-florence_00000096_pre_disaster.png,12,20,1,42,54,209,229,108,12.945326353241867,11.152091413363339
16805,/media/marda/TWOTB1/xBD/hurricanes/images/florence/hurricane-florence_00000096_pre_disaster.png,34,36,1,8,42,210,246,618,34.2154664256216,24.11986477355619
16806,/media/marda/TWOTB1/xBD/hurricanes/images/florence/hurricane-florence_00000096_pre_disaster.png,37,41,1,146,183,221,262,599,38.1717928271206,21.717048480248845
16807,/media/marda/TWOTB1/xBD/hurricanes/images/florence/hurricane-florence_00000096_pre_disaster.png,57,26,1,792,849,223,249,315,27.6514485293853,15.255646784132612
16808,/media/marda/TWOTB1/xBD/hurricanes/images/florence/hurricane-florence_00000096_pre_disaster.png,76,55,1,649,725,227,282,1484,52.837908112965295,38.212962677053454
16809,/media/marda/TWOTB1/xBD/hurricanes/images/florence/hurricane-florence_00000096_pre_disaster.png,55,58,1,49,104,228,286,1646,50.4191915073427,47.32554746039462
16810,/media/marda/TWOTB1/xBD/hurricanes/images/florence/hurricane-florence_00000096_pre_disaster.png,34,36,1,108,142,236,272,543,29.171080942430006,24.86719815935209
16811,/media/marda/TWOTB1/xBD/hurricanes/images/florence/hurricane-florence_00000096_pre_disaster.png,118,129,1,491,609,239,368,7404,120.98220504865247,87.17725830203638
16812,/media/marda/TWOTB1/xBD/hurricanes/images/florence/hurricane-florence_00000096_pre_disaster.png,93,49,1,818,911,242,291,1603,63.450214492504664,34.198731765005185
16813,/media/marda/TWOTB1/xBD/hurricanes/images/florence/hurricane-florence_00000096_pre_disaster.png,63,59,1,396,459,248,307,1588,48.902507178719134,42.82867551930023
16814,/media/marda/TWOTB1/xBD/hurricanes/images/florence/hurricane-florence_00000096_pre_disaster.png,72,43,1,330,402,261,304,1223,63.95181598201761,25.105326394043907
16815,/media/marda/TWOTB1/xBD/hurricanes/images/florence/hurricane-florence_00000096_pre_disaster.png,75,52,1,969,1044,276,328,1196,45.55124232766277,34.513031672632785
16816,/media/marda/TWOTB1/xBD/hurricanes/images/florence/hurricane-florence_00000096_pre_disaster.png,74,69,1,206,280,286,355,1994,64.58783791019033,49.324864273066424
16817,/media/marda/TWOTB1/xBD/hurricanes/images/florence/hurricane-florence_00000096_pre_disaster.png,81,49,1,646,727,287,336,1290,57.4728205478531,30.552611582738756
16818,/media/marda/TWOTB1/xBD/hurricanes/images/florence/hurricane-florence_00000096_pre_disaster.png,147,95,1,659,806,301,396,6451,119.90426026552547,72.30912574963793
16819,/media/marda/TWOTB1/xBD/hurricanes/images/florence/hurricane-florence_00000096_pre_disaster.png,45,64,1,124,169,305,369,1306,56.505297857625195,30.936490164411957
16820,/media/marda/TWOTB1/xBD/hurricanes/images/florence/hurricane-florence_00000096_pre_disaster.png,49,44,1,39,88,330,374,1056,52.446334119534804,26.706569201248808
16821,/media/marda/TWOTB1/xBD/hurricanes/images/florence/hurricane-florence_00000096_pre_disaster.png,59,49,1,355,414,333,382,1115,47.05147646935596,31.161054203739166
16822,/media/marda/TWOTB1/xBD/hurricanes/images/florence/hurricane-florence_00000096_pre_disaster.png,26,31,1,94,120,335,366,305,25.1255357686678,15.91216780193065
16823,/media/marda/TWOTB1/xBD/hurricanes/images/florence/hurricane-florence_00000096_pre_disaster.png,62,50,1,244,306,348,398,1296,54.29794684671567,31.658664288767387
16824,/media/marda/TWOTB1/xBD/hurricanes/images/florence/hurricane-florence_00000096_pre_disaster.png,58,47,1,986,1044,350,397,425,33.46573231757542,17.3631303056909
16825,/media/marda/TWOTB1/xBD/hurricanes/images/florence/hurricane-florence_00000096_pre_disaster.png,25,37,1,122,147,353,390,331,24.712161912456413,17.69150271422608
16826,/media/marda/TWOTB1/xBD/hurricanes/images/florence/hurricane-florence_00000096_pre_disaster.png,55,43,1,372,427,362,405,847,44.417815657373716,24.953286472018767
16827,/media/marda/TWOTB1/xBD/hurricanes/images/florence/hurricane-florence_00000096_pre_disaster.png,85,57,1,871,956,375,432,1544,52.70632452321198,38.90876528008289
16828,/media/marda/TWOTB1/xBD/hurricanes/images/florence/hurricane-florence_00000096_pre_disaster.png,33,37,1,219,252,380,417,412,25.951379795115816,20.94435380912364
16829,/media/marda/TWOTB1/xBD/hurricanes/images/florence/hurricane-florence_00000096_pre_disaster.png,36,42,1,468,504,381,423,413,31.43775620837403,17.571135986463226
16830,/media/marda/TWOTB1/xBD/hurricanes/images/florence/hurricane-florence_00000096_pre_disaster.png,58,52,1,258,316,382,434,1415,51.22287448407805,36.309860981076284
16831,/media/marda/TWOTB1/xBD/hurricanes/images/florence/hurricane-florence_00000096_pre_disaster.png,47,63,1,59,106,395,458,1444,48.26870921750161,39.99299606817722
16832,/media/marda/TWOTB1/xBD/hurricanes/images/florence/hurricane-florence_00000096_pre_disaster.png,65,45,1,822,887,395,440,623,32.55184731412827,25.536702539210882
16833,/media/marda/TWOTB1/xBD/hurricanes/images/florence/hurricane-florence_00000096_pre_disaster.png,75,57,1,378,453,397,454,1553,59.11866007512813,34.95501020149203
16834,/media/marda/TWOTB1/xBD/hurricanes/images/florence/hurricane-florence_00000096_pre_disaster.png,69,46,1,581,650,397,443,884,48.57856357917671,24.141144346379434
16835,/media/marda/TWOTB1/xBD/hurricanes/images/florence/hurricane-florence_00000096_pre_disaster.png,73,67,1,708,781,401,468,1587,49.27450614704499,42.66018746697272
16836,/media/marda/TWOTB1/xBD/hurricanes/images/florence/hurricane-florence_00000096_pre_disaster.png,30,35,1,229,259,407,442,268,22.75952558084828,15.745299079277816
16837,/media/marda/TWOTB1/xBD/hurricanes/images/florence/hurricane-florence_00000096_pre_disaster.png,75,87,1,547,622,427,514,2360,68.45291453799456,46.130119782841696
16838,/media/marda/TWOTB1/xBD/hurricanes/images/florence/hurricane-florence_00000096_pre_disaster.png,47,48,1,392,439,438,486,742,32.36853019418855,30.482141577811575
16839,/media/marda/TWOTB1/xBD/hurricanes/images/florence/hurricane-florence_00000096_pre_disaster.png,35,41,1,79,114,448,489,569,34.95190242877517,21.27942906503637
16840,/media/marda/TWOTB1/xBD/hurricanes/images/florence/hurricane-florence_00000096_pre_disaster.png,80,56,1,260,340,458,514,1655,75.32116453796723,30.915724239440603
16841,/media/marda/TWOTB1/xBD/hurricanes/images/florence/hurricane-florence_00000096_pre_disaster.png,66,60,1,492,558,471,531,1502,49.07489633203319,40.54814697216954
16842,/media/marda/TWOTB1/xBD/hurricanes/images/florence/hurricane-florence_00000096_pre_disaster.png,39,38,1,394,433,473,511,376,22.759951814141935,21.149072272136056
16843,/media/marda/TWOTB1/xBD/hurricanes/images/florence/hurricane-florence_00000096_pre_disaster.png,46,49,1,90,136,480,529,1001,47.14929921541691,28.34607704670438
16844,/media/marda/TWOTB1/xBD/hurricanes/images/florence/hurricane-florence_00000096_pre_disaster.png,22,34,1,248,270,484,518,168,18.64933910388475,11.883805229188026
16845,/media/marda/TWOTB1/xBD/hurricanes/images/florence/hurricane-florence_00000096_pre_disaster.png,130,141,1,848,978,487,628,7976,122.16460033568958,86.52477674445205
16846,/media/marda/TWOTB1/xBD/hurricanes/images/florence/hurricane-florence_00000096_pre_disaster.png,63,62,1,437,500,490,552,1424,45.111191260625645,42.62928584520772
16847,/media/marda/TWOTB1/xBD/hurricanes/images/florence/hurricane-florence_00000096_pre_disaster.png,144,88,1,696,840,490,578,5108,125.98610427052134,53.59405035087565
16848,/media/marda/TWOTB1/xBD/hurricanes/images/florence/hurricane-florence_00000096_pre_disaster.png,59,69,1,395,454,506,575,1397,50.936889183810116,36.342825624191626
16849,/media/marda/TWOTB1/xBD/hurricanes/images/florence/hurricane-florence_00000096_pre_disaster.png,65,56,1,90,155,522,578,1511,63.92707080579451,31.066996113402844
16850,/media/marda/TWOTB1/xBD/hurricanes/images/florence/hurricane-florence_00000096_pre_disaster.png,54,61,1,292,346,534,595,1110,45.784351561588664,34.18901374076633
16851,/media/marda/TWOTB1/xBD/hurricanes/images/florence/hurricane-florence_00000096_pre_disaster.png,86,63,1,719,805,553,616,1525,60.20981333608999,33.46259470131481
16852,/media/marda/TWOTB1/xBD/hurricanes/images/florence/hurricane-florence_00000096_pre_disaster.png,55,76,1,110,165,564,640,1814,54.817000705716836,46.06514963980417
16853,/media/marda/TWOTB1/xBD/hurricanes/images/florence/hurricane-florence_00000096_pre_disaster.png,49,50,1,171,220,572,622,819,44.80381497690787,23.904909212058623
16854,/media/marda/TWOTB1/xBD/hurricanes/images/florence/hurricane-florence_00000096_pre_disaster.png,73,73,1,816,889,593,666,1409,49.35083397872745,37.66628827687979
16855,/media/marda/TWOTB1/xBD/hurricanes/images/florence/hurricane-florence_00000096_pre_disaster.png,155,211,1,269,424,607,818,13069,198.51320499533836,118.41499335860294
16856,/media/marda/TWOTB1/xBD/hurricanes/images/florence/hurricane-florence_00000096_pre_disaster.png,116,81,1,126,242,647,728,3233,121.46251304717457,35.24884575131249
16857,/media/marda/TWOTB1/xBD/hurricanes/images/florence/hurricane-florence_00000096_pre_disaster.png,46,74,1,257,303,647,721,1245,51.22833139206333,32.40396115123611
16858,/media/marda/TWOTB1/xBD/hurricanes/images/florence/hurricane-florence_00000096_pre_disaster.png,107,139,1,534,641,671,810,6103,123.99734052144919,67.09784065750982
16859,/media/marda/TWOTB1/xBD/hurricanes/images/florence/hurricane-florence_00000096_pre_disaster.png,29,45,1,295,324,691,736,213,18.872472721368204,15.144245342637573
16860,/media/marda/TWOTB1/xBD/hurricanes/images/florence/hurricane-florence_00000096_pre_disaster.png,54,40,1,944,998,694,734,136,18.285784755126368,9.946368628779489
16861,/media/marda/TWOTB1/xBD/hurricanes/images/florence/hurricane-florence_00000096_pre_disaster.png,119,134,1,763,882,713,847,4744,117.32316771621866,67.2846952072236
16862,/media/marda/TWOTB1/xBD/hurricanes/images/florence/hurricane-florence_00000096_pre_disaster.png,68,72,1,976,1044,713,785,933,41.65559664716871,29.992697388498087
16863,/media/marda/TWOTB1/xBD/hurricanes/images/florence/hurricane-florence_00000096_pre_disaster.png,60,66,1,851,911,733,799,760,38.199553627447415,26.547052309442538
16864,/media/marda/TWOTB1/xBD/hurricanes/images/florence/hurricane-florence_00000096_pre_disaster.png,59,66,1,156,215,742,808,1125,56.246930869210956,28.563161508309253
16865,/media/marda/TWOTB1/xBD/hurricanes/images/florence/hurricane-florence_00000096_pre_disaster.png,40,50,1,207,247,748,798,409,34.11287427505825,15.842649103324938
16866,/media/marda/TWOTB1/xBD/hurricanes/images/florence/hurricane-florence_00000096_pre_disaster.png,122,97,1,157,279,762,859,4775,127.37085034247526,49.70136407582612
16867,/media/marda/TWOTB1/xBD/hurricanes/images/florence/hurricane-florence_00000096_pre_disaster.png,153,190,1,316,469,785,975,11476,177.06775859487465,115.72523371754588
16868,/media/marda/TWOTB1/xBD/hurricanes/images/florence/hurricane-florence_00000096_pre_disaster.png,85,232,1,99,184,788,1020,5397,235.80211723868214,31.720308884124393
16869,/media/marda/TWOTB1/xBD/hurricanes/images/florence/hurricane-florence_00000096_pre_disaster.png,59,78,1,302,361,815,893,1456,47.283856807332015,40.54797418795112
16870,/media/marda/TWOTB1/xBD/hurricanes/images/florence/hurricane-florence_00000096_pre_disaster.png,125,195,1,204,329,820,1015,7204,180.3923436360948,90.25255445050495
16871,/media/marda/TWOTB1/xBD/hurricanes/images/florence/hurricane-florence_00000096_pre_disaster.png,20,69,1,86,106,826,895,310,41.6108467828194,9.991554719297486
16872,/media/marda/TWOTB1/xBD/hurricanes/images/florence/hurricane-florence_00000096_pre_disaster.png,75,87,1,207,282,835,922,2541,65.45304765877685,51.95774085252523
16873,/media/marda/TWOTB1/xBD/hurricanes/images/florence/hurricane-florence_00000096_pre_disaster.png,44,60,1,332,376,854,914,629,34.22118129358959,24.18004188407688
16874,/media/marda/TWOTB1/xBD/hurricanes/images/florence/hurricane-florence_00000096_pre_disaster.png,70,82,1,925,995,860,942,1119,53.88978498428485,27.829900148199993
16875,/media/marda/TWOTB1/xBD/hurricanes/images/florence/hurricane-florence_00000096_pre_disaster.png,79,118,1,880,959,870,988,2204,89.39191397449702,36.47666506907994
16876,/media/marda/TWOTB1/xBD/hurricanes/images/florence/hurricane-florence_00000096_pre_disaster.png,82,103,1,710,792,898,1001,2411,67.42807095280949,47.564824924221845
16877,/media/marda/TWOTB1/xBD/hurricanes/images/florence/hurricane-florence_00000096_pre_disaster.png,22,73,1,107,129,911,984,326,41.04844806307333,10.634202429257343
16878,/media/marda/TWOTB1/xBD/hurricanes/images/florence/hurricane-florence_00000096_pre_disaster.png,59,89,1,685,744,912,1001,1156,52.24255568835645,29.087923414365168
16879,/media/marda/TWOTB1/xBD/hurricanes/images/florence/hurricane-florence_00000096_pre_disaster.png,56,79,1,650,706,918,997,934,43.9945285645006,28.330749183898398
16880,/media/marda/TWOTB1/xBD/hurricanes/images/florence/hurricane-florence_00000096_pre_disaster.png,93,80,1,810,903,938,1018,1802,63.851131720910125,37.286099955911
16881,/media/marda/TWOTB1/xBD/hurricanes/images/florence/hurricane-florence_00000096_pre_disaster.png,140,74,1,351,491,968,1042,2746,127.49259519398052,32.12585088332346
16882,/media/marda/TWOTB1/xBD/hurricanes/images/florence/hurricane-florence_00000096_pre_disaster.png,141,71,1,530,671,971,1042,2986,124.85673558316483,33.12620316209585
16883,/media/marda/TWOTB1/xBD/hurricanes/images/florence/hurricane-florence_00000096_pre_disaster.png,72,63,1,967,1039,981,1044,548,32.445402164169955,22.806083527944132
16884,/media/marda/TWOTB1/xBD/hurricanes/images/florence/hurricane-florence_00000224_post_disaster.png,64,32,1,276,340,0,32,1027,56.93796975373427,23.70186314480892
16885,/media/marda/TWOTB1/xBD/hurricanes/images/florence/hurricane-florence_00000224_post_disaster.png,65,37,1,197,262,25,62,1139,62.14157603879894,24.096407335809573
16886,/media/marda/TWOTB1/xBD/hurricanes/images/florence/hurricane-florence_00000224_post_disaster.png,83,40,1,446,529,62,102,1467,69.96231788944964,27.529807634897125
16887,/media/marda/TWOTB1/xBD/hurricanes/images/florence/hurricane-florence_00000224_post_disaster.png,38,18,1,521,559,71,89,214,17.76541780108155,15.787412915098194
16888,/media/marda/TWOTB1/xBD/hurricanes/images/florence/hurricane-florence_00000224_post_disaster.png,58,30,1,358,416,88,118,785,47.12143049914923,21.9874698921742
16889,/media/marda/TWOTB1/xBD/hurricanes/images/florence/hurricane-florence_00000224_post_disaster.png,64,58,1,671,735,166,224,1306,54.20206819281226,32.3980313774705
16890,/media/marda/TWOTB1/xBD/hurricanes/images/florence/hurricane-florence_00000224_post_disaster.png,53,39,1,130,183,169,208,1089,51.43680233016131,27.896536577513853
16891,/media/marda/TWOTB1/xBD/hurricanes/images/florence/hurricane-florence_00000224_post_disaster.png,47,42,1,537,584,174,216,551,40.72988813590524,19.09796207973216
16892,/media/marda/TWOTB1/xBD/hurricanes/images/florence/hurricane-florence_00000224_post_disaster.png,65,60,1,580,645,186,246,1421,60.00583913983769,31.631919197087274
16893,/media/marda/TWOTB1/xBD/hurricanes/images/florence/hurricane-florence_00000224_post_disaster.png,62,47,1,45,107,199,246,1412,63.8635449365568,29.284160532158573
16894,/media/marda/TWOTB1/xBD/hurricanes/images/florence/hurricane-florence_00000224_post_disaster.png,37,28,1,553,590,208,236,214,19.874807425952994,14.281223212513035
16895,/media/marda/TWOTB1/xBD/hurricanes/images/florence/hurricane-florence_00000224_post_disaster.png,47,27,1,634,681,214,241,260,20.17244113221449,16.94216276401482
16896,/media/marda/TWOTB1/xBD/hurricanes/images/florence/hurricane-florence_00000224_post_disaster.png,16,19,1,110,126,245,264,82,11.91710727045179,9.336229629342597
16897,/media/marda/TWOTB1/xBD/hurricanes/images/florence/hurricane-florence_00000224_post_disaster.png,10,28,1,0,10,247,275,129,20.015996634739505,9.225482815873503
16898,/media/marda/TWOTB1/xBD/hurricanes/images/florence/hurricane-florence_00000224_post_disaster.png,39,27,1,660,699,253,280,158,18.710932783725728,11.207587401092335
16899,/media/marda/TWOTB1/xBD/hurricanes/images/florence/hurricane-florence_00000224_post_disaster.png,66,67,1,655,721,410,477,786,62.35808041636895,16.72029988777459
16900,/media/marda/TWOTB1/xBD/hurricanes/images/florence/hurricane-florence_00000224_post_disaster.png,37,31,1,651,688,468,499,121,13.254816143598303,11.926076574131107
16901,/media/marda/TWOTB1/xBD/hurricanes/images/florence/hurricane-florence_00000224_post_disaster.png,71,42,1,918,989,481,523,565,35.20257797724877,21.457267049232613
16902,/media/marda/TWOTB1/xBD/hurricanes/images/florence/hurricane-florence_00000224_post_disaster.png,68,58,1,696,764,516,574,611,45.46201229121681,22.969986091980665
16903,/media/marda/TWOTB1/xBD/hurricanes/images/florence/hurricane-florence_00000224_post_disaster.png,40,33,1,682,722,521,554,89,15.243889738204192,7.7072126281377304
16904,/media/marda/TWOTB1/xBD/hurricanes/images/florence/hurricane-florence_00000224_post_disaster.png,64,64,1,647,711,575,639,709,52.4831898091243,18.536364896649584
16905,/media/marda/TWOTB1/xBD/hurricanes/images/florence/hurricane-florence_00000224_post_disaster.png,60,58,1,574,634,666,724,436,47.03460834540454,12.392243002936347
16906,/media/marda/TWOTB1/xBD/hurricanes/images/florence/hurricane-florence_00000224_post_disaster.png,38,47,1,558,596,680,727,260,22.06093712031022,15.340213621897004
16907,/media/marda/TWOTB1/xBD/hurricanes/images/florence/hurricane-florence_00000224_post_disaster.png,28,40,1,475,503,736,776,72,10.127654814476266,9.609588347360633
16908,/media/marda/TWOTB1/xBD/hurricanes/images/florence/hurricane-florence_00000224_post_disaster.png,81,88,1,474,555,737,825,1842,65.91153559067159,37.79683498657671
16909,/media/marda/TWOTB1/xBD/hurricanes/images/florence/hurricane-florence_00000263_pre_disaster.png,32,71,1,0,32,876,947,709,36.77771022475809,26.179090186041407
16910,/media/marda/TWOTB1/xBD/hurricanes/images/florence/hurricane-florence_00000369_pre_disaster.png,63,43,1,217,280,122,165,1110,67.92196200290343,25.723829862172593
16911,/media/marda/TWOTB1/xBD/hurricanes/images/florence/hurricane-florence_00000369_pre_disaster.png,25,22,1,296,321,139,161,205,19.825503131867215,13.81989841264554
16912,/media/marda/TWOTB1/xBD/hurricanes/images/florence/hurricane-florence_00000369_pre_disaster.png,32,24,1,339,371,188,212,353,22.659845071777724,20.853468764502615
16913,/media/marda/TWOTB1/xBD/hurricanes/images/florence/hurricane-florence_00000014_pre_disaster.png,67,24,1,46,113,0,24,936,62.7005212530591,21.62117377597356
16914,/media/marda/TWOTB1/xBD/hurricanes/images/florence/hurricane-florence_00000014_pre_disaster.png,41,14,1,228,269,0,14,261,29.532304746190828,12.951769040524923
16915,/media/marda/TWOTB1/xBD/hurricanes/images/florence/hurricane-florence_00000014_pre_disaster.png,61,23,1,470,531,0,23,699,42.45957054561059,22.2165676767145
16916,/media/marda/TWOTB1/xBD/hurricanes/images/florence/hurricane-florence_00000014_pre_disaster.png,69,39,1,518,587,0,39,1434,48.71055507432669,38.47060677212805
16917,/media/marda/TWOTB1/xBD/hurricanes/images/florence/hurricane-florence_00000014_pre_disaster.png,57,10,1,803,860,0,10,130,22.990506177981594,8.656765230735537
16918,/media/marda/TWOTB1/xBD/hurricanes/images/florence/hurricane-florence_00000014_pre_disaster.png,78,34,1,840,918,0,34,905,40.717709875489945,31.613508153965164
16919,/media/marda/TWOTB1/xBD/hurricanes/images/florence/hurricane-florence_00000014_pre_disaster.png,87,59,1,879,966,0,59,1694,55.48903188819078,40.36096907519052
16920,/media/marda/TWOTB1/xBD/hurricanes/images/florence/hurricane-florence_00000014_pre_disaster.png,68,56,1,568,636,1,57,1534,52.49581705526723,38.75616136715693
16921,/media/marda/TWOTB1/xBD/hurricanes/images/florence/hurricane-florence_00000014_pre_disaster.png,68,47,1,171,239,5,52,1709,57.22430107734542,39.695516817479636
16922,/media/marda/TWOTB1/xBD/hurricanes/images/florence/hurricane-florence_00000014_pre_disaster.png,53,50,1,298,351,9,59,1641,51.9897872097139,41.08528554404603
16923,/media/marda/TWOTB1/xBD/hurricanes/images/florence/hurricane-florence_00000014_pre_disaster.png,63,55,1,349,412,9,64,1817,55.33153479930952,43.26863721061667
16924,/media/marda/TWOTB1/xBD/hurricanes/images/florence/hurricane-florence_00000014_pre_disaster.png,73,56,1,610,683,18,74,1777,56.20204747323894,41.6984332164407
16925,/media/marda/TWOTB1/xBD/hurricanes/images/florence/hurricane-florence_00000014_pre_disaster.png,89,66,1,921,1010,20,86,1710,61.91064934647599,36.99519903298769
16926,/media/marda/TWOTB1/xBD/hurricanes/images/florence/hurricane-florence_00000014_pre_disaster.png,59,50,1,33,92,21,71,1800,58.69710161421387,40.27179959149536
16927,/media/marda/TWOTB1/xBD/hurricanes/images/florence/hurricane-florence_00000014_pre_disaster.png,77,51,1,656,733,38,89,1782,52.16307953511155,44.68859704974015
16928,/media/marda/TWOTB1/xBD/hurricanes/images/florence/hurricane-florence_00000014_pre_disaster.png,67,54,1,245,312,40,94,1649,57.96506423793317,37.48568073026849
16929,/media/marda/TWOTB1/xBD/hurricanes/images/florence/hurricane-florence_00000014_pre_disaster.png,67,53,1,155,222,49,102,1982,61.60142722398404,42.460305343600915
16930,/media/marda/TWOTB1/xBD/hurricanes/images/florence/hurricane-florence_00000014_pre_disaster.png,82,61,1,962,1044,50,111,1607,57.48810709874978,37.0694903043144
16931,/media/marda/TWOTB1/xBD/hurricanes/images/florence/hurricane-florence_00000014_pre_disaster.png,26,9,1,448,474,52,61,78,10.579911083716063,9.697448009513476
16932,/media/marda/TWOTB1/xBD/hurricanes/images/florence/hurricane-florence_00000014_pre_disaster.png,76,54,1,701,777,53,107,1622,55.842479208082494,38.16859322855619
16933,/media/marda/TWOTB1/xBD/hurricanes/images/florence/hurricane-florence_00000014_pre_disaster.png,66,57,1,470,536,65,122,1722,56.136981460975946,40.46580923140709
16934,/media/marda/TWOTB1/xBD/hurricanes/images/florence/hurricane-florence_00000014_pre_disaster.png,86,56,1,749,835,70,126,1833,56.57086009063429,42.43351388378542
16935,/media/marda/TWOTB1/xBD/hurricanes/images/florence/hurricane-florence_00000014_pre_disaster.png,68,56,1,509,577,95,151,1635,52.68734275123218,40.96114017624427
16936,/media/marda/TWOTB1/xBD/hurricanes/images/florence/hurricane-florence_00000014_pre_disaster.png,63,48,1,135,198,98,146,1735,56.58784902500288,40.601754217210846
16937,/media/marda/TWOTB1/xBD/hurricanes/images/florence/hurricane-florence_00000014_pre_disaster.png,84,53,1,792,876,99,152,1594,55.70732746646613,37.38554262575429
16938,/media/marda/TWOTB1/xBD/hurricanes/images/florence/hurricane-florence_00000014_pre_disaster.png,67,54,1,221,288,98,152,1979,59.02315887187629,44.18886859913795
16939,/media/marda/TWOTB1/xBD/hurricanes/images/florence/hurricane-florence_00000014_pre_disaster.png,68,60,1,557,625,110,170,1517,50.95133796269452,39.79892766725345
16940,/media/marda/TWOTB1/xBD/hurricanes/images/florence/hurricane-florence_00000014_pre_disaster.png,37,18,1,644,681,115,133,110,13.099481136085824,11.112242846193098
16941,/media/marda/TWOTB1/xBD/hurricanes/images/florence/hurricane-florence_00000014_pre_disaster.png,87,59,1,836,923,117,176,1596,53.22044614687101,39.65368754422453
16942,/media/marda/TWOTB1/xBD/hurricanes/images/florence/hurricane-florence_00000014_pre_disaster.png,72,60,1,601,673,126,186,1688,54.427081159638426,40.95211808758473
16943,/media/marda/TWOTB1/xBD/hurricanes/images/florence/hurricane-florence_00000014_pre_disaster.png,45,22,1,762,807,129,151,154,17.319825027603496,11.87479153502126
16944,/media/marda/TWOTB1/xBD/hurricanes/images/florence/hurricane-florence_00000014_pre_disaster.png,63,59,1,378,441,133,192,2108,57.738612684553814,48.66444707395964
16945,/media/marda/TWOTB1/xBD/hurricanes/images/florence/hurricane-florence_00000014_pre_disaster.png,42,18,1,708,750,138,156,108,12.274196647300153,11.82333644078841
16946,/media/marda/TWOTB1/xBD/hurricanes/images/florence/hurricane-florence_00000014_pre_disaster.png,64,57,1,119,183,139,196,1970,61.066945570706544,43.014075721028625
16947,/media/marda/TWOTB1/xBD/hurricanes/images/florence/hurricane-florence_00000014_pre_disaster.png,66,60,1,260,326,140,200,1677,60.335545301551306,36.77817933098829
16948,/media/marda/TWOTB1/xBD/hurricanes/images/florence/hurricane-florence_00000014_pre_disaster.png,15,44,1,0,15,142,186,344,37.675966299962624,13.756288117408884
16949,/media/marda/TWOTB1/xBD/hurricanes/images/florence/hurricane-florence_00000014_pre_disaster.png,74,60,1,647,721,142,202,1643,54.12558435398116,40.050798790362734
16950,/media/marda/TWOTB1/xBD/hurricanes/images/florence/hurricane-florence_00000014_pre_disaster.png,85,58,1,881,966,146,204,1523,52.644153941216125,38.290087455004866
16951,/media/marda/TWOTB1/xBD/hurricanes/images/florence/hurricane-florence_00000014_pre_disaster.png,50,55,1,328,378,153,208,1566,54.07204077610758,38.227329800854825
16952,/media/marda/TWOTB1/xBD/hurricanes/images/florence/hurricane-florence_00000014_pre_disaster.png,23,19,1,246,269,159,178,115,14.153723100097693,10.901254046992271
16953,/media/marda/TWOTB1/xBD/hurricanes/images/florence/hurricane-florence_00000014_pre_disaster.png,77,56,1,691,768,162,218,1558,51.79310194016705,40.418693625285854
16954,/media/marda/TWOTB1/xBD/hurricanes/images/florence/hurricane-florence_00000014_pre_disaster.png,87,64,1,922,1009,163,227,1702,56.835910979572674,39.403104344099084
16955,/media/marda/TWOTB1/xBD/hurricanes/images/florence/hurricane-florence_00000014_pre_disaster.png,77,59,1,744,821,169,228,1346,51.71655208949737,34.91048793774347
16956,/media/marda/TWOTB1/xBD/hurricanes/images/florence/hurricane-florence_00000014_pre_disaster.png,68,63,1,424,492,181,244,1859,55.885445352841884,44.118722981761294
16957,/media/marda/TWOTB1/xBD/hurricanes/images/florence/hurricane-florence_00000014_pre_disaster.png,79,62,1,965,1044,193,255,1415,53.535417924492734,34.93961389425242
16958,/media/marda/TWOTB1/xBD/hurricanes/images/florence/hurricane-florence_00000014_pre_disaster.png,58,49,1,99,157,195,244,1635,56.16270109663477,38.27536663386567
16959,/media/marda/TWOTB1/xBD/hurricanes/images/florence/hurricane-florence_00000014_pre_disaster.png,65,64,1,471,536,198,262,1602,56.36215785900597,37.53856497801719
16960,/media/marda/TWOTB1/xBD/hurricanes/images/florence/hurricane-florence_00000014_pre_disaster.png,55,63,1,166,221,199,262,1698,56.06107049526845,40.30934212280872
16961,/media/marda/TWOTB1/xBD/hurricanes/images/florence/hurricane-florence_00000014_pre_disaster.png,86,67,1,779,865,202,269,1824,54.42989204034754,44.47561700770816
16962,/media/marda/TWOTB1/xBD/hurricanes/images/florence/hurricane-florence_00000014_pre_disaster.png,70,69,1,516,586,212,281,1828,59.488469332361106,40.594379161024825
16963,/media/marda/TWOTB1/xBD/hurricanes/images/florence/hurricane-florence_00000014_pre_disaster.png,59,63,1,212,271,219,282,1706,56.43691548678873,39.919928805491914
16964,/media/marda/TWOTB1/xBD/hurricanes/images/florence/hurricane-florence_00000014_pre_disaster.png,75,73,1,560,635,229,302,2017,63.28912802093293,41.941682405923174
16965,/media/marda/TWOTB1/xBD/hurricanes/images/florence/hurricane-florence_00000014_pre_disaster.png,55,64,1,259,314,236,300,1498,51.75527867370496,38.56106387429486
16966,/media/marda/TWOTB1/xBD/hurricanes/images/florence/hurricane-florence_00000014_pre_disaster.png,77,66,1,606,683,246,312,1876,56.7618998349301,43.79563541120507
16967,/media/marda/TWOTB1/xBD/hurricanes/images/florence/hurricane-florence_00000014_pre_disaster.png,65,63,1,301,366,253,316,1750,55.365869316050556,41.69990471016925
16968,/media/marda/TWOTB1/xBD/hurricanes/images/florence/hurricane-florence_00000014_pre_disaster.png,84,56,1,802,886,264,320,1945,57.22374334776586,45.53853137346187
16969,/media/marda/TWOTB1/xBD/hurricanes/images/florence/hurricane-florence_00000014_pre_disaster.png,60,67,1,352,412,269,336,1741,55.22223520283348,41.91653730779671
16970,/media/marda/TWOTB1/xBD/hurricanes/images/florence/hurricane-florence_00000014_pre_disaster.png,39,24,1,503,542,275,299,173,18.044480726195147,12.881304516365795
16971,/media/marda/TWOTB1/xBD/hurricanes/images/florence/hurricane-florence_00000014_pre_disaster.png,81,44,1,664,745,282,326,1720,59.12195614608673,38.541451584117496
16972,/media/marda/TWOTB1/xBD/hurricanes/images/florence/hurricane-florence_00000014_pre_disaster.png,67,64,1,392,459,288,352,1763,55.496223085345534,41.91769392072863
16973,/media/marda/TWOTB1/xBD/hurricanes/images/florence/hurricane-florence_00000014_pre_disaster.png,60,55,1,65,125,290,345,1637,58.065254005252775,37.340370758019446
16974,/media/marda/TWOTB1/xBD/hurricanes/images/florence/hurricane-florence_00000014_pre_disaster.png,48,24,1,980,1028,309,333,119,13.724491206533829,11.409185698310319
16975,/media/marda/TWOTB1/xBD/hurricanes/images/florence/hurricane-florence_00000014_pre_disaster.png,64,62,1,442,506,310,372,1474,52.328550472092466,37.57733459964535
16976,/media/marda/TWOTB1/xBD/hurricanes/images/florence/hurricane-florence_00000014_pre_disaster.png,51,70,1,993,1044,315,385,504,69.42492471909539,10.934016537605736
16977,/media/marda/TWOTB1/xBD/hurricanes/images/florence/hurricane-florence_00000014_pre_disaster.png,51,56,1,126,177,316,372,1311,43.33095283846622,40.272685728352116
16978,/media/marda/TWOTB1/xBD/hurricanes/images/florence/hurricane-florence_00000014_pre_disaster.png,67,73,1,489,556,318,391,1749,58.71592227222855,39.22944721460449
16979,/media/marda/TWOTB1/xBD/hurricanes/images/florence/hurricane-florence_00000014_pre_disaster.png,77,63,1,951,1028,322,385,1668,53.20489141400484,41.09672673516823
16980,/media/marda/TWOTB1/xBD/hurricanes/images/florence/hurricane-florence_00000014_pre_disaster.png,76,63,1,899,975,323,386,1794,54.084860908270464,43.816417614624335
16981,/media/marda/TWOTB1/xBD/hurricanes/images/florence/hurricane-florence_00000014_pre_disaster.png,73,63,1,854,927,325,388,1640,53.14558206119792,40.430621368701296
16982,/media/marda/TWOTB1/xBD/hurricanes/images/florence/hurricane-florence_00000014_pre_disaster.png,70,65,1,801,871,327,392,1821,57.20409770620734,42.03969198475962
16983,/media/marda/TWOTB1/xBD/hurricanes/images/florence/hurricane-florence_00000014_pre_disaster.png,57,68,1,170,227,332,400,1823,56.70030372039794,42.35162025844543
16984,/media/marda/TWOTB1/xBD/hurricanes/images/florence/hurricane-florence_00000014_pre_disaster.png,63,66,1,645,708,333,399,1886,58.161683708913976,42.835324763635874
16985,/media/marda/TWOTB1/xBD/hurricanes/images/florence/hurricane-florence_00000014_pre_disaster.png,18,26,1,98,116,334,360,119,15.449587570867383,10.304297363303382
16986,/media/marda/TWOTB1/xBD/hurricanes/images/florence/hurricane-florence_00000014_pre_disaster.png,63,64,1,543,606,334,398,1758,54.36642313829735,42.66333319960307
16987,/media/marda/TWOTB1/xBD/hurricanes/images/florence/hurricane-florence_00000014_pre_disaster.png,64,62,1,696,760,334,396,1532,52.74048124082625,38.387888043599716
16988,/media/marda/TWOTB1/xBD/hurricanes/images/florence/hurricane-florence_00000014_pre_disaster.png,60,65,1,46,106,335,400,1902,57.17728899207834,43.84344110299209
16989,/media/marda/TWOTB1/xBD/hurricanes/images/florence/hurricane-florence_00000014_pre_disaster.png,62,63,1,597,659,338,401,1596,54.231832273993994,38.62446550973711
16990,/media/marda/TWOTB1/xBD/hurricanes/images/florence/hurricane-florence_00000014_pre_disaster.png,62,68,1,264,326,370,438,1781,55.47463584619493,42.35518624494854
16991,/media/marda/TWOTB1/xBD/hurricanes/images/florence/hurricane-florence_00000014_pre_disaster.png,62,63,1,111,173,382,445,1857,57.37286696841567,42.451041339653905
16992,/media/marda/TWOTB1/xBD/hurricanes/images/florence/hurricane-florence_00000014_pre_disaster.png,60,56,1,28,88,387,443,1518,56.71916449635888,36.00270303053864
16993,/media/marda/TWOTB1/xBD/hurricanes/images/florence/hurricane-florence_00000014_pre_disaster.png,62,66,1,308,370,390,456,1646,57.36500783891467,37.79486847572445
16994,/media/marda/TWOTB1/xBD/hurricanes/images/florence/hurricane-florence_00000014_pre_disaster.png,62,71,1,356,418,403,474,1493,53.3968248451739,37.26125426996105
16995,/media/marda/TWOTB1/xBD/hurricanes/images/florence/hurricane-florence_00000014_pre_disaster.png,67,72,1,398,465,420,492,1762,56.2305773939998,41.3933299912541
16996,/media/marda/TWOTB1/xBD/hurricanes/images/florence/hurricane-florence_00000014_pre_disaster.png,65,72,1,448,513,437,509,1685,55.174629596518244,40.12370600905367
16997,/media/marda/TWOTB1/xBD/hurricanes/images/florence/hurricane-florence_00000014_pre_disaster.png,64,70,1,102,166,438,508,1788,59.77561041171196,39.88608325091284
16998,/media/marda/TWOTB1/xBD/hurricanes/images/florence/hurricane-florence_00000014_pre_disaster.png,67,65,1,276,343,442,507,1693,56.757516580482786,39.55946024102691
16999,/media/marda/TWOTB1/xBD/hurricanes/images/florence/hurricane-florence_00000014_pre_disaster.png,50,64,1,994,1044,443,507,454,54.992979148567755,10.943539929733747
17000,/media/marda/TWOTB1/xBD/hurricanes/images/florence/hurricane-florence_00000014_pre_disaster.png,74,71,1,947,1021,445,516,1793,58.60450764592658,40.31450524702771
17001,/media/marda/TWOTB1/xBD/hurricanes/images/florence/hurricane-florence_00000014_pre_disaster.png,73,68,1,897,970,446,514,1617,55.44078556986038,38.09722075253346
17002,/media/marda/TWOTB1/xBD/hurricanes/images/florence/hurricane-florence_00000014_pre_disaster.png,74,68,1,849,923,447,515,1647,53.09694310012283,40.97458623462787
17003,/media/marda/TWOTB1/xBD/hurricanes/images/florence/hurricane-florence_00000014_pre_disaster.png,57,53,1,25,82,449,502,1520,57.85238360265218,35.084526853172356
17004,/media/marda/TWOTB1/xBD/hurricanes/images/florence/hurricane-florence_00000014_pre_disaster.png,66,74,1,498,564,450,524,1849,57.658710873525166,42.184055593297714
17005,/media/marda/TWOTB1/xBD/hurricanes/images/florence/hurricane-florence_00000014_pre_disaster.png,71,67,1,798,869,450,517,1834,56.50155938174225,42.99167419422735
17006,/media/marda/TWOTB1/xBD/hurricanes/images/florence/hurricane-florence_00000014_pre_disaster.png,68,67,1,752,820,451,518,1670,53.2994232698435,41.34129694001302
17007,/media/marda/TWOTB1/xBD/hurricanes/images/florence/hurricane-florence_00000014_pre_disaster.png,66,68,1,701,767,456,524,1803,56.25289576122012,42.138860263306945
17008,/media/marda/TWOTB1/xBD/hurricanes/images/florence/hurricane-florence_00000014_pre_disaster.png,60,69,1,554,614,457,526,1563,54.66903441016744,37.84595763743446
17009,/media/marda/TWOTB1/xBD/hurricanes/images/florence/hurricane-florence_00000014_pre_disaster.png,65,69,1,653,718,458,527,1768,56.246680103808536,41.50423079712172
17010,/media/marda/TWOTB1/xBD/hurricanes/images/florence/hurricane-florence_00000014_pre_disaster.png,63,69,1,602,665,459,528,1901,57.955230703608116,43.328338780800046
17011,/media/marda/TWOTB1/xBD/hurricanes/images/florence/hurricane-florence_00000014_pre_disaster.png,61,73,1,225,286,473,546,1758,54.98106159128076,42.14073534846479
17012,/media/marda/TWOTB1/xBD/hurricanes/images/florence/hurricane-florence_00000014_pre_disaster.png,62,74,1,164,226,474,548,1826,57.39665747991357,41.9994840631979
17013,/media/marda/TWOTB1/xBD/hurricanes/images/florence/hurricane-florence_00000014_pre_disaster.png,20,30,1,119,139,490,520,121,14.41982147082763,11.13828407808584
17014,/media/marda/TWOTB1/xBD/hurricanes/images/florence/hurricane-florence_00000014_pre_disaster.png,59,77,1,49,108,490,567,1775,57.95673026423432,40.79938553467168
17015,/media/marda/TWOTB1/xBD/hurricanes/images/florence/hurricane-florence_00000014_pre_disaster.png,26,29,1,365,391,495,524,120,15.569200364822851,10.02640957117197
17016,/media/marda/TWOTB1/xBD/hurricanes/images/florence/hurricane-florence_00000014_pre_disaster.png,32,31,1,432,464,499,530,117,16.31063875711025,9.511573988539716
17017,/media/marda/TWOTB1/xBD/hurricanes/images/florence/hurricane-florence_00000014_pre_disaster.png,32,30,1,486,518,504,534,98,14.795204869607552,8.910253928457351
17018,/media/marda/TWOTB1/xBD/hurricanes/images/florence/hurricane-florence_00000014_pre_disaster.png,31,29,1,549,580,511,540,86,12.57236155777951,9.023829856680456
17019,/media/marda/TWOTB1/xBD/hurricanes/images/florence/hurricane-florence_00000014_pre_disaster.png,55,63,1,989,1044,522,585,561,47.86166887561365,15.687253027829323
17020,/media/marda/TWOTB1/xBD/hurricanes/images/florence/hurricane-florence_00000014_pre_disaster.png,68,76,1,745,813,523,599,1873,57.61624636155821,42.71238950832589
17021,/media/marda/TWOTB1/xBD/hurricanes/images/florence/hurricane-florence_00000014_pre_disaster.png,74,70,1,891,965,523,593,1755,55.25304056074791,41.71249497589848
17022,/media/marda/TWOTB1/xBD/hurricanes/images/florence/hurricane-florence_00000014_pre_disaster.png,72,69,1,943,1015,524,593,1522,52.55012146212017,38.228919198810615
17023,/media/marda/TWOTB1/xBD/hurricanes/images/florence/hurricane-florence_00000014_pre_disaster.png,73,69,1,845,918,527,596,1630,52.91544033369161,40.30697313192071
17024,/media/marda/TWOTB1/xBD/hurricanes/images/florence/hurricane-florence_00000014_pre_disaster.png,67,70,1,797,864,529,599,1610,56.541378029956476,37.4719689220035
17025,/media/marda/TWOTB1/xBD/hurricanes/images/florence/hurricane-florence_00000014_pre_disaster.png,64,73,1,647,711,532,605,1864,56.41017919877312,43.25936046854977
17026,/media/marda/TWOTB1/xBD/hurricanes/images/florence/hurricane-florence_00000014_pre_disaster.png,56,80,1,403,459,534,614,2021,61.72713446695262,42.64278652276112
17027,/media/marda/TWOTB1/xBD/hurricanes/images/florence/hurricane-florence_00000014_pre_disaster.png,64,70,1,699,763,534,604,1508,53.09391839633698,37.41047344044144
17028,/media/marda/TWOTB1/xBD/hurricanes/images/florence/hurricane-florence_00000014_pre_disaster.png,57,75,1,453,510,537,612,1919,58.50882021437586,43.01607768875473
17029,/media/marda/TWOTB1/xBD/hurricanes/images/florence/hurricane-florence_00000014_pre_disaster.png,61,68,1,601,662,538,606,1476,50.72305247407845,38.20600651922495
17030,/media/marda/TWOTB1/xBD/hurricanes/images/florence/hurricane-florence_00000014_pre_disaster.png,52,70,1,98,150,539,609,1360,52.52594476730675,34.45504224334114
17031,/media/marda/TWOTB1/xBD/hurricanes/images/florence/hurricane-florence_00000014_pre_disaster.png,56,67,1,553,609,541,608,1474,51.11617473902805,37.69442632552028
17032,/media/marda/TWOTB1/xBD/hurricanes/images/florence/hurricane-florence_00000014_pre_disaster.png,55,69,1,504,559,542,611,1430,51.91449119966187,36.04952941249718
17033,/media/marda/TWOTB1/xBD/hurricanes/images/florence/hurricane-florence_00000014_pre_disaster.png,50,75,1,309,359,547,622,1649,56.85120440337444,38.45949649472294
17034,/media/marda/TWOTB1/xBD/hurricanes/images/florence/hurricane-florence_00000014_pre_disaster.png,47,70,1,358,405,547,617,1531,53.90351107958536,37.307267519398735
17035,/media/marda/TWOTB1/xBD/hurricanes/images/florence/hurricane-florence_00000014_pre_disaster.png,42,73,1,159,201,548,621,1832,57.208172960755334,41.86702126853019
17036,/media/marda/TWOTB1/xBD/hurricanes/images/florence/hurricane-florence_00000014_pre_disaster.png,46,68,1,260,306,551,619,1448,49.86399002585468,38.35813087236935
17037,/media/marda/TWOTB1/xBD/hurricanes/images/florence/hurricane-florence_00000014_pre_disaster.png,46,68,1,209,255,553,621,1497,49.13226752942143,40.44132238626468
17038,/media/marda/TWOTB1/xBD/hurricanes/images/florence/hurricane-florence_00000014_pre_disaster.png,18,62,1,0,18,585,647,424,36.43625324827087,18.03844686450045
17039,/media/marda/TWOTB1/xBD/hurricanes/images/florence/hurricane-florence_00000014_pre_disaster.png,57,77,1,4,61,626,703,1629,58.48522189464004,36.76204165245785
17040,/media/marda/TWOTB1/xBD/hurricanes/images/florence/hurricane-florence_00000014_pre_disaster.png,60,72,1,984,1044,642,714,875,51.78926612744157,22.562168086346293
17041,/media/marda/TWOTB1/xBD/hurricanes/images/florence/hurricane-florence_00000014_pre_disaster.png,75,82,1,890,965,645,727,2012,61.83980042364017,42.69370555198092
17042,/media/marda/TWOTB1/xBD/hurricanes/images/florence/hurricane-florence_00000014_pre_disaster.png,74,81,1,938,1012,645,726,1929,60.53461838551589,41.758387860135436
17043,/media/marda/TWOTB1/xBD/hurricanes/images/florence/hurricane-florence_00000014_pre_disaster.png,70,80,1,843,913,648,728,1895,59.31993804759796,41.93502200880591
17044,/media/marda/TWOTB1/xBD/hurricanes/images/florence/hurricane-florence_00000014_pre_disaster.png,56,82,1,55,111,651,733,1868,57.46363441307463,42.554574535599045
17045,/media/marda/TWOTB1/xBD/hurricanes/images/florence/hurricane-florence_00000014_pre_disaster.png,70,73,1,792,862,652,725,1731,53.84519820924473,42.543159050285226
17046,/media/marda/TWOTB1/xBD/hurricanes/images/florence/hurricane-florence_00000014_pre_disaster.png,65,64,1,744,809,653,717,1329,44.29039477009154,40.36427758439764
17047,/media/marda/TWOTB1/xBD/hurricanes/images/florence/hurricane-florence_00000014_pre_disaster.png,64,76,1,695,759,654,730,1587,54.62312479393667,38.553795465567084
17048,/media/marda/TWOTB1/xBD/hurricanes/images/florence/hurricane-florence_00000014_pre_disaster.png,63,81,1,646,709,656,737,1931,59.25457518028108,42.64683618215738
17049,/media/marda/TWOTB1/xBD/hurricanes/images/florence/hurricane-florence_00000014_pre_disaster.png,64,77,1,596,660,658,735,1829,56.2730627009133,43.28392971552083
17050,/media/marda/TWOTB1/xBD/hurricanes/images/florence/hurricane-florence_00000014_pre_disaster.png,56,78,1,552,608,659,737,1580,54.63847334579155,38.21224737243694
17051,/media/marda/TWOTB1/xBD/hurricanes/images/florence/hurricane-florence_00000014_pre_disaster.png,58,76,1,500,558,663,739,1738,56.107772296231,40.84955699728251
17052,/media/marda/TWOTB1/xBD/hurricanes/images/florence/hurricane-florence_00000014_pre_disaster.png,56,75,1,403,459,666,741,1761,55.31917502017934,41.81198336049651
17053,/media/marda/TWOTB1/xBD/hurricanes/images/florence/hurricane-florence_00000014_pre_disaster.png,55,75,1,452,507,666,741,1828,56.57352046168395,42.58933212880596
17054,/media/marda/TWOTB1/xBD/hurricanes/images/florence/hurricane-florence_00000014_pre_disaster.png,49,83,1,259,308,669,752,1947,60.76910535156783,42.18333216575121
17055,/media/marda/TWOTB1/xBD/hurricanes/images/florence/hurricane-florence_00000014_pre_disaster.png,50,81,1,355,405,669,750,1941,60.045207327208544,42.21159973980344
17056,/media/marda/TWOTB1/xBD/hurricanes/images/florence/hurricane-florence_00000014_pre_disaster.png,51,82,1,106,157,670,752,1917,59.51367778577341,41.97324440903905
17057,/media/marda/TWOTB1/xBD/hurricanes/images/florence/hurricane-florence_00000014_pre_disaster.png,48,79,1,308,356,672,751,1531,55.302850205558514,37.62913950200182
17058,/media/marda/TWOTB1/xBD/hurricanes/images/florence/hurricane-florence_00000014_pre_disaster.png,45,77,1,162,207,675,752,1754,54.37304981162859,42.558257592840285
17059,/media/marda/TWOTB1/xBD/hurricanes/images/florence/hurricane-florence_00000014_pre_disaster.png,49,75,1,210,259,675,750,1756,55.081478958764805,42.11176048049459
17060,/media/marda/TWOTB1/xBD/hurricanes/images/florence/hurricane-florence_00000014_pre_disaster.png,32,38,1,482,514,714,752,136,15.814233000620797,11.240682415959922
17061,/media/marda/TWOTB1/xBD/hurricanes/images/florence/hurricane-florence_00000014_pre_disaster.png,27,38,1,300,327,722,760,149,17.188498105243774,11.429192035893946
17062,/media/marda/TWOTB1/xBD/hurricanes/images/florence/hurricane-florence_00000014_pre_disaster.png,19,40,1,135,154,724,764,142,16.500491265951887,11.385806297593517
17063,/media/marda/TWOTB1/xBD/hurricanes/images/florence/hurricane-florence_00000450_pre_disaster.png,44,52,1,241,285,28,80,1097,52.71153290338352,27.632959713583787
17064,/media/marda/TWOTB1/xBD/hurricanes/images/florence/hurricane-florence_00000450_pre_disaster.png,26,19,1,294,320,54,73,195,19.776626785704604,13.160038907141015
17065,/media/marda/TWOTB1/xBD/hurricanes/images/florence/hurricane-florence_00000450_pre_disaster.png,26,11,1,297,323,72,83,99,15.70529737342769,8.433665737450484
17066,/media/marda/TWOTB1/xBD/hurricanes/images/florence/hurricane-florence_00000450_pre_disaster.png,45,34,1,487,532,155,189,498,35.61873336076517,21.880274757018555
17067,/media/marda/TWOTB1/xBD/hurricanes/images/florence/hurricane-florence_00000450_pre_disaster.png,31,16,1,491,522,277,293,79,12.15176514137227,8.613142881135907
17068,/media/marda/TWOTB1/xBD/hurricanes/images/florence/hurricane-florence_00000450_pre_disaster.png,46,63,1,323,369,305,368,1019,53.45242050059224,27.699250126196564
17069,/media/marda/TWOTB1/xBD/hurricanes/images/florence/hurricane-florence_00000450_pre_disaster.png,21,38,1,178,199,316,354,270,27.911117523553973,13.033487471826755
17070,/media/marda/TWOTB1/xBD/hurricanes/images/florence/hurricane-florence_00000450_pre_disaster.png,25,39,1,369,394,319,358,302,29.119717078114302,13.841381859270898
17071,/media/marda/TWOTB1/xBD/hurricanes/images/florence/hurricane-florence_00000450_pre_disaster.png,31,49,1,202,233,337,386,422,40.33285440692528,13.943101013573258
17072,/media/marda/TWOTB1/xBD/hurricanes/images/florence/hurricane-florence_00000450_pre_disaster.png,41,46,1,342,383,398,444,652,29.527025753271626,28.975393588244653
17073,/media/marda/TWOTB1/xBD/hurricanes/images/florence/hurricane-florence_00000450_pre_disaster.png,47,37,1,200,247,431,468,598,42.7804629182616,18.64987244190588
17074,/media/marda/TWOTB1/xBD/hurricanes/images/florence/hurricane-florence_00000450_pre_disaster.png,41,65,1,356,397,433,498,688,54.186895878557095,16.82295731809208
17075,/media/marda/TWOTB1/xBD/hurricanes/images/florence/hurricane-florence_00000450_pre_disaster.png,16,31,1,183,199,446,477,157,15.752475901413735,13.334119007975662
17076,/media/marda/TWOTB1/xBD/hurricanes/images/florence/hurricane-florence_00000450_pre_disaster.png,38,72,1,145,183,544,616,1434,53.429014518883164,36.245834755588504
17077,/media/marda/TWOTB1/xBD/hurricanes/images/florence/hurricane-florence_00000450_pre_disaster.png,41,34,1,549,590,552,586,200,21.501526811166705,12.385327803036928
17078,/media/marda/TWOTB1/xBD/hurricanes/images/florence/hurricane-florence_00000450_pre_disaster.png,32,28,1,592,624,554,582,54,8.870030247326662,8.12320666941029
17079,/media/marda/TWOTB1/xBD/hurricanes/images/florence/hurricane-florence_00000450_pre_disaster.png,65,55,1,230,295,572,627,1253,59.21820416479473,28.3007935154021
17080,/media/marda/TWOTB1/xBD/hurricanes/images/florence/hurricane-florence_00000450_pre_disaster.png,55,71,1,466,521,728,799,911,42.494186534840544,28.39515933530226
17081,/media/marda/TWOTB1/xBD/hurricanes/images/florence/hurricane-florence_00000450_pre_disaster.png,40,46,1,526,566,732,778,210,18.286842012947883,15.397927493602705
17082,/media/marda/TWOTB1/xBD/hurricanes/images/florence/hurricane-florence_00000450_pre_disaster.png,51,59,1,527,578,746,805,549,27.579194092923366,26.631384897094417
17083,/media/marda/TWOTB1/xBD/hurricanes/images/florence/hurricane-florence_00000450_pre_disaster.png,34,47,1,548,582,848,895,123,13.453337017993494,12.29889678861658
17084,/media/marda/TWOTB1/xBD/hurricanes/images/florence/hurricane-florence_00000450_pre_disaster.png,49,72,1,589,638,892,964,428,39.19143369309855,14.599760970870808
17085,/media/marda/TWOTB1/xBD/hurricanes/images/florence/hurricane-florence_00000450_pre_disaster.png,55,82,1,551,606,951,1033,1018,47.67545068027891,28.459061772779727
17086,/media/marda/TWOTB1/xBD/hurricanes/images/florence/hurricane-florence_00000081_post_disaster.png,163,134,1,806,969,705,839,4759,153.45592134855704,41.369448998475306
17087,/media/marda/TWOTB1/xBD/hurricanes/images/florence/hurricane-florence_00000081_post_disaster.png,70,81,1,718,788,813,894,1258,46.7258498399926,36.42830477837814
17088,/media/marda/TWOTB1/xBD/hurricanes/images/florence/hurricane-florence_00000081_post_disaster.png,46,49,1,766,812,823,872,162,18.17437532028713,11.926243817475866
17089,/media/marda/TWOTB1/xBD/hurricanes/images/florence/hurricane-florence_00000081_post_disaster.png,62,75,1,981,1043,884,959,586,38.024125991531875,21.687144296673992
17090,/media/marda/TWOTB1/xBD/hurricanes/images/florence/hurricane-florence_00000081_post_disaster.png,68,73,1,619,687,923,996,808,45.637026435367424,23.404108811614588
17091,/media/marda/TWOTB1/xBD/hurricanes/images/florence/hurricane-florence_00000503_post_disaster.png,89,95,1,799,888,915,1010,1587,59.30838895261415,35.704454854277785
17092,/media/marda/TWOTB1/xBD/hurricanes/images/florence/hurricane-florence_00000297_post_disaster.png,46,62,1,7,53,200,262,949,62.235529711284784,20.354360416033984
17093,/media/marda/TWOTB1/xBD/hurricanes/images/florence/hurricane-florence_00000297_post_disaster.png,37,40,1,0,37,291,331,445,45.89910045582272,12.991113299657968
17094,/media/marda/TWOTB1/xBD/hurricanes/images/florence/hurricane-florence_00000297_post_disaster.png,31,38,1,138,169,302,340,370,26.422472917591787,18.533302783449827
17095,/media/marda/TWOTB1/xBD/hurricanes/images/florence/hurricane-florence_00000297_post_disaster.png,17,18,1,118,135,319,337,73,14.134230433568824,6.723434922087533
17096,/media/marda/TWOTB1/xBD/hurricanes/images/florence/hurricane-florence_00000297_post_disaster.png,47,48,1,45,92,322,370,576,55.852327752077045,13.7597933736997
17097,/media/marda/TWOTB1/xBD/hurricanes/images/florence/hurricane-florence_00000297_post_disaster.png,62,56,1,99,161,327,383,1518,55.6834941185637,37.387776424968486
17098,/media/marda/TWOTB1/xBD/hurricanes/images/florence/hurricane-florence_00000297_post_disaster.png,20,26,1,184,204,364,390,106,12.44036325264946,11.391473303700508
17099,/media/marda/TWOTB1/xBD/hurricanes/images/florence/hurricane-florence_00000297_post_disaster.png,39,45,1,153,192,365,410,617,33.797817725063325,24.255479400623233
17100,/media/marda/TWOTB1/xBD/hurricanes/images/florence/hurricane-florence_00000297_post_disaster.png,51,60,1,24,75,740,800,1016,55.808419508665175,24.036141736485817
17101,/media/marda/TWOTB1/xBD/hurricanes/images/florence/hurricane-florence_00000297_post_disaster.png,22,42,1,345,367,778,820,140,16.1245154965971,11.489125293076057
17102,/media/marda/TWOTB1/xBD/hurricanes/images/florence/hurricane-florence_00000297_post_disaster.png,38,63,1,192,230,783,846,758,33.796351952735165,29.58860426785244
17103,/media/marda/TWOTB1/xBD/hurricanes/images/florence/hurricane-florence_00000297_post_disaster.png,59,66,1,121,180,787,853,1169,59.32557546583852,26.287728707213002
17104,/media/marda/TWOTB1/xBD/hurricanes/images/florence/hurricane-florence_00000297_post_disaster.png,60,68,1,299,359,797,865,1127,49.96486102406779,31.69282517491227
17105,/media/marda/TWOTB1/xBD/hurricanes/images/florence/hurricane-florence_00000297_post_disaster.png,28,81,1,69,97,893,974,839,46.68269231849929,23.91594501653482
17106,/media/marda/TWOTB1/xBD/hurricanes/images/florence/hurricane-florence_00000297_post_disaster.png,25,49,1,368,393,938,987,103,12.153208148456699,11.37654364438157
17107,/media/marda/TWOTB1/xBD/hurricanes/images/florence/hurricane-florence_00000212_pre_disaster.png,58,48,1,60,118,105,153,1449,56.301658886064665,34.85298342298232
17108,/media/marda/TWOTB1/xBD/hurricanes/images/florence/hurricane-florence_00000212_pre_disaster.png,47,45,1,659,706,360,405,709,36.805898157556015,25.527250412982838
17109,/media/marda/TWOTB1/xBD/hurricanes/images/florence/hurricane-florence_00000212_pre_disaster.png,86,45,1,891,977,392,437,1202,54.43679439428952,29.601865375270144
17110,/media/marda/TWOTB1/xBD/hurricanes/images/florence/hurricane-florence_00000212_pre_disaster.png,56,56,1,115,171,396,452,1534,51.82366198310085,38.588287328950734
17111,/media/marda/TWOTB1/xBD/hurricanes/images/florence/hurricane-florence_00000212_pre_disaster.png,61,46,1,983,1044,408,454,439,29.097089412855404,20.542247642756347
17112,/media/marda/TWOTB1/xBD/hurricanes/images/florence/hurricane-florence_00000212_pre_disaster.png,22,30,1,138,160,437,467,188,18.73630901396844,13.300632062462903
17113,/media/marda/TWOTB1/xBD/hurricanes/images/florence/hurricane-florence_00000212_pre_disaster.png,63,38,1,910,973,449,487,500,29.05801604780158,22.921550195519192
17114,/media/marda/TWOTB1/xBD/hurricanes/images/florence/hurricane-florence_00000212_pre_disaster.png,23,31,1,148,171,463,494,246,20.556601597694225,15.989891901288619
17115,/media/marda/TWOTB1/xBD/hurricanes/images/florence/hurricane-florence_00000212_pre_disaster.png,59,40,1,580,639,479,519,731,40.823052229782036,23.801103075250772
17116,/media/marda/TWOTB1/xBD/hurricanes/images/florence/hurricane-florence_00000212_pre_disaster.png,56,41,1,503,559,504,545,589,39.32586030386793,20.50414278458874
17117,/media/marda/TWOTB1/xBD/hurricanes/images/florence/hurricane-florence_00000212_pre_disaster.png,32,36,1,305,337,511,547,235,21.924525728074777,14.222356524407695
17118,/media/marda/TWOTB1/xBD/hurricanes/images/florence/hurricane-florence_00000212_pre_disaster.png,40,40,1,295,335,534,574,371,28.997428608604668,16.95624710763224
17119,/media/marda/TWOTB1/xBD/hurricanes/images/florence/hurricane-florence_00000212_pre_disaster.png,69,37,1,346,415,536,573,574,61.62699280169782,12.45220909439302
17120,/media/marda/TWOTB1/xBD/hurricanes/images/florence/hurricane-florence_00000212_pre_disaster.png,50,63,1,555,605,557,620,943,47.71551615221498,26.41485460735995
17121,/media/marda/TWOTB1/xBD/hurricanes/images/florence/hurricane-florence_00000212_pre_disaster.png,45,37,1,506,551,571,608,348,27.404042709991433,17.20617323625999
17122,/media/marda/TWOTB1/xBD/hurricanes/images/florence/hurricane-florence_00000212_pre_disaster.png,35,31,1,597,632,572,603,106,12.305608040770615,11.523016702032022
17123,/media/marda/TWOTB1/xBD/hurricanes/images/florence/hurricane-florence_00000212_pre_disaster.png,29,35,1,493,522,573,608,113,15.251383679820616,9.968414888085936
17124,/media/marda/TWOTB1/xBD/hurricanes/images/florence/hurricane-florence_00000212_pre_disaster.png,30,43,1,351,381,578,621,372,25.24657691119115,19.586029486679166
17125,/media/marda/TWOTB1/xBD/hurricanes/images/florence/hurricane-florence_00000212_pre_disaster.png,25,34,1,363,388,599,633,102,14.68350854666666,9.386532643134032
17126,/media/marda/TWOTB1/xBD/hurricanes/images/florence/hurricane-florence_00000212_pre_disaster.png,70,48,1,904,974,680,728,676,36.73297421082909,24.48725204259576
17127,/media/marda/TWOTB1/xBD/hurricanes/images/florence/hurricane-florence_00000212_pre_disaster.png,49,37,1,902,951,720,757,93,15.23108933244425,8.228781348309465
17128,/media/marda/TWOTB1/xBD/hurricanes/images/florence/hurricane-florence_00000212_pre_disaster.png,81,63,1,764,845,790,853,1265,54.58590678504129,30.718227750516142
17129,/media/marda/TWOTB1/xBD/hurricanes/images/florence/hurricane-florence_00000212_pre_disaster.png,63,58,1,893,956,791,849,390,26.287036965934153,19.52360220959901
17130,/media/marda/TWOTB1/xBD/hurricanes/images/florence/hurricane-florence_00000053_pre_disaster.png,67,30,1,432,499,0,30,1071,52.58834266051001,27.351289906523757
17131,/media/marda/TWOTB1/xBD/hurricanes/images/florence/hurricane-florence_00000053_pre_disaster.png,51,17,1,546,597,0,17,294,27.111148766244305,16.211502527635137
17132,/media/marda/TWOTB1/xBD/hurricanes/images/florence/hurricane-florence_00000053_pre_disaster.png,63,37,1,959,1022,4,41,504,38.78382441826097,18.506204757840212
17133,/media/marda/TWOTB1/xBD/hurricanes/images/florence/hurricane-florence_00000053_pre_disaster.png,43,12,1,868,911,25,37,84,11.207824819146573,10.127714641833366
17134,/media/marda/TWOTB1/xBD/hurricanes/images/florence/hurricane-florence_00000053_pre_disaster.png,92,125,1,283,375,35,160,6461,129.24671576908224,65.8494567525645
17135,/media/marda/TWOTB1/xBD/hurricanes/images/florence/hurricane-florence_00000053_pre_disaster.png,45,22,1,470,515,58,80,399,27.543585756465344,19.129059182859205
17136,/media/marda/TWOTB1/xBD/hurricanes/images/florence/hurricane-florence_00000267_post_disaster.png,28,37,1,218,246,428,465,181,23.312689963348756,10.396084520684633
17137,/media/marda/TWOTB1/xBD/hurricanes/images/florence/hurricane-florence_00000267_post_disaster.png,35,42,1,194,229,460,502,374,23.844411769304383,20.96742972168948
17138,/media/marda/TWOTB1/xBD/hurricanes/images/florence/hurricane-florence_00000363_post_disaster.png,67,46,1,598,665,142,188,951,40.771318461718515,30.82770257546746
17139,/media/marda/TWOTB1/xBD/hurricanes/images/florence/hurricane-florence_00000363_post_disaster.png,43,27,1,703,746,337,364,104,14.291670754805633,10.10717328287
17140,/media/marda/TWOTB1/xBD/hurricanes/images/florence/hurricane-florence_00000363_post_disaster.png,90,67,1,284,374,358,425,2671,82.9546871909143,43.050339726800686
17141,/media/marda/TWOTB1/xBD/hurricanes/images/florence/hurricane-florence_00000363_post_disaster.png,66,63,1,301,367,408,471,1692,52.60435028430667,42.70139837846442
17142,/media/marda/TWOTB1/xBD/hurricanes/images/florence/hurricane-florence_00000363_post_disaster.png,25,32,1,390,415,436,468,144,16.035555312501945,11.832479484789413
17143,/media/marda/TWOTB1/xBD/hurricanes/images/florence/hurricane-florence_00000199_post_disaster.png,36,12,1,530,566,0,12,141,16.443728732872284,11.606609646765936
17144,/media/marda/TWOTB1/xBD/hurricanes/images/florence/hurricane-florence_00000199_post_disaster.png,59,14,1,646,705,0,14,450,39.963162626372714,14.997451415072819
17145,/media/marda/TWOTB1/xBD/hurricanes/images/florence/hurricane-florence_00000199_post_disaster.png,91,40,1,411,502,13,53,1665,82.55259815677911,27.711768377891588
17146,/media/marda/TWOTB1/xBD/hurricanes/images/florence/hurricane-florence_00000199_post_disaster.png,54,46,1,537,591,13,59,1018,47.81022924383942,28.127410216585695
17147,/media/marda/TWOTB1/xBD/hurricanes/images/florence/hurricane-florence_00000199_post_disaster.png,65,27,1,946,1011,21,48,529,30.711471216473306,23.17776321220108
17148,/media/marda/TWOTB1/xBD/hurricanes/images/florence/hurricane-florence_00000199_post_disaster.png,94,44,1,876,970,26,70,1679,60.57170150438904,38.85813065971688
17149,/media/marda/TWOTB1/xBD/hurricanes/images/florence/hurricane-florence_00000199_post_disaster.png,89,63,1,196,285,48,111,2905,85.22464331920857,46.90109235720638
17150,/media/marda/TWOTB1/xBD/hurricanes/images/florence/hurricane-florence_00000199_post_disaster.png,63,40,1,815,878,50,90,829,39.727796778616316,27.457712892001236
17151,/media/marda/TWOTB1/xBD/hurricanes/images/florence/hurricane-florence_00000199_post_disaster.png,51,14,1,930,981,63,77,134,14.978023567401127,11.887461436207161
17152,/media/marda/TWOTB1/xBD/hurricanes/images/florence/hurricane-florence_00000199_post_disaster.png,67,47,1,774,841,74,121,1114,45.02701753056169,32.89611515084843
17153,/media/marda/TWOTB1/xBD/hurricanes/images/florence/hurricane-florence_00000199_post_disaster.png,73,49,1,970,1043,86,135,954,53.61504162154777,24.165332713077884
17154,/media/marda/TWOTB1/xBD/hurricanes/images/florence/hurricane-florence_00000199_post_disaster.png,103,46,1,689,792,87,133,2101,76.83099578740928,40.41793463850394
17155,/media/marda/TWOTB1/xBD/hurricanes/images/florence/hurricane-florence_00000199_post_disaster.png,43,12,1,835,878,97,109,87,11.44474565249455,10.258668695675262
17156,/media/marda/TWOTB1/xBD/hurricanes/images/florence/hurricane-florence_00000199_post_disaster.png,62,21,1,970,1032,148,169,219,26.208248440034783,11.17866999848357
17157,/media/marda/TWOTB1/xBD/hurricanes/images/florence/hurricane-florence_00000199_post_disaster.png,42,13,1,785,827,149,162,85,11.147372866272212,10.118968209588605
17158,/media/marda/TWOTB1/xBD/hurricanes/images/florence/hurricane-florence_00000199_post_disaster.png,67,33,1,715,782,179,212,781,40.59708525328074,25.44449150749619
17159,/media/marda/TWOTB1/xBD/hurricanes/images/florence/hurricane-florence_00000199_post_disaster.png,40,20,1,768,808,180,200,156,16.49991016876714,12.728290328202958
17160,/media/marda/TWOTB1/xBD/hurricanes/images/florence/hurricane-florence_00000199_post_disaster.png,68,43,1,328,396,197,240,1309,60.33339421950097,28.659706589279985
17161,/media/marda/TWOTB1/xBD/hurricanes/images/florence/hurricane-florence_00000199_post_disaster.png,46,29,1,699,745,233,262,251,19.755029206905643,16.940967752005964
17162,/media/marda/TWOTB1/xBD/hurricanes/images/florence/hurricane-florence_00000199_post_disaster.png,52,23,1,919,971,235,258,171,16.304083919397367,13.82967766221902
17163,/media/marda/TWOTB1/xBD/hurricanes/images/florence/hurricane-florence_00000199_post_disaster.png,50,40,1,378,428,241,281,880,39.29417153445503,30.069953990779577
17164,/media/marda/TWOTB1/xBD/hurricanes/images/florence/hurricane-florence_00000199_post_disaster.png,38,62,1,147,185,242,304,1352,58.56612992157638,30.51020317279423
17165,/media/marda/TWOTB1/xBD/hurricanes/images/florence/hurricane-florence_00000199_post_disaster.png,45,18,1,962,1007,253,271,56,8.91227083456127,8.48528137423857
17166,/media/marda/TWOTB1/xBD/hurricanes/images/florence/hurricane-florence_00000199_post_disaster.png,87,69,1,892,979,264,333,1906,58.23048001344161,45.20642618835663
17167,/media/marda/TWOTB1/xBD/hurricanes/images/florence/hurricane-florence_00000199_post_disaster.png,72,53,1,964,1036,266,319,1008,45.659273998014505,29.23795042559206
17168,/media/marda/TWOTB1/xBD/hurricanes/images/florence/hurricane-florence_00000199_post_disaster.png,50,50,1,429,479,290,340,1156,44.278598503075735,34.842018716438304
17169,/media/marda/TWOTB1/xBD/hurricanes/images/florence/hurricane-florence_00000199_post_disaster.png,79,103,1,693,772,294,397,2986,93.53182796445948,43.208937785308876
17170,/media/marda/TWOTB1/xBD/hurricanes/images/florence/hurricane-florence_00000199_post_disaster.png,82,47,1,807,889,306,353,992,50.46977517672826,25.909947931848624
17171,/media/marda/TWOTB1/xBD/hurricanes/images/florence/hurricane-florence_00000199_post_disaster.png,35,60,1,323,358,309,369,682,53.12681664034999,17.087220900290987
17172,/media/marda/TWOTB1/xBD/hurricanes/images/florence/hurricane-florence_00000199_post_disaster.png,60,35,1,428,488,361,396,509,50.073291618634435,13.593842224447222
17173,/media/marda/TWOTB1/xBD/hurricanes/images/florence/hurricane-florence_00000199_post_disaster.png,27,64,1,353,380,365,429,673,57.743719269905114,15.501655126201214
17174,/media/marda/TWOTB1/xBD/hurricanes/images/florence/hurricane-florence_00000199_post_disaster.png,85,75,1,900,985,385,460,1979,65.11572078266015,42.760654669259374
17175,/media/marda/TWOTB1/xBD/hurricanes/images/florence/hurricane-florence_00000199_post_disaster.png,63,31,1,434,497,395,426,607,53.89279590936224,15.021088272197444
17176,/media/marda/TWOTB1/xBD/hurricanes/images/florence/hurricane-florence_00000199_post_disaster.png,62,52,1,981,1043,401,453,493,31.14395489438284,23.046978102995084
17177,/media/marda/TWOTB1/xBD/hurricanes/images/florence/hurricane-florence_00000199_post_disaster.png,70,50,1,830,900,411,461,887,37.074255673424375,32.05061152238293
17178,/media/marda/TWOTB1/xBD/hurricanes/images/florence/hurricane-florence_00000199_post_disaster.png,64,52,1,782,846,427,479,888,37.30499954579172,31.697833055998988
17179,/media/marda/TWOTB1/xBD/hurricanes/images/florence/hurricane-florence_00000199_post_disaster.png,81,65,1,935,1016,455,520,1348,49.80014856660059,39.87626916968022
17180,/media/marda/TWOTB1/xBD/hurricanes/images/florence/hurricane-florence_00000199_post_disaster.png,43,30,1,846,889,456,486,110,13.15336227355618,11.270467650717878
17181,/media/marda/TWOTB1/xBD/hurricanes/images/florence/hurricane-florence_00000199_post_disaster.png,48,28,1,995,1043,458,486,65,11.445094289905867,7.6070113335587894
17182,/media/marda/TWOTB1/xBD/hurricanes/images/florence/hurricane-florence_00000199_post_disaster.png,52,47,1,227,279,468,515,876,46.26320941868732,24.84387349311328
17183,/media/marda/TWOTB1/xBD/hurricanes/images/florence/hurricane-florence_00000199_post_disaster.png,54,29,1,982,1036,485,514,128,14.336308039451044,11.908856273188931
17184,/media/marda/TWOTB1/xBD/hurricanes/images/florence/hurricane-florence_00000199_post_disaster.png,61,72,1,606,667,486,558,1323,57.42830013277692,30.82274800789759
17185,/media/marda/TWOTB1/xBD/hurricanes/images/florence/hurricane-florence_00000199_post_disaster.png,73,62,1,966,1039,502,564,939,41.61282291784129,29.959925161383527
17186,/media/marda/TWOTB1/xBD/hurricanes/images/florence/hurricane-florence_00000199_post_disaster.png,37,34,1,591,628,520,554,116,12.774769437493985,12.226033535902392
17187,/media/marda/TWOTB1/xBD/hurricanes/images/florence/hurricane-florence_00000199_post_disaster.png,52,53,1,414,466,521,574,815,38.093238758035305,28.239871603313176
17188,/media/marda/TWOTB1/xBD/hurricanes/images/florence/hurricane-florence_00000199_post_disaster.png,72,63,1,842,914,535,598,1072,42.13264397762545,34.674851258280995
17189,/media/marda/TWOTB1/xBD/hurricanes/images/florence/hurricane-florence_00000199_post_disaster.png,52,49,1,500,552,539,588,607,32.78377517741265,24.456581041785814
17190,/media/marda/TWOTB1/xBD/hurricanes/images/florence/hurricane-florence_00000199_post_disaster.png,41,62,1,342,383,546,608,747,42.68663030895957,23.304093420972
17191,/media/marda/TWOTB1/xBD/hurricanes/images/florence/hurricane-florence_00000199_post_disaster.png,48,41,1,511,559,573,614,370,28.888904879452667,16.946050225798075
17192,/media/marda/TWOTB1/xBD/hurricanes/images/florence/hurricane-florence_00000199_post_disaster.png,81,95,1,645,726,626,721,2217,75.5178868465811,44.37885211031361
17193,/media/marda/TWOTB1/xBD/hurricanes/images/florence/hurricane-florence_00000199_post_disaster.png,49,38,1,890,939,632,670,132,14.821268044644658,11.920550610763035
17194,/media/marda/TWOTB1/xBD/hurricanes/images/florence/hurricane-florence_00000199_post_disaster.png,40,41,1,628,668,641,682,176,16.98877311065698,13.593526555963182
17195,/media/marda/TWOTB1/xBD/hurricanes/images/florence/hurricane-florence_00000199_post_disaster.png,70,54,1,895,965,662,716,766,35.85395081120009,27.6715771911503
17196,/media/marda/TWOTB1/xBD/hurricanes/images/florence/hurricane-florence_00000199_post_disaster.png,129,77,1,342,471,665,742,2664,131.79328955011712,26.773023029875695
17197,/media/marda/TWOTB1/xBD/hurricanes/images/florence/hurricane-florence_00000199_post_disaster.png,67,103,1,684,751,693,796,1795,77.60567100827365,32.36847565544264
17198,/media/marda/TWOTB1/xBD/hurricanes/images/florence/hurricane-florence_00000199_post_disaster.png,61,68,1,765,826,704,772,917,39.992755578846236,29.873077541577562
17199,/media/marda/TWOTB1/xBD/hurricanes/images/florence/hurricane-florence_00000199_post_disaster.png,72,132,1,444,516,706,838,2756,115.90366126669676,31.63396119867853
17200,/media/marda/TWOTB1/xBD/hurricanes/images/florence/hurricane-florence_00000199_post_disaster.png,54,62,1,654,708,724,786,686,33.52142858199897,26.925316468911998
17201,/media/marda/TWOTB1/xBD/hurricanes/images/florence/hurricane-florence_00000199_post_disaster.png,68,131,1,347,415,734,865,2710,114.8723318075518,31.446641751893267
17202,/media/marda/TWOTB1/xBD/hurricanes/images/florence/hurricane-florence_00000199_post_disaster.png,62,60,1,952,1014,740,800,600,32.23253856148788,24.621124446160213
17203,/media/marda/TWOTB1/xBD/hurricanes/images/florence/hurricane-florence_00000199_post_disaster.png,96,71,1,183,279,743,814,1829,103.46323617784239,25.047226984031326
17204,/media/marda/TWOTB1/xBD/hurricanes/images/florence/hurricane-florence_00000199_post_disaster.png,64,53,1,892,956,782,835,483,27.989189963393848,22.628241144263736
17205,/media/marda/TWOTB1/xBD/hurricanes/images/florence/hurricane-florence_00000199_post_disaster.png,38,110,1,187,225,798,908,2089,87.92084688664193,31.667496047408356
17206,/media/marda/TWOTB1/xBD/hurricanes/images/florence/hurricane-florence_00000199_post_disaster.png,77,61,1,843,920,802,863,874,45.24776186631598,25.42323271954509
17207,/media/marda/TWOTB1/xBD/hurricanes/images/florence/hurricane-florence_00000199_post_disaster.png,77,66,1,787,864,811,877,989,49.55719871319085,26.36238483101912
17208,/media/marda/TWOTB1/xBD/hurricanes/images/florence/hurricane-florence_00000199_post_disaster.png,54,49,1,980,1034,814,863,181,16.581296687479956,14.641153257087543
17209,/media/marda/TWOTB1/xBD/hurricanes/images/florence/hurricane-florence_00000199_post_disaster.png,30,64,1,271,301,825,889,642,35.67449731670299,23.833044452116106
17210,/media/marda/TWOTB1/xBD/hurricanes/images/florence/hurricane-florence_00000199_post_disaster.png,40,42,1,727,767,829,871,71,12.67150428105662,7.586905062798292
17211,/media/marda/TWOTB1/xBD/hurricanes/images/florence/hurricane-florence_00000199_post_disaster.png,67,80,1,696,763,836,916,1117,48.555009993206504,32.20855044022041
17212,/media/marda/TWOTB1/xBD/hurricanes/images/florence/hurricane-florence_00000199_post_disaster.png,44,52,1,682,726,854,906,251,19.007637879017896,17.432550313963905
17213,/media/marda/TWOTB1/xBD/hurricanes/images/florence/hurricane-florence_00000199_post_disaster.png,47,47,1,854,901,855,902,136,13.928567445217674,13.151309692965388
17214,/media/marda/TWOTB1/xBD/hurricanes/images/florence/hurricane-florence_00000199_post_disaster.png,42,81,1,565,607,865,946,558,54.59688801633846,13.571329632026757
17215,/media/marda/TWOTB1/xBD/hurricanes/images/florence/hurricane-florence_00000199_post_disaster.png,105,72,1,937,1042,876,948,1676,72.76589229263308,31.606203257328495
17216,/media/marda/TWOTB1/xBD/hurricanes/images/florence/hurricane-florence_00000199_post_disaster.png,63,53,1,821,884,896,949,288,33.777439314636815,11.329098915399923
17217,/media/marda/TWOTB1/xBD/hurricanes/images/florence/hurricane-florence_00000199_post_disaster.png,51,55,1,918,969,898,953,196,19.241539561276763,13.585941846994709
17218,/media/marda/TWOTB1/xBD/hurricanes/images/florence/hurricane-florence_00000199_post_disaster.png,69,57,1,621,690,900,957,496,50.55857891736146,13.051971736991264
17219,/media/marda/TWOTB1/xBD/hurricanes/images/florence/hurricane-florence_00000199_post_disaster.png,49,59,1,883,932,907,966,203,24.043657600712873,11.246931494957126
17220,/media/marda/TWOTB1/xBD/hurricanes/images/florence/hurricane-florence_00000199_post_disaster.png,41,81,1,400,441,911,992,641,49.27639407751323,17.281097971956868
17221,/media/marda/TWOTB1/xBD/hurricanes/images/florence/hurricane-florence_00000199_post_disaster.png,41,90,1,358,399,919,1009,843,60.13669415821699,18.596760109593543
17222,/media/marda/TWOTB1/xBD/hurricanes/images/florence/hurricane-florence_00000199_post_disaster.png,30,46,1,494,524,926,972,62,9.724764784040628,8.688697602294345
17223,/media/marda/TWOTB1/xBD/hurricanes/images/florence/hurricane-florence_00000199_post_disaster.png,36,84,1,311,347,936,1020,625,52.800960902689894,15.673615222807177
17224,/media/marda/TWOTB1/xBD/hurricanes/images/florence/hurricane-florence_00000199_post_disaster.png,46,85,1,523,569,937,1022,699,54.61959268564464,17.01537538324842
17225,/media/marda/TWOTB1/xBD/hurricanes/images/florence/hurricane-florence_00000199_post_disaster.png,29,79,1,271,300,950,1029,529,46.9181673553088,15.023943088464419
17226,/media/marda/TWOTB1/xBD/hurricanes/images/florence/hurricane-florence_00000199_post_disaster.png,41,78,1,485,526,953,1031,539,46.73672553933706,15.343654146805646
17227,/media/marda/TWOTB1/xBD/hurricanes/images/florence/hurricane-florence_00000199_post_disaster.png,39,77,1,437,476,964,1041,570,47.434209416257964,15.977510738050908
17228,/media/marda/TWOTB1/xBD/hurricanes/images/florence/hurricane-florence_00000199_post_disaster.png,34,61,1,384,418,982,1043,281,23.870225401355228,15.619507161593177
17229,/media/marda/TWOTB1/xBD/hurricanes/images/florence/hurricane-florence_00000199_post_disaster.png,47,87,1,493,540,883,970,745,60.819964974171704,16.289483492698892
17230,/media/marda/TWOTB1/xBD/hurricanes/images/florence/hurricane-florence_00000199_post_disaster.png,39,81,1,454,493,896,977,612,48.8445750666332,16.607232297702474
17231,/media/marda/TWOTB1/xBD/hurricanes/images/florence/hurricane-florence_00000403_pre_disaster.png,30,25,1,58,88,0,25,536,28.68859776559805,24.947063599017543
17232,/media/marda/TWOTB1/xBD/hurricanes/images/florence/hurricane-florence_00000403_pre_disaster.png,35,19,1,350,385,0,19,347,23.76616156335933,19.267201201131456
17233,/media/marda/TWOTB1/xBD/hurricanes/images/florence/hurricane-florence_00000403_pre_disaster.png,69,33,1,364,433,26,59,964,61.630342662673456,22.22827883322435
17234,/media/marda/TWOTB1/xBD/hurricanes/images/florence/hurricane-florence_00000033_pre_disaster.png,50,36,1,75,125,0,36,1064,47.59679042162563,30.09675832172261
17235,/media/marda/TWOTB1/xBD/hurricanes/images/florence/hurricane-florence_00000033_pre_disaster.png,50,42,1,139,189,0,42,1102,43.06804024098423,34.73960794361617
17236,/media/marda/TWOTB1/xBD/hurricanes/images/florence/hurricane-florence_00000033_pre_disaster.png,54,27,1,306,360,0,27,767,38.04365028576217,27.387472343329
17237,/media/marda/TWOTB1/xBD/hurricanes/images/florence/hurricane-florence_00000033_pre_disaster.png,81,43,1,711,792,0,43,1345,46.12784986045718,39.45252345675066
17238,/media/marda/TWOTB1/xBD/hurricanes/images/florence/hurricane-florence_00000033_pre_disaster.png,46,8,1,759,805,0,8,76,15.778604416068307,7.3488211141041075
17239,/media/marda/TWOTB1/xBD/hurricanes/images/florence/hurricane-florence_00000033_pre_disaster.png,96,48,1,928,1024,0,48,1565,50.86047321186248,40.698181927926846
17240,/media/marda/TWOTB1/xBD/hurricanes/images/florence/hurricane-florence_00000033_pre_disaster.png,46,30,1,425,471,3,33,452,24.6219241798742,24.523662042329132
17241,/media/marda/TWOTB1/xBD/hurricanes/images/florence/hurricane-florence_00000033_pre_disaster.png,57,36,1,368,425,6,42,1076,47.955988999028335,29.65554314533839
17242,/media/marda/TWOTB1/xBD/hurricanes/images/florence/hurricane-florence_00000033_pre_disaster.png,71,47,1,548,619,6,53,1160,45.77664054297887,34.26365860053517
17243,/media/marda/TWOTB1/xBD/hurricanes/images/florence/hurricane-florence_00000033_pre_disaster.png,38,23,1,466,504,13,36,228,24.612627046355136,12.409998531878967
17244,/media/marda/TWOTB1/xBD/hurricanes/images/florence/hurricane-florence_00000033_pre_disaster.png,105,67,1,902,1007,31,98,2294,62.822899900587366,48.71362131343429
17245,/media/marda/TWOTB1/xBD/hurricanes/images/florence/hurricane-florence_00000033_pre_disaster.png,37,32,1,329,366,39,71,742,35.09827026041375,27.915178711790325
17246,/media/marda/TWOTB1/xBD/hurricanes/images/florence/hurricane-florence_00000033_pre_disaster.png,37,48,1,29,66,40,88,1191,52.18725612629872,32.69962562485046
17247,/media/marda/TWOTB1/xBD/hurricanes/images/florence/hurricane-florence_00000033_pre_disaster.png,74,51,1,495,569,43,94,1423,46.4321565313693,43.455845914788945
17248,/media/marda/TWOTB1/xBD/hurricanes/images/florence/hurricane-florence_00000033_pre_disaster.png,78,48,1,674,752,51,99,1188,50.65805875738658,32.300471497496126
17249,/media/marda/TWOTB1/xBD/hurricanes/images/florence/hurricane-florence_00000033_pre_disaster.png,52,33,1,196,248,54,87,685,44.76794899071788,22.779482729414426
17250,/media/marda/TWOTB1/xBD/hurricanes/images/florence/hurricane-florence_00000033_pre_disaster.png,151,116,1,800,951,66,182,6737,112.8237828605102,79.46788425450029
17251,/media/marda/TWOTB1/xBD/hurricanes/images/florence/hurricane-florence_00000033_pre_disaster.png,74,60,1,462,536,78,138,1718,53.639697548152654,45.11767382772798
17252,/media/marda/TWOTB1/xBD/hurricanes/images/florence/hurricane-florence_00000033_pre_disaster.png,74,53,1,633,707,92,145,1314,46.198138643253564,38.91361154012739
17253,/media/marda/TWOTB1/xBD/hurricanes/images/florence/hurricane-florence_00000033_pre_disaster.png,45,63,1,51,96,99,162,1477,55.504518537093496,35.96426645637144
17254,/media/marda/TWOTB1/xBD/hurricanes/images/florence/hurricane-florence_00000033_pre_disaster.png,61,54,1,269,330,113,167,1370,47.406146550225486,38.885993116946686
17255,/media/marda/TWOTB1/xBD/hurricanes/images/florence/hurricane-florence_00000033_pre_disaster.png,29,22,1,334,363,126,148,143,20.983037921478154,9.053892181645628
17256,/media/marda/TWOTB1/xBD/hurricanes/images/florence/hurricane-florence_00000033_pre_disaster.png,74,52,1,595,669,135,187,1255,47.56426685144005,35.57946340772813
17257,/media/marda/TWOTB1/xBD/hurricanes/images/florence/hurricane-florence_00000033_pre_disaster.png,48,48,1,112,160,144,192,980,36.31062230932893,36.01592523835214
17258,/media/marda/TWOTB1/xBD/hurricanes/images/florence/hurricane-florence_00000033_pre_disaster.png,59,49,1,422,481,147,196,955,43.92138431562818,29.412106981285287
17259,/media/marda/TWOTB1/xBD/hurricanes/images/florence/hurricane-florence_00000033_pre_disaster.png,63,58,1,314,377,148,206,1552,49.91272244072078,40.67537070295307
17260,/media/marda/TWOTB1/xBD/hurricanes/images/florence/hurricane-florence_00000033_pre_disaster.png,61,62,1,145,206,168,230,1569,52.681936605324005,41.117870132844295
17261,/media/marda/TWOTB1/xBD/hurricanes/images/florence/hurricane-florence_00000033_pre_disaster.png,32,15,1,383,415,182,197,198,20.752509888364507,12.649110640673518
17262,/media/marda/TWOTB1/xBD/hurricanes/images/florence/hurricane-florence_00000033_pre_disaster.png,80,58,1,544,624,189,247,1588,58.99863523601714,35.7516371765456
17263,/media/marda/TWOTB1/xBD/hurricanes/images/florence/hurricane-florence_00000033_pre_disaster.png,26,55,1,0,26,196,251,789,49.02296905093102,22.88219331398655
17264,/media/marda/TWOTB1/xBD/hurricanes/images/florence/hurricane-florence_00000033_pre_disaster.png,34,34,1,120,154,201,235,385,25.95576816096901,19.85604725474576
17265,/media/marda/TWOTB1/xBD/hurricanes/images/florence/hurricane-florence_00000033_pre_disaster.png,54,39,1,377,431,202,241,952,42.96910871792904,29.98492672767896
17266,/media/marda/TWOTB1/xBD/hurricanes/images/florence/hurricane-florence_00000033_pre_disaster.png,54,53,1,196,250,205,258,954,51.193802441957274,24.869046969079385
17267,/media/marda/TWOTB1/xBD/hurricanes/images/florence/hurricane-florence_00000033_pre_disaster.png,98,74,1,729,827,205,279,1951,75.81649234570173,34.293197004311025
17268,/media/marda/TWOTB1/xBD/hurricanes/images/florence/hurricane-florence_00000033_pre_disaster.png,46,28,1,623,669,219,247,215,19.82757529333425,14.530041240184453
17269,/media/marda/TWOTB1/xBD/hurricanes/images/florence/hurricane-florence_00000033_pre_disaster.png,57,61,1,13,70,231,292,1480,58.463907692169705,34.2981233249605
17270,/media/marda/TWOTB1/xBD/hurricanes/images/florence/hurricane-florence_00000033_pre_disaster.png,146,117,1,898,1044,233,350,4568,140.27681139368363,43.76688249393214
17271,/media/marda/TWOTB1/xBD/hurricanes/images/florence/hurricane-florence_00000033_pre_disaster.png,55,50,1,243,298,242,292,996,42.25419151765313,31.48906711750348
17272,/media/marda/TWOTB1/xBD/hurricanes/images/florence/hurricane-florence_00000033_pre_disaster.png,29,33,1,115,144,244,277,299,25.671777951709593,15.574617253877014
17273,/media/marda/TWOTB1/xBD/hurricanes/images/florence/hurricane-florence_00000033_pre_disaster.png,78,57,1,709,787,269,326,1225,48.58677842212319,33.49771661177798
17274,/media/marda/TWOTB1/xBD/hurricanes/images/florence/hurricane-florence_00000033_pre_disaster.png,54,55,1,62,116,272,327,1333,47.61987819085458,37.294050194654425
17275,/media/marda/TWOTB1/xBD/hurricanes/images/florence/hurricane-florence_00000033_pre_disaster.png,80,50,1,475,555,284,334,1202,63.28956142017613,31.469093422660272
17276,/media/marda/TWOTB1/xBD/hurricanes/images/florence/hurricane-florence_00000033_pre_disaster.png,36,29,1,294,330,287,316,313,23.575711899883007,17.12672232591148
17277,/media/marda/TWOTB1/xBD/hurricanes/images/florence/hurricane-florence_00000033_pre_disaster.png,63,63,1,312,375,290,353,1188,61.05811930948703,25.967899297438727
17278,/media/marda/TWOTB1/xBD/hurricanes/images/florence/hurricane-florence_00000033_pre_disaster.png,104,80,1,660,764,294,374,2724,75.02532526067009,48.31798576737692
17279,/media/marda/TWOTB1/xBD/hurricanes/images/florence/hurricane-florence_00000033_pre_disaster.png,50,55,1,105,155,313,368,976,41.11166268057581,31.695710701677783
17280,/media/marda/TWOTB1/xBD/hurricanes/images/florence/hurricane-florence_00000033_pre_disaster.png,69,62,1,415,484,329,391,1428,54.75128498242574,34.562385813881924
17281,/media/marda/TWOTB1/xBD/hurricanes/images/florence/hurricane-florence_00000033_pre_disaster.png,127,98,1,822,949,331,429,2915,111.85778127364674,34.76027433943236
17282,/media/marda/TWOTB1/xBD/hurricanes/images/florence/hurricane-florence_00000033_pre_disaster.png,37,37,1,242,279,334,371,335,29.995538682632894,14.955723781926434
17283,/media/marda/TWOTB1/xBD/hurricanes/images/florence/hurricane-florence_00000033_pre_disaster.png,53,67,1,159,212,341,408,1397,53.2117986895839,38.813360656950096
17284,/media/marda/TWOTB1/xBD/hurricanes/images/florence/hurricane-florence_00000033_pre_disaster.png,44,59,1,0,44,352,411,1225,40.98150821289755,39.38044371929197
17285,/media/marda/TWOTB1/xBD/hurricanes/images/florence/hurricane-florence_00000033_pre_disaster.png,48,50,1,268,316,353,403,770,35.910354325733344,28.324965953288118
17286,/media/marda/TWOTB1/xBD/hurricanes/images/florence/hurricane-florence_00000033_pre_disaster.png,63,56,1,385,448,381,437,1140,51.26013210728854,29.529390153083252
17287,/media/marda/TWOTB1/xBD/hurricanes/images/florence/hurricane-florence_00000033_pre_disaster.png,55,55,1,214,269,386,441,1473,49.77643367940169,40.96958296838157
17288,/media/marda/TWOTB1/xBD/hurricanes/images/florence/hurricane-florence_00000033_pre_disaster.png,92,74,1,602,694,386,460,1858,75.0145722311279,34.784250959530766
17289,/media/marda/TWOTB1/xBD/hurricanes/images/florence/hurricane-florence_00000033_pre_disaster.png,57,45,1,987,1044,390,435,282,27.82559816963873,15.752708859550921
17290,/media/marda/TWOTB1/xBD/hurricanes/images/florence/hurricane-florence_00000033_pre_disaster.png,50,47,1,463,513,393,440,498,26.78238688515971,24.851812993067416
17291,/media/marda/TWOTB1/xBD/hurricanes/images/florence/hurricane-florence_00000033_pre_disaster.png,60,66,1,32,92,396,462,1428,55.89461868392764,36.000272210908534
17292,/media/marda/TWOTB1/xBD/hurricanes/images/florence/hurricane-florence_00000033_pre_disaster.png,47,46,1,433,480,404,450,461,28.049468334142954,21.986260231117377
17293,/media/marda/TWOTB1/xBD/hurricanes/images/florence/hurricane-florence_00000033_pre_disaster.png,97,81,1,842,939,408,489,1969,63.4282361917119,41.40957373396119
17294,/media/marda/TWOTB1/xBD/hurricanes/images/florence/hurricane-florence_00000033_pre_disaster.png,83,69,1,566,649,410,479,860,78.71243397593877,14.595343867961585
17295,/media/marda/TWOTB1/xBD/hurricanes/images/florence/hurricane-florence_00000033_pre_disaster.png,63,70,1,340,403,421,491,1326,52.94867845124565,34.404424032700874
17296,/media/marda/TWOTB1/xBD/hurricanes/images/florence/hurricane-florence_00000033_pre_disaster.png,56,65,1,89,145,424,489,1234,55.80378594173511,29.298782658196174
17297,/media/marda/TWOTB1/xBD/hurricanes/images/florence/hurricane-florence_00000033_pre_disaster.png,64,54,1,550,614,430,484,662,49.01641953020093,17.961733365600878
17298,/media/marda/TWOTB1/xBD/hurricanes/images/florence/hurricane-florence_00000033_pre_disaster.png,145,151,1,899,1044,436,587,6291,130.8983630820308,92.95438624947691
17299,/media/marda/TWOTB1/xBD/hurricanes/images/florence/hurricane-florence_00000033_pre_disaster.png,86,72,1,530,616,450,522,1132,79.1271235703808,19.090173028104292
17300,/media/marda/TWOTB1/xBD/hurricanes/images/florence/hurricane-florence_00000033_pre_disaster.png,52,43,1,584,636,457,500,412,24.17735960728711,22.748523968514093
17301,/media/marda/TWOTB1/xBD/hurricanes/images/florence/hurricane-florence_00000033_pre_disaster.png,84,72,1,513,597,471,543,1136,79.16306999959231,19.150176934610094
17302,/media/marda/TWOTB1/xBD/hurricanes/images/florence/hurricane-florence_00000033_pre_disaster.png,62,68,1,313,375,474,542,1401,55.83777075853578,33.12100531882109
17303,/media/marda/TWOTB1/xBD/hurricanes/images/florence/hurricane-florence_00000033_pre_disaster.png,42,66,1,139,181,485,551,1309,56.730166873839586,32.151040730507745
17304,/media/marda/TWOTB1/xBD/hurricanes/images/florence/hurricane-florence_00000033_pre_disaster.png,23,34,1,84,107,491,525,276,22.357692646865758,16.305107692688924
17305,/media/marda/TWOTB1/xBD/hurricanes/images/florence/hurricane-florence_00000033_pre_disaster.png,105,101,1,475,580,491,592,3499,77.9452917456209,59.856847774764084
17306,/media/marda/TWOTB1/xBD/hurricanes/images/florence/hurricane-florence_00000033_pre_disaster.png,18,38,1,65,83,505,543,184,16.145228001776967,15.060710358862496
17307,/media/marda/TWOTB1/xBD/hurricanes/images/florence/hurricane-florence_00000033_pre_disaster.png,60,65,1,277,337,520,585,1149,46.46998498379753,33.86122744414148
17308,/media/marda/TWOTB1/xBD/hurricanes/images/florence/hurricane-florence_00000033_pre_disaster.png,79,74,1,762,841,522,596,1585,48.15929199230892,43.155670064303976
17309,/media/marda/TWOTB1/xBD/hurricanes/images/florence/hurricane-florence_00000033_pre_disaster.png,39,45,1,350,389,527,572,325,26.039921226895775,16.680637771427087
17310,/media/marda/TWOTB1/xBD/hurricanes/images/florence/hurricane-florence_00000033_pre_disaster.png,57,67,1,98,155,529,596,1282,59.320701157891854,30.389735410148784
17311,/media/marda/TWOTB1/xBD/hurricanes/images/florence/hurricane-florence_00000033_pre_disaster.png,42,63,1,0,42,534,597,969,44.78137773567757,28.960693406165866
17312,/media/marda/TWOTB1/xBD/hurricanes/images/florence/hurricane-florence_00000033_pre_disaster.png,102,100,1,439,541,536,636,3297,78.01515557007106,56.36001823227572
17313,/media/marda/TWOTB1/xBD/hurricanes/images/florence/hurricane-florence_00000033_pre_disaster.png,103,96,1,632,735,538,634,2738,82.59697312059079,44.09307647615632
17314,/media/marda/TWOTB1/xBD/hurricanes/images/florence/hurricane-florence_00000033_pre_disaster.png,68,60,1,716,784,542,602,804,33.63155031224727,31.911285621972297
17315,/media/marda/TWOTB1/xBD/hurricanes/images/florence/hurricane-florence_00000033_pre_disaster.png,24,47,1,44,68,549,596,417,29.185392932538203,19.6444794890057
17316,/media/marda/TWOTB1/xBD/hurricanes/images/florence/hurricane-florence_00000033_pre_disaster.png,51,54,1,305,356,563,617,671,35.18012647736235,25.433341716452357
17317,/media/marda/TWOTB1/xBD/hurricanes/images/florence/hurricane-florence_00000033_pre_disaster.png,58,70,1,39,97,564,634,1690,63.27315869480547,37.77188223258084
17318,/media/marda/TWOTB1/xBD/hurricanes/images/florence/hurricane-florence_00000033_pre_disaster.png,52,69,1,247,299,565,634,1117,42.09315473294222,35.48136053287718
17319,/media/marda/TWOTB1/xBD/hurricanes/images/florence/hurricane-florence_00000033_pre_disaster.png,98,89,1,597,695,598,687,2066,79.36372269269728,34.762990470006905
17320,/media/marda/TWOTB1/xBD/hurricanes/images/florence/hurricane-florence_00000033_pre_disaster.png,103,96,1,826,929,598,694,2296,74.38513257090521,44.90701521722746
17321,/media/marda/TWOTB1/xBD/hurricanes/images/florence/hurricane-florence_00000033_pre_disaster.png,59,71,1,195,254,605,676,1114,50.27706474026378,32.087634813412876
17322,/media/marda/TWOTB1/xBD/hurricanes/images/florence/hurricane-florence_00000033_pre_disaster.png,112,148,1,577,689,632,780,4514,136.5266282342188,53.99247864175074
17323,/media/marda/TWOTB1/xBD/hurricanes/images/florence/hurricane-florence_00000033_pre_disaster.png,72,64,1,670,742,643,707,797,48.63515968939809,21.87057863202839
17324,/media/marda/TWOTB1/xBD/hurricanes/images/florence/hurricane-florence_00000033_pre_disaster.png,83,76,1,800,883,646,722,1402,47.588061165801186,40.49895919901003
17325,/media/marda/TWOTB1/xBD/hurricanes/images/florence/hurricane-florence_00000033_pre_disaster.png,49,67,1,160,209,652,719,1088,41.37890545224761,34.33838880916044
17326,/media/marda/TWOTB1/xBD/hurricanes/images/florence/hurricane-florence_00000033_pre_disaster.png,148,149,1,672,820,669,818,6689,138.09308715013202,64.52006093148789
17327,/media/marda/TWOTB1/xBD/hurricanes/images/florence/hurricane-florence_00000033_pre_disaster.png,95,94,1,328,423,679,773,2531,81.85968585319327,42.338373494407286
17328,/media/marda/TWOTB1/xBD/hurricanes/images/florence/hurricane-florence_00000033_pre_disaster.png,53,75,1,122,175,686,761,1140,50.13464046080554,30.12157747257088
17329,/media/marda/TWOTB1/xBD/hurricanes/images/florence/hurricane-florence_00000033_pre_disaster.png,20,54,1,0,20,688,742,360,24.005380626157823,20.04747999324868
17330,/media/marda/TWOTB1/xBD/hurricanes/images/florence/hurricane-florence_00000033_pre_disaster.png,29,46,1,207,236,706,752,189,17.52593435691973,14.472379990288374
17331,/media/marda/TWOTB1/xBD/hurricanes/images/florence/hurricane-florence_00000033_pre_disaster.png,102,108,1,290,392,724,832,3311,96.67936160512835,45.566291686830056
17332,/media/marda/TWOTB1/xBD/hurricanes/images/florence/hurricane-florence_00000033_pre_disaster.png,87,88,1,521,608,735,823,1699,72.33900974944926,31.377509554482174
17333,/media/marda/TWOTB1/xBD/hurricanes/images/florence/hurricane-florence_00000033_pre_disaster.png,62,94,1,87,149,741,835,2128,58.20282177971813,50.80024965593134
17334,/media/marda/TWOTB1/xBD/hurricanes/images/florence/hurricane-florence_00000033_pre_disaster.png,76,82,1,485,561,756,838,1430,60.077646937565895,31.75213405059348
17335,/media/marda/TWOTB1/xBD/hurricanes/images/florence/hurricane-florence_00000033_pre_disaster.png,101,111,1,252,353,769,880,3283,96.84120394474044,45.27163415246813
17336,/media/marda/TWOTB1/xBD/hurricanes/images/florence/hurricane-florence_00000033_pre_disaster.png,91,90,1,472,563,779,869,1192,93.57571556955494,16.99155591534446
17337,/media/marda/TWOTB1/xBD/hurricanes/images/florence/hurricane-florence_00000033_pre_disaster.png,193,169,1,566,759,783,952,9712,187.46385542928144,75.12167000959961
17338,/media/marda/TWOTB1/xBD/hurricanes/images/florence/hurricane-florence_00000033_pre_disaster.png,64,80,1,53,117,786,866,1495,56.50987514400486,41.724171301550804
17339,/media/marda/TWOTB1/xBD/hurricanes/images/florence/hurricane-florence_00000033_pre_disaster.png,89,96,1,437,526,806,902,1959,78.76380749816086,33.138981465435315
17340,/media/marda/TWOTB1/xBD/hurricanes/images/florence/hurricane-florence_00000033_pre_disaster.png,99,110,1,214,313,816,926,2929,97.85559135322733,39.81941840486712
17341,/media/marda/TWOTB1/xBD/hurricanes/images/florence/hurricane-florence_00000033_pre_disaster.png,52,80,1,8,60,836,916,1169,55.36771641277166,28.390482831588873
17342,/media/marda/TWOTB1/xBD/hurricanes/images/florence/hurricane-florence_00000033_pre_disaster.png,74,82,1,970,1044,836,918,1044,44.446709192194575,33.69640036085075
17343,/media/marda/TWOTB1/xBD/hurricanes/images/florence/hurricane-florence_00000033_pre_disaster.png,61,71,1,491,552,849,920,808,33.809884163738054,31.897702761964354
17344,/media/marda/TWOTB1/xBD/hurricanes/images/florence/hurricane-florence_00000033_pre_disaster.png,98,101,1,428,526,853,954,1702,99.44223032516808,22.835546021309796
17345,/media/marda/TWOTB1/xBD/hurricanes/images/florence/hurricane-florence_00000033_pre_disaster.png,13,62,1,0,13,869,931,213,26.479189393599494,11.995613302205538
17346,/media/marda/TWOTB1/xBD/hurricanes/images/florence/hurricane-florence_00000033_pre_disaster.png,86,104,1,342,428,895,999,2441,70.61074660654549,47.23550747141207
17347,/media/marda/TWOTB1/xBD/hurricanes/images/florence/hurricane-florence_00000033_pre_disaster.png,127,138,1,917,1044,904,1042,4903,104.72904326348602,62.09717455060006
17348,/media/marda/TWOTB1/xBD/hurricanes/images/florence/hurricane-florence_00000033_pre_disaster.png,35,70,1,34,69,908,978,572,34.55583556446924,22.11461490398552
17349,/media/marda/TWOTB1/xBD/hurricanes/images/florence/hurricane-florence_00000033_pre_disaster.png,83,76,1,530,613,966,1042,1341,53.777109331522496,34.84900192576436
17350,/media/marda/TWOTB1/xBD/hurricanes/images/florence/hurricane-florence_00000033_pre_disaster.png,102,70,1,858,960,972,1042,1191,57.30662799162278,31.906266897721135
17351,/media/marda/TWOTB1/xBD/hurricanes/images/florence/hurricane-florence_00000002_pre_disaster.png,19,35,1,105,124,489,524,131,19.134867051332844,9.213919515782786
17352,/media/marda/TWOTB1/xBD/hurricanes/images/florence/hurricane-florence_00000002_pre_disaster.png,46,60,1,6,52,511,571,972,40.93772380745823,31.685254716665657
17353,/media/marda/TWOTB1/xBD/hurricanes/images/florence/hurricane-florence_00000002_pre_disaster.png,16,57,1,0,16,594,651,284,29.724374521819175,14.475322359861883
17354,/media/marda/TWOTB1/xBD/hurricanes/images/florence/hurricane-florence_00000002_pre_disaster.png,20,51,1,104,124,842,893,187,17.907634026189974,14.064695410705562
17355,/media/marda/TWOTB1/xBD/hurricanes/images/florence/hurricane-florence_00000002_pre_disaster.png,21,54,1,19,40,930,984,240,19.699500553830614,16.12534961332155
17356,/media/marda/TWOTB1/xBD/hurricanes/images/florence/hurricane-florence_00000002_pre_disaster.png,48,73,1,6,54,969,1042,979,51.82482238054233,27.47142211446547
17357,/media/marda/TWOTB1/xBD/hurricanes/images/florence/hurricane-florence_00000054_post_disaster.png,357,57,1,630,987,177,234,12449,378.1613741423882,44.5060948834587
17358,/media/marda/TWOTB1/xBD/hurricanes/images/florence/hurricane-florence_00000054_post_disaster.png,357,61,1,619,976,246,307,12107,377.6104271370346,43.45956747672723
17359,/media/marda/TWOTB1/xBD/hurricanes/images/florence/hurricane-florence_00000054_post_disaster.png,33,20,1,610,643,337,357,53,9.0708588395189,7.530030809109983
17360,/media/marda/TWOTB1/xBD/hurricanes/images/florence/hurricane-florence_00000054_post_disaster.png,247,53,1,610,857,343,396,8168,251.46593950642264,43.25635430426185
17361,/media/marda/TWOTB1/xBD/hurricanes/images/florence/hurricane-florence_00000054_post_disaster.png,41,31,1,578,619,386,417,351,21.71927483662594,21.326049452541326
17362,/media/marda/TWOTB1/xBD/hurricanes/images/florence/hurricane-florence_00000054_post_disaster.png,32,28,1,540,572,451,479,113,12.539896526639238,11.570374132115571
17363,/media/marda/TWOTB1/xBD/hurricanes/images/florence/hurricane-florence_00000054_post_disaster.png,37,31,1,540,577,466,497,212,18.271350540794064,15.494910315243498
17364,/media/marda/TWOTB1/xBD/hurricanes/images/florence/hurricane-florence_00000054_post_disaster.png,45,31,1,538,583,507,538,176,28.042672069411225,8.364134732238238
17365,/media/marda/TWOTB1/xBD/hurricanes/images/florence/hurricane-florence_00000136_pre_disaster.png,71,56,1,973,1044,550,606,812,37.53187335415515,28.844794968327303
17366,/media/marda/TWOTB1/xBD/hurricanes/images/florence/hurricane-florence_00000136_pre_disaster.png,67,47,1,900,967,569,616,446,30.924250133141182,19.172071619085795
17367,/media/marda/TWOTB1/xBD/hurricanes/images/florence/hurricane-florence_00000365_pre_disaster.png,56,26,1,622,678,0,26,579,30.549188979886296,25.49399275222566
17368,/media/marda/TWOTB1/xBD/hurricanes/images/florence/hurricane-florence_00000365_pre_disaster.png,63,32,1,452,515,12,44,902,50.73558279825305,23.470735855286936
17369,/media/marda/TWOTB1/xBD/hurricanes/images/florence/hurricane-florence_00000365_pre_disaster.png,78,63,1,865,943,499,562,618,57.445082939382516,14.312990031160721
17370,/media/marda/TWOTB1/xBD/hurricanes/images/florence/hurricane-florence_00000365_pre_disaster.png,58,53,1,986,1044,548,601,478,35.32955647698968,18.199652510918487
17371,/media/marda/TWOTB1/xBD/hurricanes/images/florence/hurricane-florence_00000365_pre_disaster.png,55,43,1,832,887,769,812,261,26.233532341859473,13.28014289927122
17372,/media/marda/TWOTB1/xBD/hurricanes/images/florence/hurricane-florence_00000365_pre_disaster.png,88,61,1,888,976,783,844,1466,61.817533025467434,33.75829041905473
17373,/media/marda/TWOTB1/xBD/hurricanes/images/florence/hurricane-florence_00000365_pre_disaster.png,66,78,1,782,848,964,1042,1173,45.17318257676578,35.01916794974802
17374,/media/marda/TWOTB1/xBD/hurricanes/images/florence/hurricane-florence_00000124_post_disaster.png,72,47,1,722,794,253,300,1086,42.50014265093739,33.487653452906116
17375,/media/marda/TWOTB1/xBD/hurricanes/images/florence/hurricane-florence_00000124_post_disaster.png,34,46,1,77,111,373,419,622,30.879125388843125,26.737350227844864
17376,/media/marda/TWOTB1/xBD/hurricanes/images/florence/hurricane-florence_00000124_post_disaster.png,55,41,1,343,398,396,437,657,47.80845038128671,18.361658510950175
17377,/media/marda/TWOTB1/xBD/hurricanes/images/florence/hurricane-florence_00000124_post_disaster.png,49,57,1,323,372,468,525,855,40.44088902449065,28.04529748294563
17378,/media/marda/TWOTB1/xBD/hurricanes/images/florence/hurricane-florence_00000124_post_disaster.png,63,60,1,866,929,800,860,418,25.315821383756248,22.038936319523355
17379,/media/marda/TWOTB1/xBD/hurricanes/images/florence/hurricane-florence_00000124_post_disaster.png,65,62,1,880,945,835,897,515,32.02265651128763,21.763219334213883
17380,/media/marda/TWOTB1/xBD/hurricanes/images/florence/hurricane-florence_00000124_post_disaster.png,80,67,1,951,1031,879,946,821,36.275869297753566,29.703706981879186
17381,/media/marda/TWOTB1/xBD/hurricanes/images/florence/hurricane-florence_00000492_pre_disaster.png,56,41,1,42,98,0,41,1432,53.52167881631231,34.92832909800774
17382,/media/marda/TWOTB1/xBD/hurricanes/images/florence/hurricane-florence_00000492_pre_disaster.png,92,66,1,327,419,9,75,2525,73.34722274744419,60.33004108063871
17383,/media/marda/TWOTB1/xBD/hurricanes/images/florence/hurricane-florence_00000492_pre_disaster.png,68,64,1,106,174,206,270,2026,58.04104402595048,48.340101900763315
17384,/media/marda/TWOTB1/xBD/hurricanes/images/florence/hurricane-florence_00000492_pre_disaster.png,59,83,1,36,95,243,326,2548,70.90307383852564,50.30490631720609
17385,/media/marda/TWOTB1/xBD/hurricanes/images/florence/hurricane-florence_00000019_post_disaster.png,65,78,1,519,584,0,78,745,95.91991925914446,10.349958502625338
17386,/media/marda/TWOTB1/xBD/hurricanes/images/florence/hurricane-florence_00000019_post_disaster.png,106,76,1,574,680,0,76,1854,111.01642142618877,22.197090101137576
17387,/media/marda/TWOTB1/xBD/hurricanes/images/florence/hurricane-florence_00000019_post_disaster.png,102,61,1,601,703,0,61,1509,93.059561106054,21.761344361247307
17388,/media/marda/TWOTB1/xBD/hurricanes/images/florence/hurricane-florence_00000019_post_disaster.png,80,37,1,637,717,0,37,847,55.715554848105754,20.54986916386318
17389,/media/marda/TWOTB1/xBD/hurricanes/images/florence/hurricane-florence_00000019_post_disaster.png,241,127,1,659,900,0,127,11349,225.90229081283,85.60548467270432
17390,/media/marda/TWOTB1/xBD/hurricanes/images/florence/hurricane-florence_00000019_post_disaster.png,106,80,1,561,667,17,97,1763,113.11951083682567,20.793279438251744
17391,/media/marda/TWOTB1/xBD/hurricanes/images/florence/hurricane-florence_00000019_post_disaster.png,104,79,1,546,650,42,121,2270,101.71275002049497,29.768816503730264
17392,/media/marda/TWOTB1/xBD/hurricanes/images/florence/hurricane-florence_00000019_post_disaster.png,97,71,1,531,628,72,143,1996,89.48497219782618,29.752142387683254
17393,/media/marda/TWOTB1/xBD/hurricanes/images/florence/hurricane-florence_00000019_post_disaster.png,68,118,1,477,545,83,201,1362,135.720349155388,33.011503301300316
17394,/media/marda/TWOTB1/xBD/hurricanes/images/florence/hurricane-florence_00000019_post_disaster.png,240,203,1,554,794,95,298,13052,274.2742921371976,68.65023815748751
17395,/media/marda/TWOTB1/xBD/hurricanes/images/florence/hurricane-florence_00000019_post_disaster.png,82,65,1,521,603,100,165,1295,78.33243229933699,22.040372159524225
17396,/media/marda/TWOTB1/xBD/hurricanes/images/florence/hurricane-florence_00000019_post_disaster.png,45,54,1,0,45,109,163,1577,48.559670394927295,43.15527332441762
17397,/media/marda/TWOTB1/xBD/hurricanes/images/florence/hurricane-florence_00000019_post_disaster.png,77,58,1,507,584,125,183,1088,69.85043178075749,20.78709913853727
17398,/media/marda/TWOTB1/xBD/hurricanes/images/florence/hurricane-florence_00000019_post_disaster.png,72,53,1,494,566,149,202,947,62.13423955055796,20.33809937702969
17399,/media/marda/TWOTB1/xBD/hurricanes/images/florence/hurricane-florence_00000019_post_disaster.png,55,37,1,989,1044,250,287,225,24.440403706431148,14.12634348467124
17400,/media/marda/TWOTB1/xBD/hurricanes/images/florence/hurricane-florence_00000019_post_disaster.png,155,168,1,460,615,251,419,9740,164.93006576139064,80.40255194581773
17401,/media/marda/TWOTB1/xBD/hurricanes/images/florence/hurricane-florence_00000019_post_disaster.png,73,45,1,971,1044,270,315,668,36.31186560900966,24.39321266334971
17402,/media/marda/TWOTB1/xBD/hurricanes/images/florence/hurricane-florence_00000019_post_disaster.png,76,45,1,951,1027,290,335,693,36.6383663043641,25.158270143756752
17403,/media/marda/TWOTB1/xBD/hurricanes/images/florence/hurricane-florence_00000019_post_disaster.png,73,48,1,932,1005,309,357,644,35.153998147727364,24.450687663205255
17404,/media/marda/TWOTB1/xBD/hurricanes/images/florence/hurricane-florence_00000019_post_disaster.png,73,49,1,912,985,329,378,648,37.17309382605319,23.282394089718654
17405,/media/marda/TWOTB1/xBD/hurricanes/images/florence/hurricane-florence_00000019_post_disaster.png,73,50,1,893,966,348,398,711,38.12431775533789,24.757444173529176
17406,/media/marda/TWOTB1/xBD/hurricanes/images/florence/hurricane-florence_00000019_post_disaster.png,74,51,1,875,949,367,418,760,37.66713437362238,26.92440493079204
17407,/media/marda/TWOTB1/xBD/hurricanes/images/florence/hurricane-florence_00000019_post_disaster.png,70,44,1,955,1025,370,414,484,32.271633561267386,20.034149778551495
17408,/media/marda/TWOTB1/xBD/hurricanes/images/florence/hurricane-florence_00000019_post_disaster.png,68,46,1,976,1044,388,434,552,37.43695116476397,19.43305597667871
17409,/media/marda/TWOTB1/xBD/hurricanes/images/florence/hurricane-florence_00000019_post_disaster.png,73,54,1,927,1000,395,449,648,39.25661882881903,22.025896130487713
17410,/media/marda/TWOTB1/xBD/hurricanes/images/florence/hurricane-florence_00000019_post_disaster.png,69,51,1,846,915,400,451,613,36.51968785448374,22.416623208207053
17411,/media/marda/TWOTB1/xBD/hurricanes/images/florence/hurricane-florence_00000019_post_disaster.png,52,38,1,992,1044,413,451,137,18.838292804505652,11.191591015281626
17412,/media/marda/TWOTB1/xBD/hurricanes/images/florence/hurricane-florence_00000019_post_disaster.png,121,124,1,351,472,414,538,5402,112.3426339525273,64.08404879433999
17413,/media/marda/TWOTB1/xBD/hurricanes/images/florence/hurricane-florence_00000019_post_disaster.png,73,51,1,949,1022,415,466,564,36.7862670126166,20.47758523007702
17414,/media/marda/TWOTB1/xBD/hurricanes/images/florence/hurricane-florence_00000019_post_disaster.png,71,53,1,825,896,419,472,678,38.950762382878516,23.241906141494425
17415,/media/marda/TWOTB1/xBD/hurricanes/images/florence/hurricane-florence_00000019_post_disaster.png,74,52,1,966,1040,432,484,598,37.565649709789625,21.253416229267657
17416,/media/marda/TWOTB1/xBD/hurricanes/images/florence/hurricane-florence_00000019_post_disaster.png,72,54,1,807,879,441,495,692,41.86097742566444,22.052608201879075
17417,/media/marda/TWOTB1/xBD/hurricanes/images/florence/hurricane-florence_00000019_post_disaster.png,65,48,1,878,943,454,502,479,30.695893721966623,20.80885091661423
17418,/media/marda/TWOTB1/xBD/hurricanes/images/florence/hurricane-florence_00000019_post_disaster.png,70,49,1,783,853,466,515,645,41.59028627991924,20.754810807243615
17419,/media/marda/TWOTB1/xBD/hurricanes/images/florence/hurricane-florence_00000019_post_disaster.png,70,51,1,894,964,467,518,545,36.37892143628053,19.99565971475286
17420,/media/marda/TWOTB1/xBD/hurricanes/images/florence/hurricane-florence_00000019_post_disaster.png,70,50,1,848,918,479,529,570,35.99338753876698,21.160678134175402
17421,/media/marda/TWOTB1/xBD/hurricanes/images/florence/hurricane-florence_00000019_post_disaster.png,72,50,1,913,985,488,538,561,36.69510172415932,20.44848321108036
17422,/media/marda/TWOTB1/xBD/hurricanes/images/florence/hurricane-florence_00000019_post_disaster.png,69,53,1,870,939,498,551,536,35.24070688309272,20.315315332445778
17423,/media/marda/TWOTB1/xBD/hurricanes/images/florence/hurricane-florence_00000019_post_disaster.png,72,54,1,935,1007,505,559,574,35.513431983332325,21.59039207654874
17424,/media/marda/TWOTB1/xBD/hurricanes/images/florence/hurricane-florence_00000019_post_disaster.png,67,46,1,785,852,506,552,524,37.84803837019732,18.4911268628958
17425,/media/marda/TWOTB1/xBD/hurricanes/images/florence/hurricane-florence_00000019_post_disaster.png,71,54,1,888,959,516,570,550,35.92190767480629,20.443496496506974
17426,/media/marda/TWOTB1/xBD/hurricanes/images/florence/hurricane-florence_00000019_post_disaster.png,73,53,1,957,1030,525,578,556,35.58166335507226,20.736886681978966
17427,/media/marda/TWOTB1/xBD/hurricanes/images/florence/hurricane-florence_00000019_post_disaster.png,66,53,1,803,869,529,582,557,35.830174024912836,20.57453421276784
17428,/media/marda/TWOTB1/xBD/hurricanes/images/florence/hurricane-florence_00000019_post_disaster.png,70,53,1,908,978,535,588,534,35.7498597123711,19.828028585142736
17429,/media/marda/TWOTB1/xBD/hurricanes/images/florence/hurricane-florence_00000019_post_disaster.png,67,55,1,977,1044,542,597,524,36.270632728423365,19.177077386912266
17430,/media/marda/TWOTB1/xBD/hurricanes/images/florence/hurricane-florence_00000019_post_disaster.png,68,55,1,821,889,546,601,574,37.547889403520855,20.44735384080518
17431,/media/marda/TWOTB1/xBD/hurricanes/images/florence/hurricane-florence_00000019_post_disaster.png,71,54,1,928,999,554,608,549,35.918293020777746,20.44613835485032
17432,/media/marda/TWOTB1/xBD/hurricanes/images/florence/hurricane-florence_00000019_post_disaster.png,86,81,1,707,793,564,645,1866,51.249435742219916,48.60981274493786
17433,/media/marda/TWOTB1/xBD/hurricanes/images/florence/hurricane-florence_00000019_post_disaster.png,68,55,1,842,910,565,620,589,36.348283132329016,21.635351336684483
17434,/media/marda/TWOTB1/xBD/hurricanes/images/florence/hurricane-florence_00000019_post_disaster.png,73,55,1,948,1021,572,627,557,37.187720773940555,20.002416993953123
17435,/media/marda/TWOTB1/xBD/hurricanes/images/florence/hurricane-florence_00000019_post_disaster.png,64,58,1,792,856,576,634,639,34.904201222080545,24.36253699523072
17436,/media/marda/TWOTB1/xBD/hurricanes/images/florence/hurricane-florence_00000019_post_disaster.png,49,36,1,995,1044,576,612,76,13.60722770060874,8.577244084007367
17437,/media/marda/TWOTB1/xBD/hurricanes/images/florence/hurricane-florence_00000019_post_disaster.png,71,56,1,862,933,583,639,615,37.993878319081944,21.61911976081417
17438,/media/marda/TWOTB1/xBD/hurricanes/images/florence/hurricane-florence_00000019_post_disaster.png,74,59,1,967,1041,589,648,601,36.975162456745934,21.625536312498053
17439,/media/marda/TWOTB1/xBD/hurricanes/images/florence/hurricane-florence_00000019_post_disaster.png,74,60,1,809,883,599,659,805,42.30252000006235,25.073660392635645
17440,/media/marda/TWOTB1/xBD/hurricanes/images/florence/hurricane-florence_00000019_post_disaster.png,68,56,1,884,952,602,658,472,33.43336164602075,18.865388262424073
17441,/media/marda/TWOTB1/xBD/hurricanes/images/florence/hurricane-florence_00000019_post_disaster.png,86,79,1,673,759,603,682,1533,55.51993212446881,39.27185822415964
17442,/media/marda/TWOTB1/xBD/hurricanes/images/florence/hurricane-florence_00000019_post_disaster.png,73,59,1,830,903,619,678,706,38.92288981643758,24.208792174337276
17443,/media/marda/TWOTB1/xBD/hurricanes/images/florence/hurricane-florence_00000019_post_disaster.png,69,57,1,905,974,621,678,509,33.8892521003538,20.040628673286726
17444,/media/marda/TWOTB1/xBD/hurricanes/images/florence/hurricane-florence_00000019_post_disaster.png,67,60,1,756,823,636,696,633,36.478240455597565,23.19050556156066
17445,/media/marda/TWOTB1/xBD/hurricanes/images/florence/hurricane-florence_00000019_post_disaster.png,75,62,1,848,923,636,698,728,40.58084430337056,23.965902854017582
17446,/media/marda/TWOTB1/xBD/hurricanes/images/florence/hurricane-florence_00000019_post_disaster.png,72,59,1,922,994,637,696,617,33.06829203026735,24.918632189304592
17447,/media/marda/TWOTB1/xBD/hurricanes/images/florence/hurricane-florence_00000019_post_disaster.png,62,56,1,654,716,644,700,574,35.016368299256776,21.597530016848054
17448,/media/marda/TWOTB1/xBD/hurricanes/images/florence/hurricane-florence_00000019_post_disaster.png,57,57,1,987,1044,644,701,358,32.04017380493396,15.682286604551505
17449,/media/marda/TWOTB1/xBD/hurricanes/images/florence/hurricane-florence_00000019_post_disaster.png,76,66,1,866,942,653,719,855,40.5165260806899,28.162145941547468
17450,/media/marda/TWOTB1/xBD/hurricanes/images/florence/hurricane-florence_00000019_post_disaster.png,66,58,1,734,800,657,715,624,37.512614325351,22.058740596290463
17451,/media/marda/TWOTB1/xBD/hurricanes/images/florence/hurricane-florence_00000019_post_disaster.png,67,57,1,954,1021,660,717,534,30.700613799078514,23.264949200943956
17452,/media/marda/TWOTB1/xBD/hurricanes/images/florence/hurricane-florence_00000019_post_disaster.png,68,59,1,794,862,662,721,567,38.59881195316054,19.552027199111958
17453,/media/marda/TWOTB1/xBD/hurricanes/images/florence/hurricane-florence_00000019_post_disaster.png,55,55,1,637,692,663,718,463,30.25271063339732,20.43708837167068
17454,/media/marda/TWOTB1/xBD/hurricanes/images/florence/hurricane-florence_00000019_post_disaster.png,63,59,1,716,779,677,736,572,35.943743026038526,21.260291625469296
17455,/media/marda/TWOTB1/xBD/hurricanes/images/florence/hurricane-florence_00000019_post_disaster.png,64,59,1,777,841,681,740,550,35.97975142012253,20.427547276807136
17456,/media/marda/TWOTB1/xBD/hurricanes/images/florence/hurricane-florence_00000019_post_disaster.png,63,59,1,616,679,686,745,642,38.907124341703636,22.041131885483196
17457,/media/marda/TWOTB1/xBD/hurricanes/images/florence/hurricane-florence_00000019_post_disaster.png,82,68,1,899,981,691,759,893,46.126065281495165,25.63713041903441
17458,/media/marda/TWOTB1/xBD/hurricanes/images/florence/hurricane-florence_00000019_post_disaster.png,63,62,1,698,761,694,756,549,35.92552006317586,20.42870314180425
17459,/media/marda/TWOTB1/xBD/hurricanes/images/florence/hurricane-florence_00000019_post_disaster.png,60,57,1,759,819,699,756,437,29.294775565284205,19.787481019217378
17460,/media/marda/TWOTB1/xBD/hurricanes/images/florence/hurricane-florence_00000019_post_disaster.png,74,63,1,821,895,708,771,714,42.53086329747448,22.249352997774334
17461,/media/marda/TWOTB1/xBD/hurricanes/images/florence/hurricane-florence_00000019_post_disaster.png,63,60,1,741,804,718,778,533,36.23331043461241,19.515050046196677
17462,/media/marda/TWOTB1/xBD/hurricanes/images/florence/hurricane-florence_00000019_post_disaster.png,60,56,1,599,659,719,775,666,36.28229194626269,24.01645793726989
17463,/media/marda/TWOTB1/xBD/hurricanes/images/florence/hurricane-florence_00000019_post_disaster.png,59,59,1,683,742,719,778,513,30.78489623027208,22.13090417832699
17464,/media/marda/TWOTB1/xBD/hurricanes/images/florence/hurricane-florence_00000019_post_disaster.png,73,69,1,715,788,729,798,690,43.36520827246044,26.473331467987915
17465,/media/marda/TWOTB1/xBD/hurricanes/images/florence/hurricane-florence_00000019_post_disaster.png,67,69,1,842,909,736,805,903,38.992881847755896,30.95110816034151
17466,/media/marda/TWOTB1/xBD/hurricanes/images/florence/hurricane-florence_00000019_post_disaster.png,73,61,1,800,873,737,798,742,35.052219169249405,28.019769982661234
17467,/media/marda/TWOTB1/xBD/hurricanes/images/florence/hurricane-florence_00000019_post_disaster.png,60,56,1,667,727,745,801,490,31.826020674013524,20.429084008997684
17468,/media/marda/TWOTB1/xBD/hurricanes/images/florence/hurricane-florence_00000019_post_disaster.png,58,49,1,587,645,754,803,573,38.66874760481977,19.99924905800059
17469,/media/marda/TWOTB1/xBD/hurricanes/images/florence/hurricane-florence_00000019_post_disaster.png,70,60,1,785,855,758,818,649,36.936846822659575,23.39771830662927
17470,/media/marda/TWOTB1/xBD/hurricanes/images/florence/hurricane-florence_00000019_post_disaster.png,60,52,1,707,767,763,815,403,30.16514449476377,17.73628769403257
17471,/media/marda/TWOTB1/xBD/hurricanes/images/florence/hurricane-florence_00000019_post_disaster.png,76,61,1,821,897,771,832,924,44.706065631182454,27.000045328717903
17472,/media/marda/TWOTB1/xBD/hurricanes/images/florence/hurricane-florence_00000019_post_disaster.png,66,57,1,653,719,772,829,759,41.458555795389344,25.296184651734823
17473,/media/marda/TWOTB1/xBD/hurricanes/images/florence/hurricane-florence_00000019_post_disaster.png,72,60,1,769,841,779,839,760,43.94272104203461,22.850256460935302
17474,/media/marda/TWOTB1/xBD/hurricanes/images/florence/hurricane-florence_00000019_post_disaster.png,54,50,1,588,642,781,831,510,31.443470113630177,21.354147456354173
17475,/media/marda/TWOTB1/xBD/hurricanes/images/florence/hurricane-florence_00000019_post_disaster.png,80,65,1,883,963,785,850,984,47.37922835632676,27.058017476468724
17476,/media/marda/TWOTB1/xBD/hurricanes/images/florence/hurricane-florence_00000019_post_disaster.png,66,58,1,695,761,789,847,616,39.170620810442514,20.828499832697403
17477,/media/marda/TWOTB1/xBD/hurricanes/images/florence/hurricane-florence_00000019_post_disaster.png,78,64,1,807,885,795,859,865,45.59307950465398,24.93876556304285
17478,/media/marda/TWOTB1/xBD/hurricanes/images/florence/hurricane-florence_00000019_post_disaster.png,59,58,1,650,709,800,858,672,38.296427811480804,23.44461377515058
17479,/media/marda/TWOTB1/xBD/hurricanes/images/florence/hurricane-florence_00000019_post_disaster.png,63,51,1,362,425,804,855,674,55.13079378675917,16.341647722866178
17480,/media/marda/TWOTB1/xBD/hurricanes/images/florence/hurricane-florence_00000019_post_disaster.png,70,63,1,761,831,806,869,784,40.14465967423949,25.819588911674273
17481,/media/marda/TWOTB1/xBD/hurricanes/images/florence/hurricane-florence_00000019_post_disaster.png,59,56,1,581,640,808,864,687,40.774971407659265,22.200669227238656
17482,/media/marda/TWOTB1/xBD/hurricanes/images/florence/hurricane-florence_00000019_post_disaster.png,39,41,1,688,727,808,849,77,11.479247226196284,8.992540057949334
17483,/media/marda/TWOTB1/xBD/hurricanes/images/florence/hurricane-florence_00000019_post_disaster.png,79,66,1,873,952,812,878,964,45.22566034334603,27.73645091453396
17484,/media/marda/TWOTB1/xBD/hurricanes/images/florence/hurricane-florence_00000019_post_disaster.png,64,68,1,695,759,818,886,985,39.82562337959652,32.669373325898896
17485,/media/marda/TWOTB1/xBD/hurricanes/images/florence/hurricane-florence_00000019_post_disaster.png,75,65,1,799,874,820,885,844,44.63560759962622,24.871448509472536
17486,/media/marda/TWOTB1/xBD/hurricanes/images/florence/hurricane-florence_00000019_post_disaster.png,56,52,1,650,706,829,881,423,32.37141412606572,17.488533476252275
17487,/media/marda/TWOTB1/xBD/hurricanes/images/florence/hurricane-florence_00000019_post_disaster.png,114,84,1,752,866,831,915,1926,98.56182621720386,28.415520786139993
17488,/media/marda/TWOTB1/xBD/hurricanes/images/florence/hurricane-florence_00000019_post_disaster.png,61,56,1,578,639,835,891,642,41.533745701713066,20.551227279757107
17489,/media/marda/TWOTB1/xBD/hurricanes/images/florence/hurricane-florence_00000019_post_disaster.png,82,67,1,861,943,838,905,1066,49.90185780098848,27.929463638464036
17490,/media/marda/TWOTB1/xBD/hurricanes/images/florence/hurricane-florence_00000019_post_disaster.png,64,53,1,687,751,848,901,467,38.027766747479006,16.392006115453515
17491,/media/marda/TWOTB1/xBD/hurricanes/images/florence/hurricane-florence_00000019_post_disaster.png,53,51,1,647,700,861,912,415,31.484109490540437,17.623990806262828
17492,/media/marda/TWOTB1/xBD/hurricanes/images/florence/hurricane-florence_00000019_post_disaster.png,62,56,1,574,636,862,918,705,42.7086943306304,22.20513383853053
17493,/media/marda/TWOTB1/xBD/hurricanes/images/florence/hurricane-florence_00000019_post_disaster.png,75,64,1,856,931,865,929,768,41.24875413940965,24.863767787952046
17494,/media/marda/TWOTB1/xBD/hurricanes/images/florence/hurricane-florence_00000019_post_disaster.png,53,53,1,687,740,875,928,373,26.612130854886118,18.767401710218103
17495,/media/marda/TWOTB1/xBD/hurricanes/images/florence/hurricane-florence_00000019_post_disaster.png,76,63,1,785,861,877,940,919,46.76659682646478,26.077940669284978
17496,/media/marda/TWOTB1/xBD/hurricanes/images/florence/hurricane-florence_00000019_post_disaster.png,67,86,1,564,631,885,971,1596,54.341637717474136,42.1791190100178
17497,/media/marda/TWOTB1/xBD/hurricanes/images/florence/hurricane-florence_00000019_post_disaster.png,52,55,1,643,695,887,942,442,31.588198044573666,18.595308730736832
17498,/media/marda/TWOTB1/xBD/hurricanes/images/florence/hurricane-florence_00000019_post_disaster.png,77,66,1,847,924,890,956,829,42.52130206315368,25.64660423686403
17499,/media/marda/TWOTB1/xBD/hurricanes/images/florence/hurricane-florence_00000019_post_disaster.png,66,62,1,674,740,902,964,699,42.34941952301421,22.078628148416872
17500,/media/marda/TWOTB1/xBD/hurricanes/images/florence/hurricane-florence_00000019_post_disaster.png,74,62,1,780,854,909,971,842,47.36542911078107,23.382354098901693
17501,/media/marda/TWOTB1/xBD/hurricanes/images/florence/hurricane-florence_00000019_post_disaster.png,62,56,1,339,401,912,968,859,56.685874631365365,20.258122110911657
17502,/media/marda/TWOTB1/xBD/hurricanes/images/florence/hurricane-florence_00000019_post_disaster.png,55,68,1,258,313,914,982,879,45.466704366599,25.819284947798867
17503,/media/marda/TWOTB1/xBD/hurricanes/images/florence/hurricane-florence_00000019_post_disaster.png,53,56,1,641,694,914,970,489,32.95216761139099,19.633253829713244
17504,/media/marda/TWOTB1/xBD/hurricanes/images/florence/hurricane-florence_00000019_post_disaster.png,75,63,1,732,807,919,982,951,49.119516125846665,25.353482259209144
17505,/media/marda/TWOTB1/xBD/hurricanes/images/florence/hurricane-florence_00000019_post_disaster.png,78,66,1,840,918,920,986,1003,45.05790233222477,29.193980144148156
17506,/media/marda/TWOTB1/xBD/hurricanes/images/florence/hurricane-florence_00000019_post_disaster.png,67,56,1,672,739,935,991,729,46.74494506141094,20.766761952333702
17507,/media/marda/TWOTB1/xBD/hurricanes/images/florence/hurricane-florence_00000019_post_disaster.png,68,86,1,557,625,936,1022,1674,56.520044814361775,42.72051968105343
17508,/media/marda/TWOTB1/xBD/hurricanes/images/florence/hurricane-florence_00000019_post_disaster.png,60,57,1,629,689,939,996,591,38.28956385501362,20.701576570871723
17509,/media/marda/TWOTB1/xBD/hurricanes/images/florence/hurricane-florence_00000019_post_disaster.png,121,74,1,731,852,939,1013,1998,106.9125036817769,29.158634859082742
17510,/media/marda/TWOTB1/xBD/hurricanes/images/florence/hurricane-florence_00000019_post_disaster.png,85,64,1,835,920,954,1018,1160,55.564213582840836,27.37760070363848
17511,/media/marda/TWOTB1/xBD/hurricanes/images/florence/hurricane-florence_00000019_post_disaster.png,69,60,1,665,734,961,1021,838,44.99382148320715,24.973664895135222
17512,/media/marda/TWOTB1/xBD/hurricanes/images/florence/hurricane-florence_00000019_post_disaster.png,60,57,1,333,393,964,1021,778,51.472730570313544,21.243766166826045
17513,/media/marda/TWOTB1/xBD/hurricanes/images/florence/hurricane-florence_00000019_post_disaster.png,57,59,1,631,688,966,1025,571,34.192485567375904,21.740907407521544
17514,/media/marda/TWOTB1/xBD/hurricanes/images/florence/hurricane-florence_00000019_post_disaster.png,113,71,1,733,846,970,1041,1825,95.70886480829935,27.36608048026286
17515,/media/marda/TWOTB1/xBD/hurricanes/images/florence/hurricane-florence_00000019_post_disaster.png,80,62,1,844,924,981,1043,864,51.1680794825575,22.468697966156984
17516,/media/marda/TWOTB1/xBD/hurricanes/images/florence/hurricane-florence_00000019_post_disaster.png,66,58,1,668,734,985,1043,609,44.05344496766347,18.279391958217037
17517,/media/marda/TWOTB1/xBD/hurricanes/images/florence/hurricane-florence_00000019_post_disaster.png,64,55,1,552,616,988,1043,594,45.83779595869214,17.126702067230106
17518,/media/marda/TWOTB1/xBD/hurricanes/images/florence/hurricane-florence_00000019_post_disaster.png,67,54,1,621,688,989,1043,383,42.906764199899015,12.630526415332053
17519,/media/marda/TWOTB1/xBD/hurricanes/images/florence/hurricane-florence_00000019_post_disaster.png,41,49,1,332,373,994,1043,251,32.24938371462856,10.331996825066494
17520,/media/marda/TWOTB1/xBD/hurricanes/images/florence/hurricane-florence_00000352_pre_disaster.png,40,26,1,171,211,0,26,739,35.59072302685607,27.73413441124394
17521,/media/marda/TWOTB1/xBD/hurricanes/images/florence/hurricane-florence_00000352_pre_disaster.png,188,52,1,361,549,0,52,4022,173.18110881023716,42.96756007969772
17522,/media/marda/TWOTB1/xBD/hurricanes/images/florence/hurricane-florence_00000352_pre_disaster.png,105,56,1,740,845,0,56,2296,69.69082190424423,47.32996044305993
17523,/media/marda/TWOTB1/xBD/hurricanes/images/florence/hurricane-florence_00000352_pre_disaster.png,94,112,1,712,806,76,188,3982,121.21358931366233,43.814941583592635
17524,/media/marda/TWOTB1/xBD/hurricanes/images/florence/hurricane-florence_00000352_pre_disaster.png,96,69,1,76,172,153,222,4315,98.95545327418824,57.52236532085631
17525,/media/marda/TWOTB1/xBD/hurricanes/images/florence/hurricane-florence_00000352_pre_disaster.png,74,110,1,589,663,212,322,2761,92.44635808132942,44.12621245556522
17526,/media/marda/TWOTB1/xBD/hurricanes/images/florence/hurricane-florence_00000352_pre_disaster.png,38,26,1,462,500,239,265,243,21.035503208699232,15.039522721839687
17527,/media/marda/TWOTB1/xBD/hurricanes/images/florence/hurricane-florence_00000352_pre_disaster.png,21,31,1,67,88,275,306,242,22.900987496671853,14.127617540121596
17528,/media/marda/TWOTB1/xBD/hurricanes/images/florence/hurricane-florence_00000352_pre_disaster.png,75,54,1,9,84,306,360,1932,68.2823079436978,38.60365864508905
17529,/media/marda/TWOTB1/xBD/hurricanes/images/florence/hurricane-florence_00000352_pre_disaster.png,116,98,1,399,515,395,493,3875,101.34323277020412,51.002867439625824
17530,/media/marda/TWOTB1/xBD/hurricanes/images/florence/hurricane-florence_00000352_pre_disaster.png,57,79,1,164,221,412,491,1773,67.91181092736089,35.33478494322828
17531,/media/marda/TWOTB1/xBD/hurricanes/images/florence/hurricane-florence_00000352_pre_disaster.png,52,66,1,62,114,417,483,1584,47.993763684640165,44.03823634503984
17532,/media/marda/TWOTB1/xBD/hurricanes/images/florence/hurricane-florence_00000352_pre_disaster.png,44,47,1,271,315,574,621,582,35.985519326395675,21.585023592971183
17533,/media/marda/TWOTB1/xBD/hurricanes/images/florence/hurricane-florence_00000352_pre_disaster.png,62,68,1,293,355,651,719,1323,47.21611088187247,39.118221409152184
17534,/media/marda/TWOTB1/xBD/hurricanes/images/florence/hurricane-florence_00000352_pre_disaster.png,24,36,1,359,383,686,722,91,13.146946016038266,9.193999426232534
17535,/media/marda/TWOTB1/xBD/hurricanes/images/florence/hurricane-florence_00000352_pre_disaster.png,27,60,1,109,136,691,751,468,33.04165273948453,18.629947846448584
17536,/media/marda/TWOTB1/xBD/hurricanes/images/florence/hurricane-florence_00000352_pre_disaster.png,109,90,1,261,370,740,830,3174,107.9063044806617,39.27060006199489
17537,/media/marda/TWOTB1/xBD/hurricanes/images/florence/hurricane-florence_00000352_pre_disaster.png,218,160,1,826,1044,817,977,15140,194.57962461589992,107.48670672973152
17538,/media/marda/TWOTB1/xBD/hurricanes/images/florence/hurricane-florence_00000352_pre_disaster.png,63,81,1,182,245,837,918,1291,60.22724157915681,28.927605989323492
17539,/media/marda/TWOTB1/xBD/hurricanes/images/florence/hurricane-florence_00000352_pre_disaster.png,36,58,1,113,149,890,948,258,39.12130856404113,8.709342314730298
17540,/media/marda/TWOTB1/xBD/hurricanes/images/florence/hurricane-florence_00000352_pre_disaster.png,13,49,1,23,36,908,957,113,13.127366105761585,11.580561800014761
17541,/media/marda/TWOTB1/xBD/hurricanes/images/florence/hurricane-florence_00000352_pre_disaster.png,62,105,1,413,475,937,1042,1448,78.22110715799448,26.317350730617296
17542,/media/marda/TWOTB1/xBD/hurricanes/images/florence/hurricane-florence_00000352_pre_disaster.png,30,56,1,41,71,952,1008,257,36.08389625544336,9.27368226276682
17543,/media/marda/TWOTB1/xBD/hurricanes/images/florence/hurricane-florence_00000352_pre_disaster.png,50,82,1,349,399,952,1034,1018,45.3788390986512,29.94067356946789
17544,/media/marda/TWOTB1/xBD/hurricanes/images/florence/hurricane-florence_00000352_pre_disaster.png,44,59,1,19,63,961,1020,508,43.336974516328645,18.15118819496586
17545,/media/marda/TWOTB1/xBD/hurricanes/images/florence/hurricane-florence_00000352_pre_disaster.png,74,54,1,717,791,990,1044,355,42.685734367867404,12.115671581117644
17546,/media/marda/TWOTB1/xBD/hurricanes/images/florence/hurricane-florence_00000223_pre_disaster.png,89,61,1,426,515,0,61,3493,71.50666338507736,66.14249334431085
17547,/media/marda/TWOTB1/xBD/hurricanes/images/florence/hurricane-florence_00000223_pre_disaster.png,44,32,1,109,153,22,54,835,40.42143588231097,27.40338179805443
17548,/media/marda/TWOTB1/xBD/hurricanes/images/florence/hurricane-florence_00000223_pre_disaster.png,51,87,1,53,104,67,154,2578,97.46561833828665,35.94291549642129
17549,/media/marda/TWOTB1/xBD/hurricanes/images/florence/hurricane-florence_00000223_pre_disaster.png,100,66,1,427,527,144,210,4555,91.9749933019247,66.07622534756327
17550,/media/marda/TWOTB1/xBD/hurricanes/images/florence/hurricane-florence_00000223_pre_disaster.png,100,68,1,117,217,177,245,4085,97.0123901440652,58.00150972064896
17551,/media/marda/TWOTB1/xBD/hurricanes/images/florence/hurricane-florence_00000223_pre_disaster.png,14,21,1,0,14,197,218,212,17.51974892113652,16.2016159689238
17552,/media/marda/TWOTB1/xBD/hurricanes/images/florence/hurricane-florence_00000223_pre_disaster.png,36,37,1,369,405,261,298,468,27.553016299573983,22.614204876291634
17553,/media/marda/TWOTB1/xBD/hurricanes/images/florence/hurricane-florence_00000223_pre_disaster.png,59,71,1,0,59,349,420,1980,63.729837323683924,46.445644256565394
17554,/media/marda/TWOTB1/xBD/hurricanes/images/florence/hurricane-florence_00000223_pre_disaster.png,19,38,1,116,135,359,397,224,28.841398249280758,10.368772268350563
17555,/media/marda/TWOTB1/xBD/hurricanes/images/florence/hurricane-florence_00000223_pre_disaster.png,81,54,1,184,265,372,426,2154,82.96851224162744,34.4708546758846
17556,/media/marda/TWOTB1/xBD/hurricanes/images/florence/hurricane-florence_00000223_pre_disaster.png,24,30,1,162,186,373,403,268,20.857220160382273,16.932675727764867
17557,/media/marda/TWOTB1/xBD/hurricanes/images/florence/hurricane-florence_00000223_pre_disaster.png,22,29,1,204,226,410,439,126,14.271062275796194,11.913189459907384
17558,/media/marda/TWOTB1/xBD/hurricanes/images/florence/hurricane-florence_00000223_pre_disaster.png,146,112,1,487,633,515,627,7038,120.41437547201639,81.02045918720314
17559,/media/marda/TWOTB1/xBD/hurricanes/images/florence/hurricane-florence_00000223_pre_disaster.png,48,71,1,169,217,633,704,1427,46.30750203792767,41.30401077726982
17560,/media/marda/TWOTB1/xBD/hurricanes/images/florence/hurricane-florence_00000223_pre_disaster.png,65,112,1,237,302,697,809,2703,86.9259873852381,43.085018260524336
17561,/media/marda/TWOTB1/xBD/hurricanes/images/florence/hurricane-florence_00000223_pre_disaster.png,60,42,1,773,833,763,805,189,33.92845547774589,7.4704438115621805
17562,/media/marda/TWOTB1/xBD/hurricanes/images/florence/hurricane-florence_00000223_pre_disaster.png,70,89,1,115,185,773,862,2278,72.83103355442034,48.58252789539543
17563,/media/marda/TWOTB1/xBD/hurricanes/images/florence/hurricane-florence_00000223_pre_disaster.png,155,158,1,554,709,773,931,11829,135.38949633862225,116.8059572144896
17564,/media/marda/TWOTB1/xBD/hurricanes/images/florence/hurricane-florence_00000223_pre_disaster.png,56,43,1,780,836,773,816,199,28.704582452135977,9.309911688885968
17565,/media/marda/TWOTB1/xBD/hurricanes/images/florence/hurricane-florence_00000223_pre_disaster.png,55,42,1,782,837,784,826,180,28.169881352105907,8.57089573755733
17566,/media/marda/TWOTB1/xBD/hurricanes/images/florence/hurricane-florence_00000223_pre_disaster.png,60,46,1,780,840,792,838,161,34.42357944047025,6.286930270656616
17567,/media/marda/TWOTB1/xBD/hurricanes/images/florence/hurricane-florence_00000223_pre_disaster.png,60,47,1,783,843,803,850,178,34.45792237263524,6.949537761146359
17568,/media/marda/TWOTB1/xBD/hurricanes/images/florence/hurricane-florence_00000223_pre_disaster.png,52,94,1,298,350,881,975,1719,66.15410874445315,37.00220588382764
17569,/media/marda/TWOTB1/xBD/hurricanes/images/florence/hurricane-florence_00000223_pre_disaster.png,113,74,1,626,739,897,971,1771,93.08741438090053,25.438343555246895
17570,/media/marda/TWOTB1/xBD/hurricanes/images/florence/hurricane-florence_00000223_pre_disaster.png,92,87,1,45,137,923,1010,2532,93.39489386864862,42.05247973718014
17571,/media/marda/TWOTB1/xBD/hurricanes/images/florence/hurricane-florence_00000223_pre_disaster.png,55,66,1,266,321,961,1027,815,48.174448758667005,22.50030571908606
17572,/media/marda/TWOTB1/xBD/hurricanes/images/florence/hurricane-florence_00000117_post_disaster.png,40,54,1,329,369,533,587,564,32.20444580157956,23.397247441539538
17573,/media/marda/TWOTB1/xBD/hurricanes/images/florence/hurricane-florence_00000117_post_disaster.png,50,84,1,207,257,559,643,1662,67.16866466315192,32.63933068664627
17574,/media/marda/TWOTB1/xBD/hurricanes/images/florence/hurricane-florence_00000117_post_disaster.png,43,56,1,420,463,568,624,580,41.31043474471465,19.6729729495755
17575,/media/marda/TWOTB1/xBD/hurricanes/images/florence/hurricane-florence_00000117_post_disaster.png,100,52,1,335,435,613,665,1018,93.78956828131278,20.148673822200383
17576,/media/marda/TWOTB1/xBD/hurricanes/images/florence/hurricane-florence_00000117_post_disaster.png,47,57,1,345,392,640,697,739,35.40010800953065,27.735652931329792
17577,/media/marda/TWOTB1/xBD/hurricanes/images/florence/hurricane-florence_00000117_post_disaster.png,43,73,1,280,323,650,723,1088,50.72401851488102,28.89070189929651
17578,/media/marda/TWOTB1/xBD/hurricanes/images/florence/hurricane-florence_00000396_post_disaster.png,65,36,1,900,965,407,443,506,30.91851764308536,21.563342983458508
17579,/media/marda/TWOTB1/xBD/hurricanes/images/florence/hurricane-florence_00000396_post_disaster.png,56,56,1,987,1043,409,465,545,42.78917511134725,16.89083579566951
17580,/media/marda/TWOTB1/xBD/hurricanes/images/florence/hurricane-florence_00000396_post_disaster.png,89,41,1,847,936,444,485,806,57.74720225243982,20.981582931541336
17581,/media/marda/TWOTB1/xBD/hurricanes/images/florence/hurricane-florence_00000396_post_disaster.png,55,29,1,822,877,566,595,197,25.335378305971016,10.194603401615229
17582,/media/marda/TWOTB1/xBD/hurricanes/images/florence/hurricane-florence_00000396_post_disaster.png,53,54,1,844,897,584,638,513,37.685006613874066,21.31656960804985
17583,/media/marda/TWOTB1/xBD/hurricanes/images/florence/hurricane-florence_00000396_post_disaster.png,52,54,1,810,862,606,660,557,33.021941240776734,22.383997414639698
17584,/media/marda/TWOTB1/xBD/hurricanes/images/florence/hurricane-florence_00000396_post_disaster.png,72,55,1,830,902,739,794,751,42.2379373570083,24.061059532111674
17585,/media/marda/TWOTB1/xBD/hurricanes/images/florence/hurricane-florence_00000396_post_disaster.png,40,67,1,474,514,798,865,712,38.47894003133222,24.70886041644074
17586,/media/marda/TWOTB1/xBD/hurricanes/images/florence/hurricane-florence_00000396_post_disaster.png,78,71,1,873,951,918,989,810,46.24659545772024,23.29207487130181
17587,/media/marda/TWOTB1/xBD/hurricanes/images/florence/hurricane-florence_00000396_post_disaster.png,70,68,1,853,923,950,1018,608,32.93474278259581,24.762662365240338
17588,/media/marda/TWOTB1/xBD/hurricanes/images/florence/hurricane-florence_00000385_pre_disaster.png,50,40,1,392,442,0,40,905,43.276163212925105,30.319908296505684
17589,/media/marda/TWOTB1/xBD/hurricanes/images/florence/hurricane-florence_00000385_pre_disaster.png,74,48,1,918,992,12,60,1081,48.42875056697187,30.227154420187833
17590,/media/marda/TWOTB1/xBD/hurricanes/images/florence/hurricane-florence_00000385_pre_disaster.png,39,23,1,350,389,17,40,363,24.814262738203478,20.12264791327982
17591,/media/marda/TWOTB1/xBD/hurricanes/images/florence/hurricane-florence_00000385_pre_disaster.png,40,25,1,324,364,20,45,361,27.812647373076455,17.692335056453587
17592,/media/marda/TWOTB1/xBD/hurricanes/images/florence/hurricane-florence_00000385_pre_disaster.png,31,16,1,374,405,27,43,182,18.00717520567534,13.281366734511968
17593,/media/marda/TWOTB1/xBD/hurricanes/images/florence/hurricane-florence_00000385_pre_disaster.png,47,28,1,433,480,48,76,513,31.14666901833223,21.65341593093476
17594,/media/marda/TWOTB1/xBD/hurricanes/images/florence/hurricane-florence_00000385_pre_disaster.png,50,30,1,382,432,73,103,524,38.30589155508015,18.68899897424522
17595,/media/marda/TWOTB1/xBD/hurricanes/images/florence/hurricane-florence_00000385_pre_disaster.png,39,36,1,465,504,198,234,417,32.74174361611718,17.450406396939005
17596,/media/marda/TWOTB1/xBD/hurricanes/images/florence/hurricane-florence_00000385_pre_disaster.png,45,23,1,999,1044,228,251,47,14.522679769094328,4.708993017587165
17597,/media/marda/TWOTB1/xBD/hurricanes/images/florence/hurricane-florence_00000385_pre_disaster.png,56,51,1,311,367,770,821,447,50.38322425000803,12.008124692155416
17598,/media/marda/TWOTB1/xBD/hurricanes/images/florence/hurricane-florence_00000385_pre_disaster.png,229,226,1,811,1040,781,1007,23496,187.77880612151452,167.51923532864447
17599,/media/marda/TWOTB1/xBD/hurricanes/images/florence/hurricane-florence_00000385_pre_disaster.png,42,88,1,337,379,831,919,1272,62.366013585226234,27.2191661087282
17600,/media/marda/TWOTB1/xBD/hurricanes/images/florence/hurricane-florence_00000385_pre_disaster.png,23,44,1,172,195,869,913,204,21.447519792748427,12.7077602433659
17601,/media/marda/TWOTB1/xBD/hurricanes/images/florence/hurricane-florence_00000385_pre_disaster.png,62,65,1,184,246,895,960,1243,63.83045539803864,26.833691190085343
17602,/media/marda/TWOTB1/xBD/hurricanes/images/florence/hurricane-florence_00000385_pre_disaster.png,44,81,1,386,430,934,1015,616,51.00580467422081,16.046085893460777
17603,/media/marda/TWOTB1/xBD/hurricanes/images/florence/hurricane-florence_00000385_pre_disaster.png,57,54,1,313,370,957,1011,542,51.77935292734332,14.018521988156499
17604,/media/marda/TWOTB1/xBD/hurricanes/images/florence/hurricane-florence_00000385_pre_disaster.png,54,54,1,260,314,963,1017,501,51.49029909140734,13.010728554750207
17605,/media/marda/TWOTB1/xBD/hurricanes/images/florence/hurricane-florence_00000385_pre_disaster.png,130,67,1,914,1044,975,1042,1472,89.24170532415543,25.371498317341302
17606,/media/marda/TWOTB1/xBD/hurricanes/images/florence/hurricane-florence_00000385_pre_disaster.png,63,62,1,370,433,982,1044,599,54.6621622106285,14.5832708552094
17607,/media/marda/TWOTB1/xBD/hurricanes/images/florence/hurricane-florence_00000385_pre_disaster.png,27,59,1,260,287,985,1044,247,21.384885524800183,15.214673536406508
17608,/media/marda/TWOTB1/xBD/hurricanes/images/florence/hurricane-florence_00000385_pre_disaster.png,27,57,1,239,266,987,1044,206,19.76326743662281,13.970685809959534
17609,/media/marda/TWOTB1/xBD/hurricanes/images/florence/hurricane-florence_00000385_pre_disaster.png,23,52,1,221,244,992,1044,135,14.75768511577404,12.053630852061254
17610,/media/marda/TWOTB1/xBD/hurricanes/images/florence/hurricane-florence_00000510_pre_disaster.png,35,17,1,248,283,26,43,256,29.39400761310076,11.665666522978848
17611,/media/marda/TWOTB1/xBD/hurricanes/images/florence/hurricane-florence_00000510_pre_disaster.png,55,38,1,35,90,31,69,1138,56.83006652144334,31.56403580797727
17612,/media/marda/TWOTB1/xBD/hurricanes/images/florence/hurricane-florence_00000510_pre_disaster.png,26,18,1,173,199,41,59,202,19.06449808616007,14.190155708656107
17613,/media/marda/TWOTB1/xBD/hurricanes/images/florence/hurricane-florence_00000510_pre_disaster.png,52,28,1,130,182,54,82,971,53.24796474134819,24.58366905067191
17614,/media/marda/TWOTB1/xBD/hurricanes/images/florence/hurricane-florence_00000510_pre_disaster.png,51,30,1,226,277,68,98,926,45.48712285018794,27.2170525201757
17615,/media/marda/TWOTB1/xBD/hurricanes/images/florence/hurricane-florence_00000510_pre_disaster.png,25,16,1,183,208,77,93,220,19.86074639902761,14.856192478318613
17616,/media/marda/TWOTB1/xBD/hurricanes/images/florence/hurricane-florence_00000510_pre_disaster.png,50,18,1,319,369,81,99,446,42.12389092536788,15.706411709182998
17617,/media/marda/TWOTB1/xBD/hurricanes/images/florence/hurricane-florence_00000510_pre_disaster.png,83,37,1,315,398,109,146,1397,76.37251878280416,24.537074803930654
17618,/media/marda/TWOTB1/xBD/hurricanes/images/florence/hurricane-florence_00000510_pre_disaster.png,51,37,1,172,223,193,230,1041,47.768289066540234,28.82422125689776
17619,/media/marda/TWOTB1/xBD/hurricanes/images/florence/hurricane-florence_00000510_pre_disaster.png,54,41,1,72,126,196,237,1208,56.117035633841795,29.335021388512864
17620,/media/marda/TWOTB1/xBD/hurricanes/images/florence/hurricane-florence_00000510_pre_disaster.png,50,41,1,271,321,209,250,902,38.781274977856654,30.892841966458267
17621,/media/marda/TWOTB1/xBD/hurricanes/images/florence/hurricane-florence_00000510_pre_disaster.png,53,39,1,321,374,221,260,812,41.6344278054369,26.039631280827525
17622,/media/marda/TWOTB1/xBD/hurricanes/images/florence/hurricane-florence_00000510_pre_disaster.png,22,20,1,72,94,236,256,184,24.47599685991227,10.106650621609944
17623,/media/marda/TWOTB1/xBD/hurricanes/images/florence/hurricane-florence_00000510_pre_disaster.png,58,40,1,512,570,247,287,658,37.79648538481649,23.239669264207706
17624,/media/marda/TWOTB1/xBD/hurricanes/images/florence/hurricane-florence_00000510_pre_disaster.png,36,21,1,277,313,248,269,254,29.07791756343444,11.869708800331397
17625,/media/marda/TWOTB1/xBD/hurricanes/images/florence/hurricane-florence_00000510_pre_disaster.png,21,22,1,221,242,263,285,94,13.536861570625614,9.361997427846049
17626,/media/marda/TWOTB1/xBD/hurricanes/images/florence/hurricane-florence_00000510_pre_disaster.png,57,55,1,664,721,264,319,616,52.869137238257096,15.517607390240727
17627,/media/marda/TWOTB1/xBD/hurricanes/images/florence/hurricane-florence_00000510_pre_disaster.png,74,34,1,721,795,270,304,1017,51.762594950730104,25.987736494659515
17628,/media/marda/TWOTB1/xBD/hurricanes/images/florence/hurricane-florence_00000510_pre_disaster.png,26,22,1,230,256,271,293,151,17.059097650665972,11.906409699508954
17629,/media/marda/TWOTB1/xBD/hurricanes/images/florence/hurricane-florence_00000510_pre_disaster.png,36,25,1,486,522,275,300,184,17.06290405419585,14.467763819104787
17630,/media/marda/TWOTB1/xBD/hurricanes/images/florence/hurricane-florence_00000510_pre_disaster.png,89,45,1,797,886,299,344,1471,60.99424664635034,31.611719877896068
17631,/media/marda/TWOTB1/xBD/hurricanes/images/florence/hurricane-florence_00000510_pre_disaster.png,83,41,1,901,984,307,348,1116,50.80191498908876,29.0065478672734
17632,/media/marda/TWOTB1/xBD/hurricanes/images/florence/hurricane-florence_00000510_pre_disaster.png,65,46,1,899,964,335,381,855,36.62369502622577,31.183261790261753
17633,/media/marda/TWOTB1/xBD/hurricanes/images/florence/hurricane-florence_00000510_pre_disaster.png,74,45,1,849,923,366,411,734,39.237636339696195,28.159923200019627
17634,/media/marda/TWOTB1/xBD/hurricanes/images/florence/hurricane-florence_00000510_pre_disaster.png,41,20,1,760,801,379,399,80,15.270429762611217,7.0720559150191615
17635,/media/marda/TWOTB1/xBD/hurricanes/images/florence/hurricane-florence_00000510_pre_disaster.png,57,34,1,825,882,423,457,289,27.01972081827387,14.212945444587888
17636,/media/marda/TWOTB1/xBD/hurricanes/images/florence/hurricane-florence_00000510_pre_disaster.png,53,42,1,832,885,449,491,369,25.045288946479626,19.596472298766326
17637,/media/marda/TWOTB1/xBD/hurricanes/images/florence/hurricane-florence_00000510_pre_disaster.png,66,65,1,299,365,578,643,1220,54.99083246284226,29.132391330714167
17638,/media/marda/TWOTB1/xBD/hurricanes/images/florence/hurricane-florence_00000510_post_disaster.png,35,17,1,248,283,26,43,256,29.39400761310076,11.665666522978848
17639,/media/marda/TWOTB1/xBD/hurricanes/images/florence/hurricane-florence_00000510_post_disaster.png,55,38,1,35,90,31,69,1138,56.83006652144334,31.56403580797727
17640,/media/marda/TWOTB1/xBD/hurricanes/images/florence/hurricane-florence_00000510_post_disaster.png,26,18,1,173,199,41,59,202,19.06449808616007,14.190155708656107
17641,/media/marda/TWOTB1/xBD/hurricanes/images/florence/hurricane-florence_00000510_post_disaster.png,52,28,1,130,182,54,82,971,53.24796474134819,24.58366905067191
17642,/media/marda/TWOTB1/xBD/hurricanes/images/florence/hurricane-florence_00000510_post_disaster.png,51,30,1,226,277,68,98,926,45.48712285018794,27.2170525201757
17643,/media/marda/TWOTB1/xBD/hurricanes/images/florence/hurricane-florence_00000510_post_disaster.png,25,16,1,183,208,77,93,220,19.86074639902761,14.856192478318613
17644,/media/marda/TWOTB1/xBD/hurricanes/images/florence/hurricane-florence_00000510_post_disaster.png,50,18,1,319,369,81,99,446,42.12389092536788,15.706411709182998
17645,/media/marda/TWOTB1/xBD/hurricanes/images/florence/hurricane-florence_00000510_post_disaster.png,83,37,1,315,398,109,146,1397,76.37251878280416,24.537074803930654
17646,/media/marda/TWOTB1/xBD/hurricanes/images/florence/hurricane-florence_00000510_post_disaster.png,51,37,1,172,223,193,230,1041,47.768289066540234,28.82422125689776
17647,/media/marda/TWOTB1/xBD/hurricanes/images/florence/hurricane-florence_00000510_post_disaster.png,54,41,1,72,126,196,237,1208,56.117035633841795,29.335021388512864
17648,/media/marda/TWOTB1/xBD/hurricanes/images/florence/hurricane-florence_00000510_post_disaster.png,50,41,1,271,321,209,250,902,38.781274977856654,30.892841966458267
17649,/media/marda/TWOTB1/xBD/hurricanes/images/florence/hurricane-florence_00000510_post_disaster.png,53,39,1,321,374,221,260,812,41.6344278054369,26.039631280827525
17650,/media/marda/TWOTB1/xBD/hurricanes/images/florence/hurricane-florence_00000510_post_disaster.png,22,20,1,72,94,236,256,184,24.47599685991227,10.106650621609944
17651,/media/marda/TWOTB1/xBD/hurricanes/images/florence/hurricane-florence_00000510_post_disaster.png,58,40,1,512,570,247,287,658,37.79648538481649,23.239669264207706
17652,/media/marda/TWOTB1/xBD/hurricanes/images/florence/hurricane-florence_00000510_post_disaster.png,36,21,1,277,313,248,269,254,29.07791756343444,11.869708800331397
17653,/media/marda/TWOTB1/xBD/hurricanes/images/florence/hurricane-florence_00000510_post_disaster.png,21,22,1,221,242,263,285,94,13.536861570625614,9.361997427846049
17654,/media/marda/TWOTB1/xBD/hurricanes/images/florence/hurricane-florence_00000510_post_disaster.png,57,55,1,664,721,264,319,616,52.869137238257096,15.517607390240727
17655,/media/marda/TWOTB1/xBD/hurricanes/images/florence/hurricane-florence_00000510_post_disaster.png,74,34,1,721,795,270,304,1017,51.762594950730104,25.987736494659515
17656,/media/marda/TWOTB1/xBD/hurricanes/images/florence/hurricane-florence_00000510_post_disaster.png,26,22,1,230,256,271,293,151,17.059097650665972,11.906409699508954
17657,/media/marda/TWOTB1/xBD/hurricanes/images/florence/hurricane-florence_00000510_post_disaster.png,89,45,1,797,886,299,344,1471,60.99424664635034,31.611719877896068
17658,/media/marda/TWOTB1/xBD/hurricanes/images/florence/hurricane-florence_00000510_post_disaster.png,83,41,1,901,984,307,348,1116,50.80191498908876,29.0065478672734
17659,/media/marda/TWOTB1/xBD/hurricanes/images/florence/hurricane-florence_00000510_post_disaster.png,65,46,1,899,964,335,381,855,36.62369502622577,31.183261790261753
17660,/media/marda/TWOTB1/xBD/hurricanes/images/florence/hurricane-florence_00000510_post_disaster.png,74,45,1,849,923,366,411,734,39.237636339696195,28.159923200019627
17661,/media/marda/TWOTB1/xBD/hurricanes/images/florence/hurricane-florence_00000510_post_disaster.png,41,20,1,760,801,379,399,80,15.270429762611217,7.0720559150191615
17662,/media/marda/TWOTB1/xBD/hurricanes/images/florence/hurricane-florence_00000510_post_disaster.png,57,34,1,825,882,423,457,289,27.01972081827387,14.212945444587888
17663,/media/marda/TWOTB1/xBD/hurricanes/images/florence/hurricane-florence_00000510_post_disaster.png,53,42,1,832,885,449,491,369,25.045288946479626,19.596472298766326
17664,/media/marda/TWOTB1/xBD/hurricanes/images/florence/hurricane-florence_00000510_post_disaster.png,66,65,1,299,365,578,643,1220,54.99083246284226,29.132391330714167
17665,/media/marda/TWOTB1/xBD/hurricanes/images/florence/hurricane-florence_00000146_pre_disaster.png,32,46,1,485,517,831,877,96,13.12302077423017,9.854930699525832
17666,/media/marda/TWOTB1/xBD/hurricanes/images/florence/hurricane-florence_00000146_pre_disaster.png,48,46,1,833,881,868,914,129,15.911352478910322,10.901074686704312
17667,/media/marda/TWOTB1/xBD/hurricanes/images/florence/hurricane-florence_00000146_pre_disaster.png,68,87,1,844,912,893,980,1044,50.58899743092093,27.67833732158822
17668,/media/marda/TWOTB1/xBD/hurricanes/images/florence/hurricane-florence_00000146_pre_disaster.png,55,75,1,494,549,900,975,774,34.21895853797386,30.573332200709725
17669,/media/marda/TWOTB1/xBD/hurricanes/images/florence/hurricane-florence_00000239_pre_disaster.png,41,41,1,22,63,58,99,903,38.44875138570964,31.0989900553646
17670,/media/marda/TWOTB1/xBD/hurricanes/images/florence/hurricane-florence_00000239_pre_disaster.png,52,50,1,489,541,125,175,1014,48.19674197645577,28.82772619191171
17671,/media/marda/TWOTB1/xBD/hurricanes/images/florence/hurricane-florence_00000239_pre_disaster.png,47,49,1,244,291,197,246,1371,46.446631079958706,39.23647607577834
17672,/media/marda/TWOTB1/xBD/hurricanes/images/florence/hurricane-florence_00000239_pre_disaster.png,53,51,1,210,263,356,407,1004,39.28234344860685,33.759775361698914
17673,/media/marda/TWOTB1/xBD/hurricanes/images/florence/hurricane-florence_00000239_pre_disaster.png,68,70,1,306,374,658,728,1377,54.043350935945305,34.05460071057081
17674,/media/marda/TWOTB1/xBD/hurricanes/images/florence/hurricane-florence_00000239_pre_disaster.png,45,63,1,301,346,694,757,641,31.14394048150971,27.27402664011868
17675,/media/marda/TWOTB1/xBD/hurricanes/images/florence/hurricane-florence_00000516_post_disaster.png,43,48,1,405,448,614,662,409,26.77038395428104,20.299572668109995
17676,/media/marda/TWOTB1/xBD/hurricanes/images/florence/hurricane-florence_00000516_post_disaster.png,41,50,1,257,298,652,702,573,32.59074656177618,23.505983014415275
17677,/media/marda/TWOTB1/xBD/hurricanes/images/florence/hurricane-florence_00000516_post_disaster.png,42,51,1,429,471,697,748,395,27.41055488786438,19.200767678859314
17678,/media/marda/TWOTB1/xBD/hurricanes/images/florence/hurricane-florence_00000516_post_disaster.png,31,50,1,271,302,762,812,333,22.79982118162068,19.44339566975916
17679,/media/marda/TWOTB1/xBD/hurricanes/images/florence/hurricane-florence_00000516_post_disaster.png,32,46,1,392,424,809,855,116,14.206053510986589,10.968018837605
17680,/media/marda/TWOTB1/xBD/hurricanes/images/florence/hurricane-florence_00000516_post_disaster.png,24,43,1,371,395,813,856,93,12.494889354398172,10.112390579088094
17681,/media/marda/TWOTB1/xBD/hurricanes/images/florence/hurricane-florence_00000516_post_disaster.png,31,45,1,414,445,841,886,135,15.980995022832953,11.38365280420165
17682,/media/marda/TWOTB1/xBD/hurricanes/images/florence/hurricane-florence_00000516_post_disaster.png,26,40,1,473,499,843,883,80,11.489125293076057,9.16515138991168
17683,/media/marda/TWOTB1/xBD/hurricanes/images/florence/hurricane-florence_00000516_post_disaster.png,34,44,1,526,560,853,897,85,12.329467184312398,9.253179581990683
17684,/media/marda/TWOTB1/xBD/hurricanes/images/florence/hurricane-florence_00000516_post_disaster.png,79,62,1,324,403,879,941,1435,74.38553750421636,25.765188424769153
17685,/media/marda/TWOTB1/xBD/hurricanes/images/florence/hurricane-florence_00000516_post_disaster.png,56,58,1,785,841,936,994,536,29.494457300588575,24.258234262010195
17686,/media/marda/TWOTB1/xBD/hurricanes/images/florence/hurricane-florence_00000516_post_disaster.png,33,48,1,552,585,937,985,138,14.51877838798582,12.735505559098298
17687,/media/marda/TWOTB1/xBD/hurricanes/images/florence/hurricane-florence_00000516_post_disaster.png,43,59,1,501,544,940,999,338,26.773721078501488,17.77963569591478
17688,/media/marda/TWOTB1/xBD/hurricanes/images/florence/hurricane-florence_00000516_post_disaster.png,35,56,1,379,414,953,1009,242,20.93607871429652,15.22135869260961
17689,/media/marda/TWOTB1/xBD/hurricanes/images/florence/hurricane-florence_00000516_post_disaster.png,30,45,1,498,528,954,999,67,11.38107194928195,7.6079184951775085
17690,/media/marda/TWOTB1/xBD/hurricanes/images/florence/hurricane-florence_00000516_post_disaster.png,48,68,1,457,505,960,1028,562,27.902528641857128,26.866954368282112
17691,/media/marda/TWOTB1/xBD/hurricanes/images/florence/hurricane-florence_00000516_post_disaster.png,46,66,1,347,393,975,1041,713,32.98383338148915,29.23058433121523
17692,/media/marda/TWOTB1/xBD/hurricanes/images/florence/hurricane-florence_00000473_pre_disaster.png,42,23,1,491,533,81,104,269,22.18944096416541,16.24626381395434
17693,/media/marda/TWOTB1/xBD/hurricanes/images/florence/hurricane-florence_00000473_pre_disaster.png,68,55,1,494,562,107,162,1273,46.28737346115965,39.71124150200342
17694,/media/marda/TWOTB1/xBD/hurricanes/images/florence/hurricane-florence_00000473_pre_disaster.png,40,27,1,441,481,123,150,268,22.145949208679497,16.207753144862398
17695,/media/marda/TWOTB1/xBD/hurricanes/images/florence/hurricane-florence_00000473_pre_disaster.png,82,62,1,784,866,179,241,1491,59.91970613219296,32.949048954057
17696,/media/marda/TWOTB1/xBD/hurricanes/images/florence/hurricane-florence_00000473_pre_disaster.png,55,29,1,770,825,192,221,319,22.664250913141128,18.836300456223185
17697,/media/marda/TWOTB1/xBD/hurricanes/images/florence/hurricane-florence_00000473_pre_disaster.png,44,23,1,701,745,226,249,121,13.51544339039049,11.99522187566951
17698,/media/marda/TWOTB1/xBD/hurricanes/images/florence/hurricane-florence_00000473_pre_disaster.png,46,24,1,717,763,235,259,152,17.45232294737266,11.533322668418268
17699,/media/marda/TWOTB1/xBD/hurricanes/images/florence/hurricane-florence_00000473_pre_disaster.png,57,35,1,724,781,265,300,390,26.13196329198929,19.964894109592517
17700,/media/marda/TWOTB1/xBD/hurricanes/images/florence/hurricane-florence_00000473_pre_disaster.png,30,22,1,546,576,324,346,49,9.453244276508485,7.00037038733998
17701,/media/marda/TWOTB1/xBD/hurricanes/images/florence/hurricane-florence_00000473_pre_disaster.png,73,67,1,616,689,401,468,1277,45.4610556240116,37.24899967831642
17702,/media/marda/TWOTB1/xBD/hurricanes/images/florence/hurricane-florence_00000473_pre_disaster.png,65,65,1,459,524,425,490,1177,55.11678206796301,29.761723343951665
17703,/media/marda/TWOTB1/xBD/hurricanes/images/florence/hurricane-florence_00000473_pre_disaster.png,28,27,1,408,436,433,460,62,11.724167133333351,7.163665163731003
17704,/media/marda/TWOTB1/xBD/hurricanes/images/florence/hurricane-florence_00000473_pre_disaster.png,38,48,1,296,334,657,705,307,24.98976183411362,16.41454533957603
17705,/media/marda/TWOTB1/xBD/hurricanes/images/florence/hurricane-florence_00000473_pre_disaster.png,91,73,1,762,853,665,738,1464,65.63652874699021,31.438128413868416
17706,/media/marda/TWOTB1/xBD/hurricanes/images/florence/hurricane-florence_00000473_pre_disaster.png,57,53,1,833,890,669,722,313,31.19911364210211,13.437179762136752
17707,/media/marda/TWOTB1/xBD/hurricanes/images/florence/hurricane-florence_00000473_pre_disaster.png,33,52,1,292,325,684,736,321,26.471443962923267,16.355033135436635
17708,/media/marda/TWOTB1/xBD/hurricanes/images/florence/hurricane-florence_00000473_pre_disaster.png,65,81,1,340,405,714,795,1375,52.09485975139187,40.19701735300583
17709,/media/marda/TWOTB1/xBD/hurricanes/images/florence/hurricane-florence_00000473_pre_disaster.png,70,82,1,201,271,740,822,1626,60.21366630599287,37.14112179202971
17710,/media/marda/TWOTB1/xBD/hurricanes/images/florence/hurricane-florence_00000473_pre_disaster.png,32,51,1,9,41,741,792,333,34.7647212929958,12.697828830425843
17711,/media/marda/TWOTB1/xBD/hurricanes/images/florence/hurricane-florence_00000473_pre_disaster.png,53,38,1,968,1021,745,783,136,17.386180019647735,10.426675117839974
17712,/media/marda/TWOTB1/xBD/hurricanes/images/florence/hurricane-florence_00000473_pre_disaster.png,37,61,1,57,94,753,814,547,38.83513835357139,18.81714633116823
17713,/media/marda/TWOTB1/xBD/hurricanes/images/florence/hurricane-florence_00000473_pre_disaster.png,91,47,1,887,978,770,817,684,62.10387358466054,14.689846546860771
17714,/media/marda/TWOTB1/xBD/hurricanes/images/florence/hurricane-florence_00000473_pre_disaster.png,86,56,1,762,848,793,849,1178,64.7878736341532,24.27414913468387
17715,/media/marda/TWOTB1/xBD/hurricanes/images/florence/hurricane-florence_00000473_pre_disaster.png,37,63,1,96,133,798,861,639,33.42696566380032,26.24515033552071
17716,/media/marda/TWOTB1/xBD/hurricanes/images/florence/hurricane-florence_00000473_pre_disaster.png,52,73,1,459,511,809,882,901,39.62879006256287,30.297005332455246
17717,/media/marda/TWOTB1/xBD/hurricanes/images/florence/hurricane-florence_00000473_pre_disaster.png,59,91,1,137,196,815,906,1574,56.30607918964654,40.12205591300753
17718,/media/marda/TWOTB1/xBD/hurricanes/images/florence/hurricane-florence_00000473_pre_disaster.png,77,56,1,787,864,820,876,930,48.94715446843678,25.321781565394563
17719,/media/marda/TWOTB1/xBD/hurricanes/images/florence/hurricane-florence_00000473_pre_disaster.png,62,98,1,27,89,840,938,2263,57.92071472993919,51.142677523654655
17720,/media/marda/TWOTB1/xBD/hurricanes/images/florence/hurricane-florence_00000473_pre_disaster.png,54,78,1,97,151,856,934,1224,43.38556523789437,37.81747063430078
17721,/media/marda/TWOTB1/xBD/hurricanes/images/florence/hurricane-florence_00000473_pre_disaster.png,64,91,1,980,1044,903,994,743,53.31559621662995,20.489791979551498
17722,/media/marda/TWOTB1/xBD/hurricanes/images/florence/hurricane-florence_00000473_pre_disaster.png,77,82,1,938,1015,911,993,882,45.67838062838501,25.8858945056025
17723,/media/marda/TWOTB1/xBD/hurricanes/images/florence/hurricane-florence_00000473_pre_disaster.png,80,84,1,862,942,946,1030,1017,54.91306709785069,24.468402814644335
17724,/media/marda/TWOTB1/xBD/hurricanes/images/florence/hurricane-florence_00000091_pre_disaster.png,57,15,1,0,57,0,15,435,55.99542627693717,11.923951537254812
17725,/media/marda/TWOTB1/xBD/hurricanes/images/florence/hurricane-florence_00000091_pre_disaster.png,253,71,1,278,531,0,71,8250,243.01116861622586,47.274600775659756
17726,/media/marda/TWOTB1/xBD/hurricanes/images/florence/hurricane-florence_00000091_pre_disaster.png,82,38,1,546,628,0,38,1084,58.62349735025538,27.28556053391395
17727,/media/marda/TWOTB1/xBD/hurricanes/images/florence/hurricane-florence_00000091_pre_disaster.png,46,10,1,657,703,0,10,106,20.67663437688532,8.226832806655029
17728,/media/marda/TWOTB1/xBD/hurricanes/images/florence/hurricane-florence_00000091_pre_disaster.png,79,25,1,965,1044,0,25,785,42.44228473483119,25.095334221436786
17729,/media/marda/TWOTB1/xBD/hurricanes/images/florence/hurricane-florence_00000091_pre_disaster.png,33,49,1,144,177,25,74,931,50.58468530478874,24.116053806973174
17730,/media/marda/TWOTB1/xBD/hurricanes/images/florence/hurricane-florence_00000091_pre_disaster.png,64,35,1,980,1044,36,71,674,37.080329350268705,24.11056666857262
17731,/media/marda/TWOTB1/xBD/hurricanes/images/florence/hurricane-florence_00000091_pre_disaster.png,21,19,1,9,30,55,74,269,20.23985033829373,17.69551278514126
17732,/media/marda/TWOTB1/xBD/hurricanes/images/florence/hurricane-florence_00000091_pre_disaster.png,68,45,1,704,772,58,103,1198,46.034326695799926,36.03770356395495
17733,/media/marda/TWOTB1/xBD/hurricanes/images/florence/hurricane-florence_00000091_pre_disaster.png,14,11,1,45,59,79,90,118,14.874188292193846,10.531936866066244
17734,/media/marda/TWOTB1/xBD/hurricanes/images/florence/hurricane-florence_00000091_pre_disaster.png,56,32,1,988,1044,88,120,337,31.714399524055388,15.259213813892138
17735,/media/marda/TWOTB1/xBD/hurricanes/images/florence/hurricane-florence_00000091_pre_disaster.png,61,35,1,588,649,91,126,803,37.404137146040696,29.367348232911134
17736,/media/marda/TWOTB1/xBD/hurricanes/images/florence/hurricane-florence_00000091_pre_disaster.png,37,46,1,160,197,99,145,952,46.96627998862811,26.97884011323259
17737,/media/marda/TWOTB1/xBD/hurricanes/images/florence/hurricane-florence_00000091_pre_disaster.png,79,45,1,779,858,103,148,1374,51.16992684252004,36.46274095842974
17738,/media/marda/TWOTB1/xBD/hurricanes/images/florence/hurricane-florence_00000091_pre_disaster.png,17,16,1,16,33,110,126,152,18.33716886770674,11.072771611399018
17739,/media/marda/TWOTB1/xBD/hurricanes/images/florence/hurricane-florence_00000091_pre_disaster.png,79,47,1,715,794,113,160,1338,48.49817868953623,36.20750104713268
17740,/media/marda/TWOTB1/xBD/hurricanes/images/florence/hurricane-florence_00000091_pre_disaster.png,50,48,1,486,536,124,172,963,44.70381684768568,28.916697191475947
17741,/media/marda/TWOTB1/xBD/hurricanes/images/florence/hurricane-florence_00000091_pre_disaster.png,45,34,1,65,110,134,168,830,46.5361294288981,23.676139578540436
17742,/media/marda/TWOTB1/xBD/hurricanes/images/florence/hurricane-florence_00000091_pre_disaster.png,24,41,1,16,40,141,182,569,38.90368241998538,19.230335583999082
17743,/media/marda/TWOTB1/xBD/hurricanes/images/florence/hurricane-florence_00000091_pre_disaster.png,53,38,1,602,655,143,181,611,33.04108521154911,24.702956422528505
17744,/media/marda/TWOTB1/xBD/hurricanes/images/florence/hurricane-florence_00000091_pre_disaster.png,49,45,1,401,450,151,196,935,41.71183166975794,29.221884223186
17745,/media/marda/TWOTB1/xBD/hurricanes/images/florence/hurricane-florence_00000091_pre_disaster.png,74,37,1,798,872,155,192,824,40.7113315804596,28.893158349861622
17746,/media/marda/TWOTB1/xBD/hurricanes/images/florence/hurricane-florence_00000091_pre_disaster.png,7,30,1,0,7,161,191,153,26.980459561394685,7.586055928407552
17747,/media/marda/TWOTB1/xBD/hurricanes/images/florence/hurricane-florence_00000091_pre_disaster.png,45,43,1,363,408,164,207,857,40.90044176701659,27.38266031303097
17748,/media/marda/TWOTB1/xBD/hurricanes/images/florence/hurricane-florence_00000091_pre_disaster.png,29,15,1,437,466,166,181,93,12.846195950743343,9.787361947745703
17749,/media/marda/TWOTB1/xBD/hurricanes/images/florence/hurricane-florence_00000091_pre_disaster.png,52,46,1,495,547,172,218,851,42.665954439121485,26.53070439418099
17750,/media/marda/TWOTB1/xBD/hurricanes/images/florence/hurricane-florence_00000091_pre_disaster.png,41,39,1,306,347,176,215,698,35.110547450814714,26.43478333777896
17751,/media/marda/TWOTB1/xBD/hurricanes/images/florence/hurricane-florence_00000091_pre_disaster.png,55,44,1,616,671,194,238,813,39.65379922896788,27.6811485303624
17752,/media/marda/TWOTB1/xBD/hurricanes/images/florence/hurricane-florence_00000091_pre_disaster.png,26,25,1,351,377,196,221,171,17.469200466617092,12.8717333796918
17753,/media/marda/TWOTB1/xBD/hurricanes/images/florence/hurricane-florence_00000091_pre_disaster.png,57,33,1,816,873,198,231,405,23.793496613132373,22.699042458285618
17754,/media/marda/TWOTB1/xBD/hurricanes/images/florence/hurricane-florence_00000091_pre_disaster.png,37,52,1,191,228,200,252,807,45.705912252317674,23.416261610181245
17755,/media/marda/TWOTB1/xBD/hurricanes/images/florence/hurricane-florence_00000091_pre_disaster.png,27,26,1,376,403,213,239,178,16.92622945688836,13.803494638602693
17756,/media/marda/TWOTB1/xBD/hurricanes/images/florence/hurricane-florence_00000091_pre_disaster.png,43,24,1,756,799,220,244,148,16.565768339215623,12.07450731616935
17757,/media/marda/TWOTB1/xBD/hurricanes/images/florence/hurricane-florence_00000091_pre_disaster.png,52,50,1,513,565,221,271,842,44.924003308385835,24.839648919498952
17758,/media/marda/TWOTB1/xBD/hurricanes/images/florence/hurricane-florence_00000091_pre_disaster.png,77,43,1,814,891,222,265,1051,45.887293056525806,30.343592997256852
17759,/media/marda/TWOTB1/xBD/hurricanes/images/florence/hurricane-florence_00000091_pre_disaster.png,41,43,1,320,361,227,270,699,36.09004857338836,25.696280715674636
17760,/media/marda/TWOTB1/xBD/hurricanes/images/florence/hurricane-florence_00000091_pre_disaster.png,50,46,1,100,150,236,282,1119,45.760627871757066,32.85104492858859
17761,/media/marda/TWOTB1/xBD/hurricanes/images/florence/hurricane-florence_00000091_pre_disaster.png,58,42,1,627,685,240,282,750,34.61350557516854,30.815195930615488
17762,/media/marda/TWOTB1/xBD/hurricanes/images/florence/hurricane-florence_00000091_pre_disaster.png,43,40,1,53,96,250,290,880,44.521283897176595,25.940814135224123
17763,/media/marda/TWOTB1/xBD/hurricanes/images/florence/hurricane-florence_00000091_pre_disaster.png,40,51,1,203,243,252,303,864,42.69728988075193,26.831027476282056
17764,/media/marda/TWOTB1/xBD/hurricanes/images/florence/hurricane-florence_00000091_pre_disaster.png,30,23,1,366,396,253,276,166,18.10371188337111,12.342225004495624
17765,/media/marda/TWOTB1/xBD/hurricanes/images/florence/hurricane-florence_00000091_pre_disaster.png,23,27,1,154,177,263,290,217,17.343962755587825,16.82379268084835
17766,/media/marda/TWOTB1/xBD/hurricanes/images/florence/hurricane-florence_00000091_pre_disaster.png,36,24,1,441,477,264,288,191,19.34017197798771,13.246603676806414
17767,/media/marda/TWOTB1/xBD/hurricanes/images/florence/hurricane-florence_00000091_pre_disaster.png,45,40,1,0,45,266,306,974,47.5651744035309,26.715307931666178
17768,/media/marda/TWOTB1/xBD/hurricanes/images/florence/hurricane-florence_00000091_pre_disaster.png,53,50,1,524,577,269,319,875,41.29068679039529,28.155078988830272
17769,/media/marda/TWOTB1/xBD/hurricanes/images/florence/hurricane-florence_00000091_pre_disaster.png,84,51,1,792,876,271,322,1294,54.337468447543436,32.46615690599926
17770,/media/marda/TWOTB1/xBD/hurricanes/images/florence/hurricane-florence_00000091_pre_disaster.png,50,51,1,331,381,276,327,932,39.25312038133163,33.75478332143212
17771,/media/marda/TWOTB1/xBD/hurricanes/images/florence/hurricane-florence_00000091_pre_disaster.png,54,47,1,633,687,278,325,736,35.91226700930904,27.23372718783308
17772,/media/marda/TWOTB1/xBD/hurricanes/images/florence/hurricane-florence_00000091_pre_disaster.png,76,62,1,838,914,295,357,1430,46.77435261647498,40.49670305696859
17773,/media/marda/TWOTB1/xBD/hurricanes/images/florence/hurricane-florence_00000091_pre_disaster.png,39,51,1,218,257,300,351,767,39.06969392373883,25.975450116246154
17774,/media/marda/TWOTB1/xBD/hurricanes/images/florence/hurricane-florence_00000091_pre_disaster.png,37,32,1,384,421,312,344,294,22.521883613964466,17.512151319630018
17775,/media/marda/TWOTB1/xBD/hurricanes/images/florence/hurricane-florence_00000091_pre_disaster.png,65,73,1,664,729,319,392,1426,64.42337044157023,29.475493807555477
17776,/media/marda/TWOTB1/xBD/hurricanes/images/florence/hurricane-florence_00000091_pre_disaster.png,20,40,1,64,84,320,360,323,28.920370103346155,14.78706757561136
17777,/media/marda/TWOTB1/xBD/hurricanes/images/florence/hurricane-florence_00000091_pre_disaster.png,53,49,1,351,404,328,377,918,38.20180377709047,31.619672366663398
17778,/media/marda/TWOTB1/xBD/hurricanes/images/florence/hurricane-florence_00000091_pre_disaster.png,66,44,1,767,833,330,374,852,39.55914225116585,28.195456798359025
17779,/media/marda/TWOTB1/xBD/hurricanes/images/florence/hurricane-florence_00000091_pre_disaster.png,30,34,1,122,152,337,371,406,27.253734523482027,19.780097358140733
17780,/media/marda/TWOTB1/xBD/hurricanes/images/florence/hurricane-florence_00000091_pre_disaster.png,63,43,1,719,782,342,385,730,34.54999671606689,28.086005042654964
17781,/media/marda/TWOTB1/xBD/hurricanes/images/florence/hurricane-florence_00000091_pre_disaster.png,38,50,1,234,272,352,402,692,38.71350500972023,24.165009414116152
17782,/media/marda/TWOTB1/xBD/hurricanes/images/florence/hurricane-florence_00000091_pre_disaster.png,54,54,1,507,561,376,430,891,43.22958282171835,27.34756934370632
17783,/media/marda/TWOTB1/xBD/hurricanes/images/florence/hurricane-florence_00000091_pre_disaster.png,81,56,1,849,930,383,439,1218,47.82271134274704,37.127526356121315
17784,/media/marda/TWOTB1/xBD/hurricanes/images/florence/hurricane-florence_00000091_pre_disaster.png,38,36,1,337,375,388,424,378,25.579911232297956,19.757696071307745
17785,/media/marda/TWOTB1/xBD/hurricanes/images/florence/hurricane-florence_00000091_pre_disaster.png,55,38,1,562,617,388,426,550,35.49414467480296,20.46327267361944
17786,/media/marda/TWOTB1/xBD/hurricanes/images/florence/hurricane-florence_00000091_pre_disaster.png,58,46,1,471,529,397,443,872,41.305521769071625,27.449364353183853
17787,/media/marda/TWOTB1/xBD/hurricanes/images/florence/hurricane-florence_00000091_pre_disaster.png,17,33,1,35,52,399,432,205,17.763227687010378,15.45219017368794
17788,/media/marda/TWOTB1/xBD/hurricanes/images/florence/hurricane-florence_00000091_pre_disaster.png,34,58,1,248,282,403,461,725,43.19086888676295,22.61466347617356
17789,/media/marda/TWOTB1/xBD/hurricanes/images/florence/hurricane-florence_00000091_pre_disaster.png,42,50,1,433,475,404,454,620,35.356946093108,23.3715497782165
17790,/media/marda/TWOTB1/xBD/hurricanes/images/florence/hurricane-florence_00000091_pre_disaster.png,43,53,1,394,437,415,468,686,38.726774922367284,23.47155261042227
17791,/media/marda/TWOTB1/xBD/hurricanes/images/florence/hurricane-florence_00000091_pre_disaster.png,63,49,1,741,804,418,467,897,41.96192349998073,28.28406858655353
17792,/media/marda/TWOTB1/xBD/hurricanes/images/florence/hurricane-florence_00000091_pre_disaster.png,71,45,1,862,933,427,472,704,39.82635649349338,23.168662369779383
17793,/media/marda/TWOTB1/xBD/hurricanes/images/florence/hurricane-florence_00000091_pre_disaster.png,46,45,1,354,400,431,476,700,35.83412657817534,25.53288669523194
17794,/media/marda/TWOTB1/xBD/hurricanes/images/florence/hurricane-florence_00000091_pre_disaster.png,40,58,1,257,297,451,509,890,42.86472301919629,27.643609798730626
17795,/media/marda/TWOTB1/xBD/hurricanes/images/florence/hurricane-florence_00000091_pre_disaster.png,29,57,1,0,29,455,512,782,39.67023390626671,26.327652993510803
17796,/media/marda/TWOTB1/xBD/hurricanes/images/florence/hurricane-florence_00000091_pre_disaster.png,43,56,1,169,212,460,516,956,38.558065067213256,33.121930524522554
17797,/media/marda/TWOTB1/xBD/hurricanes/images/florence/hurricane-florence_00000091_pre_disaster.png,31,44,1,108,139,464,508,494,30.194958978270783,22.968115519459456
17798,/media/marda/TWOTB1/xBD/hurricanes/images/florence/hurricane-florence_00000091_pre_disaster.png,42,46,1,55,97,467,513,927,44.41493469220517,27.533412297864423
17799,/media/marda/TWOTB1/xBD/hurricanes/images/florence/hurricane-florence_00000091_pre_disaster.png,52,49,1,685,737,483,532,579,32.052743514770555,24.1664079946132
17800,/media/marda/TWOTB1/xBD/hurricanes/images/florence/hurricane-florence_00000091_pre_disaster.png,58,64,1,563,621,487,551,1129,49.11630781108575,30.299064648640318
17801,/media/marda/TWOTB1/xBD/hurricanes/images/florence/hurricane-florence_00000091_pre_disaster.png,70,54,1,882,952,488,542,912,38.42061128288739,32.62208672297216
17802,/media/marda/TWOTB1/xBD/hurricanes/images/florence/hurricane-florence_00000091_pre_disaster.png,43,35,1,739,782,505,540,141,14.093861960800373,13.43115410008442
17803,/media/marda/TWOTB1/xBD/hurricanes/images/florence/hurricane-florence_00000091_pre_disaster.png,63,69,1,414,477,521,590,1181,48.97998114679732,34.6665682777921
17804,/media/marda/TWOTB1/xBD/hurricanes/images/florence/hurricane-florence_00000091_pre_disaster.png,55,40,1,857,912,526,566,339,24.647265260609885,18.199325786192887
17805,/media/marda/TWOTB1/xBD/hurricanes/images/florence/hurricane-florence_00000091_pre_disaster.png,41,34,1,756,797,538,572,112,12.473477914592326,12.15956211197565
17806,/media/marda/TWOTB1/xBD/hurricanes/images/florence/hurricane-florence_00000091_pre_disaster.png,126,127,1,821,947,540,667,6641,106.71429444658604,82.98410446390253
17807,/media/marda/TWOTB1/xBD/hurricanes/images/florence/hurricane-florence_00000091_pre_disaster.png,66,52,1,707,773,551,603,796,37.70921354827196,28.34095096488211
17808,/media/marda/TWOTB1/xBD/hurricanes/images/florence/hurricane-florence_00000091_pre_disaster.png,38,53,1,293,331,562,615,645,33.47491982076823,25.89522874994208
17809,/media/marda/TWOTB1/xBD/hurricanes/images/florence/hurricane-florence_00000091_pre_disaster.png,71,81,1,420,491,585,666,1838,65.52267475511718,37.76643801196341
17810,/media/marda/TWOTB1/xBD/hurricanes/images/florence/hurricane-florence_00000091_pre_disaster.png,62,63,1,471,533,586,649,1092,38.855707327466156,37.522051353205924
17811,/media/marda/TWOTB1/xBD/hurricanes/images/florence/hurricane-florence_00000091_pre_disaster.png,74,63,1,604,678,596,659,1136,49.55435171719871,30.57104838155602
17812,/media/marda/TWOTB1/xBD/hurricanes/images/florence/hurricane-florence_00000091_pre_disaster.png,50,40,1,761,811,620,660,229,21.941200769820785,14.003745390336107
17813,/media/marda/TWOTB1/xBD/hurricanes/images/florence/hurricane-florence_00000091_pre_disaster.png,40,50,1,303,343,621,671,490,27.092488285068168,24.077396596772996
17814,/media/marda/TWOTB1/xBD/hurricanes/images/florence/hurricane-florence_00000091_pre_disaster.png,33,65,1,107,140,627,692,821,43.298924757941755,25.226460760326205
17815,/media/marda/TWOTB1/xBD/hurricanes/images/florence/hurricane-florence_00000091_pre_disaster.png,70,55,1,717,787,631,686,862,44.09198986286654,25.825570826811195
17816,/media/marda/TWOTB1/xBD/hurricanes/images/florence/hurricane-florence_00000091_pre_disaster.png,33,51,1,39,72,636,687,593,34.76289482365956,22.518818561876728
17817,/media/marda/TWOTB1/xBD/hurricanes/images/florence/hurricane-florence_00000091_pre_disaster.png,48,54,1,592,640,656,710,503,27.621966843495304,23.88912786234696
17818,/media/marda/TWOTB1/xBD/hurricanes/images/florence/hurricane-florence_00000091_pre_disaster.png,54,57,1,270,324,664,721,962,47.338449880105586,26.65514983253621
17819,/media/marda/TWOTB1/xBD/hurricanes/images/florence/hurricane-florence_00000091_pre_disaster.png,43,59,1,324,367,689,748,618,32.305560336343326,26.055638219536284
17820,/media/marda/TWOTB1/xBD/hurricanes/images/florence/hurricane-florence_00000091_pre_disaster.png,61,79,1,602,663,697,776,1239,53.91047034055806,30.235465508409607
17821,/media/marda/TWOTB1/xBD/hurricanes/images/florence/hurricane-florence_00000091_pre_disaster.png,54,57,1,652,706,707,764,593,29.455994008000058,26.53304579681795
17822,/media/marda/TWOTB1/xBD/hurricanes/images/florence/hurricane-florence_00000091_pre_disaster.png,87,129,1,424,511,719,848,3381,112.28233195720541,43.18847506455694
17823,/media/marda/TWOTB1/xBD/hurricanes/images/florence/hurricane-florence_00000091_pre_disaster.png,49,66,1,335,384,732,798,1007,39.84681233780785,32.99265643978371
17824,/media/marda/TWOTB1/xBD/hurricanes/images/florence/hurricane-florence_00000091_pre_disaster.png,46,52,1,75,121,752,804,536,50.58694018151068,14.170583437340873
17825,/media/marda/TWOTB1/xBD/hurricanes/images/florence/hurricane-florence_00000091_pre_disaster.png,197,262,1,756,953,753,1015,22951,244.95729809017732,126.2582383464734
17826,/media/marda/TWOTB1/xBD/hurricanes/images/florence/hurricane-florence_00000091_pre_disaster.png,54,106,1,274,328,770,876,1927,83.35405934621593,30.804865282276925
17827,/media/marda/TWOTB1/xBD/hurricanes/images/florence/hurricane-florence_00000091_pre_disaster.png,59,82,1,318,377,771,853,1418,50.2451364044319,38.2316143274657
17828,/media/marda/TWOTB1/xBD/hurricanes/images/florence/hurricane-florence_00000091_pre_disaster.png,47,53,1,82,129,778,831,495,50.9753273707971,12.990379959174886
17829,/media/marda/TWOTB1/xBD/hurricanes/images/florence/hurricane-florence_00000091_pre_disaster.png,34,53,1,92,126,796,849,361,35.192464441451904,13.680151383335371
17830,/media/marda/TWOTB1/xBD/hurricanes/images/florence/hurricane-florence_00000091_pre_disaster.png,8,52,1,0,8,800,852,99,20.18794170763533,7.07593703533058
17831,/media/marda/TWOTB1/xBD/hurricanes/images/florence/hurricane-florence_00000091_pre_disaster.png,43,62,1,371,414,806,868,488,30.509926807696544,21.096011604421488
17832,/media/marda/TWOTB1/xBD/hurricanes/images/florence/hurricane-florence_00000091_pre_disaster.png,35,51,1,91,126,818,869,351,36.021739784226924,12.994395261391867
17833,/media/marda/TWOTB1/xBD/hurricanes/images/florence/hurricane-florence_00000091_pre_disaster.png,42,57,1,98,140,831,888,532,42.93229858349653,16.43818127679733
17834,/media/marda/TWOTB1/xBD/hurricanes/images/florence/hurricane-florence_00000091_pre_disaster.png,38,77,1,1,39,840,917,1028,49.94791787305944,27.659589133561212
17835,/media/marda/TWOTB1/xBD/hurricanes/images/florence/hurricane-florence_00000091_pre_disaster.png,109,87,1,623,732,846,933,3009,83.79712209760824,46.66619666539941
17836,/media/marda/TWOTB1/xBD/hurricanes/images/florence/hurricane-florence_00000091_pre_disaster.png,45,55,1,103,148,851,906,473,45.62749902377057,14.24506254902281
17837,/media/marda/TWOTB1/xBD/hurricanes/images/florence/hurricane-florence_00000091_pre_disaster.png,56,85,1,573,629,893,978,1042,53.144080568974196,26.126159317136985
17838,/media/marda/TWOTB1/xBD/hurricanes/images/florence/hurricane-florence_00000091_pre_disaster.png,115,137,1,479,594,896,1033,6217,94.73454690656447,88.01326937616508
17839,/media/marda/TWOTB1/xBD/hurricanes/images/florence/hurricane-florence_00000091_pre_disaster.png,92,80,1,248,340,928,1008,1847,92.51014972288003,26.446874402990087
17840,/media/marda/TWOTB1/xBD/hurricanes/images/florence/hurricane-florence_00000091_pre_disaster.png,35,67,1,341,376,940,1007,443,32.63931977468683,19.31033802869729
17841,/media/marda/TWOTB1/xBD/hurricanes/images/florence/hurricane-florence_00000091_pre_disaster.png,29,68,1,146,175,958,1026,530,31.346975707594105,22.3555634035714
17842,/media/marda/TWOTB1/xBD/hurricanes/images/florence/hurricane-florence_00000091_pre_disaster.png,36,64,1,198,234,965,1029,560,27.930472550159237,26.715712892784634
17843,/media/marda/TWOTB1/xBD/hurricanes/images/florence/hurricane-florence_00000091_pre_disaster.png,50,65,1,34,84,967,1032,708,57.292286172023104,17.906780069784578
17844,/media/marda/TWOTB1/xBD/hurricanes/images/florence/hurricane-florence_00000091_pre_disaster.png,65,75,1,370,435,967,1042,1232,53.69611439397598,33.334233512007344
17845,/media/marda/TWOTB1/xBD/hurricanes/images/florence/hurricane-florence_00000091_pre_disaster.png,23,50,1,114,137,969,1019,180,20.03262720002254,11.794831283057052
17846,/media/marda/TWOTB1/xBD/hurricanes/images/florence/hurricane-florence_00000091_pre_disaster.png,26,59,1,127,153,981,1040,254,18.940375791877294,18.014642360946766
17847,/media/marda/TWOTB1/xBD/hurricanes/images/florence/hurricane-florence_00000091_pre_disaster.png,40,62,1,317,357,982,1044,402,26.41332786357311,21.899982830471284
17848,/media/marda/TWOTB1/xBD/hurricanes/images/florence/hurricane-florence_00000091_pre_disaster.png,9,51,1,19,28,986,1037,68,9.966730657295336,9.183816238196995
17849,/media/marda/TWOTB1/xBD/hurricanes/images/florence/hurricane-florence_00000091_pre_disaster.png,36,51,1,50,86,993,1044,228,36.58556237592357,9.183444507941992
17850,/media/marda/TWOTB1/xBD/hurricanes/images/florence/hurricane-florence_00000375_pre_disaster.png,115,70,1,288,403,466,536,3133,120.97624878944399,36.326791109309134
17851,/media/marda/TWOTB1/xBD/hurricanes/images/florence/hurricane-florence_00000375_pre_disaster.png,30,38,1,404,434,495,533,194,18.86298964743751,13.700070289968584
17852,/media/marda/TWOTB1/xBD/hurricanes/images/florence/hurricane-florence_00000375_pre_disaster.png,122,73,1,293,415,514,587,3289,124.298363477358,36.957907921258524
17853,/media/marda/TWOTB1/xBD/hurricanes/images/florence/hurricane-florence_00000378_pre_disaster.png,40,35,1,490,530,159,194,559,34.584337970401656,21.835863892624655
17854,/media/marda/TWOTB1/xBD/hurricanes/images/florence/hurricane-florence_00000378_pre_disaster.png,68,84,1,781,849,616,700,1610,62.550709635130325,34.82634106258097
17855,/media/marda/TWOTB1/xBD/hurricanes/images/florence/hurricane-florence_00000378_pre_disaster.png,54,50,1,677,731,622,672,699,31.776395536008497,29.375171798235197
17856,/media/marda/TWOTB1/xBD/hurricanes/images/florence/hurricane-florence_00000378_pre_disaster.png,62,57,1,510,572,657,714,1168,46.07941440203552,33.669515772115
17857,/media/marda/TWOTB1/xBD/hurricanes/images/florence/hurricane-florence_00000464_post_disaster.png,37,50,1,37,74,450,500,644,36.85383395195701,23.523429389940677
17858,/media/marda/TWOTB1/xBD/hurricanes/images/florence/hurricane-florence_00000464_post_disaster.png,7,30,1,0,7,491,521,46,12.056351925547709,6.206112617726296
17859,/media/marda/TWOTB1/xBD/hurricanes/images/florence/hurricane-florence_00000464_post_disaster.png,17,60,1,0,17,503,563,418,39.43512845344494,15.226437052178202
17860,/media/marda/TWOTB1/xBD/hurricanes/images/florence/hurricane-florence_00000464_post_disaster.png,63,56,1,755,818,741,797,562,32.98511954734151,22.83305023864957
17861,/media/marda/TWOTB1/xBD/hurricanes/images/florence/hurricane-florence_00000464_post_disaster.png,90,79,1,763,853,799,878,1937,59.93891439288879,43.197805768145486
17862,/media/marda/TWOTB1/xBD/hurricanes/images/florence/hurricane-florence_00000464_post_disaster.png,96,94,1,498,594,850,944,2014,94.31373892482208,34.84836838642117
17863,/media/marda/TWOTB1/xBD/hurricanes/images/florence/hurricane-florence_00000464_post_disaster.png,39,59,1,199,238,957,1016,447,29.60063511560006,20.254961146744865
17864,/media/marda/TWOTB1/xBD/hurricanes/images/florence/hurricane-florence_00000464_post_disaster.png,21,58,1,59,80,985,1043,234,21.13612466331526,14.90142961064689
17865,/media/marda/TWOTB1/xBD/hurricanes/images/florence/hurricane-florence_00000049_pre_disaster.png,51,14,1,870,921,84,98,112,17.07318777849458,8.831248663570424
17866,/media/marda/TWOTB1/xBD/hurricanes/images/florence/hurricane-florence_00000049_pre_disaster.png,59,33,1,808,867,90,123,448,34.2012750349211,18.37540309889573
17867,/media/marda/TWOTB1/xBD/hurricanes/images/florence/hurricane-florence_00000049_pre_disaster.png,45,16,1,858,903,99,115,85,12.6876921821527,8.866634512337264
17868,/media/marda/TWOTB1/xBD/hurricanes/images/florence/hurricane-florence_00000021_pre_disaster.png,275,233,1,126,401,82,315,25965,282.406279944915,211.67805365493058
17869,/media/marda/TWOTB1/xBD/hurricanes/images/florence/hurricane-florence_00000021_pre_disaster.png,35,49,1,75,110,198,247,875,41.01298528027069,28.092540109945027
17870,/media/marda/TWOTB1/xBD/hurricanes/images/florence/hurricane-florence_00000021_pre_disaster.png,84,88,1,176,260,414,502,3440,73.82900981137065,62.02404345770804
17871,/media/marda/TWOTB1/xBD/hurricanes/images/florence/hurricane-florence_00000402_pre_disaster.png,48,18,1,410,458,0,18,396,32.24987557256891,16.6882202107343
17872,/media/marda/TWOTB1/xBD/hurricanes/images/florence/hurricane-florence_00000402_pre_disaster.png,39,18,1,335,374,2,20,450,29.866877723152655,19.724974086790795
17873,/media/marda/TWOTB1/xBD/hurricanes/images/florence/hurricane-florence_00000402_pre_disaster.png,23,11,1,378,401,12,23,93,12.027651394952851,10.420312555266552
17874,/media/marda/TWOTB1/xBD/hurricanes/images/florence/hurricane-florence_00000402_pre_disaster.png,23,12,1,318,341,21,33,106,13.247364806100476,10.711815754175676
17875,/media/marda/TWOTB1/xBD/hurricanes/images/florence/hurricane-florence_00000402_pre_disaster.png,53,42,1,397,450,28,70,837,43.08069786537454,26.435884793243027
17876,/media/marda/TWOTB1/xBD/hurricanes/images/florence/hurricane-florence_00000402_pre_disaster.png,56,32,1,437,493,32,64,703,38.88307800033951,23.970545802855607
17877,/media/marda/TWOTB1/xBD/hurricanes/images/florence/hurricane-florence_00000402_pre_disaster.png,39,18,1,374,413,41,59,421,28.717477084158627,19.4811289476217
17878,/media/marda/TWOTB1/xBD/hurricanes/images/florence/hurricane-florence_00000402_pre_disaster.png,73,38,1,971,1044,281,319,666,39.31904438867294,22.417874933846313
17879,/media/marda/TWOTB1/xBD/hurricanes/images/florence/hurricane-florence_00000402_pre_disaster.png,77,43,1,896,973,321,364,776,41.64306695870985,24.75131536246691
17880,/media/marda/TWOTB1/xBD/hurricanes/images/florence/hurricane-florence_00000402_pre_disaster.png,60,53,1,568,628,349,402,997,38.14284382376069,34.895595229665695
17881,/media/marda/TWOTB1/xBD/hurricanes/images/florence/hurricane-florence_00000402_pre_disaster.png,53,28,1,879,932,358,386,191,17.608698387816744,14.036313132818135
17882,/media/marda/TWOTB1/xBD/hurricanes/images/florence/hurricane-florence_00000402_pre_disaster.png,227,114,1,453,680,497,611,6193,239.32550354904942,34.51802085209157
17883,/media/marda/TWOTB1/xBD/hurricanes/images/florence/hurricane-florence_00000116_post_disaster.png,49,89,1,43,92,841,930,1786,56.58422736674609,42.55963831237635
17884,/media/marda/TWOTB1/xBD/hurricanes/images/florence/hurricane-florence_00000116_post_disaster.png,23,52,1,166,189,889,941,228,19.679655503808135,15.564543645753222
17885,/media/marda/TWOTB1/xBD/hurricanes/images/florence/hurricane-florence_00000370_pre_disaster.png,59,40,1,415,474,0,40,856,44.80211170133908,25.37237176143467
17886,/media/marda/TWOTB1/xBD/hurricanes/images/florence/hurricane-florence_00000370_pre_disaster.png,22,18,1,171,193,59,77,165,15.208835478340884,14.543309538010234
17887,/media/marda/TWOTB1/xBD/hurricanes/images/florence/hurricane-florence_00000370_pre_disaster.png,61,52,1,318,379,114,166,1249,45.56628813133375,36.20294441130151
17888,/media/marda/TWOTB1/xBD/hurricanes/images/florence/hurricane-florence_00000370_pre_disaster.png,56,59,1,245,301,144,203,1163,60.169687068364716,25.811660286781866
17889,/media/marda/TWOTB1/xBD/hurricanes/images/florence/hurricane-florence_00000370_pre_disaster.png,60,52,1,206,266,194,246,1204,50.35480802843475,31.893843115643243
17890,/media/marda/TWOTB1/xBD/hurricanes/images/florence/hurricane-florence_00000370_pre_disaster.png,58,53,1,167,225,224,277,1108,48.34992892153134,31.105237769136966
17891,/media/marda/TWOTB1/xBD/hurricanes/images/florence/hurricane-florence_00000370_pre_disaster.png,49,46,1,155,204,279,325,908,37.598225761516844,33.34580819438699
17892,/media/marda/TWOTB1/xBD/hurricanes/images/florence/hurricane-florence_00000370_pre_disaster.png,21,39,1,137,158,304,343,375,28.866932048984335,17.241921092738185
17893,/media/marda/TWOTB1/xBD/hurricanes/images/florence/hurricane-florence_00000370_pre_disaster.png,34,45,1,158,192,425,470,553,28.009136689700508,26.233253665440703
17894,/media/marda/TWOTB1/xBD/hurricanes/images/florence/hurricane-florence_00000370_pre_disaster.png,20,29,1,177,197,466,495,120,15.685721053727043,10.306542664314296
17895,/media/marda/TWOTB1/xBD/hurricanes/images/florence/hurricane-florence_00000370_pre_disaster.png,33,39,1,196,229,471,510,317,23.38366118519244,18.11301854456239
17896,/media/marda/TWOTB1/xBD/hurricanes/images/florence/hurricane-florence_00000370_pre_disaster.png,122,64,1,922,1044,692,756,1937,96.72178844278326,26.611136970002143
17897,/media/marda/TWOTB1/xBD/hurricanes/images/florence/hurricane-florence_00000153_post_disaster.png,60,53,1,330,390,62,115,1467,49.42166008912133,40.2527272076978
17898,/media/marda/TWOTB1/xBD/hurricanes/images/florence/hurricane-florence_00000153_post_disaster.png,70,42,1,801,871,168,210,842,33.79458471831705,33.26041457190204
17899,/media/marda/TWOTB1/xBD/hurricanes/images/florence/hurricane-florence_00000153_post_disaster.png,72,70,1,584,656,613,683,1314,44.5161772070541,39.14856014439257
17900,/media/marda/TWOTB1/xBD/hurricanes/images/florence/hurricane-florence_00000153_post_disaster.png,57,20,1,127,184,0,20,566,46.00107328665246,19.611992389244072
17901,/media/marda/TWOTB1/xBD/hurricanes/images/florence/hurricane-florence_00000153_post_disaster.png,60,44,1,376,436,0,44,1394,45.758303709206174,42.87763702530925
17902,/media/marda/TWOTB1/xBD/hurricanes/images/florence/hurricane-florence_00000153_post_disaster.png,37,24,1,212,249,25,49,381,29.86527858168754,16.96692258401506
17903,/media/marda/TWOTB1/xBD/hurricanes/images/florence/hurricane-florence_00000153_post_disaster.png,31,20,1,391,422,56,76,193,18.536785377291057,13.938479924464417
17904,/media/marda/TWOTB1/xBD/hurricanes/images/florence/hurricane-florence_00000153_post_disaster.png,39,26,1,309,348,75,101,420,25.09501723570899,22.407433598272934
17905,/media/marda/TWOTB1/xBD/hurricanes/images/florence/hurricane-florence_00000153_post_disaster.png,84,60,1,737,821,154,214,1842,51.806543882961364,47.58788328335707
17906,/media/marda/TWOTB1/xBD/hurricanes/images/florence/hurricane-florence_00000153_post_disaster.png,45,26,1,782,827,209,235,164,16.415954783323333,13.278267332024162
17907,/media/marda/TWOTB1/xBD/hurricanes/images/florence/hurricane-florence_00000153_post_disaster.png,58,66,1,128,186,298,364,1360,62.68899427706624,28.663058643243396
17908,/media/marda/TWOTB1/xBD/hurricanes/images/florence/hurricane-florence_00000153_post_disaster.png,30,37,1,115,145,365,402,323,25.80266844161328,16.611196667432054
17909,/media/marda/TWOTB1/xBD/hurricanes/images/florence/hurricane-florence_00000153_post_disaster.png,29,42,1,98,127,396,438,303,28.7789010589042,14.01285369933412
17910,/media/marda/TWOTB1/xBD/hurricanes/images/florence/hurricane-florence_00000153_post_disaster.png,52,64,1,610,662,728,792,644,35.1644627298893,24.36617716943499
17911,/media/marda/TWOTB1/xBD/hurricanes/images/florence/hurricane-florence_00000153_post_disaster.png,106,93,1,836,942,828,921,2260,78.65108011457589,38.804004704218094
17912,/media/marda/TWOTB1/xBD/hurricanes/images/florence/hurricane-florence_00000360_pre_disaster.png,22,31,1,4,26,0,31,437,33.939149285597054,17.384811759829752
17913,/media/marda/TWOTB1/xBD/hurricanes/images/florence/hurricane-florence_00000360_pre_disaster.png,36,28,1,85,121,0,28,672,33.41515321838508,26.842520952463815
17914,/media/marda/TWOTB1/xBD/hurricanes/images/florence/hurricane-florence_00000360_pre_disaster.png,44,28,1,369,413,0,28,570,29.356989791102805,25.665263549242084
17915,/media/marda/TWOTB1/xBD/hurricanes/images/florence/hurricane-florence_00000360_pre_disaster.png,49,44,1,422,471,0,44,922,50.95328172565939,27.06971615131507
17916,/media/marda/TWOTB1/xBD/hurricanes/images/florence/hurricane-florence_00000360_pre_disaster.png,54,21,1,521,575,0,21,548,33.903365653371914,21.2310577239774
17917,/media/marda/TWOTB1/xBD/hurricanes/images/florence/hurricane-florence_00000360_pre_disaster.png,57,36,1,325,382,12,48,1076,48.542802675292435,29.281393190981593
17918,/media/marda/TWOTB1/xBD/hurricanes/images/florence/hurricane-florence_00000360_pre_disaster.png,58,43,1,712,770,13,56,797,41.52859005995075,25.460644151729717
17919,/media/marda/TWOTB1/xBD/hurricanes/images/florence/hurricane-florence_00000360_pre_disaster.png,74,66,1,662,736,15,81,1794,65.34607000361021,38.65760389393968
17920,/media/marda/TWOTB1/xBD/hurricanes/images/florence/hurricane-florence_00000360_pre_disaster.png,85,33,1,567,652,16,49,984,69.82381121457057,18.79902039718337
17921,/media/marda/TWOTB1/xBD/hurricanes/images/florence/hurricane-florence_00000360_pre_disaster.png,38,28,1,294,332,27,55,550,31.951654256974074,22.868289390863463
17922,/media/marda/TWOTB1/xBD/hurricanes/images/florence/hurricane-florence_00000360_pre_disaster.png,51,34,1,242,293,39,73,933,44.423540350803556,27.84237462014409
17923,/media/marda/TWOTB1/xBD/hurricanes/images/florence/hurricane-florence_00000360_pre_disaster.png,62,53,1,585,647,52,105,1362,52.311661967532224,34.65526730776097
17924,/media/marda/TWOTB1/xBD/hurricanes/images/florence/hurricane-florence_00000360_pre_disaster.png,40,28,1,210,250,54,82,615,32.70906526637754,24.798196146396812
17925,/media/marda/TWOTB1/xBD/hurricanes/images/florence/hurricane-florence_00000360_pre_disaster.png,30,26,1,288,318,57,83,332,24.763305333449544,17.93186215556088
17926,/media/marda/TWOTB1/xBD/hurricanes/images/florence/hurricane-florence_00000360_pre_disaster.png,81,58,1,942,1023,69,127,1437,55.54552706676101,39.32469320829102
17927,/media/marda/TWOTB1/xBD/hurricanes/images/florence/hurricane-florence_00000360_pre_disaster.png,47,27,1,402,449,81,108,553,32.02927744873976,22.692582235064485
17928,/media/marda/TWOTB1/xBD/hurricanes/images/florence/hurricane-florence_00000360_pre_disaster.png,44,30,1,358,402,82,112,590,30.343054057226908,25.954407600059692
17929,/media/marda/TWOTB1/xBD/hurricanes/images/florence/hurricane-florence_00000360_pre_disaster.png,48,39,1,452,500,93,132,779,40.35477581673387,25.97231175887251
17930,/media/marda/TWOTB1/xBD/hurricanes/images/florence/hurricane-florence_00000360_pre_disaster.png,63,35,1,408,471,125,160,833,46.87674801983414,25.89446800293369
17931,/media/marda/TWOTB1/xBD/hurricanes/images/florence/hurricane-florence_00000360_pre_disaster.png,50,50,1,352,402,131,181,1082,44.85932263566855,32.84857367736829
17932,/media/marda/TWOTB1/xBD/hurricanes/images/florence/hurricane-florence_00000360_pre_disaster.png,64,34,1,650,714,146,180,618,42.62119262751067,19.28544973415428
17933,/media/marda/TWOTB1/xBD/hurricanes/images/florence/hurricane-florence_00000360_pre_disaster.png,50,61,1,117,167,153,214,1361,60.37768401601837,32.53881218463748
17934,/media/marda/TWOTB1/xBD/hurricanes/images/florence/hurricane-florence_00000360_pre_disaster.png,50,64,1,243,293,156,220,1514,63.96500448867369,31.21644853268113
17935,/media/marda/TWOTB1/xBD/hurricanes/images/florence/hurricane-florence_00000360_pre_disaster.png,43,65,1,280,323,159,224,1244,63.99683583690433,26.859646121246282
17936,/media/marda/TWOTB1/xBD/hurricanes/images/florence/hurricane-florence_00000360_pre_disaster.png,63,54,1,572,635,175,229,1344,46.511289544643304,38.438084630759505
17937,/media/marda/TWOTB1/xBD/hurricanes/images/florence/hurricane-florence_00000360_pre_disaster.png,63,42,1,981,1044,201,243,656,33.061245037813066,26.321709397224126
17938,/media/marda/TWOTB1/xBD/hurricanes/images/florence/hurricane-florence_00000360_pre_disaster.png,54,49,1,478,532,214,263,885,41.03375784869969,29.054882257475587
17939,/media/marda/TWOTB1/xBD/hurricanes/images/florence/hurricane-florence_00000360_pre_disaster.png,47,30,1,633,680,216,246,316,22.220761494904398,19.025568487254947
17940,/media/marda/TWOTB1/xBD/hurricanes/images/florence/hurricane-florence_00000360_pre_disaster.png,63,41,1,685,748,220,261,748,35.91236090118897,28.044780587222363
17941,/media/marda/TWOTB1/xBD/hurricanes/images/florence/hurricane-florence_00000360_pre_disaster.png,40,23,1,615,655,235,258,158,15.629900029700282,13.508022805609068
17942,/media/marda/TWOTB1/xBD/hurricanes/images/florence/hurricane-florence_00000360_pre_disaster.png,75,59,1,616,691,246,305,1822,50.75336298555747,47.16409146861341
17943,/media/marda/TWOTB1/xBD/hurricanes/images/florence/hurricane-florence_00000360_pre_disaster.png,88,52,1,812,900,246,298,1580,61.34578776954967,36.60264815358333
17944,/media/marda/TWOTB1/xBD/hurricanes/images/florence/hurricane-florence_00000360_pre_disaster.png,44,41,1,316,360,258,299,688,30.735984092561758,29.758361257256553
17945,/media/marda/TWOTB1/xBD/hurricanes/images/florence/hurricane-florence_00000360_pre_disaster.png,56,43,1,361,417,263,306,1004,43.09533014765306,30.41834065670224
17946,/media/marda/TWOTB1/xBD/hurricanes/images/florence/hurricane-florence_00000360_pre_disaster.png,45,56,1,279,324,271,327,1015,44.9672721852869,30.911500271201295
17947,/media/marda/TWOTB1/xBD/hurricanes/images/florence/hurricane-florence_00000360_pre_disaster.png,39,28,1,456,495,273,301,310,23.086503196655737,17.980204420530992
17948,/media/marda/TWOTB1/xBD/hurricanes/images/florence/hurricane-florence_00000360_pre_disaster.png,41,57,1,192,233,297,354,917,44.38378895737527,27.589367061267676
17949,/media/marda/TWOTB1/xBD/hurricanes/images/florence/hurricane-florence_00000360_pre_disaster.png,64,48,1,623,687,302,350,847,42.22774672428122,27.528787839901042
17950,/media/marda/TWOTB1/xBD/hurricanes/images/florence/hurricane-florence_00000360_pre_disaster.png,37,26,1,667,704,303,329,127,13.245827922861839,12.569078466829433
17951,/media/marda/TWOTB1/xBD/hurricanes/images/florence/hurricane-florence_00000360_pre_disaster.png,28,27,1,333,361,314,341,169,16.972955958133298,13.190865980241757
17952,/media/marda/TWOTB1/xBD/hurricanes/images/florence/hurricane-florence_00000360_pre_disaster.png,55,44,1,748,803,315,359,522,32.743741067524205,21.315107790118013
17953,/media/marda/TWOTB1/xBD/hurricanes/images/florence/hurricane-florence_00000360_pre_disaster.png,30,26,1,380,410,318,344,153,17.154828269851425,11.983729367272632
17954,/media/marda/TWOTB1/xBD/hurricanes/images/florence/hurricane-florence_00000360_pre_disaster.png,66,59,1,516,582,318,377,1388,50.099808868582485,36.95872050577876
17955,/media/marda/TWOTB1/xBD/hurricanes/images/florence/hurricane-florence_00000360_pre_disaster.png,63,39,1,690,753,321,360,536,35.9317452483823,19.939285035502923
17956,/media/marda/TWOTB1/xBD/hurricanes/images/florence/hurricane-florence_00000360_pre_disaster.png,35,55,1,124,159,322,377,893,41.26086777443334,28.576408381760768
17957,/media/marda/TWOTB1/xBD/hurricanes/images/florence/hurricane-florence_00000360_pre_disaster.png,86,47,1,853,939,335,382,1213,53.30786698706887,30.01919586086754
17958,/media/marda/TWOTB1/xBD/hurricanes/images/florence/hurricane-florence_00000360_pre_disaster.png,36,50,1,69,105,341,391,877,34.65935426206911,33.50060058666037
17959,/media/marda/TWOTB1/xBD/hurricanes/images/florence/hurricane-florence_00000360_pre_disaster.png,69,55,1,325,394,347,402,1188,65.34154631850555,27.78455450038498
17960,/media/marda/TWOTB1/xBD/hurricanes/images/florence/hurricane-florence_00000360_pre_disaster.png,59,45,1,637,696,348,393,732,32.194154481714364,30.289277408906052
17961,/media/marda/TWOTB1/xBD/hurricanes/images/florence/hurricane-florence_00000360_pre_disaster.png,45,60,1,209,254,350,410,1068,46.244355772965505,30.898761437028938
17962,/media/marda/TWOTB1/xBD/hurricanes/images/florence/hurricane-florence_00000360_pre_disaster.png,30,41,1,26,56,359,400,611,31.357618094905778,25.316922965171507
17963,/media/marda/TWOTB1/xBD/hurricanes/images/florence/hurricane-florence_00000360_pre_disaster.png,43,33,1,367,410,363,396,374,31.995499812245946,15.511246929922619
17964,/media/marda/TWOTB1/xBD/hurricanes/images/florence/hurricane-florence_00000360_pre_disaster.png,34,24,1,525,559,364,388,92,13.678622630530047,9.080776416301395
17965,/media/marda/TWOTB1/xBD/hurricanes/images/florence/hurricane-florence_00000360_pre_disaster.png,44,29,1,686,730,375,404,172,17.554922271005104,13.192809836082288
17966,/media/marda/TWOTB1/xBD/hurricanes/images/florence/hurricane-florence_00000360_pre_disaster.png,46,27,1,742,788,375,402,174,19.437096956757212,11.971771821829236
17967,/media/marda/TWOTB1/xBD/hurricanes/images/florence/hurricane-florence_00000360_pre_disaster.png,15,40,1,0,15,376,416,304,28.5179886194503,14.54878662077749
17968,/media/marda/TWOTB1/xBD/hurricanes/images/florence/hurricane-florence_00000360_pre_disaster.png,72,43,1,878,950,381,424,728,37.18618892187642,26.006720319136452
17969,/media/marda/TWOTB1/xBD/hurricanes/images/florence/hurricane-florence_00000360_pre_disaster.png,54,45,1,653,707,383,428,619,31.16555796115238,26.52240135711621
17970,/media/marda/TWOTB1/xBD/hurricanes/images/florence/hurricane-florence_00000360_pre_disaster.png,41,35,1,520,561,385,420,286,22.697391293251716,16.72223848691094
17971,/media/marda/TWOTB1/xBD/hurricanes/images/florence/hurricane-florence_00000360_pre_disaster.png,47,39,1,491,538,393,432,349,29.62144939773363,16.647560614066734
17972,/media/marda/TWOTB1/xBD/hurricanes/images/florence/hurricane-florence_00000360_pre_disaster.png,56,48,1,339,395,396,444,922,43.82767001737933,27.951785919854093
17973,/media/marda/TWOTB1/xBD/hurricanes/images/florence/hurricane-florence_00000360_pre_disaster.png,43,42,1,537,580,407,449,350,23.210656128821874,20.077038698122546
17974,/media/marda/TWOTB1/xBD/hurricanes/images/florence/hurricane-florence_00000360_pre_disaster.png,52,57,1,476,528,422,479,936,37.59885939287286,32.788902042326775
17975,/media/marda/TWOTB1/xBD/hurricanes/images/florence/hurricane-florence_00000360_pre_disaster.png,37,36,1,410,447,425,461,255,22.33350870626281,16.06368029030007
17976,/media/marda/TWOTB1/xBD/hurricanes/images/florence/hurricane-florence_00000360_pre_disaster.png,40,74,1,16,56,438,512,1255,61.5816952111125,27.198092375596
17977,/media/marda/TWOTB1/xBD/hurricanes/images/florence/hurricane-florence_00000360_pre_disaster.png,47,54,1,219,266,438,492,879,41.183634980940205,29.937871550163706
17978,/media/marda/TWOTB1/xBD/hurricanes/images/florence/hurricane-florence_00000360_pre_disaster.png,61,53,1,421,482,441,494,1011,44.85834998808477,29.856791297717137
17979,/media/marda/TWOTB1/xBD/hurricanes/images/florence/hurricane-florence_00000360_pre_disaster.png,60,49,1,353,413,456,505,926,44.02800493777575,27.888983104092304
17980,/media/marda/TWOTB1/xBD/hurricanes/images/florence/hurricane-florence_00000360_pre_disaster.png,54,46,1,679,733,463,509,594,28.759628907886217,27.228448544445733
17981,/media/marda/TWOTB1/xBD/hurricanes/images/florence/hurricane-florence_00000360_pre_disaster.png,58,53,1,687,745,492,545,627,31.76999010857983,26.386606827001604
17982,/media/marda/TWOTB1/xBD/hurricanes/images/florence/hurricane-florence_00000360_pre_disaster.png,48,54,1,243,291,513,567,814,40.17070936438109,27.051949405842876
17983,/media/marda/TWOTB1/xBD/hurricanes/images/florence/hurricane-florence_00000360_pre_disaster.png,75,53,1,552,627,516,569,1126,51.82680209799471,29.08762149283137
17984,/media/marda/TWOTB1/xBD/hurricanes/images/florence/hurricane-florence_00000360_pre_disaster.png,27,51,1,40,67,517,568,569,30.22137643232642,24.895394086808565
17985,/media/marda/TWOTB1/xBD/hurricanes/images/florence/hurricane-florence_00000360_pre_disaster.png,63,80,1,502,565,529,609,1371,58.36400893926917,35.67230754814551
17986,/media/marda/TWOTB1/xBD/hurricanes/images/florence/hurricane-florence_00000360_pre_disaster.png,64,56,1,603,667,532,588,873,38.005628945620444,30.494594277005902
17987,/media/marda/TWOTB1/xBD/hurricanes/images/florence/hurricane-florence_00000360_pre_disaster.png,102,60,1,722,824,560,620,1504,79.65757815068747,25.519147863214958
17988,/media/marda/TWOTB1/xBD/hurricanes/images/florence/hurricane-florence_00000360_pre_disaster.png,44,51,1,531,575,588,639,365,26.567754955677067,18.530805194190215
17989,/media/marda/TWOTB1/xBD/hurricanes/images/florence/hurricane-florence_00000360_pre_disaster.png,74,105,1,787,861,590,695,1548,90.13608754118972,23.098473807562137
17990,/media/marda/TWOTB1/xBD/hurricanes/images/florence/hurricane-florence_00000360_pre_disaster.png,30,36,1,522,552,591,627,73,12.037089568314498,8.23670576065536
17991,/media/marda/TWOTB1/xBD/hurricanes/images/florence/hurricane-florence_00000360_pre_disaster.png,53,47,1,479,532,598,645,480,36.297053082397746,17.600607037518788
17992,/media/marda/TWOTB1/xBD/hurricanes/images/florence/hurricane-florence_00000360_pre_disaster.png,74,114,1,723,797,612,726,2035,99.319189648704,27.83155709304171
17993,/media/marda/TWOTB1/xBD/hurricanes/images/florence/hurricane-florence_00000360_pre_disaster.png,52,54,1,297,349,613,667,765,42.761566510312306,23.66542602078279
17994,/media/marda/TWOTB1/xBD/hurricanes/images/florence/hurricane-florence_00000360_pre_disaster.png,107,125,1,614,721,623,748,2877,130.00256852007715,40.503380601756604
17995,/media/marda/TWOTB1/xBD/hurricanes/images/florence/hurricane-florence_00000360_pre_disaster.png,49,66,1,410,459,625,691,841,41.30825806239446,27.1153663933135
17996,/media/marda/TWOTB1/xBD/hurricanes/images/florence/hurricane-florence_00000360_pre_disaster.png,38,53,1,152,190,639,692,650,35.25604982556443,24.49516598462802
17997,/media/marda/TWOTB1/xBD/hurricanes/images/florence/hurricane-florence_00000360_pre_disaster.png,44,50,1,558,602,643,693,407,26.302904845836135,20.68360699801033
17998,/media/marda/TWOTB1/xBD/hurricanes/images/florence/hurricane-florence_00000360_pre_disaster.png,73,67,1,288,361,653,720,1517,65.20563735580274,31.20922120582499
17999,/media/marda/TWOTB1/xBD/hurricanes/images/florence/hurricane-florence_00000360_pre_disaster.png,46,55,1,98,144,655,710,818,42.166185216824005,26.16388663882397
18000,/media/marda/TWOTB1/xBD/hurricanes/images/florence/hurricane-florence_00000360_pre_disaster.png,30,48,1,182,212,661,709,385,23.144085833223773,22.258451841090558
18001,/media/marda/TWOTB1/xBD/hurricanes/images/florence/hurricane-florence_00000360_pre_disaster.png,50,51,1,448,498,681,732,615,38.018772504612734,21.261518350563342
18002,/media/marda/TWOTB1/xBD/hurricanes/images/florence/hurricane-florence_00000360_pre_disaster.png,20,48,1,0,20,685,733,356,23.455735022532913,20.232256726948005
18003,/media/marda/TWOTB1/xBD/hurricanes/images/florence/hurricane-florence_00000360_pre_disaster.png,102,69,1,767,869,690,759,1487,80.90207955110556,24.55634776952656
18004,/media/marda/TWOTB1/xBD/hurricanes/images/florence/hurricane-florence_00000360_pre_disaster.png,37,69,1,9,46,711,780,1054,38.99541217576447,35.171799353287476
18005,/media/marda/TWOTB1/xBD/hurricanes/images/florence/hurricane-florence_00000360_pre_disaster.png,50,60,1,343,393,736,796,778,39.62794955370545,25.717289634403922
18006,/media/marda/TWOTB1/xBD/hurricanes/images/florence/hurricane-florence_00000360_pre_disaster.png,116,76,1,601,717,736,812,2092,100.62649470592919,28.019715242042764
18007,/media/marda/TWOTB1/xBD/hurricanes/images/florence/hurricane-florence_00000360_pre_disaster.png,49,74,1,439,488,737,811,894,46.965705663405004,25.401912716486716
18008,/media/marda/TWOTB1/xBD/hurricanes/images/florence/hurricane-florence_00000360_pre_disaster.png,37,66,1,135,172,750,816,814,35.15456881664075,31.91737713204685
18009,/media/marda/TWOTB1/xBD/hurricanes/images/florence/hurricane-florence_00000360_pre_disaster.png,38,57,1,7,45,760,817,756,39.5507564363862,25.03583006306737
18010,/media/marda/TWOTB1/xBD/hurricanes/images/florence/hurricane-florence_00000360_pre_disaster.png,82,104,1,808,890,772,876,1866,83.08517403624215,37.702612680595834
18011,/media/marda/TWOTB1/xBD/hurricanes/images/florence/hurricane-florence_00000360_pre_disaster.png,23,45,1,358,381,788,833,98,12.99371458796472,9.858289498458516
18012,/media/marda/TWOTB1/xBD/hurricanes/images/florence/hurricane-florence_00000360_pre_disaster.png,63,103,1,576,639,790,893,1536,79.73276275427563,26.035026102387484
18013,/media/marda/TWOTB1/xBD/hurricanes/images/florence/hurricane-florence_00000360_pre_disaster.png,43,60,1,373,416,799,859,569,28.185932374309232,26.506765866504267
18014,/media/marda/TWOTB1/xBD/hurricanes/images/florence/hurricane-florence_00000360_pre_disaster.png,116,81,1,630,746,822,903,2111,100.47444251043223,28.02885153521591
18015,/media/marda/TWOTB1/xBD/hurricanes/images/florence/hurricane-florence_00000360_pre_disaster.png,49,74,1,383,432,830,904,986,41.99519794570613,30.852277823982906
18016,/media/marda/TWOTB1/xBD/hurricanes/images/florence/hurricane-florence_00000360_pre_disaster.png,147,82,1,717,864,853,935,2965,129.1779009483725,40.10297587507205
18017,/media/marda/TWOTB1/xBD/hurricanes/images/florence/hurricane-florence_00000360_pre_disaster.png,51,69,1,54,105,881,950,1034,62.72058573822791,25.43103070929502
18018,/media/marda/TWOTB1/xBD/hurricanes/images/florence/hurricane-florence_00000360_pre_disaster.png,53,61,1,374,427,882,943,496,42.624844786694375,15.3783708517116
18019,/media/marda/TWOTB1/xBD/hurricanes/images/florence/hurricane-florence_00000360_pre_disaster.png,39,54,1,416,455,990,1044,207,19.66560382955328,15.523210476557802
18020,/media/marda/TWOTB1/xBD/hurricanes/images/florence/hurricane-florence_00000206_pre_disaster.png,32,17,1,509,541,175,192,106,12.083316741819461,11.855778939096096
18021,/media/marda/TWOTB1/xBD/hurricanes/images/florence/hurricane-florence_00000206_pre_disaster.png,34,17,1,503,537,193,210,109,12.993994757072029,11.2807394181584
18022,/media/marda/TWOTB1/xBD/hurricanes/images/florence/hurricane-florence_00000105_post_disaster.png,70,47,1,875,945,292,339,902,34.70357580649287,33.680714141177646
18023,/media/marda/TWOTB1/xBD/hurricanes/images/florence/hurricane-florence_00000029_pre_disaster.png,29,36,1,428,457,575,611,166,17.35205852696076,12.666862074847883
18024,/media/marda/TWOTB1/xBD/hurricanes/images/florence/hurricane-florence_00000029_pre_disaster.png,25,35,1,417,442,577,612,99,14.304339930701175,9.393313792024236
18025,/media/marda/TWOTB1/xBD/hurricanes/images/florence/hurricane-florence_00000029_pre_disaster.png,28,35,1,394,422,600,635,88,12.320057871617625,9.70256294795354
18026,/media/marda/TWOTB1/xBD/hurricanes/images/florence/hurricane-florence_00000029_pre_disaster.png,19,33,1,354,373,608,641,44,8.644885001013503,6.820109764772802
18027,/media/marda/TWOTB1/xBD/hurricanes/images/florence/hurricane-florence_00000029_pre_disaster.png,46,55,1,410,456,634,689,583,29.983434933369228,25.942869947450873
18028,/media/marda/TWOTB1/xBD/hurricanes/images/florence/hurricane-florence_00000277_post_disaster.png,63,23,1,99,162,49,72,928,63.18504807161575,19.273151268513324
18029,/media/marda/TWOTB1/xBD/hurricanes/images/florence/hurricane-florence_00000277_post_disaster.png,61,43,1,87,148,128,171,1267,58.23977215182082,33.35399458280308
18030,/media/marda/TWOTB1/xBD/hurricanes/images/florence/hurricane-florence_00000277_post_disaster.png,44,41,1,172,216,138,179,1033,38.37248921133743,35.667182581608046
18031,/media/marda/TWOTB1/xBD/hurricanes/images/florence/hurricane-florence_00000277_post_disaster.png,51,19,1,993,1044,193,212,165,17.281975195754296,12.649110640673518
18032,/media/marda/TWOTB1/xBD/hurricanes/images/florence/hurricane-florence_00000277_post_disaster.png,33,19,1,174,207,196,215,299,29.450508239544256,13.550154295972048
18033,/media/marda/TWOTB1/xBD/hurricanes/images/florence/hurricane-florence_00000277_post_disaster.png,31,29,1,169,200,210,239,429,27.961224406558145,20.535356876086627
18034,/media/marda/TWOTB1/xBD/hurricanes/images/florence/hurricane-florence_00000277_post_disaster.png,19,20,1,179,198,257,277,152,17.476893263119017,11.672292508151978
18035,/media/marda/TWOTB1/xBD/hurricanes/images/florence/hurricane-florence_00000277_post_disaster.png,56,42,1,909,965,432,474,385,25.079716688844584,20.209442852644575
18036,/media/marda/TWOTB1/xBD/hurricanes/images/florence/hurricane-florence_00000277_post_disaster.png,57,54,1,819,876,774,828,300,27.969205016277947,14.328185652438549
18037,/media/marda/TWOTB1/xBD/hurricanes/images/florence/hurricane-florence_00000277_post_disaster.png,52,86,1,917,969,786,872,806,62.200653598263436,17.22926819640328
18038,/media/marda/TWOTB1/xBD/hurricanes/images/florence/hurricane-florence_00000277_post_disaster.png,42,42,1,861,903,792,834,100,11.489125293076057,11.489125293076057
18039,/media/marda/TWOTB1/xBD/hurricanes/images/florence/hurricane-florence_00000277_post_disaster.png,87,58,1,849,936,818,876,1139,59.17542989284273,25.606061869537285
18040,/media/marda/TWOTB1/xBD/hurricanes/images/florence/hurricane-florence_00000277_post_disaster.png,46,48,1,824,870,849,897,161,17.230524197936376,12.816555071269477
18041,/media/marda/TWOTB1/xBD/hurricanes/images/florence/hurricane-florence_00000277_post_disaster.png,45,40,1,875,920,849,889,80,11.704871156226073,8.923339689608758
18042,/media/marda/TWOTB1/xBD/hurricanes/images/florence/hurricane-florence_00000339_pre_disaster.png,30,36,1,317,347,0,36,615,40.02482398905553,20.33676696516156
18043,/media/marda/TWOTB1/xBD/hurricanes/images/florence/hurricane-florence_00000339_pre_disaster.png,29,15,1,339,368,4,19,227,18.993227795732246,15.895773212920142
18044,/media/marda/TWOTB1/xBD/hurricanes/images/florence/hurricane-florence_00000339_pre_disaster.png,54,44,1,990,1044,35,79,582,49.694911382459544,15.616393339461649
18045,/media/marda/TWOTB1/xBD/hurricanes/images/florence/hurricane-florence_00000339_pre_disaster.png,31,14,1,519,550,123,137,72,10.811633248950676,9.061719446644242
18046,/media/marda/TWOTB1/xBD/hurricanes/images/florence/hurricane-florence_00000339_pre_disaster.png,30,14,1,537,567,126,140,77,10.38990466845612,9.912109498633223
18047,/media/marda/TWOTB1/xBD/hurricanes/images/florence/hurricane-florence_00000339_pre_disaster.png,55,19,1,531,586,178,197,330,39.07957237621636,11.312537553705804
18048,/media/marda/TWOTB1/xBD/hurricanes/images/florence/hurricane-florence_00000339_pre_disaster.png,80,33,1,622,702,221,254,746,62.75907264753479,15.768283074408929
18049,/media/marda/TWOTB1/xBD/hurricanes/images/florence/hurricane-florence_00000339_pre_disaster.png,33,34,1,483,516,267,301,390,30.0,17.281975195754296
18050,/media/marda/TWOTB1/xBD/hurricanes/images/florence/hurricane-florence_00000339_pre_disaster.png,78,47,1,441,519,308,355,1299,62.19994187794104,30.246453687784694
18051,/media/marda/TWOTB1/xBD/hurricanes/images/florence/hurricane-florence_00000339_pre_disaster.png,43,26,1,649,692,315,341,218,21.003170406113775,13.930523803583458
18052,/media/marda/TWOTB1/xBD/hurricanes/images/florence/hurricane-florence_00000339_pre_disaster.png,83,66,1,596,679,325,391,1673,61.97833033432035,51.28967277386833
18053,/media/marda/TWOTB1/xBD/hurricanes/images/florence/hurricane-florence_00000339_pre_disaster.png,58,54,1,736,794,373,427,933,43.39937297848313,28.704722159946538
18054,/media/marda/TWOTB1/xBD/hurricanes/images/florence/hurricane-florence_00000339_pre_disaster.png,52,65,1,992,1044,413,478,321,45.19072751299484,12.88756952908518
18055,/media/marda/TWOTB1/xBD/hurricanes/images/florence/hurricane-florence_00000339_pre_disaster.png,44,44,1,129,173,432,476,751,41.926177133980964,23.843920380824418
18056,/media/marda/TWOTB1/xBD/hurricanes/images/florence/hurricane-florence_00000339_pre_disaster.png,48,57,1,663,711,526,583,774,40.60895948902834,25.133594882803003
18057,/media/marda/TWOTB1/xBD/hurricanes/images/florence/hurricane-florence_00000339_pre_disaster.png,63,50,1,770,833,540,590,765,33.79541014505462,30.090914938530286
18058,/media/marda/TWOTB1/xBD/hurricanes/images/florence/hurricane-florence_00000339_pre_disaster.png,36,35,1,654,690,569,604,176,17.172325961622498,13.513371935523196
18059,/media/marda/TWOTB1/xBD/hurricanes/images/florence/hurricane-florence_00000339_pre_disaster.png,56,40,1,666,722,586,626,532,34.12346711560735,20.723967388877007
18060,/media/marda/TWOTB1/xBD/hurricanes/images/florence/hurricane-florence_00000339_pre_disaster.png,53,55,1,750,803,598,653,640,32.03109708726419,26.69569603089148
18061,/media/marda/TWOTB1/xBD/hurricanes/images/florence/hurricane-florence_00000339_pre_disaster.png,36,33,1,699,735,599,632,58,9.529758218520893,8.225962978109198
18062,/media/marda/TWOTB1/xBD/hurricanes/images/florence/hurricane-florence_00000339_pre_disaster.png,60,71,1,850,910,600,671,968,50.34141179658548,25.66581371910492
18063,/media/marda/TWOTB1/xBD/hurricanes/images/florence/hurricane-florence_00000339_pre_disaster.png,35,32,1,691,726,605,637,56,9.16515138991168,8.0
18064,/media/marda/TWOTB1/xBD/hurricanes/images/florence/hurricane-florence_00000339_pre_disaster.png,82,64,1,786,868,636,700,1555,54.030765072749325,38.303398183448245
18065,/media/marda/TWOTB1/xBD/hurricanes/images/florence/hurricane-florence_00000118_pre_disaster.png,46,15,1,912,958,257,272,48,10.895642499377262,5.995968745117896
18066,/media/marda/TWOTB1/xBD/hurricanes/images/florence/hurricane-florence_00000118_pre_disaster.png,57,47,1,687,744,705,752,323,33.02848677076414,13.090894278590287
18067,/media/marda/TWOTB1/xBD/hurricanes/images/florence/hurricane-florence_00000118_pre_disaster.png,56,48,1,615,671,710,758,416,32.869690568494775,17.42134826479738
18068,/media/marda/TWOTB1/xBD/hurricanes/images/florence/hurricane-florence_00000118_pre_disaster.png,49,44,1,837,886,775,819,142,14.507421866630555,13.085291423146833
18069,/media/marda/TWOTB1/xBD/hurricanes/images/florence/hurricane-florence_00000118_pre_disaster.png,54,52,1,783,837,784,836,303,25.39164919249803,15.766396953530167
18070,/media/marda/TWOTB1/xBD/hurricanes/images/florence/hurricane-florence_00000118_pre_disaster.png,49,52,1,769,818,812,864,204,17.617170342349322,15.481425154517332
18071,/media/marda/TWOTB1/xBD/hurricanes/images/florence/hurricane-florence_00000118_pre_disaster.png,74,67,1,786,860,813,880,847,41.798464873867175,26.661996741239687
18072,/media/marda/TWOTB1/xBD/hurricanes/images/florence/hurricane-florence_00000118_pre_disaster.png,22,74,1,36,58,821,895,580,45.516369869310864,17.037190981380213
18073,/media/marda/TWOTB1/xBD/hurricanes/images/florence/hurricane-florence_00000118_pre_disaster.png,42,49,1,684,726,885,934,114,14.255230719854504,10.698439265866774
18074,/media/marda/TWOTB1/xBD/hurricanes/images/florence/hurricane-florence_00000118_pre_disaster.png,45,51,1,762,807,893,944,131,14.006612667118342,12.536168314277777
18075,/media/marda/TWOTB1/xBD/hurricanes/images/florence/hurricane-florence_00000118_pre_disaster.png,40,49,1,615,655,905,954,94,17.133395974314762,7.344120375474678
18076,/media/marda/TWOTB1/xBD/hurricanes/images/florence/hurricane-florence_00000118_pre_disaster.png,32,43,1,660,692,971,1014,46,8.820351326857361,7.0198936741736695
18077,/media/marda/TWOTB1/xBD/hurricanes/images/florence/hurricane-florence_00000118_pre_disaster.png,33,45,1,657,690,980,1025,71,10.87019246569509,8.697225572569343
18078,/media/marda/TWOTB1/xBD/hurricanes/images/florence/hurricane-florence_00000118_pre_disaster.png,60,61,1,707,767,981,1042,632,32.4378200937638,26.322016545320718
18079,/media/marda/TWOTB1/xBD/hurricanes/images/florence/hurricane-florence_00000279_pre_disaster.png,29,24,1,389,418,361,385,142,16.41743408091548,11.65418254854673
18080,/media/marda/TWOTB1/xBD/hurricanes/images/florence/hurricane-florence_00000279_pre_disaster.png,22,32,1,347,369,482,514,106,17.922006956356896,8.369915987689911
18081,/media/marda/TWOTB1/xBD/hurricanes/images/florence/hurricane-florence_00000279_pre_disaster.png,151,65,1,224,375,497,562,4175,159.74507646384416,34.71496508239535
18082,/media/marda/TWOTB1/xBD/hurricanes/images/florence/hurricane-florence_00000279_pre_disaster.png,21,34,1,354,375,535,569,83,15.706729582282769,7.606774863432381
18083,/media/marda/TWOTB1/xBD/hurricanes/images/florence/hurricane-florence_00000279_pre_disaster.png,152,64,1,229,381,551,615,4001,160.6986223621812,33.04625853896941
18084,/media/marda/TWOTB1/xBD/hurricanes/images/florence/hurricane-florence_00000279_pre_disaster.png,19,27,1,361,380,586,613,39,7.045638767423834,7.026202485519569
18085,/media/marda/TWOTB1/xBD/hurricanes/images/florence/hurricane-florence_00000279_pre_disaster.png,21,32,1,360,381,592,624,48,8.396005829706,7.381950773247812
18086,/media/marda/TWOTB1/xBD/hurricanes/images/florence/hurricane-florence_00000279_pre_disaster.png,151,68,1,235,386,602,670,3948,160.33359367214283,32.707687894750855
18087,/media/marda/TWOTB1/xBD/hurricanes/images/florence/hurricane-florence_00000279_pre_disaster.png,34,40,1,355,389,635,675,299,23.300597552174473,16.66513054354808
18088,/media/marda/TWOTB1/xBD/hurricanes/images/florence/hurricane-florence_00000279_pre_disaster.png,31,43,1,404,435,640,683,256,20.80081346834241,16.501124099746203
18089,/media/marda/TWOTB1/xBD/hurricanes/images/florence/hurricane-florence_00000279_pre_disaster.png,61,57,1,338,399,750,807,1032,53.27976721824268,25.695238520807283
18090,/media/marda/TWOTB1/xBD/hurricanes/images/florence/hurricane-florence_00000137_pre_disaster.png,39,39,1,730,769,766,805,93,12.027651394952851,10.420312555266552
18091,/media/marda/TWOTB1/xBD/hurricanes/images/florence/hurricane-florence_00000137_pre_disaster.png,57,73,1,160,217,837,910,1010,53.10636421977667,25.341919992039692
18092,/media/marda/TWOTB1/xBD/hurricanes/images/florence/hurricane-florence_00000137_pre_disaster.png,22,40,1,366,388,858,898,80,11.489125293076057,9.16515138991168
18093,/media/marda/TWOTB1/xBD/hurricanes/images/florence/hurricane-florence_00000137_pre_disaster.png,39,61,1,240,279,859,920,388,34.39138495493173,15.005118048650425
18094,/media/marda/TWOTB1/xBD/hurricanes/images/florence/hurricane-florence_00000137_pre_disaster.png,5,57,1,0,5,987,1044,76,19.589349696588798,5.1484644258245345
18095,/media/marda/TWOTB1/xBD/hurricanes/images/florence/hurricane-florence_00000152_post_disaster.png,47,35,1,502,549,247,282,408,23.4887940576912,22.93299096648429
18096,/media/marda/TWOTB1/xBD/hurricanes/images/florence/hurricane-florence_00000152_post_disaster.png,40,29,1,537,577,253,282,205,23.223920679922912,11.68267689973266
18097,/media/marda/TWOTB1/xBD/hurricanes/images/florence/hurricane-florence_00000152_post_disaster.png,63,57,1,392,455,254,311,811,65.82279267381912,16.335698868538124
18098,/media/marda/TWOTB1/xBD/hurricanes/images/florence/hurricane-florence_00000152_post_disaster.png,39,27,1,514,553,293,320,197,18.61088147315767,13.946242297244371
18099,/media/marda/TWOTB1/xBD/hurricanes/images/florence/hurricane-florence_00000152_post_disaster.png,55,52,1,444,499,309,361,883,40.521021040748046,28.58563121703239
18100,/media/marda/TWOTB1/xBD/hurricanes/images/florence/hurricane-florence_00000152_post_disaster.png,62,54,1,621,683,512,566,696,34.30495216921134,26.778864179586
18101,/media/marda/TWOTB1/xBD/hurricanes/images/florence/hurricane-florence_00000041_post_disaster.png,63,55,1,980,1043,357,412,862,45.933269489757876,24.66569041363205
18102,/media/marda/TWOTB1/xBD/hurricanes/images/florence/hurricane-florence_00000041_post_disaster.png,72,46,1,372,444,475,521,796,65.6097278213023,16.15007716553018
18103,/media/marda/TWOTB1/xBD/hurricanes/images/florence/hurricane-florence_00000041_post_disaster.png,115,72,1,928,1043,552,624,3515,86.22839414003859,53.95021676207462
18104,/media/marda/TWOTB1/xBD/hurricanes/images/florence/hurricane-florence_00000041_post_disaster.png,50,33,1,858,908,575,608,184,19.715125527125313,12.408189385401199
18105,/media/marda/TWOTB1/xBD/hurricanes/images/florence/hurricane-florence_00000041_post_disaster.png,114,70,1,929,1043,617,687,3071,85.37516200834445,47.64283133831585
18106,/media/marda/TWOTB1/xBD/hurricanes/images/florence/hurricane-florence_00000041_post_disaster.png,44,31,1,863,907,662,693,62,13.991796069665128,5.942202252938773
18107,/media/marda/TWOTB1/xBD/hurricanes/images/florence/hurricane-florence_00000041_post_disaster.png,108,63,1,935,1043,678,741,2381,78.73256689610636,40.108809440577176
18108,/media/marda/TWOTB1/xBD/hurricanes/images/florence/hurricane-florence_00000041_post_disaster.png,105,65,1,938,1043,733,798,2158,75.49548611158501,37.889860844008254
18109,/media/marda/TWOTB1/xBD/hurricanes/images/florence/hurricane-florence_00000496_post_disaster.png,34,76,1,0,34,786,862,767,47.8176067511754,22.57049723591278
18110,/media/marda/TWOTB1/xBD/hurricanes/images/florence/hurricane-florence_00000526_pre_disaster.png,64,87,1,624,688,382,469,2144,81.8041835738001,34.970149709710064
18111,/media/marda/TWOTB1/xBD/hurricanes/images/florence/hurricane-florence_00000505_post_disaster.png,32,41,1,175,207,620,661,254,27.413725476664492,12.415995603601784
18112,/media/marda/TWOTB1/xBD/hurricanes/images/florence/hurricane-florence_00000505_post_disaster.png,43,49,1,171,214,641,690,529,40.30609206750964,17.535716300794714
18113,/media/marda/TWOTB1/xBD/hurricanes/images/florence/hurricane-florence_00000505_post_disaster.png,45,43,1,165,210,657,700,297,43.57225202127685,9.11528844436449
18114,/media/marda/TWOTB1/xBD/hurricanes/images/florence/hurricane-florence_00000505_post_disaster.png,66,56,1,264,330,678,734,708,60.67785069857043,19.411184425696074
18115,/media/marda/TWOTB1/xBD/hurricanes/images/florence/hurricane-florence_00000505_post_disaster.png,96,194,1,308,404,622,816,5382,194.6249624192158,36.87908423241272
18116,/media/marda/TWOTB1/xBD/hurricanes/images/florence/hurricane-florence_00000505_post_disaster.png,43,64,1,161,204,714,778,850,38.80368159237108,30.379451670581847
18117,/media/marda/TWOTB1/xBD/hurricanes/images/florence/hurricane-florence_00000505_post_disaster.png,49,44,1,683,732,686,730,310,25.596342971886706,16.22030191480669
18118,/media/marda/TWOTB1/xBD/hurricanes/images/florence/hurricane-florence_00000505_post_disaster.png,69,54,1,858,927,724,778,851,39.36910036909919,28.83131513880669
18119,/media/marda/TWOTB1/xBD/hurricanes/images/florence/hurricane-florence_00000505_post_disaster.png,79,52,1,662,741,739,791,1034,59.34703216829455,23.115458071383802
18120,/media/marda/TWOTB1/xBD/hurricanes/images/florence/hurricane-florence_00000505_post_disaster.png,73,73,1,779,852,766,839,1407,51.74373475896918,40.05339267799207
18121,/media/marda/TWOTB1/xBD/hurricanes/images/florence/hurricane-florence_00000505_post_disaster.png,50,70,1,136,186,879,949,1082,49.110398153180455,31.42306526901836
18122,/media/marda/TWOTB1/xBD/hurricanes/images/florence/hurricane-florence_00000505_post_disaster.png,78,57,1,576,654,923,980,602,59.972781572172714,15.283876459918643
18123,/media/marda/TWOTB1/xBD/hurricanes/images/florence/hurricane-florence_00000505_post_disaster.png,37,58,1,133,170,935,993,524,36.17095177982819,19.368041205556437
18124,/media/marda/TWOTB1/xBD/hurricanes/images/florence/hurricane-florence_00000066_pre_disaster.png,21,15,1,10,31,39,54,196,23.186195211740472,11.356757684558142
18125,/media/marda/TWOTB1/xBD/hurricanes/images/florence/hurricane-florence_00000066_pre_disaster.png,19,20,1,17,36,56,76,288,19.838265756518428,19.44071199214171
18126,/media/marda/TWOTB1/xBD/hurricanes/images/florence/hurricane-florence_00000066_pre_disaster.png,95,38,1,866,961,57,95,1272,67.97847483194786,24.692864523804158
18127,/media/marda/TWOTB1/xBD/hurricanes/images/florence/hurricane-florence_00000066_pre_disaster.png,101,59,1,802,903,81,140,2623,69.87246286004176,49.68842528910725
18128,/media/marda/TWOTB1/xBD/hurricanes/images/florence/hurricane-florence_00000066_pre_disaster.png,70,42,1,882,952,120,162,1131,39.46131080740165,38.33832113740295
18129,/media/marda/TWOTB1/xBD/hurricanes/images/florence/hurricane-florence_00000066_pre_disaster.png,50,27,1,912,962,161,188,322,26.5329983228432,16.1245154965971
18130,/media/marda/TWOTB1/xBD/hurricanes/images/florence/hurricane-florence_00000066_pre_disaster.png,54,21,1,128,182,189,210,550,56.974849226297664,12.894720949594898
18131,/media/marda/TWOTB1/xBD/hurricanes/images/florence/hurricane-florence_00000066_pre_disaster.png,50,35,1,196,246,197,232,759,46.940020829680506,21.444872029400283
18132,/media/marda/TWOTB1/xBD/hurricanes/images/florence/hurricane-florence_00000066_pre_disaster.png,76,35,1,548,624,232,267,1082,58.965620800964786,24.48792057031125
18133,/media/marda/TWOTB1/xBD/hurricanes/images/florence/hurricane-florence_00000066_pre_disaster.png,61,91,1,961,1022,244,335,1223,91.47386318295128,21.386498822605827
18134,/media/marda/TWOTB1/xBD/hurricanes/images/florence/hurricane-florence_00000066_pre_disaster.png,61,54,1,983,1044,245,299,498,52.24247945119165,16.920996468556588
18135,/media/marda/TWOTB1/xBD/hurricanes/images/florence/hurricane-florence_00000066_pre_disaster.png,18,20,1,202,220,259,279,97,11.806746093884524,11.10837264244379
18136,/media/marda/TWOTB1/xBD/hurricanes/images/florence/hurricane-florence_00000066_pre_disaster.png,51,49,1,988,1039,299,348,388,42.70899791393896,12.10258146689453
18137,/media/marda/TWOTB1/xBD/hurricanes/images/florence/hurricane-florence_00000066_pre_disaster.png,28,44,1,184,212,355,399,533,34.04910534964269,20.772047995234615
18138,/media/marda/TWOTB1/xBD/hurricanes/images/florence/hurricane-florence_00000066_pre_disaster.png,59,73,1,578,637,426,499,1449,58.36059007242263,34.76068173314256
18139,/media/marda/TWOTB1/xBD/hurricanes/images/florence/hurricane-florence_00000066_pre_disaster.png,72,56,1,525,597,446,502,805,59.00948495700516,18.499510969933482
18140,/media/marda/TWOTB1/xBD/hurricanes/images/florence/hurricane-florence_00000066_pre_disaster.png,51,63,1,495,546,531,594,532,48.763950601674544,14.452935437438654
18141,/media/marda/TWOTB1/xBD/hurricanes/images/florence/hurricane-florence_00000066_pre_disaster.png,44,41,1,604,648,765,806,195,22.030140497707954,11.764560147460415
18142,/media/marda/TWOTB1/xBD/hurricanes/images/florence/hurricane-florence_00000066_pre_disaster.png,50,65,1,602,652,780,845,822,39.33924618120163,27.562287522284784
18143,/media/marda/TWOTB1/xBD/hurricanes/images/florence/hurricane-florence_00000462_post_disaster.png,27,43,1,0,27,116,159,729,37.14509345025359,26.40403156423377
18144,/media/marda/TWOTB1/xBD/hurricanes/images/florence/hurricane-florence_00000462_post_disaster.png,58,74,1,109,167,140,214,2115,70.1718489869732,45.583949779393436
18145,/media/marda/TWOTB1/xBD/hurricanes/images/florence/hurricane-florence_00000462_post_disaster.png,65,42,1,177,242,169,211,1516,59.80995086599002,33.73750368173075
18146,/media/marda/TWOTB1/xBD/hurricanes/images/florence/hurricane-florence_00000462_post_disaster.png,60,52,1,250,310,200,252,1419,47.49850843310038,39.99665606135041
18147,/media/marda/TWOTB1/xBD/hurricanes/images/florence/hurricane-florence_00000462_post_disaster.png,68,64,1,360,428,241,305,1805,54.50632064338122,44.267456457816124
18148,/media/marda/TWOTB1/xBD/hurricanes/images/florence/hurricane-florence_00000462_post_disaster.png,84,62,1,295,379,372,434,1887,70.10932843852213,41.508175825794375
18149,/media/marda/TWOTB1/xBD/hurricanes/images/florence/hurricane-florence_00000462_post_disaster.png,72,67,1,739,811,375,442,1470,53.77117952582928,36.15959576733934
18150,/media/marda/TWOTB1/xBD/hurricanes/images/florence/hurricane-florence_00000462_post_disaster.png,78,78,1,809,887,389,467,1647,60.412293999133965,38.99582264055743
18151,/media/marda/TWOTB1/xBD/hurricanes/images/florence/hurricane-florence_00000462_post_disaster.png,99,63,1,862,961,428,491,1732,61.872723446968116,38.45542639307987
18152,/media/marda/TWOTB1/xBD/hurricanes/images/florence/hurricane-florence_00000462_post_disaster.png,94,64,1,930,1024,444,508,1641,53.766301489119236,41.43337228519899
18153,/media/marda/TWOTB1/xBD/hurricanes/images/florence/hurricane-florence_00000462_post_disaster.png,70,66,1,79,149,500,566,1726,63.459832532937995,38.57408914861162
18154,/media/marda/TWOTB1/xBD/hurricanes/images/florence/hurricane-florence_00000462_post_disaster.png,78,61,1,693,771,532,593,1281,46.32178749168787,36.84261798300204
18155,/media/marda/TWOTB1/xBD/hurricanes/images/florence/hurricane-florence_00000462_post_disaster.png,74,66,1,57,131,547,613,1794,67.57427170628644,38.938973998625755
18156,/media/marda/TWOTB1/xBD/hurricanes/images/florence/hurricane-florence_00000462_post_disaster.png,117,80,1,817,934,564,644,2211,88.15026276433223,42.23857791233155
18157,/media/marda/TWOTB1/xBD/hurricanes/images/florence/hurricane-florence_00000462_post_disaster.png,58,60,1,476,534,580,640,1179,41.24920532634344,37.26676339206897
18158,/media/marda/TWOTB1/xBD/hurricanes/images/florence/hurricane-florence_00000462_post_disaster.png,102,81,1,890,992,591,672,1968,63.75508054921113,46.669012015291074
18159,/media/marda/TWOTB1/xBD/hurricanes/images/florence/hurricane-florence_00000462_post_disaster.png,65,77,1,8,73,631,708,1819,58.970812362226205,45.129573670146904
18160,/media/marda/TWOTB1/xBD/hurricanes/images/florence/hurricane-florence_00000462_post_disaster.png,37,80,1,0,37,674,754,1224,57.41437945236052,29.99419622362684
18161,/media/marda/TWOTB1/xBD/hurricanes/images/florence/hurricane-florence_00000462_post_disaster.png,95,75,1,572,667,706,781,1743,66.42344035495968,38.56301758498313
18162,/media/marda/TWOTB1/xBD/hurricanes/images/florence/hurricane-florence_00000462_post_disaster.png,70,93,1,973,1043,770,863,1201,57.23187564345849,32.14067603711831
18163,/media/marda/TWOTB1/xBD/hurricanes/images/florence/hurricane-florence_00000462_post_disaster.png,92,74,1,477,569,777,851,1827,69.06491391537556,38.12824575524182
18164,/media/marda/TWOTB1/xBD/hurricanes/images/florence/hurricane-florence_00000462_post_disaster.png,84,78,1,431,515,811,889,1636,63.40461332402613,39.5843883829785
18165,/media/marda/TWOTB1/xBD/hurricanes/images/florence/hurricane-florence_00000462_post_disaster.png,56,104,1,27,83,837,941,1994,70.20401589007922,40.43563192489366
18166,/media/marda/TWOTB1/xBD/hurricanes/images/florence/hurricane-florence_00000462_post_disaster.png,107,120,1,900,1007,885,1005,2708,84.42072355037834,50.88733570885658
18167,/media/marda/TWOTB1/xBD/hurricanes/images/florence/hurricane-florence_00000462_post_disaster.png,66,81,1,179,245,898,979,1795,59.96523367448179,43.374468873653115
18168,/media/marda/TWOTB1/xBD/hurricanes/images/florence/hurricane-florence_00000462_post_disaster.png,96,97,1,838,934,938,1035,2027,68.26321370256319,43.55164905491768
18169,/media/marda/TWOTB1/xBD/hurricanes/images/florence/hurricane-florence_00000375_post_disaster.png,28,31,1,294,322,507,538,142,19.91611860636397,9.378530218543787
18170,/media/marda/TWOTB1/xBD/hurricanes/images/florence/hurricane-florence_00000375_post_disaster.png,27,29,1,293,320,558,587,121,17.696584664078717,8.919415805494744
18171,/media/marda/TWOTB1/xBD/hurricanes/images/florence/hurricane-florence_00000375_post_disaster.png,115,60,1,288,403,466,526,2991,118.38795240280182,33.572993246596475
18172,/media/marda/TWOTB1/xBD/hurricanes/images/florence/hurricane-florence_00000375_post_disaster.png,30,38,1,404,434,495,533,194,18.86298964743751,13.700070289968584
18173,/media/marda/TWOTB1/xBD/hurricanes/images/florence/hurricane-florence_00000375_post_disaster.png,121,65,1,294,415,514,579,3168,120.37516484663152,35.01802355944688
18174,/media/marda/TWOTB1/xBD/hurricanes/images/florence/hurricane-florence_00000338_post_disaster.png,31,15,1,37,68,0,15,213,29.171149408705496,10.067430254018172
18175,/media/marda/TWOTB1/xBD/hurricanes/images/florence/hurricane-florence_00000338_post_disaster.png,42,38,1,247,289,57,95,687,37.44178611905135,24.50668190854184
18176,/media/marda/TWOTB1/xBD/hurricanes/images/florence/hurricane-florence_00000338_post_disaster.png,27,21,1,268,295,82,103,208,18.557974615086554,14.993966580164997
18177,/media/marda/TWOTB1/xBD/hurricanes/images/florence/hurricane-florence_00000338_post_disaster.png,38,32,1,278,316,186,218,365,30.140513280316995,17.330888538031417
18178,/media/marda/TWOTB1/xBD/hurricanes/images/florence/hurricane-florence_00000338_post_disaster.png,41,45,1,202,243,211,256,707,36.02232008524549,26.044385475164656
18179,/media/marda/TWOTB1/xBD/hurricanes/images/florence/hurricane-florence_00000338_post_disaster.png,33,33,1,219,252,256,289,362,22.70083050514482,21.337168955565
18180,/media/marda/TWOTB1/xBD/hurricanes/images/florence/hurricane-florence_00000338_post_disaster.png,30,24,1,221,251,281,305,164,23.53700991383491,9.381510199324143
18181,/media/marda/TWOTB1/xBD/hurricanes/images/florence/hurricane-florence_00000338_post_disaster.png,19,21,1,234,253,306,327,56,10.540787825377707,7.169518540460145
18182,/media/marda/TWOTB1/xBD/hurricanes/images/florence/hurricane-florence_00000338_post_disaster.png,51,69,1,177,228,384,453,1307,58.790363874034114,32.31411824663926
18183,/media/marda/TWOTB1/xBD/hurricanes/images/florence/hurricane-florence_00000338_post_disaster.png,27,34,1,208,235,476,510,175,19.734663566603146,11.76681327842475
18184,/media/marda/TWOTB1/xBD/hurricanes/images/florence/hurricane-florence_00000338_post_disaster.png,59,66,1,296,355,789,855,1041,45.89319830724484,30.79468234388902
18185,/media/marda/TWOTB1/xBD/hurricanes/images/florence/hurricane-florence_00000073_pre_disaster.png,57,48,1,663,720,435,483,522,28.361576311750238,24.56672157807912
18186,/media/marda/TWOTB1/xBD/hurricanes/images/florence/hurricane-florence_00000073_pre_disaster.png,86,84,1,622,708,504,588,2279,60.344024668695326,49.640692410481954
18187,/media/marda/TWOTB1/xBD/hurricanes/images/florence/hurricane-florence_00000225_pre_disaster.png,64,48,1,513,577,134,182,1496,45.50719698650026,43.86995216162109
18188,/media/marda/TWOTB1/xBD/hurricanes/images/florence/hurricane-florence_00000225_pre_disaster.png,55,34,1,544,599,356,390,525,38.41399922685535,18.602949206549734
18189,/media/marda/TWOTB1/xBD/hurricanes/images/florence/hurricane-florence_00000225_pre_disaster.png,42,29,1,610,652,361,390,228,18.791530207568808,16.154331255491144
18190,/media/marda/TWOTB1/xBD/hurricanes/images/florence/hurricane-florence_00000225_pre_disaster.png,46,42,1,633,679,370,412,484,30.16725957869737,21.2888432235267
18191,/media/marda/TWOTB1/xBD/hurricanes/images/florence/hurricane-florence_00000225_pre_disaster.png,38,33,1,494,532,372,405,270,21.283445243537713,17.53150347968085
18192,/media/marda/TWOTB1/xBD/hurricanes/images/florence/hurricane-florence_00000225_pre_disaster.png,56,51,1,494,550,387,438,1118,40.019463919873814,37.39590633549541
18193,/media/marda/TWOTB1/xBD/hurricanes/images/florence/hurricane-florence_00000225_pre_disaster.png,34,23,1,562,596,392,415,86,13.7906726627086,8.446832911432315
18194,/media/marda/TWOTB1/xBD/hurricanes/images/florence/hurricane-florence_00000225_pre_disaster.png,63,57,1,564,627,403,460,1068,38.46853923647004,36.99870249497796
18195,/media/marda/TWOTB1/xBD/hurricanes/images/florence/hurricane-florence_00000225_pre_disaster.png,37,31,1,664,701,439,470,109,14.113897291605856,10.282958628063724
18196,/media/marda/TWOTB1/xBD/hurricanes/images/florence/hurricane-florence_00000225_pre_disaster.png,57,71,1,647,704,453,524,1163,57.33862627305426,26.71220824836699
18197,/media/marda/TWOTB1/xBD/hurricanes/images/florence/hurricane-florence_00000225_pre_disaster.png,37,33,1,198,235,472,505,408,31.574718614562027,16.965975773698194
18198,/media/marda/TWOTB1/xBD/hurricanes/images/florence/hurricane-florence_00000225_pre_disaster.png,62,36,1,964,1026,475,511,343,25.29559440817448,18.066293927613703
18199,/media/marda/TWOTB1/xBD/hurricanes/images/florence/hurricane-florence_00000225_pre_disaster.png,23,38,1,232,255,478,516,206,22.92428263763094,11.95227774033936
18200,/media/marda/TWOTB1/xBD/hurricanes/images/florence/hurricane-florence_00000225_pre_disaster.png,25,53,1,287,312,478,531,552,42.505013793669306,17.21379441535129
18201,/media/marda/TWOTB1/xBD/hurricanes/images/florence/hurricane-florence_00000225_pre_disaster.png,71,54,1,579,650,481,535,1264,52.49843445738341,34.3987321803317
18202,/media/marda/TWOTB1/xBD/hurricanes/images/florence/hurricane-florence_00000225_pre_disaster.png,39,47,1,187,226,491,538,621,37.656033545750795,24.388742937440515
18203,/media/marda/TWOTB1/xBD/hurricanes/images/florence/hurricane-florence_00000225_pre_disaster.png,47,37,1,92,139,503,540,617,51.00591235539424,16.09404333482276
18204,/media/marda/TWOTB1/xBD/hurricanes/images/florence/hurricane-florence_00000225_pre_disaster.png,66,59,1,972,1038,517,576,688,38.44880372315705,23.537638967837562
18205,/media/marda/TWOTB1/xBD/hurricanes/images/florence/hurricane-florence_00000225_pre_disaster.png,32,34,1,328,360,541,575,277,22.87728510942136,15.99221499962756
18206,/media/marda/TWOTB1/xBD/hurricanes/images/florence/hurricane-florence_00000225_pre_disaster.png,68,61,1,114,182,626,687,1636,73.0442690887662,30.78055666669566
18207,/media/marda/TWOTB1/xBD/hurricanes/images/florence/hurricane-florence_00000225_pre_disaster.png,55,54,1,218,273,637,691,1153,51.53266827043654,30.10988275811118
18208,/media/marda/TWOTB1/xBD/hurricanes/images/florence/hurricane-florence_00000225_pre_disaster.png,60,56,1,287,347,645,701,1249,56.74563705674492,31.265520857828044
18209,/media/marda/TWOTB1/xBD/hurricanes/images/florence/hurricane-florence_00000225_pre_disaster.png,52,56,1,370,422,647,703,897,40.183083438946134,29.80374410908516
18210,/media/marda/TWOTB1/xBD/hurricanes/images/florence/hurricane-florence_00000225_pre_disaster.png,72,58,1,820,892,659,717,910,40.067298980221594,30.796387124606483
18211,/media/marda/TWOTB1/xBD/hurricanes/images/florence/hurricane-florence_00000225_pre_disaster.png,38,58,1,156,194,682,740,1082,39.016135688965115,36.393895886980836
18212,/media/marda/TWOTB1/xBD/hurricanes/images/florence/hurricane-florence_00000225_pre_disaster.png,31,55,1,328,359,683,738,586,35.62249835320967,21.820111690938305
18213,/media/marda/TWOTB1/xBD/hurricanes/images/florence/hurricane-florence_00000225_pre_disaster.png,43,49,1,384,427,694,743,567,32.80103833502301,23.00335687453707
18214,/media/marda/TWOTB1/xBD/hurricanes/images/florence/hurricane-florence_00000225_pre_disaster.png,32,53,1,211,243,702,755,529,27.645753749286943,25.286914367196115
18215,/media/marda/TWOTB1/xBD/hurricanes/images/florence/hurricane-florence_00000225_pre_disaster.png,81,52,1,922,1003,705,757,817,49.098359562321214,22.082278164648155
18216,/media/marda/TWOTB1/xBD/hurricanes/images/florence/hurricane-florence_00000225_pre_disaster.png,45,37,1,829,874,733,770,114,14.718374362133243,10.142222904147909
18217,/media/marda/TWOTB1/xBD/hurricanes/images/florence/hurricane-florence_00000225_pre_disaster.png,35,52,1,324,359,735,787,519,26.758123465922193,25.867296361626522
18218,/media/marda/TWOTB1/xBD/hurricanes/images/florence/hurricane-florence_00000225_pre_disaster.png,67,41,1,977,1044,742,783,262,33.25676333283825,10.516421275005428
18219,/media/marda/TWOTB1/xBD/hurricanes/images/florence/hurricane-florence_00000225_pre_disaster.png,53,43,1,972,1025,761,804,114,13.82727709369943,11.091993681949786
18220,/media/marda/TWOTB1/xBD/hurricanes/images/florence/hurricane-florence_00000225_pre_disaster.png,46,64,1,356,402,772,836,1109,38.92596962461688,38.03511282555622
18221,/media/marda/TWOTB1/xBD/hurricanes/images/florence/hurricane-florence_00000225_pre_disaster.png,46,38,1,951,997,780,818,65,10.255349617167536,8.596895997841836
18222,/media/marda/TWOTB1/xBD/hurricanes/images/florence/hurricane-florence_00000225_pre_disaster.png,45,38,1,939,984,783,821,58,9.19321378667686,8.569692874779994
18223,/media/marda/TWOTB1/xBD/hurricanes/images/florence/hurricane-florence_00000481_post_disaster.png,57,12,1,900,957,80,92,232,22.424120744536424,13.756224760264104
18224,/media/marda/TWOTB1/xBD/hurricanes/images/florence/hurricane-florence_00000481_post_disaster.png,49,37,1,822,871,667,704,190,18.700431046635842,13.294542045482583
18225,/media/marda/TWOTB1/xBD/hurricanes/images/florence/hurricane-florence_00000481_post_disaster.png,51,82,1,870,921,686,768,762,60.46095010706871,16.728325299374813
18226,/media/marda/TWOTB1/xBD/hurricanes/images/florence/hurricane-florence_00000481_post_disaster.png,39,46,1,608,647,697,743,197,18.726577730784147,13.975006451370705
18227,/media/marda/TWOTB1/xBD/hurricanes/images/florence/hurricane-florence_00000481_post_disaster.png,40,64,1,116,156,778,842,701,39.3970998254856,24.21481292442666
18228,/media/marda/TWOTB1/xBD/hurricanes/images/florence/hurricane-florence_00000481_post_disaster.png,64,63,1,778,842,787,850,777,34.78275463957019,29.522752928862488
18229,/media/marda/TWOTB1/xBD/hurricanes/images/florence/hurricane-florence_00000481_post_disaster.png,76,68,1,848,924,805,873,948,47.86305317423139,29.285128166631488
18230,/media/marda/TWOTB1/xBD/hurricanes/images/florence/hurricane-florence_00000481_post_disaster.png,51,72,1,77,128,822,894,1050,49.7870214849915,27.981957647464803
18231,/media/marda/TWOTB1/xBD/hurricanes/images/florence/hurricane-florence_00000481_post_disaster.png,33,57,1,408,441,825,882,379,28.42943655861544,17.888054875335797
18232,/media/marda/TWOTB1/xBD/hurricanes/images/florence/hurricane-florence_00000481_post_disaster.png,39,62,1,285,324,837,899,601,30.821186364110066,26.045206390634817
18233,/media/marda/TWOTB1/xBD/hurricanes/images/florence/hurricane-florence_00000481_post_disaster.png,61,67,1,360,421,858,925,1021,49.170226868977956,28.41352311780125
18234,/media/marda/TWOTB1/xBD/hurricanes/images/florence/hurricane-florence_00000481_post_disaster.png,55,73,1,240,295,887,960,885,50.93966328196721,23.0814793893932
18235,/media/marda/TWOTB1/xBD/hurricanes/images/florence/hurricane-florence_00000481_post_disaster.png,70,79,1,828,898,918,997,967,42.34953573648577,30.190044103226164
18236,/media/marda/TWOTB1/xBD/hurricanes/images/florence/hurricane-florence_00000481_post_disaster.png,68,69,1,365,433,944,1013,669,64.91052394940425,13.63450427050168
18237,/media/marda/TWOTB1/xBD/hurricanes/images/florence/hurricane-florence_00000481_post_disaster.png,55,75,1,34,89,952,1027,1154,57.19234749315347,27.0489229499216
18238,/media/marda/TWOTB1/xBD/hurricanes/images/florence/hurricane-florence_00000520_pre_disaster.png,310,41,1,734,1044,0,41,8977,312.5767633498315,38.49909584484857
18239,/media/marda/TWOTB1/xBD/hurricanes/images/florence/hurricane-florence_00000520_pre_disaster.png,61,15,1,977,1038,59,74,283,26.115100802823655,14.407728864710723
18240,/media/marda/TWOTB1/xBD/hurricanes/images/florence/hurricane-florence_00000520_pre_disaster.png,308,55,1,727,1035,74,129,10201,313.2609900879449,43.321501513828004
18241,/media/marda/TWOTB1/xBD/hurricanes/images/florence/hurricane-florence_00000520_pre_disaster.png,48,7,1,986,1034,75,82,45,8.165711355093652,6.98044340741045
18242,/media/marda/TWOTB1/xBD/hurricanes/images/florence/hurricane-florence_00000520_pre_disaster.png,308,53,1,702,1010,429,482,9706,315.7629015591411,40.917474104888534
18243,/media/marda/TWOTB1/xBD/hurricanes/images/florence/hurricane-florence_00000520_pre_disaster.png,44,29,1,958,1002,467,496,76,14.247888523304018,7.540134501862152
18244,/media/marda/TWOTB1/xBD/hurricanes/images/florence/hurricane-florence_00000520_pre_disaster.png,309,58,1,700,1009,513,571,9869,316.57616821157296,41.46625663645213
18245,/media/marda/TWOTB1/xBD/hurricanes/images/florence/hurricane-florence_00000520_pre_disaster.png,44,33,1,958,1002,553,586,88,15.01198989084629,8.249823089299074
18246,/media/marda/TWOTB1/xBD/hurricanes/images/florence/hurricane-florence_00000520_pre_disaster.png,46,34,1,957,1003,585,619,115,15.689356295948508,9.687613003761678
18247,/media/marda/TWOTB1/xBD/hurricanes/images/florence/hurricane-florence_00000520_pre_disaster.png,307,63,1,700,1007,597,660,9946,314.7083426582557,42.05778763190926
18248,/media/marda/TWOTB1/xBD/hurricanes/images/florence/hurricane-florence_00000520_pre_disaster.png,60,50,1,946,1006,639,689,546,28.427513740990616,25.421475776181826
18249,/media/marda/TWOTB1/xBD/hurricanes/images/florence/hurricane-florence_00000520_pre_disaster.png,70,59,1,935,1005,734,793,966,37.48192783300528,34.11998874270393
18250,/media/marda/TWOTB1/xBD/hurricanes/images/florence/hurricane-florence_00000258_post_disaster.png,64,54,1,421,485,114,168,1179,55.771840090520655,31.67988174120378
18251,/media/marda/TWOTB1/xBD/hurricanes/images/florence/hurricane-florence_00000258_post_disaster.png,37,27,1,488,525,146,173,278,21.32860243413777,17.460177862985013
18252,/media/marda/TWOTB1/xBD/hurricanes/images/florence/hurricane-florence_00000258_post_disaster.png,71,58,1,684,755,190,248,1221,52.37084965441997,30.716293463087627
18253,/media/marda/TWOTB1/xBD/hurricanes/images/florence/hurricane-florence_00000258_post_disaster.png,39,27,1,687,726,274,301,143,17.26573575130172,11.21822608779182
18254,/media/marda/TWOTB1/xBD/hurricanes/images/florence/hurricane-florence_00000258_post_disaster.png,31,29,1,68,99,285,314,365,31.111474434899385,16.062163490586514
18255,/media/marda/TWOTB1/xBD/hurricanes/images/florence/hurricane-florence_00000258_post_disaster.png,77,58,1,959,1036,314,372,1055,41.946261244392254,32.989909835106296
18256,/media/marda/TWOTB1/xBD/hurricanes/images/florence/hurricane-florence_00000258_post_disaster.png,65,49,1,968,1033,366,415,580,37.488976840805186,20.656540556158973
18257,/media/marda/TWOTB1/xBD/hurricanes/images/florence/hurricane-florence_00000258_post_disaster.png,60,39,1,983,1043,393,432,302,22.651347202633854,17.931659845647015
18258,/media/marda/TWOTB1/xBD/hurricanes/images/florence/hurricane-florence_00000258_post_disaster.png,27,57,1,215,242,901,958,236,18.423753544004242,17.168000905081556
18259,/media/marda/TWOTB1/xBD/hurricanes/images/florence/hurricane-florence_00000258_post_disaster.png,81,95,1,123,204,946,1041,2546,66.47737446125115,52.684458027823425
18260,/media/marda/TWOTB1/xBD/hurricanes/images/florence/hurricane-florence_00000258_post_disaster.png,26,56,1,199,225,954,1010,176,20.36146095697096,11.568751488537226
18261,/media/marda/TWOTB1/xBD/hurricanes/images/florence/hurricane-florence_00000258_post_disaster.png,36,57,1,74,110,986,1043,284,26.705461632133105,16.81656607914039
18262,/media/marda/TWOTB1/xBD/hurricanes/images/florence/hurricane-florence_00000425_post_disaster.png,36,55,1,256,292,484,539,758,37.74383686256199,26.67512488569934
18263,/media/marda/TWOTB1/xBD/hurricanes/images/florence/hurricane-florence_00000425_post_disaster.png,22,27,1,231,253,491,518,123,14.364955469314191,11.133894524210612
18264,/media/marda/TWOTB1/xBD/hurricanes/images/florence/hurricane-florence_00000425_post_disaster.png,18,57,1,0,18,490,547,613,41.61413342908536,19.676705497054883
18265,/media/marda/TWOTB1/xBD/hurricanes/images/florence/hurricane-florence_00000425_post_disaster.png,49,74,1,422,471,567,641,778,61.428527496384284,16.88330883677441
18266,/media/marda/TWOTB1/xBD/hurricanes/images/florence/hurricane-florence_00000425_post_disaster.png,20,58,1,0,20,568,626,722,42.78384944458643,22.523901975922524
18267,/media/marda/TWOTB1/xBD/hurricanes/images/florence/hurricane-florence_00000425_post_disaster.png,20,33,1,340,360,609,642,52,8.8167949841457,8.006889536748778
18268,/media/marda/TWOTB1/xBD/hurricanes/images/florence/hurricane-florence_00000425_post_disaster.png,35,41,1,406,441,629,670,199,17.504126447619182,15.10232238037948
18269,/media/marda/TWOTB1/xBD/hurricanes/images/florence/hurricane-florence_00000425_post_disaster.png,43,64,1,0,43,655,719,1538,48.63002663799154,42.211583466001244
18270,/media/marda/TWOTB1/xBD/hurricanes/images/florence/hurricane-florence_00000425_post_disaster.png,15,44,1,31,46,728,772,235,18.42588581369137,16.86737861287516
18271,/media/marda/TWOTB1/xBD/hurricanes/images/florence/hurricane-florence_00000425_post_disaster.png,21,56,1,13,34,761,817,541,31.265808538646237,23.053636679403866
18272,/media/marda/TWOTB1/xBD/hurricanes/images/florence/hurricane-florence_00000425_post_disaster.png,56,86,1,240,296,796,882,1259,50.47996491111982,39.540796255968594
18273,/media/marda/TWOTB1/xBD/hurricanes/images/florence/hurricane-florence_00000425_post_disaster.png,32,58,1,92,124,842,900,520,30.084826990144297,22.88928178156851
18274,/media/marda/TWOTB1/xBD/hurricanes/images/florence/hurricane-florence_00000425_post_disaster.png,71,48,1,81,152,882,930,1021,78.60635195001001,17.301408533040643
18275,/media/marda/TWOTB1/xBD/hurricanes/images/florence/hurricane-florence_00000425_post_disaster.png,54,60,1,589,643,890,950,422,33.496727569667264,16.720879287597334
18276,/media/marda/TWOTB1/xBD/hurricanes/images/florence/hurricane-florence_00000425_post_disaster.png,56,80,1,583,639,938,1018,747,44.515077251782415,22.099178246752874
18277,/media/marda/TWOTB1/xBD/hurricanes/images/florence/hurricane-florence_00000425_post_disaster.png,143,68,1,900,1043,752,820,3080,119.96708408334045,34.129724640792546
18278,/media/marda/TWOTB1/xBD/hurricanes/images/florence/hurricane-florence_00000425_post_disaster.png,172,76,1,871,1043,817,893,4146,156.58096796409782,35.25703236557197
18279,/media/marda/TWOTB1/xBD/hurricanes/images/florence/hurricane-florence_00000185_pre_disaster.png,26,39,1,369,395,19,58,476,44.016341585332846,14.405927371198
18280,/media/marda/TWOTB1/xBD/hurricanes/images/florence/hurricane-florence_00000185_pre_disaster.png,47,10,1,954,1001,41,51,54,9.595346649520952,7.625716025249646
18281,/media/marda/TWOTB1/xBD/hurricanes/images/florence/hurricane-florence_00000185_pre_disaster.png,50,28,1,250,300,45,73,817,46.48091257648226,23.174154983869457
18282,/media/marda/TWOTB1/xBD/hurricanes/images/florence/hurricane-florence_00000185_pre_disaster.png,63,26,1,953,1016,66,92,371,27.076874915035464,18.053571929671993
18283,/media/marda/TWOTB1/xBD/hurricanes/images/florence/hurricane-florence_00000185_pre_disaster.png,73,35,1,801,874,179,214,677,36.07275019291219,25.831163757825124
18284,/media/marda/TWOTB1/xBD/hurricanes/images/florence/hurricane-florence_00000185_pre_disaster.png,75,45,1,948,1023,197,242,718,32.81045810185564,29.217513300896343
18285,/media/marda/TWOTB1/xBD/hurricanes/images/florence/hurricane-florence_00000185_pre_disaster.png,93,78,1,719,812,324,402,2243,61.47387837680089,50.619610185034276
18286,/media/marda/TWOTB1/xBD/hurricanes/images/florence/hurricane-florence_00000185_pre_disaster.png,64,44,1,980,1044,339,383,469,29.98946097514832,20.42422123130115
18287,/media/marda/TWOTB1/xBD/hurricanes/images/florence/hurricane-florence_00000185_pre_disaster.png,55,35,1,783,838,365,400,327,24.219337877342696,17.78673926967948
18288,/media/marda/TWOTB1/xBD/hurricanes/images/florence/hurricane-florence_00000185_pre_disaster.png,62,38,1,982,1044,375,413,292,27.21750813127725,14.513143894439292
18289,/media/marda/TWOTB1/xBD/hurricanes/images/florence/hurricane-florence_00000185_pre_disaster.png,86,67,1,958,1044,382,449,1307,57.516917038834706,32.40482408359564
18290,/media/marda/TWOTB1/xBD/hurricanes/images/florence/hurricane-florence_00000185_pre_disaster.png,49,30,1,776,825,383,413,174,20.77508408383579,11.115723597180535
18291,/media/marda/TWOTB1/xBD/hurricanes/images/florence/hurricane-florence_00000185_pre_disaster.png,92,66,1,763,855,400,466,1664,63.37603281056992,35.7250619264932
18292,/media/marda/TWOTB1/xBD/hurricanes/images/florence/hurricane-florence_00000185_pre_disaster.png,44,40,1,656,700,510,550,192,19.629909152447276,13.080944580232387
18293,/media/marda/TWOTB1/xBD/hurricanes/images/florence/hurricane-florence_00000185_pre_disaster.png,60,56,1,670,730,523,579,649,35.00915492940045,24.467285776973686
18294,/media/marda/TWOTB1/xBD/hurricanes/images/florence/hurricane-florence_00000185_pre_disaster.png,69,69,1,689,758,546,615,690,58.51484485754354,15.75876724881271
18295,/media/marda/TWOTB1/xBD/hurricanes/images/florence/hurricane-florence_00000185_pre_disaster.png,40,40,1,572,612,589,629,137,17.55685731791573,10.470295086387498
18296,/media/marda/TWOTB1/xBD/hurricanes/images/florence/hurricane-florence_00000185_pre_disaster.png,59,59,1,579,638,610,669,631,35.37145967028244,23.812346127907983
18297,/media/marda/TWOTB1/xBD/hurricanes/images/florence/hurricane-florence_00000185_pre_disaster.png,67,67,1,613,680,645,712,993,45.35871916927756,28.71347922932756
18298,/media/marda/TWOTB1/xBD/hurricanes/images/florence/hurricane-florence_00000185_pre_disaster.png,41,44,1,529,570,654,698,200,20.486833576604496,13.070946790669394
18299,/media/marda/TWOTB1/xBD/hurricanes/images/florence/hurricane-florence_00000185_pre_disaster.png,70,66,1,520,590,680,746,758,58.85266970343162,17.191160866476473
18300,/media/marda/TWOTB1/xBD/hurricanes/images/florence/hurricane-florence_00000185_pre_disaster.png,65,78,1,539,604,724,802,1016,52.64367203279417,25.75574966552704
18301,/media/marda/TWOTB1/xBD/hurricanes/images/florence/hurricane-florence_00000185_pre_disaster.png,238,159,1,113,351,881,1040,15132,186.29696390859942,122.19319958772157
18302,/media/marda/TWOTB1/xBD/hurricanes/images/florence/hurricane-florence_00000385_post_disaster.png,50,40,1,392,442,0,40,905,43.276163212925105,30.319908296505684
18303,/media/marda/TWOTB1/xBD/hurricanes/images/florence/hurricane-florence_00000385_post_disaster.png,74,48,1,918,992,12,60,1081,48.42875056697187,30.227154420187833
18304,/media/marda/TWOTB1/xBD/hurricanes/images/florence/hurricane-florence_00000385_post_disaster.png,39,23,1,350,389,17,40,363,24.814262738203478,20.12264791327982
18305,/media/marda/TWOTB1/xBD/hurricanes/images/florence/hurricane-florence_00000385_post_disaster.png,40,25,1,324,364,20,45,361,27.812647373076455,17.692335056453587
18306,/media/marda/TWOTB1/xBD/hurricanes/images/florence/hurricane-florence_00000385_post_disaster.png,31,16,1,374,405,27,43,182,18.00717520567534,13.281366734511968
18307,/media/marda/TWOTB1/xBD/hurricanes/images/florence/hurricane-florence_00000385_post_disaster.png,47,28,1,433,480,48,76,513,31.14666901833223,21.65341593093476
18308,/media/marda/TWOTB1/xBD/hurricanes/images/florence/hurricane-florence_00000385_post_disaster.png,50,30,1,382,432,73,103,524,38.30589155508015,18.68899897424522
18309,/media/marda/TWOTB1/xBD/hurricanes/images/florence/hurricane-florence_00000385_post_disaster.png,39,36,1,465,504,198,234,417,32.74174361611718,17.450406396939005
18310,/media/marda/TWOTB1/xBD/hurricanes/images/florence/hurricane-florence_00000385_post_disaster.png,45,24,1,999,1044,228,252,50,15.335641733308819,4.696093336763753
18311,/media/marda/TWOTB1/xBD/hurricanes/images/florence/hurricane-florence_00000385_post_disaster.png,56,51,1,311,367,770,821,447,50.38322425000803,12.008124692155416
18312,/media/marda/TWOTB1/xBD/hurricanes/images/florence/hurricane-florence_00000385_post_disaster.png,229,226,1,811,1040,781,1007,23496,187.77880612151452,167.51923532864447
18313,/media/marda/TWOTB1/xBD/hurricanes/images/florence/hurricane-florence_00000385_post_disaster.png,42,88,1,337,379,831,919,1272,62.366013585226234,27.2191661087282
18314,/media/marda/TWOTB1/xBD/hurricanes/images/florence/hurricane-florence_00000385_post_disaster.png,23,44,1,172,195,869,913,204,21.447519792748427,12.7077602433659
18315,/media/marda/TWOTB1/xBD/hurricanes/images/florence/hurricane-florence_00000385_post_disaster.png,62,65,1,184,246,895,960,1243,63.83045539803864,26.833691190085343
18316,/media/marda/TWOTB1/xBD/hurricanes/images/florence/hurricane-florence_00000385_post_disaster.png,44,81,1,386,430,934,1015,616,51.00580467422081,16.046085893460777
18317,/media/marda/TWOTB1/xBD/hurricanes/images/florence/hurricane-florence_00000385_post_disaster.png,57,54,1,313,370,957,1011,542,51.77935292734332,14.018521988156499
18318,/media/marda/TWOTB1/xBD/hurricanes/images/florence/hurricane-florence_00000385_post_disaster.png,54,54,1,260,314,963,1017,501,51.49029909140734,13.010728554750207
18319,/media/marda/TWOTB1/xBD/hurricanes/images/florence/hurricane-florence_00000385_post_disaster.png,130,67,1,914,1044,974,1041,1441,89.64580314422135,24.738994760938727
18320,/media/marda/TWOTB1/xBD/hurricanes/images/florence/hurricane-florence_00000385_post_disaster.png,63,61,1,370,433,982,1043,580,54.87868602511587,14.096255595775673
18321,/media/marda/TWOTB1/xBD/hurricanes/images/florence/hurricane-florence_00000385_post_disaster.png,27,58,1,260,287,985,1043,242,20.550506444648136,15.503313567963326
18322,/media/marda/TWOTB1/xBD/hurricanes/images/florence/hurricane-florence_00000385_post_disaster.png,27,56,1,239,266,987,1043,199,19.122936485063356,13.955779944619179
18323,/media/marda/TWOTB1/xBD/hurricanes/images/florence/hurricane-florence_00000385_post_disaster.png,23,51,1,221,244,992,1043,128,14.588433311537377,11.618440531750661
18324,/media/marda/TWOTB1/xBD/hurricanes/images/florence/hurricane-florence_00000155_pre_disaster.png,47,15,1,973,1020,173,188,62,9.67820372683389,8.456869215608755
18325,/media/marda/TWOTB1/xBD/hurricanes/images/florence/hurricane-florence_00000155_pre_disaster.png,85,45,1,920,1005,288,333,662,57.94502502855441,15.20818013376405
18326,/media/marda/TWOTB1/xBD/hurricanes/images/florence/hurricane-florence_00000155_pre_disaster.png,52,28,1,909,961,303,331,124,15.847971027046828,10.506674137073942
18327,/media/marda/TWOTB1/xBD/hurricanes/images/florence/hurricane-florence_00000155_pre_disaster.png,63,56,1,981,1044,507,563,450,36.250416889075865,17.020562620295866
18328,/media/marda/TWOTB1/xBD/hurricanes/images/florence/hurricane-florence_00000155_pre_disaster.png,60,46,1,693,753,551,597,444,30.2271007256627,19.536704513383132
18329,/media/marda/TWOTB1/xBD/hurricanes/images/florence/hurricane-florence_00000155_pre_disaster.png,75,77,1,719,794,573,650,1358,61.787817310544504,28.933334196858393
18330,/media/marda/TWOTB1/xBD/hurricanes/images/florence/hurricane-florence_00000155_pre_disaster.png,48,48,1,818,866,745,793,172,18.864661045481917,12.130539261902634
18331,/media/marda/TWOTB1/xBD/hurricanes/images/florence/hurricane-florence_00000155_pre_disaster.png,71,73,1,857,928,763,836,882,45.53047884456622,25.64646154903165
18332,/media/marda/TWOTB1/xBD/hurricanes/images/florence/hurricane-florence_00000155_pre_disaster.png,46,54,1,584,630,786,840,346,22.889129607393343,19.83738743070008
18333,/media/marda/TWOTB1/xBD/hurricanes/images/florence/hurricane-florence_00000155_pre_disaster.png,44,54,1,577,621,806,860,301,21.34130233825062,18.678842088482355
18334,/media/marda/TWOTB1/xBD/hurricanes/images/florence/hurricane-florence_00000155_pre_disaster.png,60,74,1,600,660,813,887,811,40.66199008473148,27.80357386973288
18335,/media/marda/TWOTB1/xBD/hurricanes/images/florence/hurricane-florence_00000155_pre_disaster.png,31,39,1,662,693,818,857,43,8.164468109336834,7.011246487717036
18336,/media/marda/TWOTB1/xBD/hurricanes/images/florence/hurricane-florence_00000155_pre_disaster.png,42,56,1,575,617,888,944,288,20.731096531806436,18.41329345300438
18337,/media/marda/TWOTB1/xBD/hurricanes/images/florence/hurricane-florence_00000155_pre_disaster.png,34,45,1,631,665,894,939,57,9.789635414721864,7.7863458220141215
18338,/media/marda/TWOTB1/xBD/hurricanes/images/florence/hurricane-florence_00000155_pre_disaster.png,66,77,1,577,643,910,987,1114,44.822350725449596,33.40711508388456
18339,/media/marda/TWOTB1/xBD/hurricanes/images/florence/hurricane-florence_00000155_pre_disaster.png,48,66,1,544,592,931,997,573,28.879999892703818,26.358726253925326
18340,/media/marda/TWOTB1/xBD/hurricanes/images/florence/hurricane-florence_00000413_pre_disaster.png,23,26,1,0,23,25,51,392,24.315759025952413,22.036146189314987
18341,/media/marda/TWOTB1/xBD/hurricanes/images/florence/hurricane-florence_00000413_pre_disaster.png,68,49,1,5,73,49,98,1892,67.38968046506784,41.02124742660844
18342,/media/marda/TWOTB1/xBD/hurricanes/images/florence/hurricane-florence_00000413_pre_disaster.png,71,48,1,259,330,57,105,1957,64.62273108970565,42.56000970752237
18343,/media/marda/TWOTB1/xBD/hurricanes/images/florence/hurricane-florence_00000413_pre_disaster.png,65,44,1,250,315,107,151,1506,56.25170967554816,37.22162353407977
18344,/media/marda/TWOTB1/xBD/hurricanes/images/florence/hurricane-florence_00000413_pre_disaster.png,71,54,1,76,147,130,184,1844,62.06714319080535,42.83471340624116
18345,/media/marda/TWOTB1/xBD/hurricanes/images/florence/hurricane-florence_00000413_pre_disaster.png,58,67,1,279,337,208,275,1944,59.076395741242756,45.01403027379398
18346,/media/marda/TWOTB1/xBD/hurricanes/images/florence/hurricane-florence_00000413_pre_disaster.png,85,68,1,235,320,338,406,2274,74.95778813706006,42.20394793078292
18347,/media/marda/TWOTB1/xBD/hurricanes/images/florence/hurricane-florence_00000413_pre_disaster.png,41,77,1,0,41,659,736,1433,53.304957308878954,36.63667592948661
18348,/media/marda/TWOTB1/xBD/hurricanes/images/florence/hurricane-florence_00000413_pre_disaster.png,37,72,1,8,45,793,865,1253,42.23523506548655,39.38349168287091
18349,/media/marda/TWOTB1/xBD/hurricanes/images/florence/hurricane-florence_00000413_pre_disaster.png,52,81,1,13,65,862,943,1802,62.37873162312802,44.47117576050641
18350,/media/marda/TWOTB1/xBD/hurricanes/images/florence/hurricane-florence_00000467_post_disaster.png,75,16,1,721,796,0,16,487,46.484794969635985,14.577355942519699
18351,/media/marda/TWOTB1/xBD/hurricanes/images/florence/hurricane-florence_00000467_post_disaster.png,20,31,1,104,124,6,37,346,32.84878574102723,14.104811755087146
18352,/media/marda/TWOTB1/xBD/hurricanes/images/florence/hurricane-florence_00000467_post_disaster.png,54,17,1,665,719,31,48,278,30.96983646530192,12.03018472095791
18353,/media/marda/TWOTB1/xBD/hurricanes/images/florence/hurricane-florence_00000467_post_disaster.png,74,44,1,566,640,46,90,1377,51.08562401071935,38.21144311278098
18354,/media/marda/TWOTB1/xBD/hurricanes/images/florence/hurricane-florence_00000467_post_disaster.png,38,17,1,508,546,99,116,198,16.879327020617758,15.613288567636603
18355,/media/marda/TWOTB1/xBD/hurricanes/images/florence/hurricane-florence_00000467_post_disaster.png,69,37,1,416,485,101,138,761,61.129901554499135,19.241356458558275
18356,/media/marda/TWOTB1/xBD/hurricanes/images/florence/hurricane-florence_00000467_post_disaster.png,40,19,1,488,528,106,125,212,22.259298689870985,12.753779882606956
18357,/media/marda/TWOTB1/xBD/hurricanes/images/florence/hurricane-florence_00000467_post_disaster.png,56,31,1,279,335,134,165,509,51.07659101846226,13.287240119997158
18358,/media/marda/TWOTB1/xBD/hurricanes/images/florence/hurricane-florence_00000467_post_disaster.png,58,39,1,191,249,159,198,1144,53.73218770407772,28.225760169161774
18359,/media/marda/TWOTB1/xBD/hurricanes/images/florence/hurricane-florence_00000467_post_disaster.png,51,21,1,988,1039,262,283,76,11.327694736476243,9.300415925610068
18360,/media/marda/TWOTB1/xBD/hurricanes/images/florence/hurricane-florence_00000467_post_disaster.png,78,51,1,947,1025,267,318,660,51.50214857338433,17.975491577906247
18361,/media/marda/TWOTB1/xBD/hurricanes/images/florence/hurricane-florence_00000467_post_disaster.png,56,27,1,929,985,276,303,202,18.538653123874646,14.407023843922456
18362,/media/marda/TWOTB1/xBD/hurricanes/images/florence/hurricane-florence_00000467_post_disaster.png,60,43,1,308,368,322,365,553,55.15478710009056,13.40726507211258
18363,/media/marda/TWOTB1/xBD/hurricanes/images/florence/hurricane-florence_00000467_post_disaster.png,78,46,1,918,996,339,385,481,51.83439530273154,12.298660726176552
18364,/media/marda/TWOTB1/xBD/hurricanes/images/florence/hurricane-florence_00000467_post_disaster.png,61,29,1,672,733,359,388,318,38.49241835407283,11.046293891153747
18365,/media/marda/TWOTB1/xBD/hurricanes/images/florence/hurricane-florence_00000467_post_disaster.png,59,49,1,372,431,363,412,522,55.9845536993852,12.410469791238228
18366,/media/marda/TWOTB1/xBD/hurricanes/images/florence/hurricane-florence_00000467_post_disaster.png,75,55,1,858,933,378,433,918,42.56542404100563,29.33065583572636
18367,/media/marda/TWOTB1/xBD/hurricanes/images/florence/hurricane-florence_00000467_post_disaster.png,48,38,1,434,482,406,444,255,36.45623069466846,9.35197052635897
18368,/media/marda/TWOTB1/xBD/hurricanes/images/florence/hurricane-florence_00000467_post_disaster.png,70,40,1,491,561,432,472,522,56.26276462678272,12.39775712317944
18369,/media/marda/TWOTB1/xBD/hurricanes/images/florence/hurricane-florence_00000467_post_disaster.png,47,43,1,341,388,447,490,325,41.00803544273955,10.574400796448948
18370,/media/marda/TWOTB1/xBD/hurricanes/images/florence/hurricane-florence_00000467_post_disaster.png,59,38,1,918,977,449,487,253,19.88732485090083,17.02332047764515
18371,/media/marda/TWOTB1/xBD/hurricanes/images/florence/hurricane-florence_00000467_post_disaster.png,55,41,1,395,450,478,519,373,44.02827292685271,11.332271090983467
18372,/media/marda/TWOTB1/xBD/hurricanes/images/florence/hurricane-florence_00000467_post_disaster.png,56,30,1,1,57,484,514,618,64.87869814515564,12.729593586589726
18373,/media/marda/TWOTB1/xBD/hurricanes/images/florence/hurricane-florence_00000467_post_disaster.png,83,65,1,906,989,489,554,778,62.328390536683244,16.76239876846613
18374,/media/marda/TWOTB1/xBD/hurricanes/images/florence/hurricane-florence_00000467_post_disaster.png,47,58,1,587,634,490,548,526,40.87733281535989,17.205056002849496
18375,/media/marda/TWOTB1/xBD/hurricanes/images/florence/hurricane-florence_00000467_post_disaster.png,68,42,1,453,521,501,543,469,56.69881596653357,11.057748231666888
18376,/media/marda/TWOTB1/xBD/hurricanes/images/florence/hurricane-florence_00000467_post_disaster.png,54,33,1,278,332,511,544,464,50.96603300556006,12.18131385128316
18377,/media/marda/TWOTB1/xBD/hurricanes/images/florence/hurricane-florence_00000467_post_disaster.png,59,32,1,521,580,511,543,468,45.01851470969102,13.808210118138652
18378,/media/marda/TWOTB1/xBD/hurricanes/images/florence/hurricane-florence_00000467_post_disaster.png,56,32,1,77,133,553,585,642,61.82459008860671,13.73835192639836
18379,/media/marda/TWOTB1/xBD/hurricanes/images/florence/hurricane-florence_00000467_post_disaster.png,61,33,1,155,216,553,586,649,62.5289234741544,13.77280058701633
18380,/media/marda/TWOTB1/xBD/hurricanes/images/florence/hurricane-florence_00000467_post_disaster.png,82,71,1,852,934,553,624,1150,52.67985747869764,31.446260538359876
18381,/media/marda/TWOTB1/xBD/hurricanes/images/florence/hurricane-florence_00000467_post_disaster.png,57,32,1,273,330,555,587,508,53.34018527926362,12.618754581593727
18382,/media/marda/TWOTB1/xBD/hurricanes/images/florence/hurricane-florence_00000467_post_disaster.png,63,32,1,355,418,555,587,534,56.05445295527224,12.684209555252087
18383,/media/marda/TWOTB1/xBD/hurricanes/images/florence/hurricane-florence_00000467_post_disaster.png,68,32,1,443,511,555,587,546,57.30735531604787,12.67267648179111
18384,/media/marda/TWOTB1/xBD/hurricanes/images/florence/hurricane-florence_00000467_post_disaster.png,69,34,1,512,581,555,589,566,56.70117180542449,13.341155984970365
18385,/media/marda/TWOTB1/xBD/hurricanes/images/florence/hurricane-florence_00000467_post_disaster.png,54,38,1,906,960,582,620,170,16.36206953790216,13.778064740017259
18386,/media/marda/TWOTB1/xBD/hurricanes/images/florence/hurricane-florence_00000467_post_disaster.png,60,44,1,903,963,601,645,233,20.679136075369946,15.817411130596565
18387,/media/marda/TWOTB1/xBD/hurricanes/images/florence/hurricane-florence_00000467_post_disaster.png,55,41,1,888,943,610,651,154,18.78947650338026,10.972877759878621
18388,/media/marda/TWOTB1/xBD/hurricanes/images/florence/hurricane-florence_00000467_post_disaster.png,54,43,1,869,923,614,657,186,18.386380543091647,13.522794568728111
18389,/media/marda/TWOTB1/xBD/hurricanes/images/florence/hurricane-florence_00000467_post_disaster.png,28,45,1,0,28,632,677,544,31.540783262650752,22.841417504945653
18390,/media/marda/TWOTB1/xBD/hurricanes/images/florence/hurricane-florence_00000467_post_disaster.png,39,43,1,427,466,632,675,387,25.09004115524639,20.105117409870555
18391,/media/marda/TWOTB1/xBD/hurricanes/images/florence/hurricane-florence_00000467_post_disaster.png,39,45,1,64,103,633,678,701,40.79917784413263,22.49737885361749
18392,/media/marda/TWOTB1/xBD/hurricanes/images/florence/hurricane-florence_00000467_post_disaster.png,36,44,1,135,171,633,677,572,35.60829975878567,21.20251554501236
18393,/media/marda/TWOTB1/xBD/hurricanes/images/florence/hurricane-florence_00000467_post_disaster.png,47,42,1,196,243,633,675,584,40.799811424746295,18.99980341366879
18394,/media/marda/TWOTB1/xBD/hurricanes/images/florence/hurricane-florence_00000467_post_disaster.png,43,43,1,267,310,633,676,565,36.41023721992651,20.374240157733475
18395,/media/marda/TWOTB1/xBD/hurricanes/images/florence/hurricane-florence_00000467_post_disaster.png,36,42,1,347,383,633,675,393,25.417474637853,20.157066666090707
18396,/media/marda/TWOTB1/xBD/hurricanes/images/florence/hurricane-florence_00000467_post_disaster.png,42,43,1,508,550,633,676,339,23.323939788045763,19.07018189881606
18397,/media/marda/TWOTB1/xBD/hurricanes/images/florence/hurricane-florence_00000467_post_disaster.png,43,42,1,570,613,633,675,328,22.437190043286428,19.270513571888202
18398,/media/marda/TWOTB1/xBD/hurricanes/images/florence/hurricane-florence_00000467_post_disaster.png,47,35,1,888,935,637,672,60,9.21410791774517,8.852256068504117
18399,/media/marda/TWOTB1/xBD/hurricanes/images/florence/hurricane-florence_00000467_post_disaster.png,45,33,1,898,943,644,677,42,7.800480137763199,7.355294380604385
18400,/media/marda/TWOTB1/xBD/hurricanes/images/florence/hurricane-florence_00000467_post_disaster.png,43,32,1,914,957,649,681,56,9.16515138991168,8.0
18401,/media/marda/TWOTB1/xBD/hurricanes/images/florence/hurricane-florence_00000467_post_disaster.png,43,68,1,648,691,685,753,619,48.48970851335333,17.723302970888398
18402,/media/marda/TWOTB1/xBD/hurricanes/images/florence/hurricane-florence_00000467_post_disaster.png,49,57,1,508,557,699,756,424,26.285906076160273,21.562978762490935
18403,/media/marda/TWOTB1/xBD/hurricanes/images/florence/hurricane-florence_00000467_post_disaster.png,31,77,1,33,64,708,785,1092,52.107092251298525,27.82522452781526
18404,/media/marda/TWOTB1/xBD/hurricanes/images/florence/hurricane-florence_00000467_post_disaster.png,59,74,1,476,535,743,817,959,48.44024249179368,26.257333061182187
18405,/media/marda/TWOTB1/xBD/hurricanes/images/florence/hurricane-florence_00000467_post_disaster.png,42,76,1,655,697,775,851,695,53.35113275177914,17.42568273829714
18406,/media/marda/TWOTB1/xBD/hurricanes/images/florence/hurricane-florence_00000467_post_disaster.png,58,80,1,427,485,807,887,1077,51.14155343809167,27.86768488460084
18407,/media/marda/TWOTB1/xBD/hurricanes/images/florence/hurricane-florence_00000467_post_disaster.png,29,44,1,405,434,826,870,125,13.947748399863139,12.164792253635705
18408,/media/marda/TWOTB1/xBD/hurricanes/images/florence/hurricane-florence_00000467_post_disaster.png,42,88,1,661,703,843,931,800,61.61265478261433,17.340361029643848
18409,/media/marda/TWOTB1/xBD/hurricanes/images/florence/hurricane-florence_00000467_post_disaster.png,66,63,1,386,452,855,918,553,59.92596858619194,12.280948051679744
18410,/media/marda/TWOTB1/xBD/hurricanes/images/florence/hurricane-florence_00000467_post_disaster.png,49,83,1,516,565,907,990,586,54.1105011725059,14.345759776765115
18411,/media/marda/TWOTB1/xBD/hurricanes/images/florence/hurricane-florence_00000467_post_disaster.png,72,79,1,425,497,962,1041,1042,62.17324175784927,22.16909105271555
18412,/media/marda/TWOTB1/xBD/hurricanes/images/florence/hurricane-florence_00000255_post_disaster.png,40,36,1,98,138,22,58,848,36.01957273454474,31.12775879151745
18413,/media/marda/TWOTB1/xBD/hurricanes/images/florence/hurricane-florence_00000255_post_disaster.png,26,22,1,10,36,50,72,256,26.49210680130104,12.929357185431112
18414,/media/marda/TWOTB1/xBD/hurricanes/images/florence/hurricane-florence_00000104_post_disaster.png,38,18,1,498,536,0,18,212,17.666422120090573,15.738373177661385
18415,/media/marda/TWOTB1/xBD/hurricanes/images/florence/hurricane-florence_00000104_post_disaster.png,351,103,1,346,697,0,103,11491,369.5970919364129,41.54491415168885
18416,/media/marda/TWOTB1/xBD/hurricanes/images/florence/hurricane-florence_00000104_post_disaster.png,265,69,1,778,1043,0,69,6914,237.4936993672941,40.47820552766418
18417,/media/marda/TWOTB1/xBD/hurricanes/images/florence/hurricane-florence_00000104_post_disaster.png,34,10,1,502,536,94,104,88,16.1642341230358,7.311019510989235
18418,/media/marda/TWOTB1/xBD/hurricanes/images/florence/hurricane-florence_00000104_post_disaster.png,220,91,1,823,1043,152,243,7111,219.93548422454572,44.10183770750415
18419,/media/marda/TWOTB1/xBD/hurricanes/images/florence/hurricane-florence_00000104_post_disaster.png,359,136,1,408,767,225,361,12905,394.69375240559793,44.22676378058734
18420,/media/marda/TWOTB1/xBD/hurricanes/images/florence/hurricane-florence_00000104_post_disaster.png,200,96,1,843,1043,228,324,6467,197.3509243311508,44.72744981418009
18421,/media/marda/TWOTB1/xBD/hurricanes/images/florence/hurricane-florence_00000104_post_disaster.png,358,140,1,429,787,299,439,13018,392.1597273716266,44.87219945195082
18422,/media/marda/TWOTB1/xBD/hurricanes/images/florence/hurricane-florence_00000104_post_disaster.png,355,126,1,366,721,55,181,12729,393.269964364127,43.86182283584624
18423,/media/marda/TWOTB1/xBD/hurricanes/images/florence/hurricane-florence_00000092_pre_disaster.png,36,12,1,258,294,0,12,291,31.83401361563628,12.20316480785332
18424,/media/marda/TWOTB1/xBD/hurricanes/images/florence/hurricane-florence_00000092_pre_disaster.png,58,40,1,965,1023,520,560,366,22.467394581593698,21.653902121348594
18425,/media/marda/TWOTB1/xBD/hurricanes/images/florence/hurricane-florence_00000092_pre_disaster.png,44,29,1,927,971,536,565,61,9.420869152462581,8.69969776536743
18426,/media/marda/TWOTB1/xBD/hurricanes/images/florence/hurricane-florence_00000092_pre_disaster.png,52,39,1,907,959,547,586,304,21.908902300206645,18.439088914585774
18427,/media/marda/TWOTB1/xBD/hurricanes/images/florence/hurricane-florence_00000092_pre_disaster.png,51,32,1,905,956,577,609,161,15.95326936557958,13.335924662636412
18428,/media/marda/TWOTB1/xBD/hurricanes/images/florence/hurricane-florence_00000092_pre_disaster.png,54,41,1,990,1044,596,637,172,18.408284955262882,14.030267409356222
18429,/media/marda/TWOTB1/xBD/hurricanes/images/florence/hurricane-florence_00000092_pre_disaster.png,52,42,1,903,955,614,656,253,19.451016897299592,17.561900970427033
18430,/media/marda/TWOTB1/xBD/hurricanes/images/florence/hurricane-florence_00000092_pre_disaster.png,81,44,1,838,919,621,665,598,53.89021102827632,17.195414900923147
18431,/media/marda/TWOTB1/xBD/hurricanes/images/florence/hurricane-florence_00000092_pre_disaster.png,36,58,1,0,36,625,683,1224,41.55317877932646,39.242833740697165
18432,/media/marda/TWOTB1/xBD/hurricanes/images/florence/hurricane-florence_00000092_pre_disaster.png,88,36,1,943,1031,680,716,498,57.48656173566268,11.5134720272047
18433,/media/marda/TWOTB1/xBD/hurricanes/images/florence/hurricane-florence_00000092_pre_disaster.png,8,50,1,0,8,977,1027,59,12.311310339622096,7.383423807107813
18434,/media/marda/TWOTB1/xBD/hurricanes/images/florence/hurricane-florence_00000386_post_disaster.png,31,12,1,609,640,27,39,72,11.93662267124668,8.094259645222644
18435,/media/marda/TWOTB1/xBD/hurricanes/images/florence/hurricane-florence_00000386_post_disaster.png,78,14,1,582,660,61,75,633,63.55304519990852,13.321873376401985
18436,/media/marda/TWOTB1/xBD/hurricanes/images/florence/hurricane-florence_00000386_post_disaster.png,76,31,1,422,498,84,115,1403,64.03845519043189,30.472502207774546
18437,/media/marda/TWOTB1/xBD/hurricanes/images/florence/hurricane-florence_00000386_post_disaster.png,16,36,1,0,16,361,397,342,25.261310278272123,17.946458185346206
18438,/media/marda/TWOTB1/xBD/hurricanes/images/florence/hurricane-florence_00000386_post_disaster.png,25,42,1,342,367,544,586,207,22.38493229764592,12.409897928977971
18439,/media/marda/TWOTB1/xBD/hurricanes/images/florence/hurricane-florence_00000386_post_disaster.png,31,41,1,338,369,590,631,207,20.178579792885888,13.546371713608739
18440,/media/marda/TWOTB1/xBD/hurricanes/images/florence/hurricane-florence_00000386_post_disaster.png,69,51,1,345,414,604,655,738,62.15977279628664,15.79046214827437
18441,/media/marda/TWOTB1/xBD/hurricanes/images/florence/hurricane-florence_00000386_post_disaster.png,43,55,1,120,163,675,730,899,41.38094943974186,28.703159514855415
18442,/media/marda/TWOTB1/xBD/hurricanes/images/florence/hurricane-florence_00000242_post_disaster.png,65,66,1,14,79,0,66,2136,77.67535584600284,37.89726113189327
18443,/media/marda/TWOTB1/xBD/hurricanes/images/florence/hurricane-florence_00000242_post_disaster.png,58,9,1,155,213,0,9,337,58.70198762630937,7.850361855934815
18444,/media/marda/TWOTB1/xBD/hurricanes/images/florence/hurricane-florence_00000242_post_disaster.png,48,35,1,303,351,109,144,873,38.948406910497766,30.871650981126933
18445,/media/marda/TWOTB1/xBD/hurricanes/images/florence/hurricane-florence_00000242_post_disaster.png,44,17,1,431,475,129,146,310,32.49854867537916,12.751691037528795
18446,/media/marda/TWOTB1/xBD/hurricanes/images/florence/hurricane-florence_00000242_post_disaster.png,46,64,1,0,46,177,241,1749,54.176805124584426,44.06115315686
18447,/media/marda/TWOTB1/xBD/hurricanes/images/florence/hurricane-florence_00000242_post_disaster.png,25,33,1,371,396,393,426,129,16.810447272874963,10.328307251961789
18448,/media/marda/TWOTB1/xBD/hurricanes/images/florence/hurricane-florence_00000242_post_disaster.png,63,52,1,386,449,419,471,1175,52.06345849021989,30.37837262817862
18449,/media/marda/TWOTB1/xBD/hurricanes/images/florence/hurricane-florence_00000242_post_disaster.png,23,27,1,363,386,421,448,74,10.477126781232585,9.627716560555156
18450,/media/marda/TWOTB1/xBD/hurricanes/images/florence/hurricane-florence_00000242_post_disaster.png,13,33,1,38,51,541,574,84,11.291169973129106,10.022613995136396
18451,/media/marda/TWOTB1/xBD/hurricanes/images/florence/hurricane-florence_00000242_post_disaster.png,35,69,1,17,52,960,1029,598,30.782387879880616,25.761124251254472
18452,/media/marda/TWOTB1/xBD/hurricanes/images/florence/hurricane-florence_00000020_post_disaster.png,75,48,1,392,467,162,210,1443,54.96001822999467,36.06842170808738
18453,/media/marda/TWOTB1/xBD/hurricanes/images/florence/hurricane-florence_00000020_post_disaster.png,35,45,1,346,381,199,244,488,36.60410155784289,18.115464391990617
18454,/media/marda/TWOTB1/xBD/hurricanes/images/florence/hurricane-florence_00000020_post_disaster.png,63,34,1,979,1042,315,349,316,23.42743551257193,18.020124460098724
18455,/media/marda/TWOTB1/xBD/hurricanes/images/florence/hurricane-florence_00000020_post_disaster.png,55,39,1,818,873,465,504,279,19.99942613243667,18.639209634723194
18456,/media/marda/TWOTB1/xBD/hurricanes/images/florence/hurricane-florence_00000020_post_disaster.png,91,57,1,759,850,489,546,1344,58.00164204451347,33.26529548966677
18457,/media/marda/TWOTB1/xBD/hurricanes/images/florence/hurricane-florence_00000020_post_disaster.png,58,45,1,856,914,546,591,352,22.41303175586622,21.02858678218741
18458,/media/marda/TWOTB1/xBD/hurricanes/images/florence/hurricane-florence_00000020_post_disaster.png,62,78,1,351,413,833,911,1267,49.756523406642735,37.560170388002014
18459,/media/marda/TWOTB1/xBD/hurricanes/images/florence/hurricane-florence_00000020_post_disaster.png,38,54,1,440,478,840,894,274,22.153880172544326,16.252935374510866
18460,/media/marda/TWOTB1/xBD/hurricanes/images/florence/hurricane-florence_00000020_post_disaster.png,72,70,1,807,879,849,919,849,37.180961986222535,30.111572287594306
18461,/media/marda/TWOTB1/xBD/hurricanes/images/florence/hurricane-florence_00000020_post_disaster.png,60,63,1,748,808,883,946,548,27.598825090254266,26.727769029048
18462,/media/marda/TWOTB1/xBD/hurricanes/images/florence/hurricane-florence_00000362_pre_disaster.png,143,101,1,159,302,309,410,4183,160.5296326097041,35.685987614035135
18463,/media/marda/TWOTB1/xBD/hurricanes/images/florence/hurricane-florence_00000362_pre_disaster.png,16,38,1,92,108,352,390,314,29.860999239409058,13.897752797262022
18464,/media/marda/TWOTB1/xBD/hurricanes/images/florence/hurricane-florence_00000362_pre_disaster.png,18,32,1,44,62,360,392,264,19.29092035865742,18.32980097647404
18465,/media/marda/TWOTB1/xBD/hurricanes/images/florence/hurricane-florence_00000362_pre_disaster.png,17,40,1,54,71,399,439,305,23.771957967495762,17.155925508290384
18466,/media/marda/TWOTB1/xBD/hurricanes/images/florence/hurricane-florence_00000362_pre_disaster.png,26,45,1,13,39,406,451,626,29.822405667681632,28.162334279039218
18467,/media/marda/TWOTB1/xBD/hurricanes/images/florence/hurricane-florence_00000366_post_disaster.png,79,24,1,547,626,0,24,749,54.04995098923058,20.1193364625418
18468,/media/marda/TWOTB1/xBD/hurricanes/images/florence/hurricane-florence_00000366_post_disaster.png,75,51,1,226,301,0,51,1906,68.46701234174948,36.81098625065471
18469,/media/marda/TWOTB1/xBD/hurricanes/images/florence/hurricane-florence_00000366_post_disaster.png,19,27,1,0,19,210,237,325,21.449851951709633,20.25277990433138
18470,/media/marda/TWOTB1/xBD/hurricanes/images/florence/hurricane-florence_00000366_post_disaster.png,37,29,1,596,633,214,243,231,23.224405687718388,13.201771450708348
18471,/media/marda/TWOTB1/xBD/hurricanes/images/florence/hurricane-florence_00000366_post_disaster.png,102,87,1,860,962,445,532,2362,68.81784941375132,46.68922508789792
18472,/media/marda/TWOTB1/xBD/hurricanes/images/florence/hurricane-florence_00000366_post_disaster.png,59,48,1,820,879,531,579,355,31.43307245108828,15.034071082741937
18473,/media/marda/TWOTB1/xBD/hurricanes/images/florence/hurricane-florence_00000366_post_disaster.png,69,53,1,861,930,538,591,674,30.46853537664247,29.081524078640598
18474,/media/marda/TWOTB1/xBD/hurricanes/images/florence/hurricane-florence_00000366_post_disaster.png,63,62,1,719,782,632,694,481,47.386294772873896,13.843590324418797
18475,/media/marda/TWOTB1/xBD/hurricanes/images/florence/hurricane-florence_00000357_post_disaster.png,53,24,1,490,543,0,24,446,31.422443566263354,19.163656681415432
18476,/media/marda/TWOTB1/xBD/hurricanes/images/florence/hurricane-florence_00000357_post_disaster.png,56,30,1,397,453,55,85,600,39.42336258346796,20.286627077165242
18477,/media/marda/TWOTB1/xBD/hurricanes/images/florence/hurricane-florence_00000357_post_disaster.png,55,38,1,445,500,57,95,791,33.45688244148772,31.57337814197029
18478,/media/marda/TWOTB1/xBD/hurricanes/images/florence/hurricane-florence_00000357_post_disaster.png,65,36,1,584,649,85,121,814,40.47552785635607,29.24181479658447
18479,/media/marda/TWOTB1/xBD/hurricanes/images/florence/hurricane-florence_00000357_post_disaster.png,50,26,1,634,684,89,115,326,22.786348975314297,19.41786402868903
18480,/media/marda/TWOTB1/xBD/hurricanes/images/florence/hurricane-florence_00000357_post_disaster.png,55,45,1,395,450,116,161,802,40.47242650057543,26.45729157903176
18481,/media/marda/TWOTB1/xBD/hurricanes/images/florence/hurricane-florence_00000357_post_disaster.png,66,48,1,531,597,135,183,1055,39.62370470227993,35.36018167923322
18482,/media/marda/TWOTB1/xBD/hurricanes/images/florence/hurricane-florence_00000357_post_disaster.png,38,20,1,576,614,139,159,127,14.415139938236884,11.809653809041691
18483,/media/marda/TWOTB1/xBD/hurricanes/images/florence/hurricane-florence_00000357_post_disaster.png,64,45,1,491,555,202,247,763,45.3828310666112,22.756408751415492
18484,/media/marda/TWOTB1/xBD/hurricanes/images/florence/hurricane-florence_00000357_post_disaster.png,36,53,1,197,233,756,809,353,23.336763127019317,20.204668292171466
18485,/media/marda/TWOTB1/xBD/hurricanes/images/florence/hurricane-florence_00000357_post_disaster.png,59,65,1,295,354,758,823,909,45.495674356454316,26.856163638957735
18486,/media/marda/TWOTB1/xBD/hurricanes/images/florence/hurricane-florence_00000357_post_disaster.png,29,55,1,177,206,801,856,215,26.855912650539352,10.733262293953176
18487,/media/marda/TWOTB1/xBD/hurricanes/images/florence/hurricane-florence_00000357_post_disaster.png,15,50,1,16,31,834,884,171,16.58102428232971,13.867055982728996
18488,/media/marda/TWOTB1/xBD/hurricanes/images/florence/hurricane-florence_00000357_post_disaster.png,62,67,1,412,474,856,923,856,47.53646670599009,24.02364231275428
18489,/media/marda/TWOTB1/xBD/hurricanes/images/florence/hurricane-florence_00000357_post_disaster.png,39,56,1,382,421,880,936,344,24.527619262194207,18.817359722196993
18490,/media/marda/TWOTB1/xBD/hurricanes/images/florence/hurricane-florence_00000357_post_disaster.png,49,71,1,345,394,886,957,832,36.85884248634018,29.720787475988995
18491,/media/marda/TWOTB1/xBD/hurricanes/images/florence/hurricane-florence_00000357_post_disaster.png,15,52,1,27,42,887,939,124,13.926360868001217,11.924156374027845
18492,/media/marda/TWOTB1/xBD/hurricanes/images/florence/hurricane-florence_00000357_post_disaster.png,32,67,1,152,184,895,962,557,30.339872875886947,25.01179341024636
18493,/media/marda/TWOTB1/xBD/hurricanes/images/florence/hurricane-florence_00000357_post_disaster.png,35,61,1,42,77,901,962,470,33.94657874412859,18.081008416504922
18494,/media/marda/TWOTB1/xBD/hurricanes/images/florence/hurricane-florence_00000357_post_disaster.png,27,52,1,188,215,921,973,185,22.47590506050863,10.9563328746512
18495,/media/marda/TWOTB1/xBD/hurricanes/images/florence/hurricane-florence_00000357_post_disaster.png,59,70,1,470,529,927,997,826,38.92755239369192,28.203374278609157
18496,/media/marda/TWOTB1/xBD/hurricanes/images/florence/hurricane-florence_00000357_post_disaster.png,44,66,1,251,295,929,995,632,35.45472798187933,23.79395169257651
18497,/media/marda/TWOTB1/xBD/hurricanes/images/florence/hurricane-florence_00000357_post_disaster.png,34,76,1,129,163,938,1014,755,41.52067772543718,25.147962542706768
18498,/media/marda/TWOTB1/xBD/hurricanes/images/florence/hurricane-florence_00000357_post_disaster.png,50,86,1,180,230,938,1024,1185,51.871555700069,31.246147492310378
18499,/media/marda/TWOTB1/xBD/hurricanes/images/florence/hurricane-florence_00000357_post_disaster.png,41,80,1,31,72,945,1025,1080,46.95681646364342,31.873727964831975
18500,/media/marda/TWOTB1/xBD/hurricanes/images/florence/hurricane-florence_00000357_post_disaster.png,12,49,1,86,98,960,1009,89,11.46055452563566,10.432423747424703
18501,/media/marda/TWOTB1/xBD/hurricanes/images/florence/hurricane-florence_00000357_post_disaster.png,37,56,1,419,456,987,1043,236,20.017072044231686,15.749884283031031
18502,/media/marda/TWOTB1/xBD/hurricanes/images/florence/hurricane-florence_00000357_post_disaster.png,40,50,1,274,314,993,1043,163,27.726440598350642,8.704340878115728
18503,/media/marda/TWOTB1/xBD/hurricanes/images/florence/hurricane-florence_00000283_pre_disaster.png,51,43,1,82,133,0,43,1059,49.12380527636927,30.08842202099575
18504,/media/marda/TWOTB1/xBD/hurricanes/images/florence/hurricane-florence_00000283_pre_disaster.png,45,40,1,13,58,47,87,897,44.783168938876734,26.737946577606184
18505,/media/marda/TWOTB1/xBD/hurricanes/images/florence/hurricane-florence_00000283_pre_disaster.png,16,16,1,86,102,82,98,109,15.227303298314771,9.63255320919004
18506,/media/marda/TWOTB1/xBD/hurricanes/images/florence/hurricane-florence_00000283_pre_disaster.png,15,13,1,131,146,91,104,72,12.147250847468525,7.994394675733197
18507,/media/marda/TWOTB1/xBD/hurricanes/images/florence/hurricane-florence_00000283_pre_disaster.png,58,69,1,71,129,107,176,1899,65.02092595327065,38.96166520609673
18508,/media/marda/TWOTB1/xBD/hurricanes/images/florence/hurricane-florence_00000283_pre_disaster.png,54,51,1,311,365,152,203,1007,45.24717650724566,30.424642072131217
18509,/media/marda/TWOTB1/xBD/hurricanes/images/florence/hurricane-florence_00000283_pre_disaster.png,43,51,1,124,167,183,234,934,47.80935189398132,26.074090119059118
18510,/media/marda/TWOTB1/xBD/hurricanes/images/florence/hurricane-florence_00000283_pre_disaster.png,49,36,1,389,438,194,230,543,34.40470310754599,21.437507919110907
18511,/media/marda/TWOTB1/xBD/hurricanes/images/florence/hurricane-florence_00000283_pre_disaster.png,67,39,1,795,862,197,236,876,36.47700895047176,32.37079652590814
18512,/media/marda/TWOTB1/xBD/hurricanes/images/florence/hurricane-florence_00000283_pre_disaster.png,72,48,1,905,977,227,275,576,45.915652927527105,16.761009599128624
18513,/media/marda/TWOTB1/xBD/hurricanes/images/florence/hurricane-florence_00000283_pre_disaster.png,81,44,1,726,807,246,290,693,61.742924524470844,15.003690281905211
18514,/media/marda/TWOTB1/xBD/hurricanes/images/florence/hurricane-florence_00000283_pre_disaster.png,42,30,1,707,749,247,277,155,23.76633879649175,8.654406211294962
18515,/media/marda/TWOTB1/xBD/hurricanes/images/florence/hurricane-florence_00000283_pre_disaster.png,44,64,1,170,214,252,316,721,65.44523054888836,14.708833048474759
18516,/media/marda/TWOTB1/xBD/hurricanes/images/florence/hurricane-florence_00000283_pre_disaster.png,33,31,1,337,370,252,283,247,21.657752060896694,15.256226903738273
18517,/media/marda/TWOTB1/xBD/hurricanes/images/florence/hurricane-florence_00000283_pre_disaster.png,77,50,1,652,729,288,338,792,61.03777846449325,17.265331486440335
18518,/media/marda/TWOTB1/xBD/hurricanes/images/florence/hurricane-florence_00000283_pre_disaster.png,48,22,1,921,969,290,312,140,14.085188656307952,13.384399665049042
18519,/media/marda/TWOTB1/xBD/hurricanes/images/florence/hurricane-florence_00000283_pre_disaster.png,37,28,1,638,675,301,329,121,15.838393682726336,10.266698781467944
18520,/media/marda/TWOTB1/xBD/hurricanes/images/florence/hurricane-florence_00000283_pre_disaster.png,36,31,1,526,562,306,337,168,18.02737477735089,12.519107170689876
18521,/media/marda/TWOTB1/xBD/hurricanes/images/florence/hurricane-florence_00000283_pre_disaster.png,35,22,1,621,656,308,330,55,9.930213200760429,7.490100772960014
18522,/media/marda/TWOTB1/xBD/hurricanes/images/florence/hurricane-florence_00000283_pre_disaster.png,59,49,1,921,980,308,357,508,40.65397078961843,16.80245295105403
18523,/media/marda/TWOTB1/xBD/hurricanes/images/florence/hurricane-florence_00000283_pre_disaster.png,38,25,1,625,663,316,341,91,12.67569376176543,9.65689081558118
18524,/media/marda/TWOTB1/xBD/hurricanes/images/florence/hurricane-florence_00000283_pre_disaster.png,41,33,1,534,575,328,361,265,20.628516134465407,16.7667834412949
18525,/media/marda/TWOTB1/xBD/hurricanes/images/florence/hurricane-florence_00000283_pre_disaster.png,74,56,1,584,658,331,387,842,61.610326688545825,18.244745359051844
18526,/media/marda/TWOTB1/xBD/hurricanes/images/florence/hurricane-florence_00000283_pre_disaster.png,43,66,1,227,270,335,401,664,60.786050303608086,15.745072262916192
18527,/media/marda/TWOTB1/xBD/hurricanes/images/florence/hurricane-florence_00000283_pre_disaster.png,29,50,1,39,68,367,417,630,38.459993093360566,21.89640390445409
18528,/media/marda/TWOTB1/xBD/hurricanes/images/florence/hurricane-florence_00000283_pre_disaster.png,62,53,1,505,567,378,431,863,42.164552197785945,29.664044801950745
18529,/media/marda/TWOTB1/xBD/hurricanes/images/florence/hurricane-florence_00000283_pre_disaster.png,34,35,1,365,399,379,414,398,23.318505650752986,22.85189628598812
18530,/media/marda/TWOTB1/xBD/hurricanes/images/florence/hurricane-florence_00000283_pre_disaster.png,33,24,1,484,517,384,408,136,15.766083912312366,11.445401131741301
18531,/media/marda/TWOTB1/xBD/hurricanes/images/florence/hurricane-florence_00000283_pre_disaster.png,19,34,1,29,48,390,424,217,20.071415765467183,14.499295306210703
18532,/media/marda/TWOTB1/xBD/hurricanes/images/florence/hurricane-florence_00000283_pre_disaster.png,23,26,1,382,405,403,429,100,12.753640574727157,10.452973361234266
18533,/media/marda/TWOTB1/xBD/hurricanes/images/florence/hurricane-florence_00000283_pre_disaster.png,16,25,1,100,116,418,443,81,12.070342361974028,9.053711478539894
18534,/media/marda/TWOTB1/xBD/hurricanes/images/florence/hurricane-florence_00000283_pre_disaster.png,12,28,1,34,46,421,449,94,12.978264842617365,9.845117764787865
18535,/media/marda/TWOTB1/xBD/hurricanes/images/florence/hurricane-florence_00000283_pre_disaster.png,76,46,1,406,482,423,469,1254,66.71547788512882,25.203131163623453
18536,/media/marda/TWOTB1/xBD/hurricanes/images/florence/hurricane-florence_00000283_pre_disaster.png,72,59,1,319,391,428,487,1658,63.701062196529485,35.28651155246768
18537,/media/marda/TWOTB1/xBD/hurricanes/images/florence/hurricane-florence_00000283_pre_disaster.png,74,56,1,777,851,437,493,829,44.75281522128566,24.736155736045404
18538,/media/marda/TWOTB1/xBD/hurricanes/images/florence/hurricane-florence_00000283_pre_disaster.png,21,31,1,276,297,445,476,126,13.948112696782514,12.151388786948212
18539,/media/marda/TWOTB1/xBD/hurricanes/images/florence/hurricane-florence_00000283_pre_disaster.png,38,73,1,83,121,456,529,1188,61.50192397135849,25.690324365822956
18540,/media/marda/TWOTB1/xBD/hurricanes/images/florence/hurricane-florence_00000283_pre_disaster.png,53,66,1,256,309,468,534,1142,51.81523033662847,29.61221888187215
18541,/media/marda/TWOTB1/xBD/hurricanes/images/florence/hurricane-florence_00000283_pre_disaster.png,83,61,1,707,790,477,538,1199,52.35510410071626,32.90794402077285
18542,/media/marda/TWOTB1/xBD/hurricanes/images/florence/hurricane-florence_00000283_pre_disaster.png,31,38,1,0,31,504,542,357,35.357769260588874,13.50044752405919
18543,/media/marda/TWOTB1/xBD/hurricanes/images/florence/hurricane-florence_00000283_pre_disaster.png,73,58,1,644,717,552,610,980,51.93036641181591,24.830057488290652
18544,/media/marda/TWOTB1/xBD/hurricanes/images/florence/hurricane-florence_00000283_pre_disaster.png,39,38,1,560,599,568,606,248,19.110412717532082,17.322309809282117
18545,/media/marda/TWOTB1/xBD/hurricanes/images/florence/hurricane-florence_00000283_pre_disaster.png,79,65,1,566,645,605,670,1206,61.742331988832596,26.00800702885469
18546,/media/marda/TWOTB1/xBD/hurricanes/images/florence/hurricane-florence_00000283_pre_disaster.png,68,60,1,484,552,619,679,1105,55.47169980677649,27.65829961368408
18547,/media/marda/TWOTB1/xBD/hurricanes/images/florence/hurricane-florence_00000283_pre_disaster.png,65,48,1,214,279,645,693,674,63.94906015761769,14.037544560111952
18548,/media/marda/TWOTB1/xBD/hurricanes/images/florence/hurricane-florence_00000283_pre_disaster.png,65,57,1,391,456,645,702,1135,54.94543844703514,28.34593206372171
18549,/media/marda/TWOTB1/xBD/hurricanes/images/florence/hurricane-florence_00000283_pre_disaster.png,63,56,1,125,188,651,707,1257,64.59786871976937,25.77943616883985
18550,/media/marda/TWOTB1/xBD/hurricanes/images/florence/hurricane-florence_00000283_pre_disaster.png,56,49,1,39,95,662,711,804,60.257418643835074,19.52170427121831
18551,/media/marda/TWOTB1/xBD/hurricanes/images/florence/hurricane-florence_00000283_pre_disaster.png,32,59,1,108,140,686,745,703,32.35051047634345,28.85519301528017
18552,/media/marda/TWOTB1/xBD/hurricanes/images/florence/hurricane-florence_00000303_pre_disaster.png,54,45,1,730,784,494,539,336,21.875353248329773,20.337810025483822
18553,/media/marda/TWOTB1/xBD/hurricanes/images/florence/hurricane-florence_00000303_pre_disaster.png,79,67,1,761,840,501,568,1058,54.71056109872383,25.857964515357708
18554,/media/marda/TWOTB1/xBD/hurricanes/images/florence/hurricane-florence_00000303_pre_disaster.png,64,53,1,714,778,530,583,581,38.69121766109131,20.14138880636168
18555,/media/marda/TWOTB1/xBD/hurricanes/images/florence/hurricane-florence_00000303_pre_disaster.png,79,76,1,874,953,584,660,1194,49.60028051718581,35.50392810620324
18556,/media/marda/TWOTB1/xBD/hurricanes/images/florence/hurricane-florence_00000303_pre_disaster.png,48,33,1,938,986,625,658,59,10.319468574007749,7.62567456059103
18557,/media/marda/TWOTB1/xBD/hurricanes/images/florence/hurricane-florence_00000303_pre_disaster.png,55,44,1,961,1016,631,675,176,20.340856841866895,11.602291984875794
18558,/media/marda/TWOTB1/xBD/hurricanes/images/florence/hurricane-florence_00000303_pre_disaster.png,46,57,1,511,557,808,865,319,25.468163909657946,16.740508686422622
18559,/media/marda/TWOTB1/xBD/hurricanes/images/florence/hurricane-florence_00000303_pre_disaster.png,54,66,1,545,599,823,889,564,32.19761999985825,23.39157409312968
18560,/media/marda/TWOTB1/xBD/hurricanes/images/florence/hurricane-florence_00000303_pre_disaster.png,38,54,1,479,517,857,911,206,22.00500727339462,12.562320314254931
18561,/media/marda/TWOTB1/xBD/hurricanes/images/florence/hurricane-florence_00000303_pre_disaster.png,60,69,1,502,562,870,939,821,37.4441882262443,28.848282346015992
18562,/media/marda/TWOTB1/xBD/hurricanes/images/florence/hurricane-florence_00000054_pre_disaster.png,357,57,1,630,987,177,234,12449,378.1613741423882,44.5060948834587
18563,/media/marda/TWOTB1/xBD/hurricanes/images/florence/hurricane-florence_00000054_pre_disaster.png,357,61,1,619,976,246,307,12107,377.6104271370346,43.45956747672723
18564,/media/marda/TWOTB1/xBD/hurricanes/images/florence/hurricane-florence_00000054_pre_disaster.png,33,20,1,610,643,337,357,53,9.0708588395189,7.530030809109983
18565,/media/marda/TWOTB1/xBD/hurricanes/images/florence/hurricane-florence_00000054_pre_disaster.png,247,53,1,610,857,343,396,8168,251.46593950642264,43.25635430426185
18566,/media/marda/TWOTB1/xBD/hurricanes/images/florence/hurricane-florence_00000054_pre_disaster.png,41,31,1,578,619,386,417,351,21.71927483662594,21.326049452541326
18567,/media/marda/TWOTB1/xBD/hurricanes/images/florence/hurricane-florence_00000054_pre_disaster.png,32,28,1,540,572,451,479,113,12.539896526639238,11.570374132115571
18568,/media/marda/TWOTB1/xBD/hurricanes/images/florence/hurricane-florence_00000054_pre_disaster.png,37,31,1,540,577,466,497,212,18.271350540794064,15.494910315243498
18569,/media/marda/TWOTB1/xBD/hurricanes/images/florence/hurricane-florence_00000054_pre_disaster.png,45,31,1,538,583,507,538,176,28.042672069411225,8.364134732238238
18570,/media/marda/TWOTB1/xBD/hurricanes/images/florence/hurricane-florence_00000186_post_disaster.png,57,28,1,173,230,20,48,825,50.269454249206355,23.043031155256436
18571,/media/marda/TWOTB1/xBD/hurricanes/images/florence/hurricane-florence_00000186_post_disaster.png,57,49,1,268,325,24,73,1280,42.21148045191912,39.90622858861289
18572,/media/marda/TWOTB1/xBD/hurricanes/images/florence/hurricane-florence_00000186_post_disaster.png,23,15,1,251,274,64,79,113,13.895282176937638,10.895354232091229
18573,/media/marda/TWOTB1/xBD/hurricanes/images/florence/hurricane-florence_00000186_post_disaster.png,30,22,1,261,291,76,98,240,19.633378182486407,16.366544976775035
18574,/media/marda/TWOTB1/xBD/hurricanes/images/florence/hurricane-florence_00000186_post_disaster.png,44,32,1,538,582,291,323,282,22.147685776438266,17.0426523184859
18575,/media/marda/TWOTB1/xBD/hurricanes/images/florence/hurricane-florence_00000186_post_disaster.png,64,48,1,979,1043,490,538,457,33.713318795755406,18.050397215926548
18576,/media/marda/TWOTB1/xBD/hurricanes/images/florence/hurricane-florence_00000186_post_disaster.png,87,79,1,834,921,600,679,1347,55.3091100357023,35.9478662442203
18577,/media/marda/TWOTB1/xBD/hurricanes/images/florence/hurricane-florence_00000178_post_disaster.png,53,38,1,276,329,0,38,1083,39.1175125046986,38.540699366280954
18578,/media/marda/TWOTB1/xBD/hurricanes/images/florence/hurricane-florence_00000178_post_disaster.png,32,13,1,406,438,52,65,104,13.29190035744663,10.661269295642946
18579,/media/marda/TWOTB1/xBD/hurricanes/images/florence/hurricane-florence_00000178_post_disaster.png,59,59,1,168,227,154,213,1489,47.51074222765284,41.8209015915783
18580,/media/marda/TWOTB1/xBD/hurricanes/images/florence/hurricane-florence_00000178_post_disaster.png,51,50,1,227,278,185,235,1006,45.28372232337522,29.50521345064443
18581,/media/marda/TWOTB1/xBD/hurricanes/images/florence/hurricane-florence_00000178_post_disaster.png,26,23,1,359,385,437,460,82,15.756288999556018,6.951256270930285
18582,/media/marda/TWOTB1/xBD/hurricanes/images/florence/hurricane-florence_00000178_post_disaster.png,53,59,1,377,430,447,506,1272,44.838512752073115,37.73941547041028
18583,/media/marda/TWOTB1/xBD/hurricanes/images/florence/hurricane-florence_00000178_post_disaster.png,33,41,1,322,355,465,506,427,27.04073716805927,21.131903181282944
18584,/media/marda/TWOTB1/xBD/hurricanes/images/florence/hurricane-florence_00000178_post_disaster.png,28,44,1,239,267,550,594,268,23.050158030375545,15.572396296826488
18585,/media/marda/TWOTB1/xBD/hurricanes/images/florence/hurricane-florence_00000178_post_disaster.png,29,36,1,332,361,569,605,264,19.27884470215488,18.21419274329653
18586,/media/marda/TWOTB1/xBD/hurricanes/images/florence/hurricane-florence_00000178_post_disaster.png,19,27,1,323,342,571,598,49,8.0,8.0
18587,/media/marda/TWOTB1/xBD/hurricanes/images/florence/hurricane-florence_00000178_post_disaster.png,50,53,1,621,671,616,669,686,32.70402134834847,28.005408067452382
18588,/media/marda/TWOTB1/xBD/hurricanes/images/florence/hurricane-florence_00000178_post_disaster.png,28,37,1,350,378,678,715,163,18.05938930815491,12.344255559905664
18589,/media/marda/TWOTB1/xBD/hurricanes/images/florence/hurricane-florence_00000178_post_disaster.png,40,62,1,409,449,679,741,813,42.907738846926335,25.250027688981458
18590,/media/marda/TWOTB1/xBD/hurricanes/images/florence/hurricane-florence_00000178_post_disaster.png,28,47,1,200,228,748,795,190,17.370376621547575,14.620696045937713
18591,/media/marda/TWOTB1/xBD/hurricanes/images/florence/hurricane-florence_00000506_pre_disaster.png,118,147,1,829,947,59,206,4963,167.75246622956783,39.89955484114894
18592,/media/marda/TWOTB1/xBD/hurricanes/images/florence/hurricane-florence_00000506_pre_disaster.png,86,65,1,958,1044,269,334,1717,56.51844950591059,40.77698075289458
18593,/media/marda/TWOTB1/xBD/hurricanes/images/florence/hurricane-florence_00000506_pre_disaster.png,48,37,1,690,738,551,588,136,22.497161934453523,8.087466640406086
18594,/media/marda/TWOTB1/xBD/hurricanes/images/florence/hurricane-florence_00000506_pre_disaster.png,74,49,1,704,778,557,606,522,53.777590837774206,12.970116429812954
18595,/media/marda/TWOTB1/xBD/hurricanes/images/florence/hurricane-florence_00000506_pre_disaster.png,39,33,1,761,800,572,605,79,11.16957893883588,9.610121246880647
18596,/media/marda/TWOTB1/xBD/hurricanes/images/florence/hurricane-florence_00000506_pre_disaster.png,102,87,1,682,784,573,660,2133,86.08377066354467,43.07563393729064
18597,/media/marda/TWOTB1/xBD/hurricanes/images/florence/hurricane-florence_00000506_pre_disaster.png,42,33,1,768,810,580,613,96,12.955632344714871,9.890311279997434
18598,/media/marda/TWOTB1/xBD/hurricanes/images/florence/hurricane-florence_00000506_pre_disaster.png,104,85,1,920,1024,862,947,1336,78.20221854618127,22.903369372070426
18599,/media/marda/TWOTB1/xBD/hurricanes/images/florence/hurricane-florence_00000076_post_disaster.png,60,53,1,378,438,271,324,1104,43.587270388786834,34.382069309852206
18600,/media/marda/TWOTB1/xBD/hurricanes/images/florence/hurricane-florence_00000076_post_disaster.png,39,51,1,384,423,773,824,497,27.60268259054894,24.060517102550968
18601,/media/marda/TWOTB1/xBD/hurricanes/images/florence/hurricane-florence_00000076_post_disaster.png,104,71,1,868,972,589,660,1761,67.41635630776351,34.99916446680731
18602,/media/marda/TWOTB1/xBD/hurricanes/images/florence/hurricane-florence_00000076_post_disaster.png,71,57,1,431,502,717,774,1456,60.31730399242915,31.869919768834794
18603,/media/marda/TWOTB1/xBD/hurricanes/images/florence/hurricane-florence_00000076_post_disaster.png,56,60,1,987,1043,806,866,411,31.547848458956537,17.132794203000188
18604,/media/marda/TWOTB1/xBD/hurricanes/images/florence/hurricane-florence_00000076_post_disaster.png,74,79,1,850,924,840,919,1100,42.994047573462765,34.05783324702594
18605,/media/marda/TWOTB1/xBD/hurricanes/images/florence/hurricane-florence_00000076_post_disaster.png,64,69,1,811,875,924,993,674,31.663653264591925,28.54816120872864
18606,/media/marda/TWOTB1/xBD/hurricanes/images/florence/hurricane-florence_00000423_pre_disaster.png,29,52,1,128,157,729,781,316,23.674038413892795,17.74093217069055
18607,/media/marda/TWOTB1/xBD/hurricanes/images/florence/hurricane-florence_00000423_pre_disaster.png,18,42,1,141,159,753,795,102,12.503905194070558,10.826295737152016
18608,/media/marda/TWOTB1/xBD/hurricanes/images/florence/hurricane-florence_00000347_pre_disaster.png,308,159,1,736,1044,0,159,27285,301.916521878789,118.85370028111296
18609,/media/marda/TWOTB1/xBD/hurricanes/images/florence/hurricane-florence_00000347_pre_disaster.png,53,14,1,82,135,37,51,608,58.49283559845986,13.865250428855258
18610,/media/marda/TWOTB1/xBD/hurricanes/images/florence/hurricane-florence_00000347_pre_disaster.png,16,13,1,0,16,49,62,208,18.439088914585774,14.966629547095765
18611,/media/marda/TWOTB1/xBD/hurricanes/images/florence/hurricane-florence_00000347_pre_disaster.png,52,10,1,206,258,50,60,421,50.572679345238356,11.042414236846792
18612,/media/marda/TWOTB1/xBD/hurricanes/images/florence/hurricane-florence_00000347_pre_disaster.png,214,286,1,542,756,72,358,29598,311.59696342604127,126.29515311404964
18613,/media/marda/TWOTB1/xBD/hurricanes/images/florence/hurricane-florence_00000347_pre_disaster.png,54,26,1,953,1007,154,180,238,22.320034560780247,14.259335967975234
18614,/media/marda/TWOTB1/xBD/hurricanes/images/florence/hurricane-florence_00000347_pre_disaster.png,54,47,1,990,1044,297,344,313,35.056919427823935,12.655888020184372
18615,/media/marda/TWOTB1/xBD/hurricanes/images/florence/hurricane-florence_00000347_pre_disaster.png,58,64,1,603,661,588,652,1180,48.28303787003499,33.114140839843934
18616,/media/marda/TWOTB1/xBD/hurricanes/images/florence/hurricane-florence_00000347_pre_disaster.png,60,73,1,785,845,601,674,682,55.33986677267391,16.440621873497637
18617,/media/marda/TWOTB1/xBD/hurricanes/images/florence/hurricane-florence_00000347_pre_disaster.png,93,48,1,605,698,671,719,1335,75.04359370827412,23.839017279330264
18618,/media/marda/TWOTB1/xBD/hurricanes/images/florence/hurricane-florence_00000244_post_disaster.png,29,10,1,392,421,44,54,90,13.168853939915916,8.990505388671375
18619,/media/marda/TWOTB1/xBD/hurricanes/images/florence/hurricane-florence_00000244_post_disaster.png,50,27,1,423,473,71,98,525,33.062685670763024,23.17989912113078
18620,/media/marda/TWOTB1/xBD/hurricanes/images/florence/hurricane-florence_00000244_post_disaster.png,120,81,1,331,451,99,180,4949,116.59840072534078,65.46463514180407
18621,/media/marda/TWOTB1/xBD/hurricanes/images/florence/hurricane-florence_00000244_post_disaster.png,40,35,1,520,560,192,227,371,33.31563654024672,16.2363294573823
18622,/media/marda/TWOTB1/xBD/hurricanes/images/florence/hurricane-florence_00000244_post_disaster.png,33,43,1,369,402,238,281,479,36.61608719374259,18.022582412741208
18623,/media/marda/TWOTB1/xBD/hurricanes/images/florence/hurricane-florence_00000244_post_disaster.png,63,62,1,276,339,240,302,1544,67.19952236070272,36.348797698340476
18624,/media/marda/TWOTB1/xBD/hurricanes/images/florence/hurricane-florence_00000193_pre_disaster.png,26,38,1,62,88,23,61,479,38.50967729609677,17.635639027739582
18625,/media/marda/TWOTB1/xBD/hurricanes/images/florence/hurricane-florence_00000193_pre_disaster.png,36,41,1,21,57,36,77,879,38.2612916023462,30.506486852733893
18626,/media/marda/TWOTB1/xBD/hurricanes/images/florence/hurricane-florence_00000193_pre_disaster.png,45,26,1,533,578,102,128,300,21.57379871519209,18.532345540125196
18627,/media/marda/TWOTB1/xBD/hurricanes/images/florence/hurricane-florence_00000193_pre_disaster.png,21,57,1,0,21,197,254,571,48.30729448572832,18.180398215397695
18628,/media/marda/TWOTB1/xBD/hurricanes/images/florence/hurricane-florence_00000193_pre_disaster.png,35,35,1,248,283,220,255,354,27.095028799201653,17.346121131609433
18629,/media/marda/TWOTB1/xBD/hurricanes/images/florence/hurricane-florence_00000193_pre_disaster.png,37,34,1,0,37,261,295,860,41.534517143676496,27.585159009765558
18630,/media/marda/TWOTB1/xBD/hurricanes/images/florence/hurricane-florence_00000193_pre_disaster.png,45,43,1,294,339,261,304,724,34.099553594765005,30.033923102762046
18631,/media/marda/TWOTB1/xBD/hurricanes/images/florence/hurricane-florence_00000193_pre_disaster.png,25,41,1,0,25,294,335,516,30.13131160795807,24.317412667286863
18632,/media/marda/TWOTB1/xBD/hurricanes/images/florence/hurricane-florence_00000193_pre_disaster.png,42,50,1,0,42,362,412,716,50.50651889916966,19.023426996193816
18633,/media/marda/TWOTB1/xBD/hurricanes/images/florence/hurricane-florence_00000193_pre_disaster.png,24,41,1,17,41,460,501,300,25.275423808105664,15.88136210882922
18634,/media/marda/TWOTB1/xBD/hurricanes/images/florence/hurricane-florence_00000472_pre_disaster.png,70,60,1,4,74,0,60,2560,64.94211890733332,51.81327912778941
18635,/media/marda/TWOTB1/xBD/hurricanes/images/florence/hurricane-florence_00000472_pre_disaster.png,71,39,1,180,251,0,39,1572,58.4198949338296,38.5765113258668
18636,/media/marda/TWOTB1/xBD/hurricanes/images/florence/hurricane-florence_00000472_pre_disaster.png,96,62,1,754,850,7,69,2241,70.47775366060236,46.59088925333062
18637,/media/marda/TWOTB1/xBD/hurricanes/images/florence/hurricane-florence_00000472_pre_disaster.png,72,49,1,560,632,10,59,1556,47.94965408445421,43.93187894177035
18638,/media/marda/TWOTB1/xBD/hurricanes/images/florence/hurricane-florence_00000472_pre_disaster.png,38,46,1,0,38,53,99,927,43.00354155800322,36.03021159882407
18639,/media/marda/TWOTB1/xBD/hurricanes/images/florence/hurricane-florence_00000472_pre_disaster.png,62,53,1,174,236,56,109,1904,52.586498036843984,49.981850960903564
18640,/media/marda/TWOTB1/xBD/hurricanes/images/florence/hurricane-florence_00000472_pre_disaster.png,76,55,1,139,215,113,168,1915,64.17903663016925,43.62801189142549
18641,/media/marda/TWOTB1/xBD/hurricanes/images/florence/hurricane-florence_00000472_pre_disaster.png,60,60,1,117,177,166,226,2090,54.140116208290884,51.327724926051594
18642,/media/marda/TWOTB1/xBD/hurricanes/images/florence/hurricane-florence_00000472_pre_disaster.png,90,64,1,617,707,311,375,1913,63.06290775091868,43.122104603478334
18643,/media/marda/TWOTB1/xBD/hurricanes/images/florence/hurricane-florence_00000472_pre_disaster.png,65,72,1,46,111,335,407,2252,65.99482205341963,48.69287422803887
18644,/media/marda/TWOTB1/xBD/hurricanes/images/florence/hurricane-florence_00000472_pre_disaster.png,82,69,1,601,683,363,432,1816,59.94446796510147,42.85087515824488
18645,/media/marda/TWOTB1/xBD/hurricanes/images/florence/hurricane-florence_00000472_pre_disaster.png,83,80,1,392,475,416,496,2519,76.91548803774785,45.45342695219808
18646,/media/marda/TWOTB1/xBD/hurricanes/images/florence/hurricane-florence_00000472_pre_disaster.png,76,75,1,586,662,424,499,1741,58.989055758079914,42.443815019085115
18647,/media/marda/TWOTB1/xBD/hurricanes/images/florence/hurricane-florence_00000472_pre_disaster.png,106,74,1,850,956,474,548,2214,63.03574381292773,48.88855310247368
18648,/media/marda/TWOTB1/xBD/hurricanes/images/florence/hurricane-florence_00000472_pre_disaster.png,73,109,1,360,433,608,717,2837,79.74069894714263,52.99098566298609
18649,/media/marda/TWOTB1/xBD/hurricanes/images/florence/hurricane-florence_00000472_pre_disaster.png,84,83,1,688,772,679,762,2099,55.3254291477023,50.77131777695638
18650,/media/marda/TWOTB1/xBD/hurricanes/images/florence/hurricane-florence_00000472_pre_disaster.png,96,92,1,888,984,701,793,1905,68.49602358175822,37.02062904772747
18651,/media/marda/TWOTB1/xBD/hurricanes/images/florence/hurricane-florence_00000472_pre_disaster.png,101,78,1,493,594,716,794,2291,73.67412358946542,42.26007375285826
18652,/media/marda/TWOTB1/xBD/hurricanes/images/florence/hurricane-florence_00000472_pre_disaster.png,97,90,1,731,828,726,816,2102,67.64721755992618,47.40281531080499
18653,/media/marda/TWOTB1/xBD/hurricanes/images/florence/hurricane-florence_00000472_pre_disaster.png,111,103,1,454,565,755,858,3412,88.66426731697798,56.284084451879984
18654,/media/marda/TWOTB1/xBD/hurricanes/images/florence/hurricane-florence_00000472_pre_disaster.png,92,87,1,783,875,770,857,2299,64.30227601957299,49.559309654509406
18655,/media/marda/TWOTB1/xBD/hurricanes/images/florence/hurricane-florence_00000472_pre_disaster.png,19,73,1,0,19,867,940,559,41.22522871113774,18.218941468495476
18656,/media/marda/TWOTB1/xBD/hurricanes/images/florence/hurricane-florence_00000472_pre_disaster.png,50,95,1,45,95,883,978,1679,57.187702371179924,42.892962038378485
18657,/media/marda/TWOTB1/xBD/hurricanes/images/florence/hurricane-florence_00000472_pre_disaster.png,59,103,1,91,150,897,1000,2171,61.00293504436863,49.50684527913659
18658,/media/marda/TWOTB1/xBD/hurricanes/images/florence/hurricane-florence_00000472_pre_disaster.png,81,80,1,518,599,897,977,1934,63.21162325886013,43.80125123859143
18659,/media/marda/TWOTB1/xBD/hurricanes/images/florence/hurricane-florence_00000472_pre_disaster.png,56,96,1,288,344,915,1011,2008,63.97849634844487,44.18115662434735
18660,/media/marda/TWOTB1/xBD/hurricanes/images/florence/hurricane-florence_00000472_pre_disaster.png,102,83,1,923,1025,928,1011,1681,62.41306964437028,37.376415338745375
18661,/media/marda/TWOTB1/xBD/hurricanes/images/florence/hurricane-florence_00000472_pre_disaster.png,98,83,1,543,641,944,1027,2110,75.28553651942653,40.25574178512204
18662,/media/marda/TWOTB1/xBD/hurricanes/images/florence/hurricane-florence_00000472_pre_disaster.png,56,57,1,442,498,987,1044,361,37.30853171904834,15.02904585857172
18663,/media/marda/TWOTB1/xBD/hurricanes/images/florence/hurricane-florence_00000472_pre_disaster.png,66,55,1,589,655,989,1044,430,44.14469066496174,13.752725930478384
18664,/media/marda/TWOTB1/xBD/hurricanes/images/florence/hurricane-florence_00000307_post_disaster.png,31,32,1,47,78,262,294,371,30.634094649116005,17.857984124624753
18665,/media/marda/TWOTB1/xBD/hurricanes/images/florence/hurricane-florence_00000307_post_disaster.png,17,44,1,0,17,282,326,340,33.24961197041822,15.217347458680605
18666,/media/marda/TWOTB1/xBD/hurricanes/images/florence/hurricane-florence_00000307_post_disaster.png,33,29,1,431,464,307,336,165,15.301968142832251,14.493376485714604
18667,/media/marda/TWOTB1/xBD/hurricanes/images/florence/hurricane-florence_00000307_post_disaster.png,29,30,1,8,37,308,338,255,29.407126730864885,12.395667693104777
18668,/media/marda/TWOTB1/xBD/hurricanes/images/florence/hurricane-florence_00000307_post_disaster.png,15,27,1,34,49,319,346,117,13.153897371912121,11.884081545732244
18669,/media/marda/TWOTB1/xBD/hurricanes/images/florence/hurricane-florence_00000307_post_disaster.png,29,25,1,464,493,336,361,109,13.536208176334991,10.696166016747615
18670,/media/marda/TWOTB1/xBD/hurricanes/images/florence/hurricane-florence_00000307_post_disaster.png,13,37,1,0,13,512,549,140,14.970442173716302,12.469789775364445
18671,/media/marda/TWOTB1/xBD/hurricanes/images/florence/hurricane-florence_00000307_post_disaster.png,8,43,1,0,8,574,617,120,22.18006950174009,7.557047131150083
18672,/media/marda/TWOTB1/xBD/hurricanes/images/florence/hurricane-florence_00000307_post_disaster.png,27,34,1,209,236,580,614,136,20.41505168517815,8.94383031355492
18673,/media/marda/TWOTB1/xBD/hurricanes/images/florence/hurricane-florence_00000320_post_disaster.png,29,23,1,266,295,131,154,179,22.497608286977304,10.64419852068971
18674,/media/marda/TWOTB1/xBD/hurricanes/images/florence/hurricane-florence_00000320_post_disaster.png,45,36,1,295,340,180,216,537,27.4063501189104,26.07670811502925
18675,/media/marda/TWOTB1/xBD/hurricanes/images/florence/hurricane-florence_00000320_post_disaster.png,83,67,1,436,519,245,312,1884,57.36071285860207,44.29322621121645
18676,/media/marda/TWOTB1/xBD/hurricanes/images/florence/hurricane-florence_00000320_post_disaster.png,61,52,1,500,561,300,352,738,43.66354726820535,22.572904822654902
18677,/media/marda/TWOTB1/xBD/hurricanes/images/florence/hurricane-florence_00000320_post_disaster.png,52,60,1,992,1044,378,438,352,50.474606117034554,10.223210553658404
18678,/media/marda/TWOTB1/xBD/hurricanes/images/florence/hurricane-florence_00000320_post_disaster.png,65,49,1,808,873,413,462,393,41.19636965704227,12.737022238897882
18679,/media/marda/TWOTB1/xBD/hurricanes/images/florence/hurricane-florence_00000320_post_disaster.png,66,54,1,805,871,510,564,611,29.84180202306191,27.098013915956095
18680,/media/marda/TWOTB1/xBD/hurricanes/images/florence/hurricane-florence_00000320_post_disaster.png,54,49,1,697,751,561,610,368,27.95906448420085,17.607664342640142
18681,/media/marda/TWOTB1/xBD/hurricanes/images/florence/hurricane-florence_00000320_post_disaster.png,76,67,1,945,1021,633,700,888,42.30623089714628,27.70356860125413
18682,/media/marda/TWOTB1/xBD/hurricanes/images/florence/hurricane-florence_00000320_post_disaster.png,56,44,1,972,1028,728,772,142,15.821047614964643,12.038470160745643
18683,/media/marda/TWOTB1/xBD/hurricanes/images/florence/hurricane-florence_00000320_post_disaster.png,68,70,1,335,403,97,167,2200,67.1968816997523,45.258126366722145
18684,/media/marda/TWOTB1/xBD/hurricanes/images/florence/hurricane-florence_00000543_post_disaster.png,19,28,1,0,19,329,357,274,22.260719137869316,16.676039851963164
18685,/media/marda/TWOTB1/xBD/hurricanes/images/florence/hurricane-florence_00000543_post_disaster.png,33,57,1,51,84,597,654,560,27.628803755411305,27.08669413131358
18686,/media/marda/TWOTB1/xBD/hurricanes/images/florence/hurricane-florence_00000543_post_disaster.png,43,62,1,131,174,624,686,579,46.12613995337122,16.758262783321
18687,/media/marda/TWOTB1/xBD/hurricanes/images/florence/hurricane-florence_00000543_post_disaster.png,61,77,1,919,980,702,779,639,54.90235516806622,15.416721884788402
18688,/media/marda/TWOTB1/xBD/hurricanes/images/florence/hurricane-florence_00000543_post_disaster.png,57,45,1,954,1011,718,763,199,19.75747256630906,13.45419354427249
18689,/media/marda/TWOTB1/xBD/hurricanes/images/florence/hurricane-florence_00000543_post_disaster.png,27,92,1,0,27,901,993,752,51.452303542026016,20.862984614785606
18690,/media/marda/TWOTB1/xBD/hurricanes/images/florence/hurricane-florence_00000234_pre_disaster.png,76,42,1,903,979,110,152,835,38.56249698441912,28.908658311717648
18691,/media/marda/TWOTB1/xBD/hurricanes/images/florence/hurricane-florence_00000234_pre_disaster.png,55,24,1,952,1007,161,185,343,22.386719203825763,20.45561160011001
18692,/media/marda/TWOTB1/xBD/hurricanes/images/florence/hurricane-florence_00000234_pre_disaster.png,67,48,1,716,783,202,250,843,35.423958650282366,31.76712505711734
18693,/media/marda/TWOTB1/xBD/hurricanes/images/florence/hurricane-florence_00000234_pre_disaster.png,78,59,1,668,746,226,285,1429,45.18353160851433,42.19189342739854
18694,/media/marda/TWOTB1/xBD/hurricanes/images/florence/hurricane-florence_00000234_pre_disaster.png,23,70,1,0,23,651,721,574,40.93044089615149,21.134099909787643
18695,/media/marda/TWOTB1/xBD/hurricanes/images/florence/hurricane-florence_00000234_pre_disaster.png,52,76,1,57,109,798,874,1140,42.77525720086521,35.27889837957801
18696,/media/marda/TWOTB1/xBD/hurricanes/images/florence/hurricane-florence_00000234_pre_disaster.png,13,55,1,25,38,848,903,215,24.759237982621777,11.64608506368543
18697,/media/marda/TWOTB1/xBD/hurricanes/images/florence/hurricane-florence_00000328_pre_disaster.png,27,28,1,0,27,148,176,461,29.8011724790846,20.68463834809945
18698,/media/marda/TWOTB1/xBD/hurricanes/images/florence/hurricane-florence_00000328_pre_disaster.png,112,53,1,3,115,165,218,2960,123.9844171858047,31.743849475725778
18699,/media/marda/TWOTB1/xBD/hurricanes/images/florence/hurricane-florence_00000328_pre_disaster.png,8,16,1,5,13,214,230,49,8.554933350390092,7.305731662228463
18700,/media/marda/TWOTB1/xBD/hurricanes/images/florence/hurricane-florence_00000328_pre_disaster.png,114,58,1,15,129,217,275,3130,126.17832120499594,32.93684946176162
18701,/media/marda/TWOTB1/xBD/hurricanes/images/florence/hurricane-florence_00000328_pre_disaster.png,28,16,1,531,559,235,251,44,8.064292936694622,7.055288568623478
18702,/media/marda/TWOTB1/xBD/hurricanes/images/florence/hurricane-florence_00000328_pre_disaster.png,132,59,1,442,574,245,304,3311,127.7655664909357,34.240375115259006
18703,/media/marda/TWOTB1/xBD/hurricanes/images/florence/hurricane-florence_00000328_pre_disaster.png,8,15,1,16,24,271,286,43,8.014381369814155,6.802401475951732
18704,/media/marda/TWOTB1/xBD/hurricanes/images/florence/hurricane-florence_00000328_pre_disaster.png,115,58,1,26,141,274,332,3248,126.4375964844354,34.10324922670662
18705,/media/marda/TWOTB1/xBD/hurricanes/images/florence/hurricane-florence_00000328_pre_disaster.png,31,18,1,541,572,290,308,76,10.322914657212545,9.411331842620818
18706,/media/marda/TWOTB1/xBD/hurricanes/images/florence/hurricane-florence_00000328_pre_disaster.png,132,62,1,453,585,299,361,3207,128.54880025261028,33.04894836807995
18707,/media/marda/TWOTB1/xBD/hurricanes/images/florence/hurricane-florence_00000328_pre_disaster.png,9,20,1,27,36,324,344,58,9.213545319815026,7.974095992433984
18708,/media/marda/TWOTB1/xBD/hurricanes/images/florence/hurricane-florence_00000328_pre_disaster.png,114,61,1,37,151,329,390,3040,126.11665208153998,31.97118048808909
18709,/media/marda/TWOTB1/xBD/hurricanes/images/florence/hurricane-florence_00000328_pre_disaster.png,9,21,1,37,46,380,401,69,9.853433481761975,8.960153445991399
18710,/media/marda/TWOTB1/xBD/hurricanes/images/florence/hurricane-florence_00000328_pre_disaster.png,112,60,1,50,162,385,445,2944,124.76927935474636,31.320695232623997
18711,/media/marda/TWOTB1/xBD/hurricanes/images/florence/hurricane-florence_00000328_pre_disaster.png,11,26,1,40,51,393,419,86,11.00543792082219,9.931886512771262
18712,/media/marda/TWOTB1/xBD/hurricanes/images/florence/hurricane-florence_00000125_post_disaster.png,21,49,1,0,21,386,435,410,31.56041587815432,19.66653882209613
18713,/media/marda/TWOTB1/xBD/hurricanes/images/florence/hurricane-florence_00000125_post_disaster.png,24,59,1,0,24,425,484,547,37.10420556874409,22.139626379658765
18714,/media/marda/TWOTB1/xBD/hurricanes/images/florence/hurricane-florence_00000125_post_disaster.png,42,53,1,487,529,818,871,216,24.633593210503328,12.813779467823167
18715,/media/marda/TWOTB1/xBD/hurricanes/images/florence/hurricane-florence_00000463_pre_disaster.png,48,28,1,567,615,0,28,288,35.253548260596475,10.899531937544307
18716,/media/marda/TWOTB1/xBD/hurricanes/images/florence/hurricane-florence_00000463_pre_disaster.png,44,15,1,620,664,51,66,127,21.758758502825543,7.828865172240488
18717,/media/marda/TWOTB1/xBD/hurricanes/images/florence/hurricane-florence_00000463_pre_disaster.png,67,10,1,565,632,147,157,218,50.33752033148814,5.632837839691454
18718,/media/marda/TWOTB1/xBD/hurricanes/images/florence/hurricane-florence_00000463_pre_disaster.png,66,11,1,565,631,157,168,211,48.67536607424849,5.657266592827832
18719,/media/marda/TWOTB1/xBD/hurricanes/images/florence/hurricane-florence_00000463_pre_disaster.png,35,13,1,615,650,157,170,81,11.843711478326757,9.169653303382603
18720,/media/marda/TWOTB1/xBD/hurricanes/images/florence/hurricane-florence_00000463_pre_disaster.png,58,42,1,980,1038,742,784,235,21.083505441638618,14.7504800917472
18721,/media/marda/TWOTB1/xBD/hurricanes/images/florence/hurricane-florence_00000463_pre_disaster.png,58,49,1,954,1012,799,848,230,21.60654247074682,14.273159045974557
18722,/media/marda/TWOTB1/xBD/hurricanes/images/florence/hurricane-florence_00000243_pre_disaster.png,35,20,1,199,234,39,59,296,27.474108271545347,14.473700992151644
18723,/media/marda/TWOTB1/xBD/hurricanes/images/florence/hurricane-florence_00000243_pre_disaster.png,61,53,1,424,485,108,161,1182,42.2439782207529,37.27053321514898
18724,/media/marda/TWOTB1/xBD/hurricanes/images/florence/hurricane-florence_00000243_pre_disaster.png,72,64,1,364,436,226,290,1809,53.74517328486447,46.0745758704447
18725,/media/marda/TWOTB1/xBD/hurricanes/images/florence/hurricane-florence_00000243_pre_disaster.png,31,36,1,353,384,242,278,244,29.36155277929411,11.224816437903103
18726,/media/marda/TWOTB1/xBD/hurricanes/images/florence/hurricane-florence_00000243_pre_disaster.png,45,23,1,791,836,346,369,97,13.396924398940131,9.665504689155147
18727,/media/marda/TWOTB1/xBD/hurricanes/images/florence/hurricane-florence_00000243_pre_disaster.png,61,39,1,739,800,354,393,602,34.79319705321706,23.154340313423322
18728,/media/marda/TWOTB1/xBD/hurricanes/images/florence/hurricane-florence_00000243_pre_disaster.png,60,65,1,784,844,395,460,616,54.280078694054346,15.16527436038864
18729,/media/marda/TWOTB1/xBD/hurricanes/images/florence/hurricane-florence_00000243_pre_disaster.png,87,74,1,957,1044,522,596,1511,51.63557488166612,38.65514968037799
18730,/media/marda/TWOTB1/xBD/hurricanes/images/florence/hurricane-florence_00000243_pre_disaster.png,52,74,1,633,685,576,650,775,61.1018422750631,16.884327549392825
18731,/media/marda/TWOTB1/xBD/hurricanes/images/florence/hurricane-florence_00000243_pre_disaster.png,62,50,1,860,922,599,649,400,24.082169747024583,22.217040763240586
18732,/media/marda/TWOTB1/xBD/hurricanes/images/florence/hurricane-florence_00000243_pre_disaster.png,56,54,1,913,969,610,664,252,35.04167134853725,10.281923623741559
18733,/media/marda/TWOTB1/xBD/hurricanes/images/florence/hurricane-florence_00000243_pre_disaster.png,61,54,1,835,896,614,668,473,26.58940813880657,23.779191551006463
18734,/media/marda/TWOTB1/xBD/hurricanes/images/florence/hurricane-florence_00000243_pre_disaster.png,46,37,1,998,1044,615,652,45,11.876929147789301,5.5303683215025865
18735,/media/marda/TWOTB1/xBD/hurricanes/images/florence/hurricane-florence_00000243_pre_disaster.png,57,41,1,927,984,632,673,153,22.8115607827859,8.961720438362038
18736,/media/marda/TWOTB1/xBD/hurricanes/images/florence/hurricane-florence_00000243_pre_disaster.png,69,53,1,940,1009,652,705,556,31.511541343603938,23.168620800088842
18737,/media/marda/TWOTB1/xBD/hurricanes/images/florence/hurricane-florence_00000243_pre_disaster.png,35,35,1,591,626,660,695,77,10.55588999393662,9.879886005155614
18738,/media/marda/TWOTB1/xBD/hurricanes/images/florence/hurricane-florence_00000243_pre_disaster.png,48,39,1,888,936,669,708,123,15.051559531908593,11.040032121476829
18739,/media/marda/TWOTB1/xBD/hurricanes/images/florence/hurricane-florence_00000243_pre_disaster.png,61,68,1,608,669,680,748,1051,42.76160217554167,32.8117674748645
18740,/media/marda/TWOTB1/xBD/hurricanes/images/florence/hurricane-florence_00000243_pre_disaster.png,73,84,1,836,909,680,764,1414,58.3152616741024,34.18334532305352
18741,/media/marda/TWOTB1/xBD/hurricanes/images/florence/hurricane-florence_00000243_pre_disaster.png,67,77,1,916,983,829,906,790,48.162759050453346,21.909761861846302
18742,/media/marda/TWOTB1/xBD/hurricanes/images/florence/hurricane-florence_00000244_pre_disaster.png,29,10,1,392,421,44,54,90,13.168853939915916,8.990505388671375
18743,/media/marda/TWOTB1/xBD/hurricanes/images/florence/hurricane-florence_00000244_pre_disaster.png,50,27,1,423,473,71,98,525,33.062685670763024,23.17989912113078
18744,/media/marda/TWOTB1/xBD/hurricanes/images/florence/hurricane-florence_00000244_pre_disaster.png,120,81,1,331,451,99,180,4949,116.59840072534078,65.46463514180407
18745,/media/marda/TWOTB1/xBD/hurricanes/images/florence/hurricane-florence_00000244_pre_disaster.png,40,35,1,520,560,192,227,371,33.31563654024672,16.2363294573823
18746,/media/marda/TWOTB1/xBD/hurricanes/images/florence/hurricane-florence_00000244_pre_disaster.png,33,43,1,369,402,238,281,479,36.61608719374259,18.022582412741208
18747,/media/marda/TWOTB1/xBD/hurricanes/images/florence/hurricane-florence_00000244_pre_disaster.png,63,62,1,276,339,240,302,1544,67.19952236070272,36.348797698340476
18748,/media/marda/TWOTB1/xBD/hurricanes/images/florence/hurricane-florence_00000157_pre_disaster.png,58,24,1,852,910,289,313,349,28.94506666075493,15.87815200125437
18749,/media/marda/TWOTB1/xBD/hurricanes/images/florence/hurricane-florence_00000157_pre_disaster.png,76,74,1,718,794,589,663,1263,50.392939942448315,33.41854914906073
18750,/media/marda/TWOTB1/xBD/hurricanes/images/florence/hurricane-florence_00000157_pre_disaster.png,67,51,1,832,899,616,667,442,36.83491559668609,15.87536529219027
18751,/media/marda/TWOTB1/xBD/hurricanes/images/florence/hurricane-florence_00000157_pre_disaster.png,79,79,1,775,854,915,994,1099,44.376369761776004,33.04840866683832
18752,/media/marda/TWOTB1/xBD/hurricanes/images/florence/hurricane-florence_00000157_pre_disaster.png,71,69,1,953,1024,965,1034,823,33.67601499813866,32.863544494190585
18753,/media/marda/TWOTB1/xBD/hurricanes/images/florence/hurricane-florence_00000459_post_disaster.png,24,57,1,131,155,968,1025,217,19.010430734933323,15.260040977374002
18754,/media/marda/TWOTB1/xBD/hurricanes/images/florence/hurricane-florence_00000459_post_disaster.png,28,52,1,0,28,0,52,931,46.54547123589193,31.203519892302197
18755,/media/marda/TWOTB1/xBD/hurricanes/images/florence/hurricane-florence_00000459_post_disaster.png,32,44,1,0,32,163,207,1117,42.58234987602826,34.7749442374363
18756,/media/marda/TWOTB1/xBD/hurricanes/images/florence/hurricane-florence_00000459_post_disaster.png,57,79,1,17,74,691,770,1493,49.41317032377334,41.50167466882546
18757,/media/marda/TWOTB1/xBD/hurricanes/images/florence/hurricane-florence_00000459_post_disaster.png,69,31,1,308,377,0,31,845,45.87543566636055,32.01514787647992
18758,/media/marda/TWOTB1/xBD/hurricanes/images/florence/hurricane-florence_00000459_post_disaster.png,51,11,1,585,636,0,11,253,28.496679982511306,11.622737937909777
18759,/media/marda/TWOTB1/xBD/hurricanes/images/florence/hurricane-florence_00000459_post_disaster.png,55,26,1,662,717,0,26,498,30.470876211996067,21.74004647078656
18760,/media/marda/TWOTB1/xBD/hurricanes/images/florence/hurricane-florence_00000459_post_disaster.png,91,61,1,711,802,0,61,2072,71.19020596367223,46.44185264018034
18761,/media/marda/TWOTB1/xBD/hurricanes/images/florence/hurricane-florence_00000459_post_disaster.png,9,11,1,61,70,57,68,81,11.893328104054724,9.137289889789303
18762,/media/marda/TWOTB1/xBD/hurricanes/images/florence/hurricane-florence_00000459_post_disaster.png,82,56,1,221,303,97,153,2335,67.06965833805867,48.05047309548832
18763,/media/marda/TWOTB1/xBD/hurricanes/images/florence/hurricane-florence_00000459_post_disaster.png,76,63,1,521,597,108,171,1884,64.7383163611208,39.05140528006153
18764,/media/marda/TWOTB1/xBD/hurricanes/images/florence/hurricane-florence_00000459_post_disaster.png,62,42,1,981,1043,110,152,503,33.51389714611904,21.19599807008766
18765,/media/marda/TWOTB1/xBD/hurricanes/images/florence/hurricane-florence_00000459_post_disaster.png,46,55,1,45,91,143,198,1577,52.270683753066066,41.975052359048135
18766,/media/marda/TWOTB1/xBD/hurricanes/images/florence/hurricane-florence_00000459_post_disaster.png,74,70,1,329,403,152,222,2317,62.12561116662108,51.70657638532209
18767,/media/marda/TWOTB1/xBD/hurricanes/images/florence/hurricane-florence_00000459_post_disaster.png,103,66,1,742,845,153,219,2479,69.84337281311775,48.24488036922713
18768,/media/marda/TWOTB1/xBD/hurricanes/images/florence/hurricane-florence_00000459_post_disaster.png,90,57,1,565,655,169,226,2138,64.34432323595452,44.146323125313515
18769,/media/marda/TWOTB1/xBD/hurricanes/images/florence/hurricane-florence_00000459_post_disaster.png,62,59,1,159,221,199,258,1426,56.49016833553939,33.768239426780326
18770,/media/marda/TWOTB1/xBD/hurricanes/images/florence/hurricane-florence_00000459_post_disaster.png,66,68,1,198,264,253,321,1874,61.512963342239296,44.22197177434853
18771,/media/marda/TWOTB1/xBD/hurricanes/images/florence/hurricane-florence_00000459_post_disaster.png,75,62,1,493,568,280,342,1545,47.340516858021196,43.53341369947993
18772,/media/marda/TWOTB1/xBD/hurricanes/images/florence/hurricane-florence_00000459_post_disaster.png,67,74,1,349,416,375,449,1691,56.02623640437738,42.39586857807183
18773,/media/marda/TWOTB1/xBD/hurricanes/images/florence/hurricane-florence_00000459_post_disaster.png,86,82,1,409,495,396,478,2414,73.32885040038984,43.41769834917243
18774,/media/marda/TWOTB1/xBD/hurricanes/images/florence/hurricane-florence_00000459_post_disaster.png,33,67,1,0,33,458,525,1103,49.106491132451104,30.803257092717068
18775,/media/marda/TWOTB1/xBD/hurricanes/images/florence/hurricane-florence_00000459_post_disaster.png,54,60,1,21,75,483,543,1382,50.403014880928694,36.80788038223672
18776,/media/marda/TWOTB1/xBD/hurricanes/images/florence/hurricane-florence_00000459_post_disaster.png,60,71,1,56,116,509,580,1621,54.48803530200199,40.073154879670305
18777,/media/marda/TWOTB1/xBD/hurricanes/images/florence/hurricane-florence_00000459_post_disaster.png,57,66,1,94,151,537,603,1389,51.607231985857574,36.347965053489816
18778,/media/marda/TWOTB1/xBD/hurricanes/images/florence/hurricane-florence_00000459_post_disaster.png,61,76,1,129,190,566,642,1557,50.33086655177538,42.07574188923507
18779,/media/marda/TWOTB1/xBD/hurricanes/images/florence/hurricane-florence_00000459_post_disaster.png,18,57,1,0,18,581,638,233,29.940612068622226,15.753111871805558
18780,/media/marda/TWOTB1/xBD/hurricanes/images/florence/hurricane-florence_00000459_post_disaster.png,58,86,1,168,226,593,679,1670,57.02572534345268,39.71248798026598
18781,/media/marda/TWOTB1/xBD/hurricanes/images/florence/hurricane-florence_00000459_post_disaster.png,49,82,1,210,259,627,709,1406,55.757391187921904,35.4130582452616
18782,/media/marda/TWOTB1/xBD/hurricanes/images/florence/hurricane-florence_00000459_post_disaster.png,60,70,1,29,89,632,702,1544,54.74545459751406,37.61310024323627
18783,/media/marda/TWOTB1/xBD/hurricanes/images/florence/hurricane-florence_00000459_post_disaster.png,39,65,1,79,118,660,725,842,37.74500370389708,31.547748955326934
18784,/media/marda/TWOTB1/xBD/hurricanes/images/florence/hurricane-florence_00000459_post_disaster.png,62,69,1,981,1043,670,739,595,44.45133074020869,21.139990264021638
18785,/media/marda/TWOTB1/xBD/hurricanes/images/florence/hurricane-florence_00000459_post_disaster.png,66,83,1,269,335,687,770,1618,53.334925744686586,42.71352777060233
18786,/media/marda/TWOTB1/xBD/hurricanes/images/florence/hurricane-florence_00000459_post_disaster.png,46,75,1,113,159,690,765,1111,42.88645084917751,36.02061952733837
18787,/media/marda/TWOTB1/xBD/hurricanes/images/florence/hurricane-florence_00000459_post_disaster.png,51,90,1,141,192,715,805,1619,56.47649534779498,39.41970332891079
18788,/media/marda/TWOTB1/xBD/hurricanes/images/florence/hurricane-florence_00000459_post_disaster.png,56,82,1,313,369,718,800,1352,50.42449922173232,35.291263752314826
18789,/media/marda/TWOTB1/xBD/hurricanes/images/florence/hurricane-florence_00000459_post_disaster.png,11,65,1,0,11,728,793,328,42.08296900660087,10.75482190958551
18790,/media/marda/TWOTB1/xBD/hurricanes/images/florence/hurricane-florence_00000459_post_disaster.png,61,90,1,337,398,758,848,1614,55.06446091966263,39.51262471548777
18791,/media/marda/TWOTB1/xBD/hurricanes/images/florence/hurricane-florence_00000459_post_disaster.png,43,73,1,105,148,761,834,966,41.85422850443386,33.29930835660281
18792,/media/marda/TWOTB1/xBD/hurricanes/images/florence/hurricane-florence_00000459_post_disaster.png,67,78,1,226,293,772,850,1530,56.339457595159274,36.24142747946684
18793,/media/marda/TWOTB1/xBD/hurricanes/images/florence/hurricane-florence_00000459_post_disaster.png,67,93,1,370,437,787,880,1711,54.29795358278003,42.16177991441414
18794,/media/marda/TWOTB1/xBD/hurricanes/images/florence/hurricane-florence_00000459_post_disaster.png,16,83,1,0,16,792,875,492,51.787514669004786,13.871195208471422
18795,/media/marda/TWOTB1/xBD/hurricanes/images/florence/hurricane-florence_00000459_post_disaster.png,55,94,1,196,251,802,896,1545,57.429235474129605,36.80427264886081
18796,/media/marda/TWOTB1/xBD/hurricanes/images/florence/hurricane-florence_00000459_post_disaster.png,76,80,1,401,477,825,905,1616,56.49260887921454,38.385129104047216
18797,/media/marda/TWOTB1/xBD/hurricanes/images/florence/hurricane-florence_00000459_post_disaster.png,49,92,1,166,215,837,929,1435,54.24477766340034,35.475735284820104
18798,/media/marda/TWOTB1/xBD/hurricanes/images/florence/hurricane-florence_00000459_post_disaster.png,54,86,1,271,325,838,924,1249,49.88735308295848,36.57123559245369
18799,/media/marda/TWOTB1/xBD/hurricanes/images/florence/hurricane-florence_00000459_post_disaster.png,80,82,1,444,524,858,940,1572,55.14767178356957,38.77980465226981
18800,/media/marda/TWOTB1/xBD/hurricanes/images/florence/hurricane-florence_00000459_post_disaster.png,41,86,1,71,112,880,966,1368,51.0451076968475,35.70340233492894
18801,/media/marda/TWOTB1/xBD/hurricanes/images/florence/hurricane-florence_00000459_post_disaster.png,78,99,1,478,556,885,984,1893,59.01785375952344,43.72713168468938
18802,/media/marda/TWOTB1/xBD/hurricanes/images/florence/hurricane-florence_00000459_post_disaster.png,47,89,1,25,72,888,977,1582,55.34832887056852,38.723843858914314
18803,/media/marda/TWOTB1/xBD/hurricanes/images/florence/hurricane-florence_00000459_post_disaster.png,71,85,1,327,398,895,980,1583,55.82917096735929,39.39586075181603
18804,/media/marda/TWOTB1/xBD/hurricanes/images/florence/hurricane-florence_00000459_post_disaster.png,77,86,1,359,436,917,1003,1650,56.30358336316464,38.96791361922521
18805,/media/marda/TWOTB1/xBD/hurricanes/images/florence/hurricane-florence_00000459_post_disaster.png,75,99,1,502,577,920,1019,1807,57.98190091625542,41.94932303079084
18806,/media/marda/TWOTB1/xBD/hurricanes/images/florence/hurricane-florence_00000459_post_disaster.png,66,88,1,392,458,953,1041,1563,54.82658399216728,38.06518108768396
18807,/media/marda/TWOTB1/xBD/hurricanes/images/florence/hurricane-florence_00000459_post_disaster.png,77,82,1,526,603,959,1041,1536,51.9952787846877,39.55506790914472
18808,/media/marda/TWOTB1/xBD/hurricanes/images/florence/hurricane-florence_00000459_post_disaster.png,54,57,1,421,475,986,1043,280,32.54616841561605,14.831433216593561
18809,/media/marda/TWOTB1/xBD/hurricanes/images/florence/hurricane-florence_00000336_pre_disaster.png,18,11,1,189,207,25,36,62,11.446514176567868,7.424626317382524
18810,/media/marda/TWOTB1/xBD/hurricanes/images/florence/hurricane-florence_00000336_pre_disaster.png,52,26,1,721,773,92,118,314,23.763111644732525,17.657819836919234
18811,/media/marda/TWOTB1/xBD/hurricanes/images/florence/hurricane-florence_00000336_pre_disaster.png,45,18,1,697,742,99,117,162,15.264986079985961,14.18853763506656
18812,/media/marda/TWOTB1/xBD/hurricanes/images/florence/hurricane-florence_00000336_pre_disaster.png,69,54,1,761,830,105,159,808,54.84424365196123,19.660439765637925
18813,/media/marda/TWOTB1/xBD/hurricanes/images/florence/hurricane-florence_00000336_pre_disaster.png,37,15,1,669,706,121,136,64,12.957394137331368,6.685490327556438
18814,/media/marda/TWOTB1/xBD/hurricanes/images/florence/hurricane-florence_00000336_pre_disaster.png,65,38,1,619,684,149,187,625,43.095235471834776,19.353208162656475
18815,/media/marda/TWOTB1/xBD/hurricanes/images/florence/hurricane-florence_00000336_pre_disaster.png,37,39,1,30,67,159,198,726,31.798659818024934,30.133039304885617
18816,/media/marda/TWOTB1/xBD/hurricanes/images/florence/hurricane-florence_00000336_pre_disaster.png,43,22,1,660,703,165,187,168,18.442860739398604,12.211700412971755
18817,/media/marda/TWOTB1/xBD/hurricanes/images/florence/hurricane-florence_00000336_pre_disaster.png,68,59,1,649,717,193,252,855,62.973326801434084,18.13017630111573
18818,/media/marda/TWOTB1/xBD/hurricanes/images/florence/hurricane-florence_00000336_pre_disaster.png,41,22,1,598,639,205,227,107,17.700858204051094,8.133198477153883
18819,/media/marda/TWOTB1/xBD/hurricanes/images/florence/hurricane-florence_00000336_pre_disaster.png,87,91,1,178,265,235,326,3526,84.1376732345565,55.26007754881642
18820,/media/marda/TWOTB1/xBD/hurricanes/images/florence/hurricane-florence_00000489_pre_disaster.png,133,60,1,200,333,410,470,4638,134.1408412632236,46.04242838473426
18821,/media/marda/TWOTB1/xBD/hurricanes/images/florence/hurricane-florence_00000489_pre_disaster.png,14,22,1,185,199,421,443,48,9.957261911086414,6.1496514544976835
18822,/media/marda/TWOTB1/xBD/hurricanes/images/florence/hurricane-florence_00000347_post_disaster.png,308,159,1,736,1044,0,159,27246,301.9373294016522,118.68922798090883
18823,/media/marda/TWOTB1/xBD/hurricanes/images/florence/hurricane-florence_00000347_post_disaster.png,53,14,1,82,135,37,51,608,58.49283559845986,13.865250428855258
18824,/media/marda/TWOTB1/xBD/hurricanes/images/florence/hurricane-florence_00000347_post_disaster.png,16,13,1,0,16,49,62,208,18.439088914585774,14.966629547095765
18825,/media/marda/TWOTB1/xBD/hurricanes/images/florence/hurricane-florence_00000347_post_disaster.png,52,10,1,206,258,50,60,421,50.572679345238356,11.042414236846792
18826,/media/marda/TWOTB1/xBD/hurricanes/images/florence/hurricane-florence_00000347_post_disaster.png,214,286,1,542,756,72,358,29598,311.59696342604127,126.29515311404964
18827,/media/marda/TWOTB1/xBD/hurricanes/images/florence/hurricane-florence_00000347_post_disaster.png,54,26,1,953,1007,154,180,238,22.320034560780247,14.259335967975234
18828,/media/marda/TWOTB1/xBD/hurricanes/images/florence/hurricane-florence_00000347_post_disaster.png,54,47,1,990,1044,297,344,310,34.90744179964389,12.614150471757554
18829,/media/marda/TWOTB1/xBD/hurricanes/images/florence/hurricane-florence_00000347_post_disaster.png,58,64,1,603,661,588,652,1180,48.28303787003499,33.114140839843934
18830,/media/marda/TWOTB1/xBD/hurricanes/images/florence/hurricane-florence_00000347_post_disaster.png,60,73,1,785,845,601,674,682,55.33986677267391,16.440621873497637
18831,/media/marda/TWOTB1/xBD/hurricanes/images/florence/hurricane-florence_00000347_post_disaster.png,93,48,1,605,698,671,719,1335,75.04359370827412,23.839017279330264
18832,/media/marda/TWOTB1/xBD/hurricanes/images/florence/hurricane-florence_00000359_post_disaster.png,62,25,1,979,1041,1,26,375,22.858300739214787,21.794983729290948
18833,/media/marda/TWOTB1/xBD/hurricanes/images/florence/hurricane-florence_00000359_post_disaster.png,44,46,1,12,56,15,61,1195,47.07170558804733,34.764677421095854
18834,/media/marda/TWOTB1/xBD/hurricanes/images/florence/hurricane-florence_00000359_post_disaster.png,45,17,1,966,1011,22,39,145,18.591152323119605,10.374296847716176
18835,/media/marda/TWOTB1/xBD/hurricanes/images/florence/hurricane-florence_00000359_post_disaster.png,69,46,1,922,991,44,90,1044,45.04026860791979,30.65362853821398
18836,/media/marda/TWOTB1/xBD/hurricanes/images/florence/hurricane-florence_00000359_post_disaster.png,48,8,1,978,1026,66,74,50,10.830330662981256,6.259707479626183
18837,/media/marda/TWOTB1/xBD/hurricanes/images/florence/hurricane-florence_00000359_post_disaster.png,67,32,1,919,986,141,173,578,32.004403922574554,23.94903201329555
18838,/media/marda/TWOTB1/xBD/hurricanes/images/florence/hurricane-florence_00000359_post_disaster.png,62,22,1,961,1023,168,190,255,23.567579679206276,14.498178413137742
18839,/media/marda/TWOTB1/xBD/hurricanes/images/florence/hurricane-florence_00000359_post_disaster.png,53,40,1,991,1044,377,417,275,27.729225254354066,13.31422568669572
18840,/media/marda/TWOTB1/xBD/hurricanes/images/florence/hurricane-florence_00000359_post_disaster.png,77,45,1,893,970,404,449,688,39.63712790106021,22.955824692660563
18841,/media/marda/TWOTB1/xBD/hurricanes/images/florence/hurricane-florence_00000359_post_disaster.png,66,59,1,925,991,489,548,764,44.931391645174934,22.692974506404468
18842,/media/marda/TWOTB1/xBD/hurricanes/images/florence/hurricane-florence_00000359_post_disaster.png,73,63,1,957,1030,553,616,949,44.37461861464773,28.51059541968071
18843,/media/marda/TWOTB1/xBD/hurricanes/images/florence/hurricane-florence_00000359_post_disaster.png,56,39,1,859,915,581,620,269,21.14965127048252,17.27427173934219
18844,/media/marda/TWOTB1/xBD/hurricanes/images/florence/hurricane-florence_00000359_post_disaster.png,70,69,1,974,1044,597,666,852,47.94565491881146,23.528957623017305
18845,/media/marda/TWOTB1/xBD/hurricanes/images/florence/hurricane-florence_00000359_post_disaster.png,63,56,1,928,991,611,667,514,29.193173740748463,23.514344730187723
18846,/media/marda/TWOTB1/xBD/hurricanes/images/florence/hurricane-florence_00000359_post_disaster.png,71,68,1,887,958,616,684,1009,41.390543804187864,32.146320066314836
18847,/media/marda/TWOTB1/xBD/hurricanes/images/florence/hurricane-florence_00000359_post_disaster.png,79,59,1,828,907,640,699,1024,47.22634178677965,30.682344577258206
18848,/media/marda/TWOTB1/xBD/hurricanes/images/florence/hurricane-florence_00000359_post_disaster.png,71,75,1,927,998,726,801,973,47.6785746564377,27.235394908426844
18849,/media/marda/TWOTB1/xBD/hurricanes/images/florence/hurricane-florence_00000359_post_disaster.png,65,74,1,826,891,743,817,919,46.070462373954676,26.86342281639173
18850,/media/marda/TWOTB1/xBD/hurricanes/images/florence/hurricane-florence_00000359_post_disaster.png,52,49,1,816,868,787,836,195,19.615222530362416,13.32501593569772
18851,/media/marda/TWOTB1/xBD/hurricanes/images/florence/hurricane-florence_00000359_post_disaster.png,71,79,1,952,1023,803,882,949,48.6424548495452,26.001440460818586
18852,/media/marda/TWOTB1/xBD/hurricanes/images/florence/hurricane-florence_00000359_post_disaster.png,85,77,1,722,807,946,1023,1215,56.57203641992497,28.566704857416543
18853,/media/marda/TWOTB1/xBD/hurricanes/images/florence/hurricane-florence_00000359_post_disaster.png,47,56,1,780,827,981,1037,146,14.687887012545337,13.348549858538195
18854,/media/marda/TWOTB1/xBD/hurricanes/images/florence/hurricane-florence_00000359_post_disaster.png,69,77,1,842,911,804,881,1019,46.53678020332071,29.360894779689605
18855,/media/marda/TWOTB1/xBD/hurricanes/images/florence/hurricane-florence_00000359_post_disaster.png,70,63,1,718,788,756,819,750,45.0445651647493,22.09944519682663
18856,/media/marda/TWOTB1/xBD/hurricanes/images/florence/hurricane-florence_00000359_post_disaster.png,54,57,1,804,858,816,873,375,24.793165886755308,20.08441799507074
18857,/media/marda/TWOTB1/xBD/hurricanes/images/florence/hurricane-florence_00000359_post_disaster.png,100,78,1,836,936,860,938,1589,67.75874035315232,37.625326261314406
18858,/media/marda/TWOTB1/xBD/hurricanes/images/florence/hurricane-florence_00000359_post_disaster.png,42,58,1,570,612,949,1007,230,20.814389840965845,14.819688907970244
18859,/media/marda/TWOTB1/xBD/hurricanes/images/florence/hurricane-florence_00000471_post_disaster.png,74,47,1,380,454,74,121,1961,61.59459587317508,42.37846073028257
18860,/media/marda/TWOTB1/xBD/hurricanes/images/florence/hurricane-florence_00000434_post_disaster.png,53,76,1,29,82,925,1001,1522,57.374568501545596,37.06114601989035
18861,/media/marda/TWOTB1/xBD/hurricanes/images/florence/hurricane-florence_00000434_post_disaster.png,50,48,1,464,514,250,298,481,45.987050474814794,13.968711867985084
18862,/media/marda/TWOTB1/xBD/hurricanes/images/florence/hurricane-florence_00000095_pre_disaster.png,55,20,1,727,782,0,20,415,26.960705000935512,20.074992290171387
18863,/media/marda/TWOTB1/xBD/hurricanes/images/florence/hurricane-florence_00000095_pre_disaster.png,60,53,1,596,656,2,55,1201,56.71719181165249,27.996823714858504
18864,/media/marda/TWOTB1/xBD/hurricanes/images/florence/hurricane-florence_00000095_pre_disaster.png,67,39,1,774,841,151,190,827,38.52092497941753,28.603567118900774
18865,/media/marda/TWOTB1/xBD/hurricanes/images/florence/hurricane-florence_00000095_pre_disaster.png,73,34,1,784,857,192,226,768,43.11490005463561,23.55296397544866
18866,/media/marda/TWOTB1/xBD/hurricanes/images/florence/hurricane-florence_00000095_pre_disaster.png,72,38,1,794,866,222,260,751,41.784038535217405,23.798167486408143
18867,/media/marda/TWOTB1/xBD/hurricanes/images/florence/hurricane-florence_00000095_pre_disaster.png,67,43,1,709,776,301,344,768,38.08713506899575,26.69589509604668
18868,/media/marda/TWOTB1/xBD/hurricanes/images/florence/hurricane-florence_00000095_pre_disaster.png,21,31,1,96,117,312,343,205,17.930099298717742,14.957983932937035
18869,/media/marda/TWOTB1/xBD/hurricanes/images/florence/hurricane-florence_00000095_pre_disaster.png,71,43,1,820,891,318,361,844,42.433445893029216,26.345583332472994
18870,/media/marda/TWOTB1/xBD/hurricanes/images/florence/hurricane-florence_00000095_pre_disaster.png,50,56,1,46,96,324,380,1057,50.31981884367427,28.03756545655216
18871,/media/marda/TWOTB1/xBD/hurricanes/images/florence/hurricane-florence_00000095_pre_disaster.png,52,56,1,747,799,374,430,645,47.45469613876957,19.166423483221383
18872,/media/marda/TWOTB1/xBD/hurricanes/images/florence/hurricane-florence_00000095_pre_disaster.png,48,23,1,910,958,381,404,82,12.759819086185432,8.655457212238897
18873,/media/marda/TWOTB1/xBD/hurricanes/images/florence/hurricane-florence_00000095_pre_disaster.png,74,45,1,837,911,382,427,867,43.58488721200217,26.224411790991276
18874,/media/marda/TWOTB1/xBD/hurricanes/images/florence/hurricane-florence_00000095_pre_disaster.png,38,27,1,742,780,409,436,88,11.205615999700695,10.601451864603247
18875,/media/marda/TWOTB1/xBD/hurricanes/images/florence/hurricane-florence_00000095_pre_disaster.png,65,41,1,845,910,416,457,596,34.50672125184279,22.633667407370094
18876,/media/marda/TWOTB1/xBD/hurricanes/images/florence/hurricane-florence_00000095_pre_disaster.png,36,33,1,566,602,442,475,205,16.673633757726172,16.057709070629407
18877,/media/marda/TWOTB1/xBD/hurricanes/images/florence/hurricane-florence_00000095_pre_disaster.png,84,71,1,733,817,500,571,1641,55.72010174489296,43.47875893663248
18878,/media/marda/TWOTB1/xBD/hurricanes/images/florence/hurricane-florence_00000095_pre_disaster.png,49,40,1,705,754,536,576,286,21.403165130957095,17.90580378230112
18879,/media/marda/TWOTB1/xBD/hurricanes/images/florence/hurricane-florence_00000095_pre_disaster.png,63,72,1,771,834,547,619,1026,53.48319595087449,26.87175659949447
18880,/media/marda/TWOTB1/xBD/hurricanes/images/florence/hurricane-florence_00000095_pre_disaster.png,57,55,1,548,605,552,607,678,40.781114597834616,27.315770631667135
18881,/media/marda/TWOTB1/xBD/hurricanes/images/florence/hurricane-florence_00000095_pre_disaster.png,56,45,1,756,812,598,643,357,28.34831073419158,16.67931962656872
18882,/media/marda/TWOTB1/xBD/hurricanes/images/florence/hurricane-florence_00000095_pre_disaster.png,53,57,1,586,639,617,674,762,34.60310648940661,29.077308944552936
18883,/media/marda/TWOTB1/xBD/hurricanes/images/florence/hurricane-florence_00000095_pre_disaster.png,61,59,1,787,848,632,691,646,34.248226509824335,24.823266152395412
18884,/media/marda/TWOTB1/xBD/hurricanes/images/florence/hurricane-florence_00000095_pre_disaster.png,54,47,1,586,640,647,694,461,32.62069731747676,19.079480665004915
18885,/media/marda/TWOTB1/xBD/hurricanes/images/florence/hurricane-florence_00000095_pre_disaster.png,60,59,1,808,868,684,743,684,37.92612874756043,27.419666185887653
18886,/media/marda/TWOTB1/xBD/hurricanes/images/florence/hurricane-florence_00000095_pre_disaster.png,51,57,1,756,807,698,755,522,30.09606883624454,22.760605001600013
18887,/media/marda/TWOTB1/xBD/hurricanes/images/florence/hurricane-florence_00000095_pre_disaster.png,63,77,1,740,803,739,816,1064,51.23108220926959,27.699678120039465
18888,/media/marda/TWOTB1/xBD/hurricanes/images/florence/hurricane-florence_00000095_pre_disaster.png,63,67,1,836,899,749,816,752,40.30413124988496,25.15817190333061
18889,/media/marda/TWOTB1/xBD/hurricanes/images/florence/hurricane-florence_00000095_pre_disaster.png,41,47,1,746,787,788,835,176,16.278145914895678,14.45473351346423
18890,/media/marda/TWOTB1/xBD/hurricanes/images/florence/hurricane-florence_00000095_pre_disaster.png,73,63,1,841,914,793,856,781,42.190515829696594,24.41322128729545
18891,/media/marda/TWOTB1/xBD/hurricanes/images/florence/hurricane-florence_00000095_pre_disaster.png,70,88,1,650,720,819,907,1689,61.99400667427289,36.35487109351191
18892,/media/marda/TWOTB1/xBD/hurricanes/images/florence/hurricane-florence_00000095_pre_disaster.png,93,103,1,842,935,827,930,1882,73.21908128517885,46.296411372650645
18893,/media/marda/TWOTB1/xBD/hurricanes/images/florence/hurricane-florence_00000095_pre_disaster.png,45,47,1,724,769,868,915,196,18.510224954768322,14.07133821683585
18894,/media/marda/TWOTB1/xBD/hurricanes/images/florence/hurricane-florence_00000095_pre_disaster.png,68,59,1,976,1044,879,938,597,32.89553649563112,23.606026358540092
18895,/media/marda/TWOTB1/xBD/hurricanes/images/florence/hurricane-florence_00000095_pre_disaster.png,69,63,1,872,941,898,961,610,36.36733516299628,22.119504941350694
18896,/media/marda/TWOTB1/xBD/hurricanes/images/florence/hurricane-florence_00000095_pre_disaster.png,49,53,1,847,896,908,961,172,15.495703961728003,14.91225390924151
18897,/media/marda/TWOTB1/xBD/hurricanes/images/florence/hurricane-florence_00000095_pre_disaster.png,57,58,1,890,947,941,999,276,19.484444871541097,18.957922535643284
18898,/media/marda/TWOTB1/xBD/hurricanes/images/florence/hurricane-florence_00000095_pre_disaster.png,55,60,1,989,1044,948,1008,288,23.39268967088489,16.328550950237886
18899,/media/marda/TWOTB1/xBD/hurricanes/images/florence/hurricane-florence_00000095_pre_disaster.png,83,67,1,842,925,949,1016,858,53.29175007463769,21.29574188448697
18900,/media/marda/TWOTB1/xBD/hurricanes/images/florence/hurricane-florence_00000095_pre_disaster.png,59,59,1,809,868,968,1027,425,27.897686352286357,20.742090767505783
18901,/media/marda/TWOTB1/xBD/hurricanes/images/florence/hurricane-florence_00000095_pre_disaster.png,73,60,1,896,969,975,1035,551,38.10617958364437,19.136647309612723
18902,/media/marda/TWOTB1/xBD/hurricanes/images/florence/hurricane-florence_00000271_pre_disaster.png,34,63,1,374,408,961,1024,395,30.25020485889177,17.29177893489921
18903,/media/marda/TWOTB1/xBD/hurricanes/images/florence/hurricane-florence_00000271_pre_disaster.png,55,64,1,468,523,980,1044,552,34.98041325513453,21.146976676288197
18904,/media/marda/TWOTB1/xBD/hurricanes/images/florence/hurricane-florence_00000494_pre_disaster.png,60,38,1,162,222,62,100,1499,58.60568742899339,37.25185446627608
18905,/media/marda/TWOTB1/xBD/hurricanes/images/florence/hurricane-florence_00000494_pre_disaster.png,61,39,1,371,432,62,101,1633,50.67124191168275,42.424012379673805
18906,/media/marda/TWOTB1/xBD/hurricanes/images/florence/hurricane-florence_00000494_pre_disaster.png,78,63,1,350,428,113,176,2542,72.32582361656289,49.39407188749264
18907,/media/marda/TWOTB1/xBD/hurricanes/images/florence/hurricane-florence_00000494_pre_disaster.png,83,59,1,515,598,118,177,2211,68.26923755910649,46.75817925889658
18908,/media/marda/TWOTB1/xBD/hurricanes/images/florence/hurricane-florence_00000494_pre_disaster.png,62,59,1,366,428,190,249,1834,59.445961118261955,43.14822306187602
18909,/media/marda/TWOTB1/xBD/hurricanes/images/florence/hurricane-florence_00000494_pre_disaster.png,74,68,1,528,602,197,265,1989,63.60627001782037,43.65372639254581
18910,/media/marda/TWOTB1/xBD/hurricanes/images/florence/hurricane-florence_00000494_pre_disaster.png,87,50,1,373,460,265,315,1915,74.3839963192007,38.84742118993687
18911,/media/marda/TWOTB1/xBD/hurricanes/images/florence/hurricane-florence_00000494_pre_disaster.png,54,67,1,25,79,277,344,1845,53.95311987665065,45.71928872485052
18912,/media/marda/TWOTB1/xBD/hurricanes/images/florence/hurricane-florence_00000494_pre_disaster.png,72,68,1,421,493,327,395,1925,66.05252420082039,39.82885068158139
18913,/media/marda/TWOTB1/xBD/hurricanes/images/florence/hurricane-florence_00000494_pre_disaster.png,72,78,1,215,287,493,571,2115,61.115311102556696,49.009032163923955
18914,/media/marda/TWOTB1/xBD/hurricanes/images/florence/hurricane-florence_00000494_pre_disaster.png,80,62,1,826,906,516,578,1410,47.764711845577175,40.02433105266985
18915,/media/marda/TWOTB1/xBD/hurricanes/images/florence/hurricane-florence_00000494_pre_disaster.png,97,71,1,752,849,524,595,2539,73.49492890836555,47.38127894610241
18916,/media/marda/TWOTB1/xBD/hurricanes/images/florence/hurricane-florence_00000494_pre_disaster.png,42,82,1,24,66,573,655,1891,64.34094799568857,40.20991405212686
18917,/media/marda/TWOTB1/xBD/hurricanes/images/florence/hurricane-florence_00000494_pre_disaster.png,77,77,1,433,510,604,681,1762,54.358076176808,43.230889360344335
18918,/media/marda/TWOTB1/xBD/hurricanes/images/florence/hurricane-florence_00000494_pre_disaster.png,50,48,1,682,732,621,669,292,23.50139446953608,16.538612517368072
18919,/media/marda/TWOTB1/xBD/hurricanes/images/florence/hurricane-florence_00000494_pre_disaster.png,73,85,1,134,207,735,820,2195,72.6657879062156,42.01006817593323
18920,/media/marda/TWOTB1/xBD/hurricanes/images/florence/hurricane-florence_00000494_pre_disaster.png,62,97,1,96,158,771,868,2347,64.83236270171831,52.0180636117729
18921,/media/marda/TWOTB1/xBD/hurricanes/images/florence/hurricane-florence_00000494_pre_disaster.png,22,95,1,0,22,820,915,743,56.116524488083336,19.603528235726593
18922,/media/marda/TWOTB1/xBD/hurricanes/images/florence/hurricane-florence_00000518_pre_disaster.png,86,43,1,469,555,0,43,1683,65.58236538010219,33.949077512232705
18923,/media/marda/TWOTB1/xBD/hurricanes/images/florence/hurricane-florence_00000518_pre_disaster.png,59,80,1,75,134,952,1032,1300,51.65993656655303,35.14279456106215
18924,/media/marda/TWOTB1/xBD/hurricanes/images/florence/hurricane-florence_00000494_post_disaster.png,60,38,1,162,222,62,100,1499,58.60568742899339,37.25185446627608
18925,/media/marda/TWOTB1/xBD/hurricanes/images/florence/hurricane-florence_00000494_post_disaster.png,61,39,1,371,432,62,101,1633,50.67124191168275,42.424012379673805
18926,/media/marda/TWOTB1/xBD/hurricanes/images/florence/hurricane-florence_00000494_post_disaster.png,78,63,1,350,428,113,176,2542,72.32582361656289,49.39407188749264
18927,/media/marda/TWOTB1/xBD/hurricanes/images/florence/hurricane-florence_00000494_post_disaster.png,62,59,1,366,428,190,249,1834,59.445961118261955,43.14822306187602
18928,/media/marda/TWOTB1/xBD/hurricanes/images/florence/hurricane-florence_00000494_post_disaster.png,87,50,1,373,460,265,315,1915,74.3839963192007,38.84742118993687
18929,/media/marda/TWOTB1/xBD/hurricanes/images/florence/hurricane-florence_00000494_post_disaster.png,54,67,1,25,79,277,344,1845,53.95311987665065,45.71928872485052
18930,/media/marda/TWOTB1/xBD/hurricanes/images/florence/hurricane-florence_00000494_post_disaster.png,83,59,1,515,598,118,177,2211,68.26923755910649,46.75817925889658
18931,/media/marda/TWOTB1/xBD/hurricanes/images/florence/hurricane-florence_00000494_post_disaster.png,74,68,1,528,602,197,265,1989,63.60627001782037,43.65372639254581
18932,/media/marda/TWOTB1/xBD/hurricanes/images/florence/hurricane-florence_00000494_post_disaster.png,72,68,1,421,493,327,395,1925,66.05252420082039,39.82885068158139
18933,/media/marda/TWOTB1/xBD/hurricanes/images/florence/hurricane-florence_00000494_post_disaster.png,72,78,1,215,287,493,571,2115,61.115311102556696,49.009032163923955
18934,/media/marda/TWOTB1/xBD/hurricanes/images/florence/hurricane-florence_00000494_post_disaster.png,80,62,1,826,906,516,578,1410,47.764711845577175,40.02433105266985
18935,/media/marda/TWOTB1/xBD/hurricanes/images/florence/hurricane-florence_00000494_post_disaster.png,97,71,1,752,849,524,595,2539,73.49492890836555,47.38127894610241
18936,/media/marda/TWOTB1/xBD/hurricanes/images/florence/hurricane-florence_00000494_post_disaster.png,42,82,1,24,66,573,655,1891,64.34094799568857,40.20991405212686
18937,/media/marda/TWOTB1/xBD/hurricanes/images/florence/hurricane-florence_00000494_post_disaster.png,77,77,1,433,510,604,681,1762,54.358076176808,43.230889360344335
18938,/media/marda/TWOTB1/xBD/hurricanes/images/florence/hurricane-florence_00000494_post_disaster.png,50,48,1,682,732,621,669,292,23.50139446953608,16.538612517368072
18939,/media/marda/TWOTB1/xBD/hurricanes/images/florence/hurricane-florence_00000494_post_disaster.png,73,85,1,134,207,735,820,2195,72.6657879062156,42.01006817593323
18940,/media/marda/TWOTB1/xBD/hurricanes/images/florence/hurricane-florence_00000494_post_disaster.png,62,97,1,96,158,771,868,2347,64.83236270171831,52.0180636117729
18941,/media/marda/TWOTB1/xBD/hurricanes/images/florence/hurricane-florence_00000494_post_disaster.png,22,95,1,0,22,820,915,743,56.116524488083336,19.603528235726593
18942,/media/marda/TWOTB1/xBD/hurricanes/images/florence/hurricane-florence_00000082_pre_disaster.png,79,68,1,654,733,429,497,1289,58.696657224151096,29.02788475807173
18943,/media/marda/TWOTB1/xBD/hurricanes/images/florence/hurricane-florence_00000082_pre_disaster.png,23,39,1,74,97,461,500,277,20.28629039451931,18.223363322002218
18944,/media/marda/TWOTB1/xBD/hurricanes/images/florence/hurricane-florence_00000082_pre_disaster.png,58,63,1,792,850,901,964,327,24.175794537447214,21.949968117356715
18945,/media/marda/TWOTB1/xBD/hurricanes/images/florence/hurricane-florence_00000021_post_disaster.png,45,45,1,209,254,82,127,827,48.168441534232294,29.349320716759728
18946,/media/marda/TWOTB1/xBD/hurricanes/images/florence/hurricane-florence_00000021_post_disaster.png,248,74,1,134,382,158,232,7522,273.2667299325139,36.77775571685289
18947,/media/marda/TWOTB1/xBD/hurricanes/images/florence/hurricane-florence_00000021_post_disaster.png,35,49,1,75,110,198,247,875,41.01298528027069,28.092540109945027
18948,/media/marda/TWOTB1/xBD/hurricanes/images/florence/hurricane-florence_00000021_post_disaster.png,84,88,1,176,260,414,502,3440,73.82900981137065,62.02404345770804
18949,/media/marda/TWOTB1/xBD/hurricanes/images/florence/hurricane-florence_00000021_post_disaster.png,18,29,1,243,261,153,182,155,27.19464038759103,7.668284369932854
18950,/media/marda/TWOTB1/xBD/hurricanes/images/florence/hurricane-florence_00000021_post_disaster.png,240,69,1,151,391,211,280,5833,263.48596790625936,29.53359697754046
18951,/media/marda/TWOTB1/xBD/hurricanes/images/florence/hurricane-florence_00000021_post_disaster.png,248,72,1,126,374,106,178,7049,274.3127496150307,34.36693857544398
18952,/media/marda/TWOTB1/xBD/hurricanes/images/florence/hurricane-florence_00000021_post_disaster.png,135,61,1,266,401,258,319,4216,136.53478067149,41.140459693783484
18953,/media/marda/TWOTB1/xBD/hurricanes/images/florence/hurricane-florence_00000417_pre_disaster.png,131,30,1,825,956,0,30,1195,91.5682228716877,23.454276944623793
18954,/media/marda/TWOTB1/xBD/hurricanes/images/florence/hurricane-florence_00000417_pre_disaster.png,137,53,1,798,935,16,69,2743,117.13041453126856,31.12535856890058
18955,/media/marda/TWOTB1/xBD/hurricanes/images/florence/hurricane-florence_00000417_pre_disaster.png,138,54,1,781,919,63,117,2923,119.42162768999584,32.528435135548115
18956,/media/marda/TWOTB1/xBD/hurricanes/images/florence/hurricane-florence_00000417_pre_disaster.png,44,9,1,880,924,68,77,70,9.696674760533577,9.188758028081663
18957,/media/marda/TWOTB1/xBD/hurricanes/images/florence/hurricane-florence_00000417_pre_disaster.png,43,8,1,875,918,79,87,52,8.70613168114442,7.632596254777482
18958,/media/marda/TWOTB1/xBD/hurricanes/images/florence/hurricane-florence_00000417_pre_disaster.png,48,17,1,769,817,135,152,165,18.51962617184771,11.872600939414392
18959,/media/marda/TWOTB1/xBD/hurricanes/images/florence/hurricane-florence_00000417_pre_disaster.png,92,102,1,210,302,348,450,2872,106.79670248854305,35.83944185680542
18960,/media/marda/TWOTB1/xBD/hurricanes/images/florence/hurricane-florence_00000417_pre_disaster.png,56,58,1,519,575,427,485,764,42.36162327673504,24.04785024195374
18961,/media/marda/TWOTB1/xBD/hurricanes/images/florence/hurricane-florence_00000417_pre_disaster.png,55,47,1,490,545,482,529,544,38.57667801331843,18.83770869806321
18962,/media/marda/TWOTB1/xBD/hurricanes/images/florence/hurricane-florence_00000417_pre_disaster.png,53,45,1,469,522,499,544,385,38.28195158923888,13.437473939655783
18963,/media/marda/TWOTB1/xBD/hurricanes/images/florence/hurricane-florence_00000417_pre_disaster.png,56,53,1,536,592,509,562,690,32.95000049076508,27.538094839812967
18964,/media/marda/TWOTB1/xBD/hurricanes/images/florence/hurricane-florence_00000417_pre_disaster.png,91,107,1,432,523,513,620,2856,87.37102106608589,49.93929210374756
18965,/media/marda/TWOTB1/xBD/hurricanes/images/florence/hurricane-florence_00000417_pre_disaster.png,81,75,1,350,431,569,644,1770,65.22705805005467,38.71514339943724
18966,/media/marda/TWOTB1/xBD/hurricanes/images/florence/hurricane-florence_00000417_pre_disaster.png,41,44,1,427,468,589,633,314,21.159049480202427,19.84177156857965
18967,/media/marda/TWOTB1/xBD/hurricanes/images/florence/hurricane-florence_00000417_pre_disaster.png,90,96,1,430,520,624,720,2378,74.17563485317443,46.487102426932374
18968,/media/marda/TWOTB1/xBD/hurricanes/images/florence/hurricane-florence_00000417_pre_disaster.png,59,68,1,269,328,662,730,989,56.12814785573231,23.255661784264856
18969,/media/marda/TWOTB1/xBD/hurricanes/images/florence/hurricane-florence_00000417_pre_disaster.png,34,37,1,559,593,663,700,96,11.89276563867621,10.91466141466861
18970,/media/marda/TWOTB1/xBD/hurricanes/images/florence/hurricane-florence_00000417_pre_disaster.png,34,37,1,575,609,671,708,94,11.922422293417393,10.554040058245041
18971,/media/marda/TWOTB1/xBD/hurricanes/images/florence/hurricane-florence_00000417_pre_disaster.png,51,47,1,629,680,673,720,325,23.65399880550017,18.344080957896743
18972,/media/marda/TWOTB1/xBD/hurricanes/images/florence/hurricane-florence_00000417_pre_disaster.png,58,61,1,499,557,682,743,777,38.53915201145792,26.705199284812117
18973,/media/marda/TWOTB1/xBD/hurricanes/images/florence/hurricane-florence_00000417_pre_disaster.png,29,46,1,296,325,723,769,166,15.799099719716741,13.822244293336883
18974,/media/marda/TWOTB1/xBD/hurricanes/images/florence/hurricane-florence_00000417_pre_disaster.png,75,78,1,550,625,725,803,1144,59.89065047310522,25.46925903408846
18975,/media/marda/TWOTB1/xBD/hurricanes/images/florence/hurricane-florence_00000417_pre_disaster.png,84,95,1,402,486,784,879,1675,80.76808502597154,27.548817254580456
18976,/media/marda/TWOTB1/xBD/hurricanes/images/florence/hurricane-florence_00000417_pre_disaster.png,47,52,1,704,751,795,847,188,18.663809023795825,13.495566599059877
18977,/media/marda/TWOTB1/xBD/hurricanes/images/florence/hurricane-florence_00000417_pre_disaster.png,55,56,1,680,735,802,858,376,28.267048553073373,17.57843756509453
18978,/media/marda/TWOTB1/xBD/hurricanes/images/florence/hurricane-florence_00000417_pre_disaster.png,76,79,1,653,729,835,914,1318,47.37304935443852,37.13496080420713
18979,/media/marda/TWOTB1/xBD/hurricanes/images/florence/hurricane-florence_00000417_pre_disaster.png,58,66,1,483,541,881,947,668,35.427106021535906,26.991457057444933
18980,/media/marda/TWOTB1/xBD/hurricanes/images/florence/hurricane-florence_00000417_pre_disaster.png,77,94,1,452,529,890,984,1695,52.28554791044908,43.26472173921092
18981,/media/marda/TWOTB1/xBD/hurricanes/images/florence/hurricane-florence_00000417_pre_disaster.png,40,52,1,614,654,936,988,127,14.89355721107665,11.48589975092355
18982,/media/marda/TWOTB1/xBD/hurricanes/images/florence/hurricane-florence_00000417_pre_disaster.png,53,70,1,437,490,951,1021,602,40.196779398855064,19.829044665858046
18983,/media/marda/TWOTB1/xBD/hurricanes/images/florence/hurricane-florence_00000417_pre_disaster.png,70,77,1,475,545,965,1042,1210,44.617213473899305,36.906081694189666
18984,/media/marda/TWOTB1/xBD/hurricanes/images/florence/hurricane-florence_00000417_pre_disaster.png,102,76,1,565,667,966,1042,1591,66.42764153803114,37.43147764573231
18985,/media/marda/TWOTB1/xBD/hurricanes/images/florence/hurricane-florence_00000432_pre_disaster.png,60,30,1,933,993,127,157,566,28.069701537219828,26.741488384897536
18986,/media/marda/TWOTB1/xBD/hurricanes/images/florence/hurricane-florence_00000432_pre_disaster.png,79,35,1,858,937,163,198,1132,49.41686227510283,30.12857207989455
18987,/media/marda/TWOTB1/xBD/hurricanes/images/florence/hurricane-florence_00000432_pre_disaster.png,57,60,1,702,759,299,359,778,48.818817404038,23.737378186708742
18988,/media/marda/TWOTB1/xBD/hurricanes/images/florence/hurricane-florence_00000432_pre_disaster.png,54,37,1,791,845,366,403,485,26.164637448508405,24.549632248623716
18989,/media/marda/TWOTB1/xBD/hurricanes/images/florence/hurricane-florence_00000432_pre_disaster.png,34,23,1,687,721,376,399,76,11.810217755428805,8.5964095967093
18990,/media/marda/TWOTB1/xBD/hurricanes/images/florence/hurricane-florence_00000432_pre_disaster.png,35,20,1,687,722,388,408,64,10.10566749386685,8.359155729103442
18991,/media/marda/TWOTB1/xBD/hurricanes/images/florence/hurricane-florence_00000432_pre_disaster.png,88,42,1,706,794,414,456,1380,66.51893847914546,27.648089933262977
18992,/media/marda/TWOTB1/xBD/hurricanes/images/florence/hurricane-florence_00000282_pre_disaster.png,108,115,1,573,681,837,952,3347,90.5900239559789,49.307713733441275
18993,/media/marda/TWOTB1/xBD/hurricanes/images/florence/hurricane-florence_00000282_pre_disaster.png,82,84,1,812,894,853,937,1362,47.90775672749064,37.85326403942853
18994,/media/marda/TWOTB1/xBD/hurricanes/images/florence/hurricane-florence_00000282_pre_disaster.png,54,68,1,293,347,974,1042,534,50.774912568828604,13.985021481352904
18995,/media/marda/TWOTB1/xBD/hurricanes/images/florence/hurricane-florence_00000282_pre_disaster.png,45,64,1,280,325,980,1044,411,36.45138781743048,15.023416289666061
18996,/media/marda/TWOTB1/xBD/hurricanes/images/florence/hurricane-florence_00000285_pre_disaster.png,65,63,1,570,635,169,232,1177,59.26912812173618,28.76738805613596
18997,/media/marda/TWOTB1/xBD/hurricanes/images/florence/hurricane-florence_00000285_pre_disaster.png,69,51,1,617,686,194,245,962,48.87514833706721,28.40033887960437
18998,/media/marda/TWOTB1/xBD/hurricanes/images/florence/hurricane-florence_00000285_pre_disaster.png,29,17,1,561,590,233,250,38,9.288067201267252,5.597086343069893
18999,/media/marda/TWOTB1/xBD/hurricanes/images/florence/hurricane-florence_00000285_pre_disaster.png,67,38,1,574,641,234,272,680,43.49548420705868,24.24758003039753
19000,/media/marda/TWOTB1/xBD/hurricanes/images/florence/hurricane-florence_00000285_pre_disaster.png,86,58,1,703,789,290,348,1304,65.8420752106568,26.19978670234889
19001,/media/marda/TWOTB1/xBD/hurricanes/images/florence/hurricane-florence_00000285_pre_disaster.png,77,77,1,967,1044,677,754,1033,57.34034451342825,24.32864635577457
19002,/media/marda/TWOTB1/xBD/hurricanes/images/florence/hurricane-florence_00000285_pre_disaster.png,52,48,1,856,908,732,780,201,16.86775547812757,15.955188986492445
19003,/media/marda/TWOTB1/xBD/hurricanes/images/florence/hurricane-florence_00000285_pre_disaster.png,51,40,1,993,1044,743,783,71,10.55502384490132,8.889874954796722
19004,/media/marda/TWOTB1/xBD/hurricanes/images/florence/hurricane-florence_00000285_pre_disaster.png,50,37,1,982,1032,755,792,44,8.38091101381512,7.185844671043456
19005,/media/marda/TWOTB1/xBD/hurricanes/images/florence/hurricane-florence_00000439_post_disaster.png,113,91,1,800,913,181,272,3308,95.07082132241212,46.0844283197805
19006,/media/marda/TWOTB1/xBD/hurricanes/images/florence/hurricane-florence_00000439_post_disaster.png,47,31,1,784,831,301,332,163,17.516757327999898,12.537652124113208
19007,/media/marda/TWOTB1/xBD/hurricanes/images/florence/hurricane-florence_00000439_post_disaster.png,61,34,1,54,115,329,363,654,65.22907414242144,13.390157836614913
19008,/media/marda/TWOTB1/xBD/hurricanes/images/florence/hurricane-florence_00000439_post_disaster.png,96,60,1,687,783,336,396,1121,80.78311093259882,18.463425034179696
19009,/media/marda/TWOTB1/xBD/hurricanes/images/florence/hurricane-florence_00000439_post_disaster.png,88,67,1,775,863,341,408,1596,57.77598420071619,37.90861161753804
19010,/media/marda/TWOTB1/xBD/hurricanes/images/florence/hurricane-florence_00000439_post_disaster.png,50,35,1,714,764,388,423,279,19.81050706386376,18.668098687663477
19011,/media/marda/TWOTB1/xBD/hurricanes/images/florence/hurricane-florence_00000439_post_disaster.png,56,50,1,741,797,397,447,453,34.955195617105545,18.205302354831943
19012,/media/marda/TWOTB1/xBD/hurricanes/images/florence/hurricane-florence_00000439_post_disaster.png,61,56,1,752,813,415,471,703,41.70742586758026,22.243991516345563
19013,/media/marda/TWOTB1/xBD/hurricanes/images/florence/hurricane-florence_00000439_post_disaster.png,72,66,1,873,945,457,523,781,58.145335414037845,18.186908620441628
19014,/media/marda/TWOTB1/xBD/hurricanes/images/florence/hurricane-florence_00000439_post_disaster.png,65,61,1,713,778,480,541,1005,41.54434233741745,33.19486874572988
19015,/media/marda/TWOTB1/xBD/hurricanes/images/florence/hurricane-florence_00000439_post_disaster.png,42,40,1,673,715,508,548,258,20.518694224247817,16.86361232390823
19016,/media/marda/TWOTB1/xBD/hurricanes/images/florence/hurricane-florence_00000439_post_disaster.png,60,45,1,878,938,512,557,382,24.891085725760366,20.103628987967724
19017,/media/marda/TWOTB1/xBD/hurricanes/images/florence/hurricane-florence_00000439_post_disaster.png,35,27,1,680,715,527,554,52,9.974308312539248,7.0057990995809
19018,/media/marda/TWOTB1/xBD/hurricanes/images/florence/hurricane-florence_00000439_post_disaster.png,59,58,1,644,703,613,671,691,32.48450685894625,28.872133733496387
19019,/media/marda/TWOTB1/xBD/hurricanes/images/florence/hurricane-florence_00000439_post_disaster.png,63,77,1,808,871,656,733,875,56.28113468707321,20.73709130728184
19020,/media/marda/TWOTB1/xBD/hurricanes/images/florence/hurricane-florence_00000439_post_disaster.png,110,118,1,933,1043,700,818,3697,78.86382824976896,61.959386494197496
19021,/media/marda/TWOTB1/xBD/hurricanes/images/florence/hurricane-florence_00000439_post_disaster.png,105,89,1,796,901,769,858,2080,83.51689885224569,33.69401639340648
19022,/media/marda/TWOTB1/xBD/hurricanes/images/florence/hurricane-florence_00000439_post_disaster.png,58,76,1,556,614,791,867,990,43.40182139424774,30.855056252349108
19023,/media/marda/TWOTB1/xBD/hurricanes/images/florence/hurricane-florence_00000439_post_disaster.png,109,102,1,897,1006,804,906,2176,80.3091051362047,42.03385763613153
19024,/media/marda/TWOTB1/xBD/hurricanes/images/florence/hurricane-florence_00000439_post_disaster.png,96,90,1,788,884,851,941,1634,59.824940048567626,41.445599926154465
19025,/media/marda/TWOTB1/xBD/hurricanes/images/florence/hurricane-florence_00000439_post_disaster.png,74,85,1,705,779,891,976,826,61.48290291421708,17.836885876176314
19026,/media/marda/TWOTB1/xBD/hurricanes/images/florence/hurricane-florence_00000439_post_disaster.png,71,79,1,764,835,948,1027,790,46.19536085288314,22.808437381180998
19027,/media/marda/TWOTB1/xBD/hurricanes/images/florence/hurricane-florence_00000439_post_disaster.png,68,62,1,670,738,981,1043,821,45.654670932221805,24.1495143559878
19028,/media/marda/TWOTB1/xBD/hurricanes/images/florence/hurricane-florence_00000409_post_disaster.png,66,37,1,434,500,0,37,1200,47.05683089919826,35.37542240268947
19029,/media/marda/TWOTB1/xBD/hurricanes/images/florence/hurricane-florence_00000409_post_disaster.png,76,58,1,264,340,128,186,2117,62.5216012208976,46.24886756488823
19030,/media/marda/TWOTB1/xBD/hurricanes/images/florence/hurricane-florence_00000409_post_disaster.png,55,71,1,55,110,207,278,1990,61.50565680984872,44.57115958668875
19031,/media/marda/TWOTB1/xBD/hurricanes/images/florence/hurricane-florence_00000409_post_disaster.png,7,27,1,0,7,221,248,72,18.309838792656787,6.009749357297524
19032,/media/marda/TWOTB1/xBD/hurricanes/images/florence/hurricane-florence_00000409_post_disaster.png,41,66,1,136,177,231,297,1278,56.555354665934324,31.559484639730083
19033,/media/marda/TWOTB1/xBD/hurricanes/images/florence/hurricane-florence_00000409_post_disaster.png,52,70,1,92,144,349,419,1774,57.36777055616887,44.62468840131155
19034,/media/marda/TWOTB1/xBD/hurricanes/images/florence/hurricane-florence_00000409_post_disaster.png,48,93,1,0,48,696,789,2095,75.83015874634177,39.052894168693655
19035,/media/marda/TWOTB1/xBD/hurricanes/images/florence/hurricane-florence_00000409_post_disaster.png,16,81,1,0,16,856,937,726,54.42906791023788,17.62846869215576
19036,/media/marda/TWOTB1/xBD/hurricanes/images/florence/hurricane-florence_00000409_post_disaster.png,89,71,1,293,382,199,270,2506,70.66040140259271,51.30379034462957
19037,/media/marda/TWOTB1/xBD/hurricanes/images/florence/hurricane-florence_00000409_post_disaster.png,74,51,1,218,292,362,413,2032,70.3028253083835,39.61023515708867
19038,/media/marda/TWOTB1/xBD/hurricanes/images/florence/hurricane-florence_00000409_post_disaster.png,67,92,1,106,173,864,956,2357,65.31917237892165,50.6136789090695
19039,/media/marda/TWOTB1/xBD/hurricanes/images/florence/hurricane-florence_00000409_post_disaster.png,77,43,1,581,658,0,43,1479,55.960871751948005,37.725763655755244
19040,/media/marda/TWOTB1/xBD/hurricanes/images/florence/hurricane-florence_00000409_post_disaster.png,75,48,1,968,1043,12,60,1267,45.92631026963729,36.171801967935274
19041,/media/marda/TWOTB1/xBD/hurricanes/images/florence/hurricane-florence_00000409_post_disaster.png,82,65,1,448,530,98,163,1986,60.09518275046401,47.80876999589661
19042,/media/marda/TWOTB1/xBD/hurricanes/images/florence/hurricane-florence_00000409_post_disaster.png,78,66,1,492,570,153,219,1912,63.58721968925899,42.1836308518652
19043,/media/marda/TWOTB1/xBD/hurricanes/images/florence/hurricane-florence_00000409_post_disaster.png,91,83,1,711,802,170,253,2598,73.70109760133779,49.60802819359816
19044,/media/marda/TWOTB1/xBD/hurricanes/images/florence/hurricane-florence_00000409_post_disaster.png,95,77,1,577,672,278,355,2555,63.13872100386712,55.49387394530978
19045,/media/marda/TWOTB1/xBD/hurricanes/images/florence/hurricane-florence_00000409_post_disaster.png,81,59,1,419,500,329,388,1988,65.38046447581777,41.33560926255082
19046,/media/marda/TWOTB1/xBD/hurricanes/images/florence/hurricane-florence_00000409_post_disaster.png,86,74,1,846,932,375,449,1716,53.46200707209923,43.36128001958533
19047,/media/marda/TWOTB1/xBD/hurricanes/images/florence/hurricane-florence_00000409_post_disaster.png,99,82,1,921,1020,478,560,2223,63.13563374589599,51.64430882395609
19048,/media/marda/TWOTB1/xBD/hurricanes/images/florence/hurricane-florence_00000409_post_disaster.png,87,92,1,771,858,539,631,2237,67.0926939915284,48.76164792252352
19049,/media/marda/TWOTB1/xBD/hurricanes/images/florence/hurricane-florence_00000409_post_disaster.png,96,79,1,835,931,666,745,1814,55.72950940950129,47.046271583498296
19050,/media/marda/TWOTB1/xBD/hurricanes/images/florence/hurricane-florence_00000409_post_disaster.png,96,86,1,868,964,801,887,2176,63.841009233266384,47.6809085557286
19051,/media/marda/TWOTB1/xBD/hurricanes/images/florence/hurricane-florence_00000409_post_disaster.png,70,84,1,351,421,812,896,1689,51.38307849666353,45.92644718789319
19052,/media/marda/TWOTB1/xBD/hurricanes/images/florence/hurricane-florence_00000409_post_disaster.png,112,88,1,853,965,868,956,2558,73.62788724326992,52.515880672113965
19053,/media/marda/TWOTB1/xBD/hurricanes/images/florence/hurricane-florence_00000409_post_disaster.png,88,84,1,457,545,879,963,2140,65.98222152087929,45.18208216987212
19054,/media/marda/TWOTB1/xBD/hurricanes/images/florence/hurricane-florence_00000409_post_disaster.png,87,92,1,224,311,938,1030,2535,73.27849971063083,48.36660396388583
19055,/media/marda/TWOTB1/xBD/hurricanes/images/florence/hurricane-florence_00000409_post_disaster.png,88,97,1,570,658,944,1041,2450,61.43533218683089,54.06738411679309
19056,/media/marda/TWOTB1/xBD/hurricanes/images/florence/hurricane-florence_00000409_post_disaster.png,82,78,1,647,729,963,1041,1628,53.30979883573369,39.71252674848836
19057,/media/marda/TWOTB1/xBD/hurricanes/images/florence/hurricane-florence_00000409_post_disaster.png,74,71,1,309,383,970,1041,1222,55.46230881107892,32.26576818232741
19058,/media/marda/TWOTB1/xBD/hurricanes/images/florence/hurricane-florence_00000409_post_disaster.png,86,55,1,717,803,988,1043,424,60.45778704071572,12.283590762354592
19059,/media/marda/TWOTB1/xBD/hurricanes/images/florence/hurricane-florence_00000055_post_disaster.png,51,71,1,74,125,312,383,1490,61.999318817892835,33.67210772736383
19060,/media/marda/TWOTB1/xBD/hurricanes/images/florence/hurricane-florence_00000055_post_disaster.png,63,65,1,63,126,756,821,1212,68.18348233950715,23.602604666426334
19061,/media/marda/TWOTB1/xBD/hurricanes/images/florence/hurricane-florence_00000055_post_disaster.png,48,68,1,113,161,810,878,846,46.6483848017252,25.73031227078271
19062,/media/marda/TWOTB1/xBD/hurricanes/images/florence/hurricane-florence_00000055_post_disaster.png,18,43,1,146,164,760,803,110,15.839613220679885,9.298495841806323
19063,/media/marda/TWOTB1/xBD/hurricanes/images/florence/hurricane-florence_00000055_post_disaster.png,36,81,1,206,242,813,894,670,54.64609773751028,16.701668901596715
19064,/media/marda/TWOTB1/xBD/hurricanes/images/florence/hurricane-florence_00000055_post_disaster.png,28,53,1,97,125,954,1007,232,27.30508441749461,11.194973441318586
19065,/media/marda/TWOTB1/xBD/hurricanes/images/florence/hurricane-florence_00000055_post_disaster.png,56,56,1,121,177,987,1043,478,49.98223514220269,14.13332429072128
19066,/media/marda/TWOTB1/xBD/hurricanes/images/florence/hurricane-florence_00000055_post_disaster.png,20,52,1,84,104,991,1043,135,16.7500843655336,10.998243852952877
19067,/media/marda/TWOTB1/xBD/hurricanes/images/florence/hurricane-florence_00000006_post_disaster.png,47,29,1,0,47,0,29,1036,50.1126402403969,28.60306786507227
19068,/media/marda/TWOTB1/xBD/hurricanes/images/florence/hurricane-florence_00000006_post_disaster.png,55,13,1,337,392,0,13,518,49.70819326665649,14.221898957491474
19069,/media/marda/TWOTB1/xBD/hurricanes/images/florence/hurricane-florence_00000006_post_disaster.png,65,39,1,620,685,0,39,992,41.94475465000935,32.22131836685908
19070,/media/marda/TWOTB1/xBD/hurricanes/images/florence/hurricane-florence_00000006_post_disaster.png,66,14,1,660,726,0,14,309,39.337498306656165,12.15614906124641
19071,/media/marda/TWOTB1/xBD/hurricanes/images/florence/hurricane-florence_00000006_post_disaster.png,69,32,1,831,900,0,32,881,38.38540926442651,30.288523047330436
19072,/media/marda/TWOTB1/xBD/hurricanes/images/florence/hurricane-florence_00000006_post_disaster.png,69,24,1,873,942,0,24,743,38.63476430899056,25.43792906479367
19073,/media/marda/TWOTB1/xBD/hurricanes/images/florence/hurricane-florence_00000006_post_disaster.png,73,33,1,912,985,0,33,983,37.90086313811826,34.584204634714524
19074,/media/marda/TWOTB1/xBD/hurricanes/images/florence/hurricane-florence_00000006_post_disaster.png,74,37,1,953,1027,0,37,1076,40.93128532494623,34.75747088805049
19075,/media/marda/TWOTB1/xBD/hurricanes/images/florence/hurricane-florence_00000006_post_disaster.png,78,56,1,786,864,1,57,1380,52.5571956364318,35.103325715220016
19076,/media/marda/TWOTB1/xBD/hurricanes/images/florence/hurricane-florence_00000006_post_disaster.png,55,40,1,989,1044,6,46,498,43.934693926497644,15.259035619745866
19077,/media/marda/TWOTB1/xBD/hurricanes/images/florence/hurricane-florence_00000006_post_disaster.png,63,56,1,585,648,8,64,1249,50.88213514273557,32.44800968283395
19078,/media/marda/TWOTB1/xBD/hurricanes/images/florence/hurricane-florence_00000006_post_disaster.png,84,50,1,745,829,25,75,1462,53.79294038575474,35.6719037224006
19079,/media/marda/TWOTB1/xBD/hurricanes/images/florence/hurricane-florence_00000006_post_disaster.png,41,17,1,502,543,42,59,174,22.03856138212575,10.610300042050456
19080,/media/marda/TWOTB1/xBD/hurricanes/images/florence/hurricane-florence_00000006_post_disaster.png,72,51,1,882,954,45,96,1704,56.416160691682464,41.3068112090501
19081,/media/marda/TWOTB1/xBD/hurricanes/images/florence/hurricane-florence_00000006_post_disaster.png,78,42,1,713,791,47,89,1183,48.99776322827128,31.855306394752997
19082,/media/marda/TWOTB1/xBD/hurricanes/images/florence/hurricane-florence_00000006_post_disaster.png,74,52,1,925,999,51,103,1474,53.80038434566133,36.417389958900934
19083,/media/marda/TWOTB1/xBD/hurricanes/images/florence/hurricane-florence_00000006_post_disaster.png,73,52,1,839,912,52,104,1585,54.20663179054111,39.109063771545266
19084,/media/marda/TWOTB1/xBD/hurricanes/images/florence/hurricane-florence_00000006_post_disaster.png,77,53,1,964,1041,57,110,1496,52.825323783421176,37.46647192322079
19085,/media/marda/TWOTB1/xBD/hurricanes/images/florence/hurricane-florence_00000006_post_disaster.png,78,45,1,681,759,69,114,1392,53.78734173599385,34.00340587375497
19086,/media/marda/TWOTB1/xBD/hurricanes/images/florence/hurricane-florence_00000006_post_disaster.png,81,47,1,794,875,70,117,1299,49.455109878274186,34.691410906914925
19087,/media/marda/TWOTB1/xBD/hurricanes/images/florence/hurricane-florence_00000006_post_disaster.png,35,18,1,466,501,78,96,186,16.242653858069254,15.337238475365494
19088,/media/marda/TWOTB1/xBD/hurricanes/images/florence/hurricane-florence_00000006_post_disaster.png,81,44,1,643,724,90,134,1356,53.347668303348215,33.894627982793054
19089,/media/marda/TWOTB1/xBD/hurricanes/images/florence/hurricane-florence_00000006_post_disaster.png,85,48,1,759,844,92,140,1358,56.07161543157232,32.367416363037606
19090,/media/marda/TWOTB1/xBD/hurricanes/images/florence/hurricane-florence_00000006_post_disaster.png,59,39,1,508,567,106,145,780,37.38994056379118,28.840742468970447
19091,/media/marda/TWOTB1/xBD/hurricanes/images/florence/hurricane-florence_00000006_post_disaster.png,82,53,1,726,808,110,163,1476,53.55665319818172,36.378802938390095
19092,/media/marda/TWOTB1/xBD/hurricanes/images/florence/hurricane-florence_00000006_post_disaster.png,80,51,1,692,772,128,179,1271,53.255814516313876,31.897475995788675
19093,/media/marda/TWOTB1/xBD/hurricanes/images/florence/hurricane-florence_00000006_post_disaster.png,76,60,1,510,586,146,206,1705,58.58290952159082,39.22642858256807
19094,/media/marda/TWOTB1/xBD/hurricanes/images/florence/hurricane-florence_00000006_post_disaster.png,70,55,1,905,975,154,209,1348,53.214146363929274,33.488297061572595
19095,/media/marda/TWOTB1/xBD/hurricanes/images/florence/hurricane-florence_00000006_post_disaster.png,78,57,1,854,932,159,216,1562,53.082253622626276,39.68580108142012
19096,/media/marda/TWOTB1/xBD/hurricanes/images/florence/hurricane-florence_00000006_post_disaster.png,74,52,1,943,1017,161,213,1246,51.193279409797256,32.30505051710533
19097,/media/marda/TWOTB1/xBD/hurricanes/images/florence/hurricane-florence_00000006_post_disaster.png,62,54,1,982,1044,165,219,918,53.68482883659959,22.912165193269384
19098,/media/marda/TWOTB1/xBD/hurricanes/images/florence/hurricane-florence_00000006_post_disaster.png,58,41,1,0,58,175,216,1933,64.81492365535507,39.4568294739629
19099,/media/marda/TWOTB1/xBD/hurricanes/images/florence/hurricane-florence_00000006_post_disaster.png,103,42,1,232,335,180,222,3211,105.78072880723683,40.36525023178134
19100,/media/marda/TWOTB1/xBD/hurricanes/images/florence/hurricane-florence_00000006_post_disaster.png,103,43,1,78,181,183,226,3601,112.54866317090791,42.469452657514275
19101,/media/marda/TWOTB1/xBD/hurricanes/images/florence/hurricane-florence_00000006_post_disaster.png,88,50,1,806,894,185,235,1382,54.663742426870144,33.58250818659823
19102,/media/marda/TWOTB1/xBD/hurricanes/images/florence/hurricane-florence_00000006_post_disaster.png,71,54,1,612,683,190,244,1376,53.319918278825455,34.357229850664844
19103,/media/marda/TWOTB1/xBD/hurricanes/images/florence/hurricane-florence_00000006_post_disaster.png,73,60,1,508,581,196,256,1433,57.230855525111,33.264151553170144
19104,/media/marda/TWOTB1/xBD/hurricanes/images/florence/hurricane-florence_00000006_post_disaster.png,84,54,1,775,859,204,258,1333,54.7372544163433,32.790312384962924
19105,/media/marda/TWOTB1/xBD/hurricanes/images/florence/hurricane-florence_00000006_post_disaster.png,74,69,1,749,823,219,288,1458,55.72812304552983,36.36697578443248
19106,/media/marda/TWOTB1/xBD/hurricanes/images/florence/hurricane-florence_00000006_post_disaster.png,72,58,1,914,986,222,280,1580,54.94827442170233,37.894089220819154
19107,/media/marda/TWOTB1/xBD/hurricanes/images/florence/hurricane-florence_00000006_post_disaster.png,65,56,1,699,764,226,282,1424,52.33725611039114,36.03309701569775
19108,/media/marda/TWOTB1/xBD/hurricanes/images/florence/hurricane-florence_00000006_post_disaster.png,77,107,1,339,416,227,334,4739,110.11543812001788,57.124243263476934
19109,/media/marda/TWOTB1/xBD/hurricanes/images/florence/hurricane-florence_00000006_post_disaster.png,80,52,1,616,696,228,280,1364,53.12927069812543,34.27005167341094
19110,/media/marda/TWOTB1/xBD/hurricanes/images/florence/hurricane-florence_00000006_post_disaster.png,75,58,1,956,1031,229,287,1222,48.09582487217933,33.28343928465754
19111,/media/marda/TWOTB1/xBD/hurricanes/images/florence/hurricane-florence_00000006_post_disaster.png,83,59,1,862,945,230,289,1466,53.248614209159385,36.1721219843586
19112,/media/marda/TWOTB1/xBD/hurricanes/images/florence/hurricane-florence_00000006_post_disaster.png,48,39,1,996,1044,238,277,136,30.692932181476937,6.7561432190772015
19113,/media/marda/TWOTB1/xBD/hurricanes/images/florence/hurricane-florence_00000006_post_disaster.png,68,59,1,516,584,239,298,1399,51.187055928268144,36.38960549675567
19114,/media/marda/TWOTB1/xBD/hurricanes/images/florence/hurricane-florence_00000006_post_disaster.png,45,105,1,119,164,257,362,3854,109.92630304117569,46.53778642213347
19115,/media/marda/TWOTB1/xBD/hurricanes/images/florence/hurricane-florence_00000006_post_disaster.png,75,58,1,635,710,263,321,1473,54.11549851374389,36.03017100845976
19116,/media/marda/TWOTB1/xBD/hurricanes/images/florence/hurricane-florence_00000006_post_disaster.png,89,53,1,826,915,264,317,1463,56.214217152103096,34.629556856991044
19117,/media/marda/TWOTB1/xBD/hurricanes/images/florence/hurricane-florence_00000006_post_disaster.png,64,108,1,268,332,265,373,4044,109.68171401628518,49.2493534386724
19118,/media/marda/TWOTB1/xBD/hurricanes/images/florence/hurricane-florence_00000006_post_disaster.png,75,56,1,530,605,281,337,1493,51.46162450358524,38.51893906540585
19119,/media/marda/TWOTB1/xBD/hurricanes/images/florence/hurricane-florence_00000006_post_disaster.png,72,59,1,799,871,286,345,1145,47.40758021623657,32.178847184765374
19120,/media/marda/TWOTB1/xBD/hurricanes/images/florence/hurricane-florence_00000006_post_disaster.png,69,63,1,758,827,300,363,1503,51.75388708796218,38.085095509819865
19121,/media/marda/TWOTB1/xBD/hurricanes/images/florence/hurricane-florence_00000006_post_disaster.png,65,65,1,667,732,301,366,1129,48.278526721458626,30.973561404155777
19122,/media/marda/TWOTB1/xBD/hurricanes/images/florence/hurricane-florence_00000006_post_disaster.png,61,54,1,718,779,313,367,1181,46.66060588210653,33.343951570894724
19123,/media/marda/TWOTB1/xBD/hurricanes/images/florence/hurricane-florence_00000006_post_disaster.png,75,66,1,543,618,314,380,1613,55.18671471437175,39.04122333123385
19124,/media/marda/TWOTB1/xBD/hurricanes/images/florence/hurricane-florence_00000006_post_disaster.png,73,112,1,354,427,325,437,4342,107.14546708079426,53.87771491141075
19125,/media/marda/TWOTB1/xBD/hurricanes/images/florence/hurricane-florence_00000006_post_disaster.png,82,63,1,943,1025,325,388,1496,53.09162464723905,37.39619291260887
19126,/media/marda/TWOTB1/xBD/hurricanes/images/florence/hurricane-florence_00000006_post_disaster.png,87,62,1,894,981,337,399,1508,51.256871653372485,38.74411978750511
19127,/media/marda/TWOTB1/xBD/hurricanes/images/florence/hurricane-florence_00000006_post_disaster.png,56,57,1,988,1044,341,398,464,46.3539546344314,14.18002389351502
19128,/media/marda/TWOTB1/xBD/hurricanes/images/florence/hurricane-florence_00000006_post_disaster.png,72,64,1,566,638,352,416,1484,53.6954378353141,36.28489282661212
19129,/media/marda/TWOTB1/xBD/hurricanes/images/florence/hurricane-florence_00000006_post_disaster.png,49,110,1,120,169,358,468,3871,108.63746462296655,47.80978887136862
19130,/media/marda/TWOTB1/xBD/hurricanes/images/florence/hurricane-florence_00000006_post_disaster.png,90,68,1,865,955,363,431,1719,56.639007645944744,40.51398261730267
19131,/media/marda/TWOTB1/xBD/hurricanes/images/florence/hurricane-florence_00000006_post_disaster.png,64,110,1,283,347,366,476,3853,110.10170601323841,47.02246146881895
19132,/media/marda/TWOTB1/xBD/hurricanes/images/florence/hurricane-florence_00000006_post_disaster.png,66,54,1,841,907,390,444,1231,46.30873482417468,35.7242458874235
19133,/media/marda/TWOTB1/xBD/hurricanes/images/florence/hurricane-florence_00000006_post_disaster.png,80,66,1,587,667,392,458,1551,55.604494512808486,37.56200842810702
19134,/media/marda/TWOTB1/xBD/hurricanes/images/florence/hurricane-florence_00000006_post_disaster.png,68,71,1,803,871,395,466,1424,55.39358705284085,34.677072652267896
19135,/media/marda/TWOTB1/xBD/hurricanes/images/florence/hurricane-florence_00000006_post_disaster.png,65,70,1,765,830,402,472,1374,55.3932144344125,33.50901308645176
19136,/media/marda/TWOTB1/xBD/hurricanes/images/florence/hurricane-florence_00000006_post_disaster.png,72,76,1,628,700,406,482,1550,53.304533947924924,38.28296312174906
19137,/media/marda/TWOTB1/xBD/hurricanes/images/florence/hurricane-florence_00000006_post_disaster.png,61,66,1,725,786,410,476,1370,54.8001846016987,33.33768842259432
19138,/media/marda/TWOTB1/xBD/hurricanes/images/florence/hurricane-florence_00000006_post_disaster.png,61,60,1,686,747,417,477,1275,48.32370460688625,34.80490579964701
19139,/media/marda/TWOTB1/xBD/hurricanes/images/florence/hurricane-florence_00000006_post_disaster.png,114,106,1,392,506,421,527,3806,107.03365165139655,47.57102961084997
19140,/media/marda/TWOTB1/xBD/hurricanes/images/florence/hurricane-florence_00000006_post_disaster.png,111,106,1,470,581,491,597,3690,105.46738853076705,46.44799793764684
19141,/media/marda/TWOTB1/xBD/hurricanes/images/florence/hurricane-florence_00000006_post_disaster.png,108,58,1,297,405,498,556,3453,110.74998875803574,41.52755058165658
19142,/media/marda/TWOTB1/xBD/hurricanes/images/florence/hurricane-florence_00000006_post_disaster.png,99,61,1,197,296,500,561,3706,107.02312389078743,46.04291016568062
19143,/media/marda/TWOTB1/xBD/hurricanes/images/florence/hurricane-florence_00000006_post_disaster.png,98,59,1,95,193,501,560,3460,109.35188962688424,42.12122856740315
19144,/media/marda/TWOTB1/xBD/hurricanes/images/florence/hurricane-florence_00000006_post_disaster.png,115,110,1,543,658,559,669,3572,108.18921385109729,44.09067638046267
19145,/media/marda/TWOTB1/xBD/hurricanes/images/florence/hurricane-florence_00000006_post_disaster.png,46,70,1,74,120,610,680,1429,48.227780957102134,39.778257972605694
19146,/media/marda/TWOTB1/xBD/hurricanes/images/florence/hurricane-florence_00000006_post_disaster.png,46,70,1,117,163,616,686,1363,47.035417364271346,38.40179307232278
19147,/media/marda/TWOTB1/xBD/hurricanes/images/florence/hurricane-florence_00000006_post_disaster.png,137,67,1,884,1021,632,699,3554,108.94561935593693,42.97120007094773
19148,/media/marda/TWOTB1/xBD/hurricanes/images/florence/hurricane-florence_00000006_post_disaster.png,48,68,1,26,74,638,706,1036,45.99443933242535,30.087888809910663
19149,/media/marda/TWOTB1/xBD/hurricanes/images/florence/hurricane-florence_00000006_post_disaster.png,127,64,1,784,911,641,705,3228,106.42344544788945,40.2416506286584
19150,/media/marda/TWOTB1/xBD/hurricanes/images/florence/hurricane-florence_00000006_post_disaster.png,51,73,1,150,201,644,717,1223,45.2359898475408,35.861151343077196
19151,/media/marda/TWOTB1/xBD/hurricanes/images/florence/hurricane-florence_00000006_post_disaster.png,123,67,1,684,807,644,711,3441,107.98993966083457,42.11091245455375
19152,/media/marda/TWOTB1/xBD/hurricanes/images/florence/hurricane-florence_00000006_post_disaster.png,38,60,1,23,61,683,743,1177,40.584447269765846,40.07910013912926
19153,/media/marda/TWOTB1/xBD/hurricanes/images/florence/hurricane-florence_00000006_post_disaster.png,48,63,1,164,212,688,751,1046,42.92679008003159,33.07762452723375
19154,/media/marda/TWOTB1/xBD/hurricanes/images/florence/hurricane-florence_00000006_post_disaster.png,89,126,1,940,1029,701,827,3872,109.27026942499339,47.55454605261779
19155,/media/marda/TWOTB1/xBD/hurricanes/images/florence/hurricane-florence_00000006_post_disaster.png,128,107,1,753,881,720,827,3598,105.87747669682906,45.843462743979735
19156,/media/marda/TWOTB1/xBD/hurricanes/images/florence/hurricane-florence_00000006_post_disaster.png,48,72,1,34,82,721,793,1181,44.5701407308734,35.74713797569141
19157,/media/marda/TWOTB1/xBD/hurricanes/images/florence/hurricane-florence_00000006_post_disaster.png,47,63,1,165,212,726,789,1254,45.663798440380454,36.33169158684251
19158,/media/marda/TWOTB1/xBD/hurricanes/images/florence/hurricane-florence_00000006_post_disaster.png,46,60,1,85,131,736,796,1207,48.25607422831242,34.152898803371116
19159,/media/marda/TWOTB1/xBD/hurricanes/images/florence/hurricane-florence_00000006_post_disaster.png,55,63,1,168,223,762,825,1430,52.0730331226851,37.630375107606355
19160,/media/marda/TWOTB1/xBD/hurricanes/images/florence/hurricane-florence_00000006_post_disaster.png,52,62,1,84,136,771,833,1294,49.89719906457449,34.56568736837184
19161,/media/marda/TWOTB1/xBD/hurricanes/images/florence/hurricane-florence_00000006_post_disaster.png,136,110,1,838,974,772,882,3777,109.84840218122618,46.39300606581411
19162,/media/marda/TWOTB1/xBD/hurricanes/images/florence/hurricane-florence_00000006_post_disaster.png,57,66,1,168,225,805,871,1463,55.497775571195206,36.08356135710287
19163,/media/marda/TWOTB1/xBD/hurricanes/images/florence/hurricane-florence_00000006_post_disaster.png,78,78,1,58,136,817,895,2758,82.57584651364412,46.69528216987291
19164,/media/marda/TWOTB1/xBD/hurricanes/images/florence/hurricane-florence_00000006_post_disaster.png,30,77,1,21,51,819,896,1117,48.100394304420725,30.263238450020477
19165,/media/marda/TWOTB1/xBD/hurricanes/images/florence/hurricane-florence_00000006_post_disaster.png,17,59,1,0,17,826,885,376,27.851346398570026,17.711139544078748
19166,/media/marda/TWOTB1/xBD/hurricanes/images/florence/hurricane-florence_00000006_post_disaster.png,47,66,1,172,219,841,907,1153,47.43898727305814,33.98997747809362
19167,/media/marda/TWOTB1/xBD/hurricanes/images/florence/hurricane-florence_00000006_post_disaster.png,54,67,1,172,226,882,949,1382,51.167846263468476,36.492216604212565
19168,/media/marda/TWOTB1/xBD/hurricanes/images/florence/hurricane-florence_00000006_post_disaster.png,117,82,1,22,139,902,984,3739,125.94466307980014,41.87934259057632
19169,/media/marda/TWOTB1/xBD/hurricanes/images/florence/hurricane-florence_00000006_post_disaster.png,21,80,1,0,21,904,984,822,48.449571385727,22.63326385371651
19170,/media/marda/TWOTB1/xBD/hurricanes/images/florence/hurricane-florence_00000006_post_disaster.png,55,71,1,174,229,919,990,1191,53.726215252426535,32.00231999598099
19171,/media/marda/TWOTB1/xBD/hurricanes/images/florence/hurricane-florence_00000006_post_disaster.png,80,84,1,24,104,957,1041,2463,91.59760603894776,42.347869524422116
19172,/media/marda/TWOTB1/xBD/hurricanes/images/florence/hurricane-florence_00000006_post_disaster.png,40,81,1,102,142,958,1039,1290,47.70201371669904,35.69810835931745
19173,/media/marda/TWOTB1/xBD/hurricanes/images/florence/hurricane-florence_00000006_post_disaster.png,50,75,1,175,225,958,1033,1343,45.94919190213571,40.4271167797721
19174,/media/marda/TWOTB1/xBD/hurricanes/images/florence/hurricane-florence_00000006_post_disaster.png,20,74,1,0,20,967,1041,425,35.676467824299216,20.183964085667125
19175,/media/marda/TWOTB1/xBD/hurricanes/images/florence/hurricane-florence_00000006_post_disaster.png,30,46,1,195,225,997,1043,144,27.688746209726915,6.831300510639732
19176,/media/marda/TWOTB1/xBD/hurricanes/images/florence/hurricane-florence_00000307_pre_disaster.png,43,33,1,5,48,54,87,941,43.59988890145511,29.190210024039033
19177,/media/marda/TWOTB1/xBD/hurricanes/images/florence/hurricane-florence_00000307_pre_disaster.png,31,32,1,47,78,262,294,371,30.634094649116005,17.857984124624753
19178,/media/marda/TWOTB1/xBD/hurricanes/images/florence/hurricane-florence_00000307_pre_disaster.png,17,44,1,0,17,282,326,340,33.24961197041822,15.217347458680605
19179,/media/marda/TWOTB1/xBD/hurricanes/images/florence/hurricane-florence_00000307_pre_disaster.png,46,65,1,464,510,296,361,684,53.41374682648357,22.05355815717972
19180,/media/marda/TWOTB1/xBD/hurricanes/images/florence/hurricane-florence_00000307_pre_disaster.png,11,24,1,43,54,304,328,68,10.155390215859489,9.005739485532125
19181,/media/marda/TWOTB1/xBD/hurricanes/images/florence/hurricane-florence_00000307_pre_disaster.png,33,29,1,431,464,307,336,165,15.301968142832251,14.493376485714604
19182,/media/marda/TWOTB1/xBD/hurricanes/images/florence/hurricane-florence_00000307_pre_disaster.png,29,30,1,8,37,308,338,255,29.407126730864885,12.395667693104777
19183,/media/marda/TWOTB1/xBD/hurricanes/images/florence/hurricane-florence_00000307_pre_disaster.png,15,27,1,34,49,319,346,117,13.153897371912121,11.884081545732244
19184,/media/marda/TWOTB1/xBD/hurricanes/images/florence/hurricane-florence_00000307_pre_disaster.png,13,37,1,0,13,512,549,140,14.970442173716302,12.469789775364445
19185,/media/marda/TWOTB1/xBD/hurricanes/images/florence/hurricane-florence_00000307_pre_disaster.png,8,43,1,0,8,574,617,120,22.18006950174009,7.557047131150083
19186,/media/marda/TWOTB1/xBD/hurricanes/images/florence/hurricane-florence_00000307_pre_disaster.png,27,34,1,209,236,580,614,136,20.41505168517815,8.94383031355492
19187,/media/marda/TWOTB1/xBD/hurricanes/images/florence/hurricane-florence_00000307_pre_disaster.png,25,36,1,286,311,659,695,78,15.49274312887743,6.770873859985007
19188,/media/marda/TWOTB1/xBD/hurricanes/images/florence/hurricane-florence_00000307_pre_disaster.png,22,41,1,223,245,709,750,91,11.60105693813812,10.561540534709902
19189,/media/marda/TWOTB1/xBD/hurricanes/images/florence/hurricane-florence_00000307_pre_disaster.png,22,40,1,223,245,724,764,83,11.86944365822134,9.437021389770992
19190,/media/marda/TWOTB1/xBD/hurricanes/images/florence/hurricane-florence_00000083_post_disaster.png,30,55,1,15,45,550,605,869,36.51508235842856,31.359921482689668
19191,/media/marda/TWOTB1/xBD/hurricanes/images/florence/hurricane-florence_00000083_post_disaster.png,21,68,1,0,21,807,875,639,40.35505423893898,20.975376334600867
19192,/media/marda/TWOTB1/xBD/hurricanes/images/florence/hurricane-florence_00000083_post_disaster.png,59,87,1,278,337,947,1034,1351,46.032183399668334,38.69146910032874
19193,/media/marda/TWOTB1/xBD/hurricanes/images/florence/hurricane-florence_00000083_post_disaster.png,51,63,1,344,395,980,1043,503,34.26436313000523,21.437998141581176
19194,/media/marda/TWOTB1/xBD/hurricanes/images/florence/hurricane-florence_00000503_pre_disaster.png,89,95,1,799,888,915,1010,1587,59.30838895261415,35.704454854277785
19195,/media/marda/TWOTB1/xBD/hurricanes/images/florence/hurricane-florence_00000472_post_disaster.png,70,60,1,4,74,0,60,2560,64.94211890733332,51.81327912778941
19196,/media/marda/TWOTB1/xBD/hurricanes/images/florence/hurricane-florence_00000472_post_disaster.png,71,39,1,180,251,0,39,1572,58.4198949338296,38.5765113258668
19197,/media/marda/TWOTB1/xBD/hurricanes/images/florence/hurricane-florence_00000472_post_disaster.png,96,62,1,754,850,7,69,2241,70.47775366060236,46.59088925333062
19198,/media/marda/TWOTB1/xBD/hurricanes/images/florence/hurricane-florence_00000472_post_disaster.png,72,49,1,560,632,10,59,1556,47.94965408445421,43.93187894177035
19199,/media/marda/TWOTB1/xBD/hurricanes/images/florence/hurricane-florence_00000472_post_disaster.png,38,46,1,0,38,53,99,927,43.00354155800322,36.03021159882407
19200,/media/marda/TWOTB1/xBD/hurricanes/images/florence/hurricane-florence_00000472_post_disaster.png,62,53,1,174,236,56,109,1904,52.586498036843984,49.981850960903564
19201,/media/marda/TWOTB1/xBD/hurricanes/images/florence/hurricane-florence_00000472_post_disaster.png,76,55,1,139,215,113,168,1915,64.17903663016925,43.62801189142549
19202,/media/marda/TWOTB1/xBD/hurricanes/images/florence/hurricane-florence_00000472_post_disaster.png,60,60,1,117,177,166,226,2090,54.140116208290884,51.327724926051594
19203,/media/marda/TWOTB1/xBD/hurricanes/images/florence/hurricane-florence_00000472_post_disaster.png,90,64,1,617,707,311,375,1913,63.06290775091868,43.122104603478334
19204,/media/marda/TWOTB1/xBD/hurricanes/images/florence/hurricane-florence_00000472_post_disaster.png,65,72,1,46,111,335,407,2252,65.99482205341963,48.69287422803887
19205,/media/marda/TWOTB1/xBD/hurricanes/images/florence/hurricane-florence_00000472_post_disaster.png,82,69,1,601,683,363,432,1816,59.94446796510147,42.85087515824488
19206,/media/marda/TWOTB1/xBD/hurricanes/images/florence/hurricane-florence_00000472_post_disaster.png,83,80,1,392,475,416,496,2519,76.91548803774785,45.45342695219808
19207,/media/marda/TWOTB1/xBD/hurricanes/images/florence/hurricane-florence_00000472_post_disaster.png,76,75,1,586,662,424,499,1741,58.989055758079914,42.443815019085115
19208,/media/marda/TWOTB1/xBD/hurricanes/images/florence/hurricane-florence_00000472_post_disaster.png,73,109,1,360,433,608,717,2837,79.74069894714263,52.99098566298609
19209,/media/marda/TWOTB1/xBD/hurricanes/images/florence/hurricane-florence_00000472_post_disaster.png,19,73,1,0,19,867,940,559,41.22522871113774,18.218941468495476
19210,/media/marda/TWOTB1/xBD/hurricanes/images/florence/hurricane-florence_00000472_post_disaster.png,50,95,1,45,95,883,978,1679,57.187702371179924,42.892962038378485
19211,/media/marda/TWOTB1/xBD/hurricanes/images/florence/hurricane-florence_00000472_post_disaster.png,59,103,1,91,150,897,1000,2171,61.00293504436863,49.50684527913659
19212,/media/marda/TWOTB1/xBD/hurricanes/images/florence/hurricane-florence_00000472_post_disaster.png,56,96,1,288,344,915,1011,2008,63.97849634844487,44.18115662434735
19213,/media/marda/TWOTB1/xBD/hurricanes/images/florence/hurricane-florence_00000472_post_disaster.png,101,78,1,493,594,716,794,2291,73.67412358946542,42.26007375285826
19214,/media/marda/TWOTB1/xBD/hurricanes/images/florence/hurricane-florence_00000472_post_disaster.png,111,103,1,454,565,755,858,3412,88.66426731697798,56.284084451879984
19215,/media/marda/TWOTB1/xBD/hurricanes/images/florence/hurricane-florence_00000472_post_disaster.png,81,80,1,518,599,897,977,1934,63.21162325886013,43.80125123859143
19216,/media/marda/TWOTB1/xBD/hurricanes/images/florence/hurricane-florence_00000472_post_disaster.png,98,83,1,543,641,944,1027,2110,75.28553651942653,40.25574178512204
19217,/media/marda/TWOTB1/xBD/hurricanes/images/florence/hurricane-florence_00000472_post_disaster.png,68,54,1,588,656,989,1043,389,43.412699622270964,12.80051083953539
19218,/media/marda/TWOTB1/xBD/hurricanes/images/florence/hurricane-florence_00000472_post_disaster.png,106,74,1,850,956,474,548,2214,63.03574381292773,48.88855310247368
19219,/media/marda/TWOTB1/xBD/hurricanes/images/florence/hurricane-florence_00000472_post_disaster.png,84,83,1,688,772,679,762,2099,55.3254291477023,50.77131777695638
19220,/media/marda/TWOTB1/xBD/hurricanes/images/florence/hurricane-florence_00000472_post_disaster.png,96,92,1,888,984,701,793,1905,68.49602358175822,37.02062904772747
19221,/media/marda/TWOTB1/xBD/hurricanes/images/florence/hurricane-florence_00000472_post_disaster.png,97,90,1,731,828,726,816,2102,67.64721755992618,47.40281531080499
19222,/media/marda/TWOTB1/xBD/hurricanes/images/florence/hurricane-florence_00000472_post_disaster.png,92,87,1,783,875,770,857,2299,64.30227601957299,49.559309654509406
19223,/media/marda/TWOTB1/xBD/hurricanes/images/florence/hurricane-florence_00000472_post_disaster.png,102,83,1,923,1025,928,1011,1681,62.41306964437028,37.376415338745375
19224,/media/marda/TWOTB1/xBD/hurricanes/images/florence/hurricane-florence_00000420_post_disaster.png,40,25,1,6,46,0,25,652,40.04204921433622,21.903012097967963
19225,/media/marda/TWOTB1/xBD/hurricanes/images/florence/hurricane-florence_00000420_post_disaster.png,36,43,1,31,67,110,153,724,41.289402572682505,23.234472442645973
19226,/media/marda/TWOTB1/xBD/hurricanes/images/florence/hurricane-florence_00000420_post_disaster.png,22,28,1,49,71,206,234,220,18.315998320767815,16.07828700302514
19227,/media/marda/TWOTB1/xBD/hurricanes/images/florence/hurricane-florence_00000420_post_disaster.png,42,39,1,189,231,241,280,515,36.64650675388312,18.76931505825344
19228,/media/marda/TWOTB1/xBD/hurricanes/images/florence/hurricane-florence_00000420_post_disaster.png,10,40,1,0,10,517,557,114,16.95788856307949,10.20119426893973
19229,/media/marda/TWOTB1/xBD/hurricanes/images/florence/hurricane-florence_00000420_post_disaster.png,49,71,1,0,49,560,631,1540,51.275179187246145,42.85178411980683
19230,/media/marda/TWOTB1/xBD/hurricanes/images/florence/hurricane-florence_00000420_post_disaster.png,75,76,1,294,369,735,811,1969,71.67343085974775,38.449514019565896
19231,/media/marda/TWOTB1/xBD/hurricanes/images/florence/hurricane-florence_00000420_post_disaster.png,62,76,1,132,194,837,913,1793,62.382674661487634,41.35440905127428
19232,/media/marda/TWOTB1/xBD/hurricanes/images/florence/hurricane-florence_00000480_pre_disaster.png,80,50,1,832,912,190,240,924,57.97259824970772,23.1278802943972
19233,/media/marda/TWOTB1/xBD/hurricanes/images/florence/hurricane-florence_00000480_pre_disaster.png,46,21,1,821,867,238,259,101,12.396668224956086,10.72800040398209
19234,/media/marda/TWOTB1/xBD/hurricanes/images/florence/hurricane-florence_00000480_pre_disaster.png,47,57,1,135,182,465,522,1563,48.04705699089038,43.41536674568197
19235,/media/marda/TWOTB1/xBD/hurricanes/images/florence/hurricane-florence_00000480_pre_disaster.png,48,52,1,335,383,485,537,725,38.20482259036366,24.828595933381788
19236,/media/marda/TWOTB1/xBD/hurricanes/images/florence/hurricane-florence_00000480_pre_disaster.png,68,75,1,424,492,490,565,1503,48.45716342687951,41.13260280388583
19237,/media/marda/TWOTB1/xBD/hurricanes/images/florence/hurricane-florence_00000480_pre_disaster.png,37,44,1,302,339,493,537,267,26.91914023185688,13.259270767909717
19238,/media/marda/TWOTB1/xBD/hurricanes/images/florence/hurricane-florence_00000480_pre_disaster.png,17,39,1,92,109,509,548,249,19.77425324235318,16.867032562106942
19239,/media/marda/TWOTB1/xBD/hurricanes/images/florence/hurricane-florence_00000480_pre_disaster.png,16,33,1,152,168,511,544,145,14.046229092683127,13.760513222185102
19240,/media/marda/TWOTB1/xBD/hurricanes/images/florence/hurricane-florence_00000480_pre_disaster.png,42,49,1,346,388,530,579,484,30.2214101839296,21.022131425915102
19241,/media/marda/TWOTB1/xBD/hurricanes/images/florence/hurricane-florence_00000480_pre_disaster.png,17,32,1,153,170,531,563,156,14.966629547095765,13.808210118138652
19242,/media/marda/TWOTB1/xBD/hurricanes/images/florence/hurricane-florence_00000480_pre_disaster.png,19,43,1,101,120,538,581,320,25.478109104763558,16.767621892974688
19243,/media/marda/TWOTB1/xBD/hurricanes/images/florence/hurricane-florence_00000480_pre_disaster.png,37,47,1,234,271,541,588,408,24.32486450419594,22.20207572257935
19244,/media/marda/TWOTB1/xBD/hurricanes/images/florence/hurricane-florence_00000480_pre_disaster.png,17,26,1,156,173,545,571,61,14.060841351813774,5.796775260366202
19245,/media/marda/TWOTB1/xBD/hurricanes/images/florence/hurricane-florence_00000480_pre_disaster.png,51,62,1,200,251,564,626,577,55.44246798019676,13.93678726018069
19246,/media/marda/TWOTB1/xBD/hurricanes/images/florence/hurricane-florence_00000392_post_disaster.png,35,17,1,231,266,0,17,246,27.01737714699559,12.16262850877295
19247,/media/marda/TWOTB1/xBD/hurricanes/images/florence/hurricane-florence_00000392_post_disaster.png,89,33,1,763,852,0,33,1096,50.11653789737642,31.0867168390036
19248,/media/marda/TWOTB1/xBD/hurricanes/images/florence/hurricane-florence_00000392_post_disaster.png,113,57,1,714,827,58,115,2058,79.20234447210186,45.18414886295723
19249,/media/marda/TWOTB1/xBD/hurricanes/images/florence/hurricane-florence_00000392_post_disaster.png,73,65,1,410,483,182,247,1813,56.79746847129174,42.47312063017083
19250,/media/marda/TWOTB1/xBD/hurricanes/images/florence/hurricane-florence_00000392_post_disaster.png,75,47,1,921,996,186,233,941,40.05688308183009,31.939176489448126
19251,/media/marda/TWOTB1/xBD/hurricanes/images/florence/hurricane-florence_00000392_post_disaster.png,64,33,1,970,1034,231,264,348,23.551199008084854,19.533312569930153
19252,/media/marda/TWOTB1/xBD/hurricanes/images/florence/hurricane-florence_00000392_post_disaster.png,79,105,1,212,291,936,1041,2009,85.37639611035428,35.565747468802826
19253,/media/marda/TWOTB1/xBD/hurricanes/images/florence/hurricane-florence_00000410_pre_disaster.png,72,75,1,562,634,11,86,2021,72.28813849830638,42.8443304289184
19254,/media/marda/TWOTB1/xBD/hurricanes/images/florence/hurricane-florence_00000410_pre_disaster.png,70,63,1,509,579,13,76,1785,58.035035043555425,43.200060864472945
19255,/media/marda/TWOTB1/xBD/hurricanes/images/florence/hurricane-florence_00000410_pre_disaster.png,58,68,1,89,147,30,98,2013,70.11052417539277,40.434847134549095
19256,/media/marda/TWOTB1/xBD/hurricanes/images/florence/hurricane-florence_00000410_pre_disaster.png,71,44,1,668,739,39,83,1499,49.12600246901457,41.81474412043212
19257,/media/marda/TWOTB1/xBD/hurricanes/images/florence/hurricane-florence_00000410_pre_disaster.png,82,63,1,195,277,144,207,2234,67.90695104298337,46.91794785960259
19258,/media/marda/TWOTB1/xBD/hurricanes/images/florence/hurricane-florence_00000410_pre_disaster.png,66,74,1,565,631,156,230,2061,70.8823667890095,43.64084807714724
19259,/media/marda/TWOTB1/xBD/hurricanes/images/florence/hurricane-florence_00000410_pre_disaster.png,92,67,1,781,873,163,230,2054,67.28614794432168,43.27857793438905
19260,/media/marda/TWOTB1/xBD/hurricanes/images/florence/hurricane-florence_00000410_pre_disaster.png,69,71,1,614,683,173,244,1946,64.3469544755509,42.2166903507388
19261,/media/marda/TWOTB1/xBD/hurricanes/images/florence/hurricane-florence_00000410_pre_disaster.png,85,71,1,750,835,190,261,1979,60.34629107212353,46.150726133086046
19262,/media/marda/TWOTB1/xBD/hurricanes/images/florence/hurricane-florence_00000410_pre_disaster.png,92,74,1,258,350,220,294,2730,85.31130409249766,46.422592570249975
19263,/media/marda/TWOTB1/xBD/hurricanes/images/florence/hurricane-florence_00000410_pre_disaster.png,94,74,1,657,751,251,325,2248,74.03437618942256,42.36491665072459
19264,/media/marda/TWOTB1/xBD/hurricanes/images/florence/hurricane-florence_00000410_pre_disaster.png,56,75,1,335,391,375,450,1947,63.3755906990329,43.30317825837319
19265,/media/marda/TWOTB1/xBD/hurricanes/images/florence/hurricane-florence_00000410_pre_disaster.png,64,70,1,980,1044,375,445,797,50.917037009731,23.2061931797731
19266,/media/marda/TWOTB1/xBD/hurricanes/images/florence/hurricane-florence_00000410_pre_disaster.png,99,88,1,911,1010,433,521,2392,65.10371796063588,51.0971364602944
19267,/media/marda/TWOTB1/xBD/hurricanes/images/florence/hurricane-florence_00000410_pre_disaster.png,73,81,1,716,789,549,630,2044,61.441751385713154,47.110502267649515
19268,/media/marda/TWOTB1/xBD/hurricanes/images/florence/hurricane-florence_00000410_pre_disaster.png,82,81,1,635,717,562,643,2323,66.36046122199421,49.49538319458709
19269,/media/marda/TWOTB1/xBD/hurricanes/images/florence/hurricane-florence_00000410_pre_disaster.png,74,69,1,538,612,578,647,1893,55.19573211408683,46.198112013830624
19270,/media/marda/TWOTB1/xBD/hurricanes/images/florence/hurricane-florence_00000410_pre_disaster.png,87,105,1,769,856,692,797,2258,73.03462258105503,46.51115037616103
19271,/media/marda/TWOTB1/xBD/hurricanes/images/florence/hurricane-florence_00000410_pre_disaster.png,16,58,1,0,16,704,762,465,34.623017678764825,17.887865955618757
19272,/media/marda/TWOTB1/xBD/hurricanes/images/florence/hurricane-florence_00000364_post_disaster.png,358,408,1,428,786,0,408,86585,434.4350701792331,297.0737839095982
19273,/media/marda/TWOTB1/xBD/hurricanes/images/florence/hurricane-florence_00000364_post_disaster.png,46,3,1,784,830,0,3,22,14.73527769800844,2.134839941494035
19274,/media/marda/TWOTB1/xBD/hurricanes/images/florence/hurricane-florence_00000364_post_disaster.png,42,31,1,57,99,38,69,869,43.75216058200869,26.007039141024702
19275,/media/marda/TWOTB1/xBD/hurricanes/images/florence/hurricane-florence_00000364_post_disaster.png,8,22,1,0,8,69,91,95,21.122979190512744,6.904294258143848
19276,/media/marda/TWOTB1/xBD/hurricanes/images/florence/hurricane-florence_00000364_post_disaster.png,33,19,1,97,130,78,97,332,33.00812980668291,15.33943678692614
19277,/media/marda/TWOTB1/xBD/hurricanes/images/florence/hurricane-florence_00000364_post_disaster.png,30,23,1,55,85,84,107,321,35.036028856676914,17.171670129508726
19278,/media/marda/TWOTB1/xBD/hurricanes/images/florence/hurricane-florence_00000364_post_disaster.png,19,22,1,16,35,101,123,210,17.88070560168307,15.677807728371944
19279,/media/marda/TWOTB1/xBD/hurricanes/images/florence/hurricane-florence_00000364_post_disaster.png,62,46,1,864,926,249,295,704,40.68003426506058,22.812661993159825
19280,/media/marda/TWOTB1/xBD/hurricanes/images/florence/hurricane-florence_00000364_post_disaster.png,128,117,1,275,403,418,535,7894,117.44787449297839,90.76258576709606
19281,/media/marda/TWOTB1/xBD/hurricanes/images/florence/hurricane-florence_00000364_post_disaster.png,37,31,1,531,568,421,452,167,16.665502063013953,13.439060472253974
19282,/media/marda/TWOTB1/xBD/hurricanes/images/florence/hurricane-florence_00000364_post_disaster.png,41,68,1,433,474,510,578,634,53.53317171870943,17.82505900058294
19283,/media/marda/TWOTB1/xBD/hurricanes/images/florence/hurricane-florence_00000364_post_disaster.png,51,63,1,395,446,531,594,590,50.52546293750198,15.51091402528208
19284,/media/marda/TWOTB1/xBD/hurricanes/images/florence/hurricane-florence_00000364_post_disaster.png,62,59,1,358,420,544,603,653,56.373064930921174,15.476991813054939
19285,/media/marda/TWOTB1/xBD/hurricanes/images/florence/hurricane-florence_00000364_post_disaster.png,61,58,1,332,393,555,613,628,58.11317668626475,14.398076117078393
19286,/media/marda/TWOTB1/xBD/hurricanes/images/florence/hurricane-florence_00000364_post_disaster.png,61,58,1,310,371,566,624,602,58.36797846287089,13.774513773368723
19287,/media/marda/TWOTB1/xBD/hurricanes/images/florence/hurricane-florence_00000364_post_disaster.png,60,56,1,286,346,579,635,612,56.961059427486305,14.360291235057755
19288,/media/marda/TWOTB1/xBD/hurricanes/images/florence/hurricane-florence_00000364_post_disaster.png,53,59,1,266,319,589,648,493,51.8207192672419,12.707803795991843
19289,/media/marda/TWOTB1/xBD/hurricanes/images/florence/hurricane-florence_00000364_post_disaster.png,48,53,1,243,291,602,655,404,45.93710255605537,11.766223459504163
19290,/media/marda/TWOTB1/xBD/hurricanes/images/florence/hurricane-florence_00000364_post_disaster.png,87,71,1,182,269,611,682,1583,73.7146448425305,37.04216118244833
19291,/media/marda/TWOTB1/xBD/hurricanes/images/florence/hurricane-florence_00000364_post_disaster.png,47,50,1,385,432,613,663,354,36.29195401720442,13.031957900502306
19292,/media/marda/TWOTB1/xBD/hurricanes/images/florence/hurricane-florence_00000364_post_disaster.png,28,80,1,37,65,616,696,700,63.1481538273167,14.746473768657738
19293,/media/marda/TWOTB1/xBD/hurricanes/images/florence/hurricane-florence_00000364_post_disaster.png,70,64,1,365,435,622,686,798,64.6388993807744,17.485492877027703
19294,/media/marda/TWOTB1/xBD/hurricanes/images/florence/hurricane-florence_00000364_post_disaster.png,38,46,1,421,459,629,675,254,23.885827656268397,14.545498320223075
19295,/media/marda/TWOTB1/xBD/hurricanes/images/florence/hurricane-florence_00000364_post_disaster.png,56,58,1,170,226,634,692,689,55.69020291692226,17.35178157533541
19296,/media/marda/TWOTB1/xBD/hurricanes/images/florence/hurricane-florence_00000364_post_disaster.png,78,92,1,337,415,634,726,1306,86.47638143264203,23.779549852215645
19297,/media/marda/TWOTB1/xBD/hurricanes/images/florence/hurricane-florence_00000364_post_disaster.png,55,63,1,139,194,642,705,838,56.53420898543478,21.17615963017332
19298,/media/marda/TWOTB1/xBD/hurricanes/images/florence/hurricane-florence_00000364_post_disaster.png,59,58,1,380,439,653,711,526,52.42528807032864,13.399422616889044
19299,/media/marda/TWOTB1/xBD/hurricanes/images/florence/hurricane-florence_00000364_post_disaster.png,53,61,1,120,173,657,718,633,53.02648097517671,18.66003449926441
19300,/media/marda/TWOTB1/xBD/hurricanes/images/florence/hurricane-florence_00000364_post_disaster.png,55,77,1,320,375,659,736,695,65.08748308554377,14.269172839786737
19301,/media/marda/TWOTB1/xBD/hurricanes/images/florence/hurricane-florence_00000364_post_disaster.png,49,79,1,275,324,662,741,935,59.72661596495007,21.29415321915672
19302,/media/marda/TWOTB1/xBD/hurricanes/images/florence/hurricane-florence_00000364_post_disaster.png,46,71,1,254,300,668,739,642,56.84893980729077,14.993951196368972
19303,/media/marda/TWOTB1/xBD/hurricanes/images/florence/hurricane-florence_00000364_post_disaster.png,42,57,1,482,524,680,737,506,35.501837947194375,18.864564118862987
19304,/media/marda/TWOTB1/xBD/hurricanes/images/florence/hurricane-florence_00000364_post_disaster.png,12,35,1,1,13,681,716,88,11.847612688246057,9.918145531267108
19305,/media/marda/TWOTB1/xBD/hurricanes/images/florence/hurricane-florence_00000364_post_disaster.png,28,73,1,107,135,681,754,734,55.561221630608806,18.13007482993154
19306,/media/marda/TWOTB1/xBD/hurricanes/images/florence/hurricane-florence_00000364_post_disaster.png,39,73,1,51,90,683,756,988,55.62487180102387,24.930094770228163
19307,/media/marda/TWOTB1/xBD/hurricanes/images/florence/hurricane-florence_00000364_post_disaster.png,56,62,1,202,258,691,753,639,55.20840538291652,17.622907060751224
19308,/media/marda/TWOTB1/xBD/hurricanes/images/florence/hurricane-florence_00000364_post_disaster.png,8,43,1,0,8,702,745,79,14.338753881822873,7.690071422612406
19309,/media/marda/TWOTB1/xBD/hurricanes/images/florence/hurricane-florence_00000364_post_disaster.png,43,68,1,420,463,702,770,564,41.5340166652904,19.036588026229275
19310,/media/marda/TWOTB1/xBD/hurricanes/images/florence/hurricane-florence_00000364_post_disaster.png,40,61,1,390,430,709,770,473,31.86827801004517,20.265592999509963
19311,/media/marda/TWOTB1/xBD/hurricanes/images/florence/hurricane-florence_00000364_post_disaster.png,50,77,1,171,221,711,788,729,60.20586812789499,16.187468818537806
19312,/media/marda/TWOTB1/xBD/hurricanes/images/florence/hurricane-florence_00000364_post_disaster.png,70,74,1,223,293,712,786,1198,58.122157056486124,39.59471679954003
19313,/media/marda/TWOTB1/xBD/hurricanes/images/florence/hurricane-florence_00000364_post_disaster.png,23,61,1,0,23,722,783,469,29.940312070550448,21.749843314675324
19314,/media/marda/TWOTB1/xBD/hurricanes/images/florence/hurricane-florence_00000364_post_disaster.png,38,63,1,362,400,728,791,385,38.35838363943384,13.424466859295986
19315,/media/marda/TWOTB1/xBD/hurricanes/images/florence/hurricane-florence_00000364_post_disaster.png,49,55,1,107,156,733,788,569,49.535996140656636,15.230211612458069
19316,/media/marda/TWOTB1/xBD/hurricanes/images/florence/hurricane-florence_00000364_post_disaster.png,36,76,1,74,110,736,812,697,55.2374587711766,16.829329262120613
19317,/media/marda/TWOTB1/xBD/hurricanes/images/florence/hurricane-florence_00000364_post_disaster.png,35,65,1,337,372,743,808,415,39.91397305010826,14.605918847704018
19318,/media/marda/TWOTB1/xBD/hurricanes/images/florence/hurricane-florence_00000364_post_disaster.png,46,65,1,188,234,748,813,735,39.70207913937586,31.03022672786236
19319,/media/marda/TWOTB1/xBD/hurricanes/images/florence/hurricane-florence_00000364_post_disaster.png,31,57,1,302,333,757,814,335,28.872061015388034,15.787748804212365
19320,/media/marda/TWOTB1/xBD/hurricanes/images/florence/hurricane-florence_00000364_post_disaster.png,36,58,1,0,36,762,820,523,41.82339954990931,16.769893645476667
19321,/media/marda/TWOTB1/xBD/hurricanes/images/florence/hurricane-florence_00000364_post_disaster.png,48,55,1,115,163,765,820,534,48.58742101828442,14.702332798388017
19322,/media/marda/TWOTB1/xBD/hurricanes/images/florence/hurricane-florence_00000364_post_disaster.png,51,64,1,6,57,788,852,720,56.796646352053465,16.856894225000598
19323,/media/marda/TWOTB1/xBD/hurricanes/images/florence/hurricane-florence_00000364_post_disaster.png,54,62,1,128,182,794,856,630,57.22368762052267,14.736135244247622
19324,/media/marda/TWOTB1/xBD/hurricanes/images/florence/hurricane-florence_00000364_post_disaster.png,25,61,1,99,124,795,856,332,28.733936697037716,15.507274340140448
19325,/media/marda/TWOTB1/xBD/hurricanes/images/florence/hurricane-florence_00000364_post_disaster.png,29,58,1,218,247,798,856,290,23.271825973623887,16.931129974893278
19326,/media/marda/TWOTB1/xBD/hurricanes/images/florence/hurricane-florence_00000364_post_disaster.png,45,66,1,147,192,830,896,677,41.176867769672064,29.15306639849121
19327,/media/marda/TWOTB1/xBD/hurricanes/images/florence/hurricane-florence_00000364_post_disaster.png,25,60,1,197,222,830,890,338,27.300604575948398,16.465801907203794
19328,/media/marda/TWOTB1/xBD/hurricanes/images/florence/hurricane-florence_00000364_post_disaster.png,26,54,1,7,33,832,886,316,26.79195952231467,15.78279725790351
19329,/media/marda/TWOTB1/xBD/hurricanes/images/florence/hurricane-florence_00000364_post_disaster.png,55,65,1,27,82,849,914,803,61.58716555329641,17.25159101212408
19330,/media/marda/TWOTB1/xBD/hurricanes/images/florence/hurricane-florence_00000364_post_disaster.png,33,79,1,119,152,850,929,787,48.815096371693265,22.429355710880476
19331,/media/marda/TWOTB1/xBD/hurricanes/images/florence/hurricane-florence_00000364_post_disaster.png,52,62,1,40,92,881,943,738,56.23890319241538,18.820392562159757
19332,/media/marda/TWOTB1/xBD/hurricanes/images/florence/hurricane-florence_00000364_post_disaster.png,40,65,1,68,108,906,971,638,40.807064010317916,20.66138908816319
19333,/media/marda/TWOTB1/xBD/hurricanes/images/florence/hurricane-florence_00000364_post_disaster.png,25,68,1,135,160,939,1007,390,33.46159114295514,15.574291379554413
19334,/media/marda/TWOTB1/xBD/hurricanes/images/florence/hurricane-florence_00000364_post_disaster.png,23,70,1,111,134,947,1017,330,37.52432786901319,11.777635448878481
19335,/media/marda/TWOTB1/xBD/hurricanes/images/florence/hurricane-florence_00000364_post_disaster.png,22,59,1,86,108,965,1024,296,21.323722155780413,18.256589866926724
19336,/media/marda/TWOTB1/xBD/hurricanes/images/florence/hurricane-florence_00000364_post_disaster.png,37,71,1,29,66,970,1041,835,39.03768760047538,28.064799525547702
19337,/media/marda/TWOTB1/xBD/hurricanes/images/florence/hurricane-florence_00000364_post_disaster.png,231,135,1,167,398,227,362,15397,244.54773563327643,83.86794563738248
19338,/media/marda/TWOTB1/xBD/hurricanes/images/florence/hurricane-florence_00000531_pre_disaster.png,68,24,1,549,617,66,90,1041,52.27996865139066,26.42615017378995
19339,/media/marda/TWOTB1/xBD/hurricanes/images/florence/hurricane-florence_00000531_pre_disaster.png,66,58,1,170,236,90,148,3085,64.6700172067546,63.67619079568086
19340,/media/marda/TWOTB1/xBD/hurricanes/images/florence/hurricane-florence_00000338_pre_disaster.png,31,15,1,37,68,0,15,213,29.171149408705496,10.067430254018172
19341,/media/marda/TWOTB1/xBD/hurricanes/images/florence/hurricane-florence_00000338_pre_disaster.png,42,38,1,247,289,57,95,687,37.44178611905135,24.50668190854184
19342,/media/marda/TWOTB1/xBD/hurricanes/images/florence/hurricane-florence_00000338_pre_disaster.png,27,21,1,268,295,82,103,208,18.557974615086554,14.993966580164997
19343,/media/marda/TWOTB1/xBD/hurricanes/images/florence/hurricane-florence_00000338_pre_disaster.png,38,32,1,278,316,186,218,365,30.140513280316995,17.330888538031417
19344,/media/marda/TWOTB1/xBD/hurricanes/images/florence/hurricane-florence_00000338_pre_disaster.png,41,45,1,202,243,211,256,707,36.02232008524549,26.044385475164656
19345,/media/marda/TWOTB1/xBD/hurricanes/images/florence/hurricane-florence_00000338_pre_disaster.png,33,33,1,219,252,256,289,362,22.70083050514482,21.337168955565
19346,/media/marda/TWOTB1/xBD/hurricanes/images/florence/hurricane-florence_00000338_pre_disaster.png,30,24,1,221,251,281,305,164,23.53700991383491,9.381510199324143
19347,/media/marda/TWOTB1/xBD/hurricanes/images/florence/hurricane-florence_00000338_pre_disaster.png,19,21,1,234,253,306,327,56,10.540787825377707,7.169518540460145
19348,/media/marda/TWOTB1/xBD/hurricanes/images/florence/hurricane-florence_00000338_pre_disaster.png,51,69,1,177,228,384,453,1307,58.790363874034114,32.31411824663926
19349,/media/marda/TWOTB1/xBD/hurricanes/images/florence/hurricane-florence_00000338_pre_disaster.png,27,34,1,208,235,476,510,175,19.734663566603146,11.76681327842475
19350,/media/marda/TWOTB1/xBD/hurricanes/images/florence/hurricane-florence_00000338_pre_disaster.png,59,66,1,296,355,789,855,1041,45.89319830724484,30.79468234388902
19351,/media/marda/TWOTB1/xBD/hurricanes/images/florence/hurricane-florence_00000127_post_disaster.png,48,16,1,843,891,7,23,233,18.318402100595115,16.666273250805535
19352,/media/marda/TWOTB1/xBD/hurricanes/images/florence/hurricane-florence_00000127_post_disaster.png,54,24,1,906,960,15,39,332,26.632403471909022,17.10152678623183
19353,/media/marda/TWOTB1/xBD/hurricanes/images/florence/hurricane-florence_00000127_post_disaster.png,49,36,1,739,788,50,86,682,39.41380593683489,23.12215416025222
19354,/media/marda/TWOTB1/xBD/hurricanes/images/florence/hurricane-florence_00000127_post_disaster.png,58,44,1,48,106,130,174,1055,58.15512632051947,24.21726046857077
19355,/media/marda/TWOTB1/xBD/hurricanes/images/florence/hurricane-florence_00000047_pre_disaster.png,73,49,1,317,390,245,294,1343,68.38273252505742,30.857876703984765
19356,/media/marda/TWOTB1/xBD/hurricanes/images/florence/hurricane-florence_00000047_pre_disaster.png,53,17,1,493,546,286,303,295,37.849334618218386,10.295469586590405
19357,/media/marda/TWOTB1/xBD/hurricanes/images/florence/hurricane-florence_00000047_pre_disaster.png,68,47,1,633,701,488,535,1152,47.00012995351657,32.06617916098672
19358,/media/marda/TWOTB1/xBD/hurricanes/images/florence/hurricane-florence_00000047_pre_disaster.png,55,52,1,695,750,491,543,860,38.698939973202386,29.479973595982287
19359,/media/marda/TWOTB1/xBD/hurricanes/images/florence/hurricane-florence_00000047_pre_disaster.png,87,47,1,826,913,498,545,1248,58.40906362762575,27.882383111061156
19360,/media/marda/TWOTB1/xBD/hurricanes/images/florence/hurricane-florence_00000047_pre_disaster.png,39,48,1,392,431,509,557,568,30.92204516567259,24.305599262386146
19361,/media/marda/TWOTB1/xBD/hurricanes/images/florence/hurricane-florence_00000047_pre_disaster.png,37,56,1,353,390,512,568,812,40.52317580566768,26.524469145835813
19362,/media/marda/TWOTB1/xBD/hurricanes/images/florence/hurricane-florence_00000047_pre_disaster.png,40,34,1,681,721,514,548,169,15.500708080604841,14.465654717216296
19363,/media/marda/TWOTB1/xBD/hurricanes/images/florence/hurricane-florence_00000047_pre_disaster.png,44,36,1,674,718,537,573,269,20.708094966011497,17.249911814150508
19364,/media/marda/TWOTB1/xBD/hurricanes/images/florence/hurricane-florence_00000047_pre_disaster.png,49,32,1,824,873,572,604,191,18.51907157556056,13.443604789278558
19365,/media/marda/TWOTB1/xBD/hurricanes/images/florence/hurricane-florence_00000047_pre_disaster.png,61,40,1,432,493,574,614,502,49.5384678274886,13.479193363929577
19366,/media/marda/TWOTB1/xBD/hurricanes/images/florence/hurricane-florence_00000047_pre_disaster.png,39,39,1,413,452,642,681,337,25.966515307470896,17.274319947490245
19367,/media/marda/TWOTB1/xBD/hurricanes/images/florence/hurricane-florence_00000047_pre_disaster.png,57,87,1,347,404,646,733,1923,64.59122160497623,40.59001789021522
19368,/media/marda/TWOTB1/xBD/hurricanes/images/florence/hurricane-florence_00000047_pre_disaster.png,58,63,1,410,468,658,721,1618,47.97008109893148,44.96136586073763
19369,/media/marda/TWOTB1/xBD/hurricanes/images/florence/hurricane-florence_00000047_pre_disaster.png,46,59,1,46,92,703,762,1049,46.98802957700125,29.493630725324845
19370,/media/marda/TWOTB1/xBD/hurricanes/images/florence/hurricane-florence_00000047_pre_disaster.png,35,47,1,69,104,759,806,468,35.74406524642073,17.734708421399542
19371,/media/marda/TWOTB1/xBD/hurricanes/images/florence/hurricane-florence_00000047_pre_disaster.png,18,39,1,84,102,792,831,109,18.063773437049026,7.884523231447616
19372,/media/marda/TWOTB1/xBD/hurricanes/images/florence/hurricane-florence_00000047_pre_disaster.png,125,144,1,919,1044,870,1014,8575,120.485351570761,95.01303217582938
19373,/media/marda/TWOTB1/xBD/hurricanes/images/florence/hurricane-florence_00000047_pre_disaster.png,58,52,1,191,249,943,995,377,60.81145930693048,10.212335551956974
19374,/media/marda/TWOTB1/xBD/hurricanes/images/florence/hurricane-florence_00000047_pre_disaster.png,41,81,1,171,212,961,1042,1310,52.819135322748245,34.60836610358452
19375,/media/marda/TWOTB1/xBD/hurricanes/images/florence/hurricane-florence_00000047_pre_disaster.png,80,60,1,950,1030,984,1044,656,46.510321375250214,19.11012575116438
19376,/media/marda/TWOTB1/xBD/hurricanes/images/florence/hurricane-florence_00000252_pre_disaster.png,69,62,1,856,925,393,455,1021,47.44594011140919,28.476467866623207
19377,/media/marda/TWOTB1/xBD/hurricanes/images/florence/hurricane-florence_00000213_post_disaster.png,69,40,1,424,493,273,313,1218,57.20911924070867,28.838539442039462
19378,/media/marda/TWOTB1/xBD/hurricanes/images/florence/hurricane-florence_00000213_post_disaster.png,62,43,1,301,363,291,334,1434,55.262408221135225,34.544515808157776
19379,/media/marda/TWOTB1/xBD/hurricanes/images/florence/hurricane-florence_00000213_post_disaster.png,40,25,1,713,753,412,437,83,13.58322661295089,8.25511038743634
19380,/media/marda/TWOTB1/xBD/hurricanes/images/florence/hurricane-florence_00000213_post_disaster.png,93,52,1,767,860,419,471,1808,70.76427257751955,34.04052594568855
19381,/media/marda/TWOTB1/xBD/hurricanes/images/florence/hurricane-florence_00000213_post_disaster.png,103,55,1,588,691,420,475,2145,88.91974235469597,33.21996474829418
19382,/media/marda/TWOTB1/xBD/hurricanes/images/florence/hurricane-florence_00000213_post_disaster.png,50,46,1,403,453,423,469,749,37.04375805321699,27.80606457969486
19383,/media/marda/TWOTB1/xBD/hurricanes/images/florence/hurricane-florence_00000213_post_disaster.png,74,49,1,496,570,429,478,1420,60.084834278467476,31.34708427123569
19384,/media/marda/TWOTB1/xBD/hurricanes/images/florence/hurricane-florence_00000213_post_disaster.png,59,46,1,288,347,433,479,910,52.652706366208754,23.273768760945263
19385,/media/marda/TWOTB1/xBD/hurricanes/images/florence/hurricane-florence_00000213_post_disaster.png,80,95,1,883,963,920,1015,2086,64.49862418999419,45.453628493826564
19386,/media/marda/TWOTB1/xBD/hurricanes/images/florence/hurricane-florence_00000213_post_disaster.png,87,92,1,871,958,771,863,2445,68.58870507879392,48.83678217681216
19387,/media/marda/TWOTB1/xBD/hurricanes/images/florence/hurricane-florence_00000278_pre_disaster.png,75,15,1,857,932,0,15,315,36.91614308059958,13.10603278441741
19388,/media/marda/TWOTB1/xBD/hurricanes/images/florence/hurricane-florence_00000278_pre_disaster.png,71,33,1,796,867,26,59,741,38.94076081407525,25.251973184065086
19389,/media/marda/TWOTB1/xBD/hurricanes/images/florence/hurricane-florence_00000278_pre_disaster.png,42,13,1,761,803,33,46,105,13.560827634255936,10.187903954228096
19390,/media/marda/TWOTB1/xBD/hurricanes/images/florence/hurricane-florence_00000278_pre_disaster.png,39,11,1,716,755,37,48,64,11.29914813027723,7.693414490982049
19391,/media/marda/TWOTB1/xBD/hurricanes/images/florence/hurricane-florence_00000278_pre_disaster.png,75,38,1,725,800,56,94,1010,45.517137252394505,29.336017270890018
19392,/media/marda/TWOTB1/xBD/hurricanes/images/florence/hurricane-florence_00000278_pre_disaster.png,80,42,1,650,730,89,131,1137,54.418863938299516,27.801466608694003
19393,/media/marda/TWOTB1/xBD/hurricanes/images/florence/hurricane-florence_00000278_pre_disaster.png,67,38,1,977,1044,104,142,609,32.466893447771426,25.424166076497244
19394,/media/marda/TWOTB1/xBD/hurricanes/images/florence/hurricane-florence_00000278_pre_disaster.png,75,46,1,581,656,121,167,1132,53.25499968532685,28.369847270954583
19395,/media/marda/TWOTB1/xBD/hurricanes/images/florence/hurricane-florence_00000278_pre_disaster.png,28,17,1,449,477,162,179,88,11.51333197879576,10.312724065693304
19396,/media/marda/TWOTB1/xBD/hurricanes/images/florence/hurricane-florence_00000278_pre_disaster.png,58,37,1,512,570,164,201,750,34.33653020253455,28.59570003971828
19397,/media/marda/TWOTB1/xBD/hurricanes/images/florence/hurricane-florence_00000278_pre_disaster.png,85,66,1,839,924,166,232,1314,66.59402850738584,34.414718530720755
19398,/media/marda/TWOTB1/xBD/hurricanes/images/florence/hurricane-florence_00000278_pre_disaster.png,77,43,1,761,838,195,238,950,48.22247215560462,26.176835845468545
19399,/media/marda/TWOTB1/xBD/hurricanes/images/florence/hurricane-florence_00000278_pre_disaster.png,64,43,1,440,504,196,239,941,49.08629359682577,25.593270464766036
19400,/media/marda/TWOTB1/xBD/hurricanes/images/florence/hurricane-florence_00000278_pre_disaster.png,71,47,1,692,763,223,270,1012,42.90041531266107,32.447696310853395
19401,/media/marda/TWOTB1/xBD/hurricanes/images/florence/hurricane-florence_00000278_pre_disaster.png,62,48,1,369,431,227,275,1018,47.071500627252526,28.63653737480069
19402,/media/marda/TWOTB1/xBD/hurricanes/images/florence/hurricane-florence_00000278_pre_disaster.png,49,26,1,810,859,237,263,221,17.74209853079069,16.56912582956142
19403,/media/marda/TWOTB1/xBD/hurricanes/images/florence/hurricane-florence_00000278_pre_disaster.png,63,50,1,290,353,264,314,1123,54.82025423780547,27.34558456983233
19404,/media/marda/TWOTB1/xBD/hurricanes/images/florence/hurricane-florence_00000278_pre_disaster.png,67,41,1,628,695,265,306,737,42.45084556173918,23.150746195449592
19405,/media/marda/TWOTB1/xBD/hurricanes/images/florence/hurricane-florence_00000278_pre_disaster.png,45,33,1,577,622,266,299,322,22.76786697563335,18.90254045834747
19406,/media/marda/TWOTB1/xBD/hurricanes/images/florence/hurricane-florence_00000278_pre_disaster.png,53,24,1,722,775,276,300,322,28.24201118964423,15.071006130453139
19407,/media/marda/TWOTB1/xBD/hurricanes/images/florence/hurricane-florence_00000278_pre_disaster.png,75,48,1,542,617,294,342,1126,53.92449248966748,28.128647622302104
19408,/media/marda/TWOTB1/xBD/hurricanes/images/florence/hurricane-florence_00000278_pre_disaster.png,62,46,1,458,520,338,384,761,47.85983855981262,21.13162404479329
19409,/media/marda/TWOTB1/xBD/hurricanes/images/florence/hurricane-florence_00000278_pre_disaster.png,45,58,1,160,205,354,412,1134,43.60954079863284,35.13815761021312
19410,/media/marda/TWOTB1/xBD/hurricanes/images/florence/hurricane-florence_00000278_pre_disaster.png,40,37,1,472,512,371,408,315,22.364151328714314,18.84046450311946
19411,/media/marda/TWOTB1/xBD/hurricanes/images/florence/hurricane-florence_00000278_pre_disaster.png,53,47,1,396,449,391,438,770,38.94844800977286,26.157900071215018
19412,/media/marda/TWOTB1/xBD/hurricanes/images/florence/hurricane-florence_00000278_pre_disaster.png,66,71,1,227,293,474,545,1680,56.60395687893107,40.18060279734881
19413,/media/marda/TWOTB1/xBD/hurricanes/images/florence/hurricane-florence_00000278_pre_disaster.png,15,28,1,180,195,482,510,68,10.792637325581355,8.534883659080485
19414,/media/marda/TWOTB1/xBD/hurricanes/images/florence/hurricane-florence_00000278_pre_disaster.png,47,56,1,296,343,494,550,669,31.831255894344125,28.064515507122113
19415,/media/marda/TWOTB1/xBD/hurricanes/images/florence/hurricane-florence_00000278_pre_disaster.png,21,49,1,184,205,952,1001,127,15.509057089349156,10.990540607494156
19416,/media/marda/TWOTB1/xBD/hurricanes/images/florence/hurricane-florence_00000245_post_disaster.png,33,27,1,41,74,258,285,524,37.71805348779121,18.598193862929477
19417,/media/marda/TWOTB1/xBD/hurricanes/images/florence/hurricane-florence_00000245_post_disaster.png,22,10,1,33,55,0,10,115,19.035980008048796,9.24784193447725
19418,/media/marda/TWOTB1/xBD/hurricanes/images/florence/hurricane-florence_00000245_post_disaster.png,134,82,1,536,670,104,186,3327,128.2321484943163,34.643982822057446
19419,/media/marda/TWOTB1/xBD/hurricanes/images/florence/hurricane-florence_00000245_post_disaster.png,18,64,1,0,18,202,266,613,55.98859928302842,16.837961765264996
19420,/media/marda/TWOTB1/xBD/hurricanes/images/florence/hurricane-florence_00000133_post_disaster.png,79,70,1,964,1043,604,674,597,58.60582566638009,13.585246145933741
19421,/media/marda/TWOTB1/xBD/hurricanes/images/florence/hurricane-florence_00000460_post_disaster.png,10,42,1,0,10,478,520,201,26.957440907132924,10.085016493768192
19422,/media/marda/TWOTB1/xBD/hurricanes/images/florence/hurricane-florence_00000460_post_disaster.png,44,82,1,0,44,556,638,1739,67.36893864342481,38.36085060976235
19423,/media/marda/TWOTB1/xBD/hurricanes/images/florence/hurricane-florence_00000460_post_disaster.png,64,79,1,199,263,845,924,1891,58.70488232739604,43.312845464248916
19424,/media/marda/TWOTB1/xBD/hurricanes/images/florence/hurricane-florence_00000460_post_disaster.png,74,74,1,566,640,309,383,1998,62.39107464360928,44.70455543471719
19425,/media/marda/TWOTB1/xBD/hurricanes/images/florence/hurricane-florence_00000460_post_disaster.png,95,82,1,650,745,526,608,2143,64.12483427442436,47.39368641162775
19426,/media/marda/TWOTB1/xBD/hurricanes/images/florence/hurricane-florence_00000460_post_disaster.png,96,75,1,896,992,526,601,2046,67.08195695584094,45.573831194489394
19427,/media/marda/TWOTB1/xBD/hurricanes/images/florence/hurricane-florence_00000460_post_disaster.png,94,89,1,737,831,688,777,2056,59.416274026410996,45.96833234813256
19428,/media/marda/TWOTB1/xBD/hurricanes/images/florence/hurricane-florence_00000460_post_disaster.png,77,80,1,682,759,822,902,1559,47.825487278236366,45.67449807426
19429,/media/marda/TWOTB1/xBD/hurricanes/images/florence/hurricane-florence_00000460_post_disaster.png,79,85,1,609,688,956,1041,1618,57.72839547101224,41.9061555233289
19430,/media/marda/TWOTB1/xBD/hurricanes/images/florence/hurricane-florence_00000001_post_disaster.png,60,46,1,984,1044,103,149,722,45.343627573008234,21.25558838577783
19431,/media/marda/TWOTB1/xBD/hurricanes/images/florence/hurricane-florence_00000001_post_disaster.png,72,51,1,806,878,113,164,1284,46.312139584674235,36.94259329602633
19432,/media/marda/TWOTB1/xBD/hurricanes/images/florence/hurricane-florence_00000001_post_disaster.png,69,38,1,771,840,139,177,844,38.56638080101359,29.385304361040472
19433,/media/marda/TWOTB1/xBD/hurricanes/images/florence/hurricane-florence_00000001_post_disaster.png,71,39,1,731,802,156,195,921,41.095859628510276,29.376293869312416
19434,/media/marda/TWOTB1/xBD/hurricanes/images/florence/hurricane-florence_00000001_post_disaster.png,78,57,1,686,764,167,224,1429,49.88457644247281,38.11239771736745
19435,/media/marda/TWOTB1/xBD/hurricanes/images/florence/hurricane-florence_00000001_post_disaster.png,69,49,1,659,728,198,247,1007,39.52667026110765,33.25094365702427
19436,/media/marda/TWOTB1/xBD/hurricanes/images/florence/hurricane-florence_00000001_post_disaster.png,71,54,1,879,950,207,261,1350,47.81884803883908,37.60651220423249
19437,/media/marda/TWOTB1/xBD/hurricanes/images/florence/hurricane-florence_00000001_post_disaster.png,75,58,1,621,696,222,280,1342,52.0796004865903,33.99677220566249
19438,/media/marda/TWOTB1/xBD/hurricanes/images/florence/hurricane-florence_00000001_post_disaster.png,77,60,1,786,863,233,293,1290,51.60338817073421,33.21075975374659
19439,/media/marda/TWOTB1/xBD/hurricanes/images/florence/hurricane-florence_00000001_post_disaster.png,78,58,1,747,825,255,313,1269,48.04297336564106,35.091379949339775
19440,/media/marda/TWOTB1/xBD/hurricanes/images/florence/hurricane-florence_00000001_post_disaster.png,68,48,1,601,669,263,311,1005,39.54713792006741,33.202526767096295
19441,/media/marda/TWOTB1/xBD/hurricanes/images/florence/hurricane-florence_00000001_post_disaster.png,74,54,1,710,784,284,338,1112,43.842896930550204,33.58842400517346
19442,/media/marda/TWOTB1/xBD/hurricanes/images/florence/hurricane-florence_00000001_post_disaster.png,74,54,1,567,641,293,347,1264,50.193681380335654,33.46041641788633
19443,/media/marda/TWOTB1/xBD/hurricanes/images/florence/hurricane-florence_00000001_post_disaster.png,78,61,1,681,759,316,377,1310,51.32100262767274,33.963794417159015
19444,/media/marda/TWOTB1/xBD/hurricanes/images/florence/hurricane-florence_00000001_post_disaster.png,73,58,1,548,621,327,385,1249,49.19680981429341,33.67160494647078
19445,/media/marda/TWOTB1/xBD/hurricanes/images/florence/hurricane-florence_00000001_post_disaster.png,74,59,1,525,599,363,422,1338,52.978302000588585,33.8863824822682
19446,/media/marda/TWOTB1/xBD/hurricanes/images/florence/hurricane-florence_00000001_post_disaster.png,82,61,1,808,890,376,437,1332,48.06763070500219,36.78705309503813
19447,/media/marda/TWOTB1/xBD/hurricanes/images/florence/hurricane-florence_00000001_post_disaster.png,70,55,1,635,705,389,444,1087,43.36962904673118,33.19829037291322
19448,/media/marda/TWOTB1/xBD/hurricanes/images/florence/hurricane-florence_00000001_post_disaster.png,71,61,1,505,576,401,462,1196,49.86197508034542,31.886438013888355
19449,/media/marda/TWOTB1/xBD/hurricanes/images/florence/hurricane-florence_00000001_post_disaster.png,77,59,1,613,690,424,483,1255,48.08821909799953,34.775344173330794
19450,/media/marda/TWOTB1/xBD/hurricanes/images/florence/hurricane-florence_00000001_post_disaster.png,71,62,1,484,555,438,500,1260,51.12409546495687,32.781334365675775
19451,/media/marda/TWOTB1/xBD/hurricanes/images/florence/hurricane-florence_00000001_post_disaster.png,83,58,1,926,1009,459,517,1095,44.620272357955116,32.512809319694355
19452,/media/marda/TWOTB1/xBD/hurricanes/images/florence/hurricane-florence_00000001_post_disaster.png,64,56,1,598,662,461,517,1031,38.15926552949902,35.6567547149585
19453,/media/marda/TWOTB1/xBD/hurricanes/images/florence/hurricane-florence_00000001_post_disaster.png,74,61,1,759,833,463,524,1175,42.84505291953218,36.058879630596415
19454,/media/marda/TWOTB1/xBD/hurricanes/images/florence/hurricane-florence_00000001_post_disaster.png,65,58,1,470,535,480,538,1115,44.653103026803514,32.989878780560126
19455,/media/marda/TWOTB1/xBD/hurricanes/images/florence/hurricane-florence_00000001_post_disaster.png,19,37,1,22,41,493,530,143,19.80990534720525,9.689105510455411
19456,/media/marda/TWOTB1/xBD/hurricanes/images/florence/hurricane-florence_00000001_post_disaster.png,14,32,1,12,26,497,529,74,14.54126123882041,6.866743031488298
19457,/media/marda/TWOTB1/xBD/hurricanes/images/florence/hurricane-florence_00000001_post_disaster.png,75,64,1,573,648,497,561,1251,50.77408521055102,32.720380411460184
19458,/media/marda/TWOTB1/xBD/hurricanes/images/florence/hurricane-florence_00000001_post_disaster.png,65,59,1,452,517,517,576,1037,41.55844098263767,32.90079515326114
19459,/media/marda/TWOTB1/xBD/hurricanes/images/florence/hurricane-florence_00000001_post_disaster.png,76,69,1,551,627,534,603,1448,52.222217777467115,36.83093272502918
19460,/media/marda/TWOTB1/xBD/hurricanes/images/florence/hurricane-florence_00000001_post_disaster.png,68,65,1,423,491,550,615,1286,52.63011760464589,32.1541585215451
19461,/media/marda/TWOTB1/xBD/hurricanes/images/florence/hurricane-florence_00000001_post_disaster.png,89,64,1,861,950,563,627,1234,54.26503286170107,30.1611789599775
19462,/media/marda/TWOTB1/xBD/hurricanes/images/florence/hurricane-florence_00000001_post_disaster.png,70,66,1,530,600,567,633,1263,43.43603579720922,39.08086167673806
19463,/media/marda/TWOTB1/xBD/hurricanes/images/florence/hurricane-florence_00000001_post_disaster.png,22,45,1,40,62,573,618,481,26.46393860457362,24.19667650382442
19464,/media/marda/TWOTB1/xBD/hurricanes/images/florence/hurricane-florence_00000001_post_disaster.png,9,33,1,68,77,584,617,110,15.024582512451678,9.737756610103043
19465,/media/marda/TWOTB1/xBD/hurricanes/images/florence/hurricane-florence_00000001_post_disaster.png,72,74,1,589,661,584,658,1434,51.54097354448229,37.01038597194319
19466,/media/marda/TWOTB1/xBD/hurricanes/images/florence/hurricane-florence_00000001_post_disaster.png,72,62,1,972,1044,585,647,858,39.461485120902374,29.487899396630336
19467,/media/marda/TWOTB1/xBD/hurricanes/images/florence/hurricane-florence_00000001_post_disaster.png,63,62,1,409,472,590,652,1034,42.6465802616675,31.812798487322645
19468,/media/marda/TWOTB1/xBD/hurricanes/images/florence/hurricane-florence_00000001_post_disaster.png,31,64,1,0,31,597,661,681,33.778399852842725,30.77027661417192
19469,/media/marda/TWOTB1/xBD/hurricanes/images/florence/hurricane-florence_00000001_post_disaster.png,71,74,1,628,699,605,679,1256,48.17278394975758,34.663007793577826
19470,/media/marda/TWOTB1/xBD/hurricanes/images/florence/hurricane-florence_00000001_post_disaster.png,81,65,1,950,1031,618,683,1069,38.84849775010978,35.96353550114518
19471,/media/marda/TWOTB1/xBD/hurricanes/images/florence/hurricane-florence_00000001_post_disaster.png,67,71,1,381,448,622,693,1341,49.8677002446418,35.52844926772738
19472,/media/marda/TWOTB1/xBD/hurricanes/images/florence/hurricane-florence_00000001_post_disaster.png,76,78,1,665,741,622,700,1476,55.98082016329684,34.73914059735881
19473,/media/marda/TWOTB1/xBD/hurricanes/images/florence/hurricane-florence_00000001_post_disaster.png,88,70,1,816,904,634,704,1398,56.50523582377729,32.67677866577762
19474,/media/marda/TWOTB1/xBD/hurricanes/images/florence/hurricane-florence_00000001_post_disaster.png,75,73,1,490,565,641,714,1472,50.09231734619153,39.05581175454184
19475,/media/marda/TWOTB1/xBD/hurricanes/images/florence/hurricane-florence_00000001_post_disaster.png,77,77,1,699,776,645,722,1411,50.677945683455796,37.02649801329309
19476,/media/marda/TWOTB1/xBD/hurricanes/images/florence/hurricane-florence_00000001_post_disaster.png,70,72,1,359,429,659,731,1445,53.09738560741859,36.16762148515797
19477,/media/marda/TWOTB1/xBD/hurricanes/images/florence/hurricane-florence_00000001_post_disaster.png,87,70,1,795,882,673,743,1330,53.31162960127761,33.147952433503505
19478,/media/marda/TWOTB1/xBD/hurricanes/images/florence/hurricane-florence_00000001_post_disaster.png,72,68,1,738,810,675,743,1056,39.618917798788516,35.425378709011675
19479,/media/marda/TWOTB1/xBD/hurricanes/images/florence/hurricane-florence_00000001_post_disaster.png,62,64,1,544,606,679,743,971,41.824133338635754,31.054947933462277
19480,/media/marda/TWOTB1/xBD/hurricanes/images/florence/hurricane-florence_00000001_post_disaster.png,73,82,1,575,648,697,779,1534,56.80242092761635,35.670400427771526
19481,/media/marda/TWOTB1/xBD/hurricanes/images/florence/hurricane-florence_00000001_post_disaster.png,56,71,1,342,398,700,771,1166,42.57770473103825,35.8211752316
19482,/media/marda/TWOTB1/xBD/hurricanes/images/florence/hurricane-florence_00000001_post_disaster.png,79,73,1,782,861,710,783,1305,48.678757304415726,35.689991370079
19483,/media/marda/TWOTB1/xBD/hurricanes/images/florence/hurricane-florence_00000001_post_disaster.png,57,68,1,455,512,715,783,954,38.066627240927026,32.89988947070898
19484,/media/marda/TWOTB1/xBD/hurricanes/images/florence/hurricane-florence_00000001_post_disaster.png,75,81,1,609,684,717,798,1426,51.58583020570574,36.80883704726112
19485,/media/marda/TWOTB1/xBD/hurricanes/images/florence/hurricane-florence_00000001_post_disaster.png,69,73,1,653,722,738,811,1148,42.47700468897511,35.340438123982
19486,/media/marda/TWOTB1/xBD/hurricanes/images/florence/hurricane-florence_00000001_post_disaster.png,66,76,1,234,300,748,824,1019,69.38331476093758,24.358698241138146
19487,/media/marda/TWOTB1/xBD/hurricanes/images/florence/hurricane-florence_00000001_post_disaster.png,90,78,1,869,959,756,834,1489,55.18108428484808,35.9035948448847
19488,/media/marda/TWOTB1/xBD/hurricanes/images/florence/hurricane-florence_00000001_post_disaster.png,30,55,1,171,201,758,813,358,22.344617724871355,21.39291018574608
19489,/media/marda/TWOTB1/xBD/hurricanes/images/florence/hurricane-florence_00000001_post_disaster.png,67,75,1,419,486,758,833,1212,47.3761082761306,34.05798891351002
19490,/media/marda/TWOTB1/xBD/hurricanes/images/florence/hurricane-florence_00000001_post_disaster.png,74,82,1,684,758,759,841,1474,55.5874423563947,34.79865842579039
19491,/media/marda/TWOTB1/xBD/hurricanes/images/florence/hurricane-florence_00000001_post_disaster.png,78,73,1,743,821,782,855,1225,46.95180660466916,34.57126543822887
19492,/media/marda/TWOTB1/xBD/hurricanes/images/florence/hurricane-florence_00000001_post_disaster.png,87,78,1,850,937,795,873,1286,51.13056189713047,33.44158242967378
19493,/media/marda/TWOTB1/xBD/hurricanes/images/florence/hurricane-florence_00000001_post_disaster.png,73,73,1,728,801,818,891,1124,40.46462179939151,36.26139453000947
19494,/media/marda/TWOTB1/xBD/hurricanes/images/florence/hurricane-florence_00000001_post_disaster.png,86,80,1,828,914,831,911,1393,54.3646695841432,34.05879449547254
19495,/media/marda/TWOTB1/xBD/hurricanes/images/florence/hurricane-florence_00000001_post_disaster.png,54,46,1,987,1041,837,883,112,13.119195526608195,11.514973595188515
19496,/media/marda/TWOTB1/xBD/hurricanes/images/florence/hurricane-florence_00000001_post_disaster.png,83,81,1,694,777,849,930,1455,51.27960011478597,37.655132132963246
19497,/media/marda/TWOTB1/xBD/hurricanes/images/florence/hurricane-florence_00000001_post_disaster.png,69,83,1,408,477,851,934,1413,54.54970278644436,34.29270713081739
19498,/media/marda/TWOTB1/xBD/hurricanes/images/florence/hurricane-florence_00000001_post_disaster.png,87,77,1,809,896,871,948,1364,53.310729054358426,33.83307092030147
19499,/media/marda/TWOTB1/xBD/hurricanes/images/florence/hurricane-florence_00000001_post_disaster.png,60,78,1,440,500,886,964,989,39.54961568313199,33.12281769730176
19500,/media/marda/TWOTB1/xBD/hurricanes/images/florence/hurricane-florence_00000001_post_disaster.png,73,79,1,682,755,891,970,1203,48.1896180752868,32.78190717088697
19501,/media/marda/TWOTB1/xBD/hurricanes/images/florence/hurricane-florence_00000001_post_disaster.png,56,83,1,301,357,892,975,1125,47.47643667749687,31.320987126533385
19502,/media/marda/TWOTB1/xBD/hurricanes/images/florence/hurricane-florence_00000001_post_disaster.png,83,85,1,786,869,901,986,1284,49.54266412492385,35.3404960321655
19503,/media/marda/TWOTB1/xBD/hurricanes/images/florence/hurricane-florence_00000001_post_disaster.png,56,69,1,486,542,911,980,829,37.22862127659457,29.689506066596454
19504,/media/marda/TWOTB1/xBD/hurricanes/images/florence/hurricane-florence_00000001_post_disaster.png,63,87,1,520,583,914,1001,1324,52.727998881433,33.510176341325035
19505,/media/marda/TWOTB1/xBD/hurricanes/images/florence/hurricane-florence_00000001_post_disaster.png,60,84,1,327,387,922,1006,1250,49.52614362766875,33.36941770800813
19506,/media/marda/TWOTB1/xBD/hurricanes/images/florence/hurricane-florence_00000001_post_disaster.png,80,84,1,657,737,924,1008,1552,55.35551547193036,36.867620099920956
19507,/media/marda/TWOTB1/xBD/hurricanes/images/florence/hurricane-florence_00000001_post_disaster.png,67,90,1,559,626,925,1015,1493,52.75121873460554,37.4287526593573
19508,/media/marda/TWOTB1/xBD/hurricanes/images/florence/hurricane-florence_00000001_post_disaster.png,82,80,1,860,942,933,1013,1131,47.57294007100581,35.5716947053231
19509,/media/marda/TWOTB1/xBD/hurricanes/images/florence/hurricane-florence_00000001_post_disaster.png,77,81,1,770,847,941,1022,1176,47.97178676505303,32.388546592573235
19510,/media/marda/TWOTB1/xBD/hurricanes/images/florence/hurricane-florence_00000001_post_disaster.png,31,80,1,85,116,943,1023,762,43.806725558567834,23.918681352802842
19511,/media/marda/TWOTB1/xBD/hurricanes/images/florence/hurricane-florence_00000001_post_disaster.png,57,82,1,366,423,950,1032,1012,50.188648821136944,26.34569578316429
19512,/media/marda/TWOTB1/xBD/hurricanes/images/florence/hurricane-florence_00000001_post_disaster.png,65,72,1,596,661,953,1025,982,38.67374670456179,33.17271950637206
19513,/media/marda/TWOTB1/xBD/hurricanes/images/florence/hurricane-florence_00000001_post_disaster.png,72,75,1,642,714,966,1041,1150,47.346122033509396,31.761693651103123
19514,/media/marda/TWOTB1/xBD/hurricanes/images/florence/hurricane-florence_00000001_post_disaster.png,62,65,1,396,458,976,1041,786,40.5910617807604,26.64318578289703
19515,/media/marda/TWOTB1/xBD/hurricanes/images/florence/hurricane-florence_00000001_post_disaster.png,67,62,1,753,820,979,1041,610,34.13036544450155,24.284281206611645
19516,/media/marda/TWOTB1/xBD/hurricanes/images/florence/hurricane-florence_00000001_post_disaster.png,77,70,1,826,903,506,576,1179,48.34924774461607,32.483463189460814
19517,/media/marda/TWOTB1/xBD/hurricanes/images/florence/hurricane-florence_00000001_post_disaster.png,74,95,1,936,1010,855,950,1271,62.60589515475908,29.89503926779416
19518,/media/marda/TWOTB1/xBD/hurricanes/images/florence/hurricane-florence_00000201_post_disaster.png,394,32,1,585,979,0,32,5903,348.35955417648836,25.921212692052038
19519,/media/marda/TWOTB1/xBD/hurricanes/images/florence/hurricane-florence_00000201_post_disaster.png,64,69,1,296,360,436,505,1304,55.320839080705156,31.27834358960059
19520,/media/marda/TWOTB1/xBD/hurricanes/images/florence/hurricane-florence_00000201_post_disaster.png,42,35,1,729,771,597,632,86,13.522931050866847,8.600312887581262
19521,/media/marda/TWOTB1/xBD/hurricanes/images/florence/hurricane-florence_00000201_post_disaster.png,62,85,1,733,795,611,696,671,70.01183085074297,12.812480350916756
19522,/media/marda/TWOTB1/xBD/hurricanes/images/florence/hurricane-florence_00000201_post_disaster.png,65,83,1,795,860,696,779,1051,58.87299168611858,23.818281349097898
19523,/media/marda/TWOTB1/xBD/hurricanes/images/florence/hurricane-florence_00000201_post_disaster.png,58,86,1,619,677,700,786,986,62.581511592235145,20.975657858687352
19524,/media/marda/TWOTB1/xBD/hurricanes/images/florence/hurricane-florence_00000201_post_disaster.png,66,78,1,786,852,808,886,918,47.8574427986904,25.441017996487602
19525,/media/marda/TWOTB1/xBD/hurricanes/images/florence/hurricane-florence_00000201_post_disaster.png,59,78,1,660,719,834,912,851,49.01393954515328,23.011648394385922
19526,/media/marda/TWOTB1/xBD/hurricanes/images/florence/hurricane-florence_00000201_post_disaster.png,61,82,1,853,914,931,1013,931,49.231889378190125,25.157872755162657
19527,/media/marda/TWOTB1/xBD/hurricanes/images/florence/hurricane-florence_00000460_pre_disaster.png,74,74,1,566,640,309,383,1998,62.39107464360928,44.70455543471719
19528,/media/marda/TWOTB1/xBD/hurricanes/images/florence/hurricane-florence_00000460_pre_disaster.png,10,42,1,0,10,478,520,201,26.957440907132924,10.085016493768192
19529,/media/marda/TWOTB1/xBD/hurricanes/images/florence/hurricane-florence_00000460_pre_disaster.png,95,82,1,650,745,526,608,2143,64.12483427442436,47.39368641162775
19530,/media/marda/TWOTB1/xBD/hurricanes/images/florence/hurricane-florence_00000460_pre_disaster.png,96,75,1,896,992,526,601,2046,67.08195695584094,45.573831194489394
19531,/media/marda/TWOTB1/xBD/hurricanes/images/florence/hurricane-florence_00000460_pre_disaster.png,44,82,1,0,44,556,638,1739,67.36893864342481,38.36085060976235
19532,/media/marda/TWOTB1/xBD/hurricanes/images/florence/hurricane-florence_00000460_pre_disaster.png,94,89,1,737,831,688,777,2056,59.416274026410996,45.96833234813256
19533,/media/marda/TWOTB1/xBD/hurricanes/images/florence/hurricane-florence_00000460_pre_disaster.png,77,80,1,682,759,822,902,1559,47.825487278236366,45.67449807426
19534,/media/marda/TWOTB1/xBD/hurricanes/images/florence/hurricane-florence_00000460_pre_disaster.png,64,79,1,199,263,845,924,1891,58.70488232739604,43.312845464248916
19535,/media/marda/TWOTB1/xBD/hurricanes/images/florence/hurricane-florence_00000460_pre_disaster.png,79,86,1,609,688,956,1042,1666,57.93718198987963,42.84242792642717
19536,/media/marda/TWOTB1/xBD/hurricanes/images/florence/hurricane-florence_00000373_post_disaster.png,66,56,1,507,573,124,180,1090,53.119729551806834,27.377176485551175
19537,/media/marda/TWOTB1/xBD/hurricanes/images/florence/hurricane-florence_00000373_post_disaster.png,25,28,1,88,113,176,204,303,21.520771095435734,18.67627642749851
19538,/media/marda/TWOTB1/xBD/hurricanes/images/florence/hurricane-florence_00000373_post_disaster.png,37,24,1,320,357,191,215,248,24.669530721203216,13.30578094457587
19539,/media/marda/TWOTB1/xBD/hurricanes/images/florence/hurricane-florence_00000373_post_disaster.png,60,52,1,395,455,210,262,865,50.320301832353664,23.045167587692827
19540,/media/marda/TWOTB1/xBD/hurricanes/images/florence/hurricane-florence_00000373_post_disaster.png,53,48,1,320,373,218,266,884,35.28859100017574,33.20667063825773
19541,/media/marda/TWOTB1/xBD/hurricanes/images/florence/hurricane-florence_00000373_post_disaster.png,42,54,1,77,119,223,277,1018,40.05190363113902,33.58702563179832
19542,/media/marda/TWOTB1/xBD/hurricanes/images/florence/hurricane-florence_00000373_post_disaster.png,39,26,1,510,549,225,251,168,16.907764872732788,13.336710607199008
19543,/media/marda/TWOTB1/xBD/hurricanes/images/florence/hurricane-florence_00000373_post_disaster.png,37,28,1,416,453,275,303,210,17.366950087313707,16.198427228121698
19544,/media/marda/TWOTB1/xBD/hurricanes/images/florence/hurricane-florence_00000373_post_disaster.png,15,45,1,0,15,323,368,241,29.539636533688903,13.333383531998091
19545,/media/marda/TWOTB1/xBD/hurricanes/images/florence/hurricane-florence_00000373_post_disaster.png,62,66,1,352,414,385,451,1097,60.22076011057055,24.32114249295761
19546,/media/marda/TWOTB1/xBD/hurricanes/images/florence/hurricane-florence_00000373_post_disaster.png,39,32,1,540,579,386,418,202,19.254389524563454,13.952781455592541
19547,/media/marda/TWOTB1/xBD/hurricanes/images/florence/hurricane-florence_00000373_post_disaster.png,66,67,1,491,557,393,460,1118,51.769815790955306,28.815215271491756
19548,/media/marda/TWOTB1/xBD/hurricanes/images/florence/hurricane-florence_00000373_post_disaster.png,52,42,1,564,616,416,458,372,29.833203346666966,16.6615595032607
19549,/media/marda/TWOTB1/xBD/hurricanes/images/florence/hurricane-florence_00000373_post_disaster.png,40,34,1,589,629,430,464,168,15.276800921659687,14.735932215885752
19550,/media/marda/TWOTB1/xBD/hurricanes/images/florence/hurricane-florence_00000373_post_disaster.png,47,36,1,624,671,450,486,210,24.295616132118532,11.557277179697678
19551,/media/marda/TWOTB1/xBD/hurricanes/images/florence/hurricane-florence_00000373_post_disaster.png,32,33,1,379,411,462,495,158,16.046566156763653,13.146742124977502
19552,/media/marda/TWOTB1/xBD/hurricanes/images/florence/hurricane-florence_00000373_post_disaster.png,36,35,1,526,562,463,498,171,16.785473141892176,13.75196724629538
19553,/media/marda/TWOTB1/xBD/hurricanes/images/florence/hurricane-florence_00000373_post_disaster.png,47,50,1,393,440,468,518,448,39.486678493958294,16.71129510667329
19554,/media/marda/TWOTB1/xBD/hurricanes/images/florence/hurricane-florence_00000373_post_disaster.png,55,36,1,620,675,471,507,298,29.756011435585833,16.56237930074759
19555,/media/marda/TWOTB1/xBD/hurricanes/images/florence/hurricane-florence_00000373_post_disaster.png,29,30,1,424,453,479,509,104,12.539326161653484,11.130435803993498
19556,/media/marda/TWOTB1/xBD/hurricanes/images/florence/hurricane-florence_00000373_post_disaster.png,52,41,1,601,653,489,530,298,30.022176598217982,13.28541844399142
19557,/media/marda/TWOTB1/xBD/hurricanes/images/florence/hurricane-florence_00000373_post_disaster.png,39,38,1,619,658,538,576,150,15.151911657975196,13.156008166867835
19558,/media/marda/TWOTB1/xBD/hurricanes/images/florence/hurricane-florence_00000373_post_disaster.png,46,41,1,625,671,573,614,231,18.51283111994241,16.679387821444145
19559,/media/marda/TWOTB1/xBD/hurricanes/images/florence/hurricane-florence_00000100_post_disaster.png,32,42,1,337,369,5,47,417,37.200286095308485,17.37279387521968
19560,/media/marda/TWOTB1/xBD/hurricanes/images/florence/hurricane-florence_00000100_post_disaster.png,87,35,1,852,939,36,71,1241,56.98414541677371,28.90911048413736
19561,/media/marda/TWOTB1/xBD/hurricanes/images/florence/hurricane-florence_00000100_post_disaster.png,68,41,1,463,531,87,128,1000,54.17126961390739,24.472623652100577
19562,/media/marda/TWOTB1/xBD/hurricanes/images/florence/hurricane-florence_00000100_post_disaster.png,33,16,1,493,526,152,168,80,11.902230565043496,8.985371866347235
19563,/media/marda/TWOTB1/xBD/hurricanes/images/florence/hurricane-florence_00000100_post_disaster.png,26,15,1,479,505,188,203,55,9.121014408845921,8.207987761673005
19564,/media/marda/TWOTB1/xBD/hurricanes/images/florence/hurricane-florence_00000090_pre_disaster.png,53,62,1,725,778,570,632,668,37.640806372558345,24.581129073561637
19565,/media/marda/TWOTB1/xBD/hurricanes/images/florence/hurricane-florence_00000090_pre_disaster.png,72,75,1,582,654,755,830,1208,48.21159343182828,33.327686851168174
19566,/media/marda/TWOTB1/xBD/hurricanes/images/florence/hurricane-florence_00000090_pre_disaster.png,77,84,1,462,539,885,969,1443,52.41401615673607,37.80345191267937
19567,/media/marda/TWOTB1/xBD/hurricanes/images/florence/hurricane-florence_00000090_pre_disaster.png,68,81,1,399,467,940,1021,1195,44.08375748770758,36.33860380268759
19568,/media/marda/TWOTB1/xBD/hurricanes/images/florence/hurricane-florence_00000090_pre_disaster.png,56,68,1,345,401,974,1042,866,41.030944412824006,28.765279708966744
19569,/media/marda/TWOTB1/xBD/hurricanes/images/florence/hurricane-florence_00000141_post_disaster.png,43,40,1,420,463,73,113,757,40.18343105081443,24.90233846028779
19570,/media/marda/TWOTB1/xBD/hurricanes/images/florence/hurricane-florence_00000141_post_disaster.png,49,25,1,451,500,148,173,584,36.88656687419144,21.23052165813727
19571,/media/marda/TWOTB1/xBD/hurricanes/images/florence/hurricane-florence_00000141_post_disaster.png,43,61,1,444,487,216,277,1379,60.07729490881606,30.616034472887588
19572,/media/marda/TWOTB1/xBD/hurricanes/images/florence/hurricane-florence_00000141_post_disaster.png,57,47,1,555,612,484,531,853,36.81580479149665,31.051924396370918
19573,/media/marda/TWOTB1/xBD/hurricanes/images/florence/hurricane-florence_00000141_post_disaster.png,71,54,1,630,701,516,570,1192,50.25983197156285,31.753612726000753
19574,/media/marda/TWOTB1/xBD/hurricanes/images/florence/hurricane-florence_00000141_post_disaster.png,57,41,1,838,895,538,579,433,26.118935254618656,22.06059951141501
19575,/media/marda/TWOTB1/xBD/hurricanes/images/florence/hurricane-florence_00000141_post_disaster.png,41,79,1,377,418,757,836,915,54.69780307729841,22.33242076282757
19576,/media/marda/TWOTB1/xBD/hurricanes/images/florence/hurricane-florence_00000141_post_disaster.png,58,60,1,136,194,822,882,1257,57.16699836923655,29.03034753736428
19577,/media/marda/TWOTB1/xBD/hurricanes/images/florence/hurricane-florence_00000295_pre_disaster.png,32,35,1,218,250,421,456,425,27.245726082524932,20.601608812627873
19578,/media/marda/TWOTB1/xBD/hurricanes/images/florence/hurricane-florence_00000295_pre_disaster.png,31,40,1,137,168,444,484,636,30.664482834247902,27.62518322104718
19579,/media/marda/TWOTB1/xBD/hurricanes/images/florence/hurricane-florence_00000295_pre_disaster.png,47,51,1,555,602,591,642,398,25.93991880053783,20.375311999275155
19580,/media/marda/TWOTB1/xBD/hurricanes/images/florence/hurricane-florence_00000295_pre_disaster.png,65,67,1,717,782,858,925,667,34.09124379890692,26.315427830821086
19581,/media/marda/TWOTB1/xBD/hurricanes/images/florence/hurricane-florence_00000295_pre_disaster.png,41,53,1,689,730,985,1038,83,12.29359711884532,8.997991743810767
19582,/media/marda/TWOTB1/xBD/hurricanes/images/florence/hurricane-florence_00000295_pre_disaster.png,52,48,1,608,660,996,1044,168,31.610597006450092,7.193651016395991
19583,/media/marda/TWOTB1/xBD/hurricanes/images/florence/hurricane-florence_00000488_post_disaster.png,40,23,1,148,188,0,23,532,35.21691819310722,20.864551996383398
19584,/media/marda/TWOTB1/xBD/hurricanes/images/florence/hurricane-florence_00000488_post_disaster.png,70,42,1,550,620,5,47,1191,44.52176331928544,36.01936799638872
19585,/media/marda/TWOTB1/xBD/hurricanes/images/florence/hurricane-florence_00000488_post_disaster.png,35,31,1,51,86,32,63,459,41.801282587315924,14.63517433470607
19586,/media/marda/TWOTB1/xBD/hurricanes/images/florence/hurricane-florence_00000488_post_disaster.png,31,46,1,112,143,45,91,567,51.81949567232047,14.541813751229089
19587,/media/marda/TWOTB1/xBD/hurricanes/images/florence/hurricane-florence_00000488_post_disaster.png,85,59,1,687,772,56,115,1862,58.8087265035997,42.76400341598098
19588,/media/marda/TWOTB1/xBD/hurricanes/images/florence/hurricane-florence_00000488_post_disaster.png,36,18,1,547,583,99,117,166,16.38348598139491,13.597153816763035
19589,/media/marda/TWOTB1/xBD/hurricanes/images/florence/hurricane-florence_00000488_post_disaster.png,49,29,1,13,62,116,145,518,55.02428815266253,12.585668829019827
19590,/media/marda/TWOTB1/xBD/hurricanes/images/florence/hurricane-florence_00000488_post_disaster.png,46,32,1,80,126,133,165,535,48.18373768365272,16.33415439742671
19591,/media/marda/TWOTB1/xBD/hurricanes/images/florence/hurricane-florence_00000488_post_disaster.png,32,21,1,141,173,159,180,221,30.998677380465757,9.55199653854317
19592,/media/marda/TWOTB1/xBD/hurricanes/images/florence/hurricane-florence_00000488_post_disaster.png,21,19,1,99,120,165,184,147,18.248409003721406,10.814562058001654
19593,/media/marda/TWOTB1/xBD/hurricanes/images/florence/hurricane-florence_00000488_post_disaster.png,28,57,1,94,122,207,264,702,54.01349238135316,20.80256663786779
19594,/media/marda/TWOTB1/xBD/hurricanes/images/florence/hurricane-florence_00000488_post_disaster.png,27,39,1,47,74,209,248,573,32.650606750102305,23.35507632837524
19595,/media/marda/TWOTB1/xBD/hurricanes/images/florence/hurricane-florence_00000488_post_disaster.png,13,19,1,117,130,209,228,57,10.927764526083145,7.135527791323865
19596,/media/marda/TWOTB1/xBD/hurricanes/images/florence/hurricane-florence_00000488_post_disaster.png,37,52,1,146,183,230,282,638,47.908220506837964,23.98194229714391
19597,/media/marda/TWOTB1/xBD/hurricanes/images/florence/hurricane-florence_00000488_post_disaster.png,32,51,1,209,241,244,295,585,45.7009855285346,20.27365551829953
19598,/media/marda/TWOTB1/xBD/hurricanes/images/florence/hurricane-florence_00000488_post_disaster.png,66,36,1,295,361,272,308,627,62.94935990960231,13.331075290982033
19599,/media/marda/TWOTB1/xBD/hurricanes/images/florence/hurricane-florence_00000488_post_disaster.png,32,59,1,132,164,329,388,672,50.495226538129806,19.16830507440106
19600,/media/marda/TWOTB1/xBD/hurricanes/images/florence/hurricane-florence_00000488_post_disaster.png,27,47,1,187,214,351,398,484,34.67270587755416,19.57610784893384
19601,/media/marda/TWOTB1/xBD/hurricanes/images/florence/hurricane-florence_00000488_post_disaster.png,21,31,1,93,114,370,401,203,17.873205320170825,15.215175839303551
19602,/media/marda/TWOTB1/xBD/hurricanes/images/florence/hurricane-florence_00000488_post_disaster.png,34,46,1,247,281,373,419,410,35.943557668761436,18.49903084444715
19603,/media/marda/TWOTB1/xBD/hurricanes/images/florence/hurricane-florence_00000488_post_disaster.png,21,32,1,195,216,404,436,148,14.304836024489811,13.896592200456798
19604,/media/marda/TWOTB1/xBD/hurricanes/images/florence/hurricane-florence_00000488_post_disaster.png,13,42,1,0,13,536,578,159,18.4116733674945,13.035065706618239
19605,/media/marda/TWOTB1/xBD/hurricanes/images/florence/hurricane-florence_00000488_post_disaster.png,35,78,1,0,35,958,1036,880,39.91572853920806,29.85478884261524
19606,/media/marda/TWOTB1/xBD/hurricanes/images/florence/hurricane-florence_00000214_post_disaster.png,42,55,1,50,92,0,55,1520,56.87161277609152,38.21306546402239
19607,/media/marda/TWOTB1/xBD/hurricanes/images/florence/hurricane-florence_00000214_post_disaster.png,42,17,1,318,360,0,17,373,30.12374731200172,16.65428131702744
19608,/media/marda/TWOTB1/xBD/hurricanes/images/florence/hurricane-florence_00000214_post_disaster.png,35,8,1,397,432,0,8,109,20.128078593860767,7.3550810125701505
19609,/media/marda/TWOTB1/xBD/hurricanes/images/florence/hurricane-florence_00000214_post_disaster.png,112,113,1,555,667,0,113,5598,109.68100934192987,81.67339678885804
19610,/media/marda/TWOTB1/xBD/hurricanes/images/florence/hurricane-florence_00000214_post_disaster.png,86,15,1,835,921,0,15,447,55.21800017535442,11.301767119844719
19611,/media/marda/TWOTB1/xBD/hurricanes/images/florence/hurricane-florence_00000214_post_disaster.png,100,63,1,814,914,20,83,2871,68.73620360387612,56.20213344705363
19612,/media/marda/TWOTB1/xBD/hurricanes/images/florence/hurricane-florence_00000214_post_disaster.png,25,22,1,127,152,22,44,278,19.872322342399503,18.659395671879157
19613,/media/marda/TWOTB1/xBD/hurricanes/images/florence/hurricane-florence_00000214_post_disaster.png,60,39,1,412,472,30,69,1144,42.11123163919586,36.74590717228652
19614,/media/marda/TWOTB1/xBD/hurricanes/images/florence/hurricane-florence_00000214_post_disaster.png,23,18,1,134,157,52,70,219,18.586570956880546,15.80066189477663
19615,/media/marda/TWOTB1/xBD/hurricanes/images/florence/hurricane-florence_00000214_post_disaster.png,55,45,1,66,121,56,101,1354,54.46968993731309,38.024392265565695
19616,/media/marda/TWOTB1/xBD/hurricanes/images/florence/hurricane-florence_00000214_post_disaster.png,16,13,1,65,81,63,76,147,17.47192929481836,12.097680817945303
19617,/media/marda/TWOTB1/xBD/hurricanes/images/florence/hurricane-florence_00000214_post_disaster.png,24,17,1,136,160,67,84,226,20.00620687841578,15.1396901791663
19618,/media/marda/TWOTB1/xBD/hurricanes/images/florence/hurricane-florence_00000214_post_disaster.png,11,10,1,48,59,73,83,72,11.394975789806628,8.565302288473575
19619,/media/marda/TWOTB1/xBD/hurricanes/images/florence/hurricane-florence_00000214_post_disaster.png,40,17,1,413,453,74,91,246,25.552591006054097,12.691355835036843
19620,/media/marda/TWOTB1/xBD/hurricanes/images/florence/hurricane-florence_00000214_post_disaster.png,33,19,1,382,415,79,98,243,19.34402155377192,16.505093780902282
19621,/media/marda/TWOTB1/xBD/hurricanes/images/florence/hurricane-florence_00000214_post_disaster.png,14,10,1,50,64,81,91,82,14.410017935665962,7.661125668491506
19622,/media/marda/TWOTB1/xBD/hurricanes/images/florence/hurricane-florence_00000214_post_disaster.png,75,45,1,968,1043,91,136,1225,43.48203607835784,37.49489121880419
19623,/media/marda/TWOTB1/xBD/hurricanes/images/florence/hurricane-florence_00000214_post_disaster.png,21,22,1,57,78,103,125,264,22.18248257372172,15.835787874631746
19624,/media/marda/TWOTB1/xBD/hurricanes/images/florence/hurricane-florence_00000214_post_disaster.png,40,22,1,323,363,113,135,325,27.986395872958397,15.3254693415601
19625,/media/marda/TWOTB1/xBD/hurricanes/images/florence/hurricane-florence_00000214_post_disaster.png,77,63,1,924,1001,114,177,1737,57.69138130125056,39.86671353497537
19626,/media/marda/TWOTB1/xBD/hurricanes/images/florence/hurricane-florence_00000214_post_disaster.png,38,25,1,287,325,129,154,417,29.930556021803678,18.561264176169388
19627,/media/marda/TWOTB1/xBD/hurricanes/images/florence/hurricane-florence_00000214_post_disaster.png,71,52,1,848,919,132,184,1231,48.12712609701064,33.67656927297651
19628,/media/marda/TWOTB1/xBD/hurricanes/images/florence/hurricane-florence_00000214_post_disaster.png,63,36,1,776,839,160,196,740,32.097481467348906,30.09543445529406
19629,/media/marda/TWOTB1/xBD/hurricanes/images/florence/hurricane-florence_00000214_post_disaster.png,57,37,1,305,362,170,207,1050,45.73353928435892,29.991343988411316
19630,/media/marda/TWOTB1/xBD/hurricanes/images/florence/hurricane-florence_00000214_post_disaster.png,67,34,1,731,798,172,206,817,42.36326235313428,25.681755953276074
19631,/media/marda/TWOTB1/xBD/hurricanes/images/florence/hurricane-florence_00000214_post_disaster.png,51,54,1,240,291,174,228,1404,52.299310266566984,36.62753377044326
19632,/media/marda/TWOTB1/xBD/hurricanes/images/florence/hurricane-florence_00000214_post_disaster.png,99,32,1,938,1037,182,214,856,64.85098021674791,18.25167086097329
19633,/media/marda/TWOTB1/xBD/hurricanes/images/florence/hurricane-florence_00000214_post_disaster.png,50,26,1,906,956,184,210,218,22.515794938227586,12.9633387910527
19634,/media/marda/TWOTB1/xBD/hurricanes/images/florence/hurricane-florence_00000214_post_disaster.png,70,51,1,689,759,185,236,1304,45.61769522141063,39.2317980544829
19635,/media/marda/TWOTB1/xBD/hurricanes/images/florence/hurricane-florence_00000214_post_disaster.png,62,36,1,641,703,199,235,722,39.50342377987898,23.9038990925643
19636,/media/marda/TWOTB1/xBD/hurricanes/images/florence/hurricane-florence_00000214_post_disaster.png,52,22,1,908,960,205,227,138,16.987132753755642,10.93934206724761
19637,/media/marda/TWOTB1/xBD/hurricanes/images/florence/hurricane-florence_00000214_post_disaster.png,50,35,1,607,657,210,245,494,26.574140422518454,24.715548076409977
19638,/media/marda/TWOTB1/xBD/hurricanes/images/florence/hurricane-florence_00000214_post_disaster.png,45,28,1,733,778,215,243,236,20.19786199396352,15.383533179314384
19639,/media/marda/TWOTB1/xBD/hurricanes/images/florence/hurricane-florence_00000214_post_disaster.png,54,39,1,651,705,239,278,630,30.40953465610211,27.540025896653383
19640,/media/marda/TWOTB1/xBD/hurricanes/images/florence/hurricane-florence_00000214_post_disaster.png,46,31,1,702,748,239,270,269,24.27669489080866,14.779038418793562
19641,/media/marda/TWOTB1/xBD/hurricanes/images/florence/hurricane-florence_00000214_post_disaster.png,35,38,1,93,128,241,279,688,33.16841305831069,27.278354168258137
19642,/media/marda/TWOTB1/xBD/hurricanes/images/florence/hurricane-florence_00000214_post_disaster.png,49,47,1,10,59,253,300,1309,52.628072554150684,32.95958248845585
19643,/media/marda/TWOTB1/xBD/hurricanes/images/florence/hurricane-florence_00000214_post_disaster.png,50,49,1,585,635,265,314,783,42.155440952364366,24.753047813560997
19644,/media/marda/TWOTB1/xBD/hurricanes/images/florence/hurricane-florence_00000214_post_disaster.png,45,49,1,427,472,268,317,736,42.214731645037716,23.27364587565494
19645,/media/marda/TWOTB1/xBD/hurricanes/images/florence/hurricane-florence_00000214_post_disaster.png,116,88,1,728,844,275,363,4551,83.54558440985221,72.50931290486139
19646,/media/marda/TWOTB1/xBD/hurricanes/images/florence/hurricane-florence_00000214_post_disaster.png,59,81,1,384,443,276,357,1844,79.17022171545034,31.019886093789633
19647,/media/marda/TWOTB1/xBD/hurricanes/images/florence/hurricane-florence_00000214_post_disaster.png,40,27,1,616,656,276,303,213,19.284348543290292,14.758529099734833
19648,/media/marda/TWOTB1/xBD/hurricanes/images/florence/hurricane-florence_00000214_post_disaster.png,52,57,1,491,543,277,334,1032,50.69276051549087,27.11585543033938
19649,/media/marda/TWOTB1/xBD/hurricanes/images/florence/hurricane-florence_00000214_post_disaster.png,50,78,1,218,268,322,400,1697,71.33632674521947,31.586800542078795
19650,/media/marda/TWOTB1/xBD/hurricanes/images/florence/hurricane-florence_00000214_post_disaster.png,60,55,1,627,687,344,399,995,42.0598055035298,31.349151366438797
19651,/media/marda/TWOTB1/xBD/hurricanes/images/florence/hurricane-florence_00000214_post_disaster.png,56,67,1,516,572,365,432,1401,58.03830532980255,31.805948961251993
19652,/media/marda/TWOTB1/xBD/hurricanes/images/florence/hurricane-florence_00000214_post_disaster.png,74,96,1,744,818,371,467,2120,90.64358931319649,31.172877912476533
19653,/media/marda/TWOTB1/xBD/hurricanes/images/florence/hurricane-florence_00000214_post_disaster.png,77,63,1,914,991,381,444,1384,49.54830735333744,37.28126697338107
19654,/media/marda/TWOTB1/xBD/hurricanes/images/florence/hurricane-florence_00000214_post_disaster.png,50,35,1,692,742,395,430,246,22.00972799966592,14.969709368721022
19655,/media/marda/TWOTB1/xBD/hurricanes/images/florence/hurricane-florence_00000214_post_disaster.png,30,52,1,0,30,398,450,715,38.01912067794251,26.27551161451552
19656,/media/marda/TWOTB1/xBD/hurricanes/images/florence/hurricane-florence_00000214_post_disaster.png,46,59,1,271,317,401,460,996,40.97498930599128,32.46162470800155
19657,/media/marda/TWOTB1/xBD/hurricanes/images/florence/hurricane-florence_00000214_post_disaster.png,12,31,1,40,52,416,447,108,15.549873601850607,9.382282223328408
19658,/media/marda/TWOTB1/xBD/hurricanes/images/florence/hurricane-florence_00000214_post_disaster.png,82,56,1,628,710,422,478,1615,59.44244351106756,35.32780670072915
19659,/media/marda/TWOTB1/xBD/hurricanes/images/florence/hurricane-florence_00000214_post_disaster.png,47,43,1,534,581,426,469,517,26.69508693795264,25.74074374877922
19660,/media/marda/TWOTB1/xBD/hurricanes/images/florence/hurricane-florence_00000214_post_disaster.png,20,32,1,2,22,439,471,200,19.745530103566665,13.583682892689403
19661,/media/marda/TWOTB1/xBD/hurricanes/images/florence/hurricane-florence_00000214_post_disaster.png,69,48,1,688,757,440,488,867,42.94469711380286,26.606038954141344
19662,/media/marda/TWOTB1/xBD/hurricanes/images/florence/hurricane-florence_00000214_post_disaster.png,37,73,1,56,93,442,515,1320,61.323298696300924,30.273890645550757
19663,/media/marda/TWOTB1/xBD/hurricanes/images/florence/hurricane-florence_00000214_post_disaster.png,12,30,1,23,35,450,480,108,13.54845613835007,10.714929147576044
19664,/media/marda/TWOTB1/xBD/hurricanes/images/florence/hurricane-florence_00000214_post_disaster.png,40,65,1,172,212,466,531,1096,49.539398973628444,29.463621109517064
19665,/media/marda/TWOTB1/xBD/hurricanes/images/florence/hurricane-florence_00000214_post_disaster.png,74,57,1,648,722,471,528,1258,51.483693194753826,32.431804895110126
19666,/media/marda/TWOTB1/xBD/hurricanes/images/florence/hurricane-florence_00000214_post_disaster.png,48,52,1,546,594,474,526,676,36.01476495903142,24.99032145549896
19667,/media/marda/TWOTB1/xBD/hurricanes/images/florence/hurricane-florence_00000214_post_disaster.png,63,45,1,980,1043,483,528,549,29.986482741448548,24.23186114247911
19668,/media/marda/TWOTB1/xBD/hurricanes/images/florence/hurricane-florence_00000214_post_disaster.png,58,83,1,294,352,487,570,1831,70.35572810373633,34.703417566925225
19669,/media/marda/TWOTB1/xBD/hurricanes/images/florence/hurricane-florence_00000214_post_disaster.png,61,70,1,439,500,487,557,1386,52.71549552560254,36.90962175388974
19670,/media/marda/TWOTB1/xBD/hurricanes/images/florence/hurricane-florence_00000214_post_disaster.png,37,47,1,417,454,495,542,383,27.559580802495415,18.331052408134525
19671,/media/marda/TWOTB1/xBD/hurricanes/images/florence/hurricane-florence_00000214_post_disaster.png,44,46,1,495,539,499,545,479,26.471647034836792,23.981717453649225
19672,/media/marda/TWOTB1/xBD/hurricanes/images/florence/hurricane-florence_00000214_post_disaster.png,38,42,1,174,212,522,564,486,33.92391047195134,18.82484226245073
19673,/media/marda/TWOTB1/xBD/hurricanes/images/florence/hurricane-florence_00000214_post_disaster.png,53,57,1,403,456,533,590,901,36.60413092248239,33.3559243978861
19674,/media/marda/TWOTB1/xBD/hurricanes/images/florence/hurricane-florence_00000214_post_disaster.png,38,45,1,181,219,548,593,566,34.84152824969414,21.53507319391662
19675,/media/marda/TWOTB1/xBD/hurricanes/images/florence/hurricane-florence_00000214_post_disaster.png,74,54,1,961,1035,553,607,779,35.08105141638889,29.389061018102655
19676,/media/marda/TWOTB1/xBD/hurricanes/images/florence/hurricane-florence_00000214_post_disaster.png,55,60,1,653,708,558,618,736,37.961495387530825,25.88206695149378
19677,/media/marda/TWOTB1/xBD/hurricanes/images/florence/hurricane-florence_00000214_post_disaster.png,38,47,1,188,226,572,619,606,33.99256339715477,23.419799023072734
19678,/media/marda/TWOTB1/xBD/hurricanes/images/florence/hurricane-florence_00000214_post_disaster.png,45,47,1,240,285,588,635,669,39.23826735637576,22.537038099165034
19679,/media/marda/TWOTB1/xBD/hurricanes/images/florence/hurricane-florence_00000214_post_disaster.png,42,35,1,846,888,590,625,68,9.852632352540299,9.436274836210513
19680,/media/marda/TWOTB1/xBD/hurricanes/images/florence/hurricane-florence_00000214_post_disaster.png,75,57,1,851,926,599,656,929,43.88315743883872,27.730551112887404
19681,/media/marda/TWOTB1/xBD/hurricanes/images/florence/hurricane-florence_00000214_post_disaster.png,12,39,1,90,102,613,652,117,15.275373144863632,10.18250247302953
19682,/media/marda/TWOTB1/xBD/hurricanes/images/florence/hurricane-florence_00000214_post_disaster.png,51,59,1,430,481,613,672,800,36.076367790791416,29.338629603707588
19683,/media/marda/TWOTB1/xBD/hurricanes/images/florence/hurricane-florence_00000214_post_disaster.png,42,53,1,116,158,618,671,739,40.13381954847166,24.23412726063491
19684,/media/marda/TWOTB1/xBD/hurricanes/images/florence/hurricane-florence_00000214_post_disaster.png,53,53,1,990,1043,620,673,230,28.87675988274269,11.509028161518527
19685,/media/marda/TWOTB1/xBD/hurricanes/images/florence/hurricane-florence_00000214_post_disaster.png,72,62,1,678,750,622,684,1047,50.372243520164425,27.59252378509818
19686,/media/marda/TWOTB1/xBD/hurricanes/images/florence/hurricane-florence_00000214_post_disaster.png,31,47,1,344,375,652,699,298,22.916050871602042,17.323736696076352
19687,/media/marda/TWOTB1/xBD/hurricanes/images/florence/hurricane-florence_00000214_post_disaster.png,69,74,1,720,789,655,729,1325,49.588014681959976,35.42374469461648
19688,/media/marda/TWOTB1/xBD/hurricanes/images/florence/hurricane-florence_00000214_post_disaster.png,66,61,1,882,948,657,718,727,35.612688172027084,27.241981899330877
19689,/media/marda/TWOTB1/xBD/hurricanes/images/florence/hurricane-florence_00000214_post_disaster.png,71,58,1,589,660,660,718,1147,53.94507087706949,27.99297034352695
19690,/media/marda/TWOTB1/xBD/hurricanes/images/florence/hurricane-florence_00000214_post_disaster.png,51,58,1,239,290,686,744,950,44.40414128430814,28.510791925055027
19691,/media/marda/TWOTB1/xBD/hurricanes/images/florence/hurricane-florence_00000214_post_disaster.png,44,76,1,324,368,688,764,961,50.317024359248144,25.497609514955826
19692,/media/marda/TWOTB1/xBD/hurricanes/images/florence/hurricane-florence_00000214_post_disaster.png,39,70,1,151,190,696,766,858,44.347723464842936,26.147418526504385
19693,/media/marda/TWOTB1/xBD/hurricanes/images/florence/hurricane-florence_00000214_post_disaster.png,26,45,1,302,328,698,743,144,17.39061512536953,11.167502428902363
19694,/media/marda/TWOTB1/xBD/hurricanes/images/florence/hurricane-florence_00000214_post_disaster.png,69,65,1,894,963,707,772,776,37.00668086676028,27.818551179742403
19695,/media/marda/TWOTB1/xBD/hurricanes/images/florence/hurricane-florence_00000214_post_disaster.png,35,66,1,123,158,711,777,754,40.59131375399856,24.680062533598107
19696,/media/marda/TWOTB1/xBD/hurricanes/images/florence/hurricane-florence_00000214_post_disaster.png,38,67,1,228,266,729,796,710,37.27835853582874,26.011731318530803
19697,/media/marda/TWOTB1/xBD/hurricanes/images/florence/hurricane-florence_00000214_post_disaster.png,23,40,1,267,290,729,769,145,16.704304492061016,11.66137071555665
19698,/media/marda/TWOTB1/xBD/hurricanes/images/florence/hurricane-florence_00000214_post_disaster.png,27,56,1,66,93,735,791,536,27.765688851930165,25.701300204923527
19699,/media/marda/TWOTB1/xBD/hurricanes/images/florence/hurricane-florence_00000214_post_disaster.png,76,54,1,726,802,737,791,566,52.2837411524595,16.04088169139763
19700,/media/marda/TWOTB1/xBD/hurricanes/images/florence/hurricane-florence_00000214_post_disaster.png,52,75,1,7,59,743,818,1316,57.83517703240103,34.400961802899914
19701,/media/marda/TWOTB1/xBD/hurricanes/images/florence/hurricane-florence_00000214_post_disaster.png,35,73,1,307,342,748,821,569,50.153048490731294,15.15393843557518
19702,/media/marda/TWOTB1/xBD/hurricanes/images/florence/hurricane-florence_00000214_post_disaster.png,68,67,1,910,978,755,822,868,37.774655917267346,30.58553921276449
19703,/media/marda/TWOTB1/xBD/hurricanes/images/florence/hurricane-florence_00000214_post_disaster.png,34,50,1,261,295,758,808,358,26.4177856651176,18.121256307465153
19704,/media/marda/TWOTB1/xBD/hurricanes/images/florence/hurricane-florence_00000214_post_disaster.png,51,78,1,233,284,770,848,1290,52.188754485610545,32.86375693476311
19705,/media/marda/TWOTB1/xBD/hurricanes/images/florence/hurricane-florence_00000214_post_disaster.png,56,68,1,618,674,771,839,891,41.299003648564764,28.525334210546532
19706,/media/marda/TWOTB1/xBD/hurricanes/images/florence/hurricane-florence_00000214_post_disaster.png,18,43,1,53,71,784,827,180,18.399688239290995,12.906869301501137
19707,/media/marda/TWOTB1/xBD/hurricanes/images/florence/hurricane-florence_00000214_post_disaster.png,37,76,1,168,205,795,871,849,46.43212317217672,24.597901759423937
19708,/media/marda/TWOTB1/xBD/hurricanes/images/florence/hurricane-florence_00000214_post_disaster.png,68,65,1,763,831,796,861,803,38.35981348197965,27.897036107564357
19709,/media/marda/TWOTB1/xBD/hurricanes/images/florence/hurricane-florence_00000214_post_disaster.png,57,74,1,721,778,812,886,837,43.320759210783834,25.678353902666785
19710,/media/marda/TWOTB1/xBD/hurricanes/images/florence/hurricane-florence_00000214_post_disaster.png,53,73,1,255,308,819,892,1065,44.84438007661275,32.6552217254346
19711,/media/marda/TWOTB1/xBD/hurricanes/images/florence/hurricane-florence_00000214_post_disaster.png,58,66,1,830,888,869,935,590,33.95724168891843,22.922517089943554
19712,/media/marda/TWOTB1/xBD/hurricanes/images/florence/hurricane-florence_00000214_post_disaster.png,65,81,1,745,810,884,965,1165,47.26373748673291,33.32300729673574
19713,/media/marda/TWOTB1/xBD/hurricanes/images/florence/hurricane-florence_00000214_post_disaster.png,47,79,1,425,472,899,978,711,49.07629103556632,21.335797391658964
19714,/media/marda/TWOTB1/xBD/hurricanes/images/florence/hurricane-florence_00000214_post_disaster.png,51,59,1,788,839,912,971,297,22.812596569761897,17.220560322827094
19715,/media/marda/TWOTB1/xBD/hurricanes/images/florence/hurricane-florence_00000214_post_disaster.png,104,78,1,932,1036,914,992,1851,71.91707225364395,33.68293262652469
19716,/media/marda/TWOTB1/xBD/hurricanes/images/florence/hurricane-florence_00000214_post_disaster.png,30,56,1,40,70,916,972,458,31.162720451663105,19.21116823071669
19717,/media/marda/TWOTB1/xBD/hurricanes/images/florence/hurricane-florence_00000214_post_disaster.png,56,80,1,661,717,924,1004,910,45.69903460913822,26.257540191920718
19718,/media/marda/TWOTB1/xBD/hurricanes/images/florence/hurricane-florence_00000214_post_disaster.png,40,67,1,323,363,940,1007,570,29.584433091243067,25.485130604334607
19719,/media/marda/TWOTB1/xBD/hurricanes/images/florence/hurricane-florence_00000214_post_disaster.png,20,63,1,76,96,948,1011,352,26.325978947589988,17.9123399744461
19720,/media/marda/TWOTB1/xBD/hurricanes/images/florence/hurricane-florence_00000214_post_disaster.png,50,67,1,195,245,949,1016,1007,45.39255656110485,29.664682558408366
19721,/media/marda/TWOTB1/xBD/hurricanes/images/florence/hurricane-florence_00000214_post_disaster.png,39,68,1,286,325,950,1018,642,31.480710785107043,26.898410543604143
19722,/media/marda/TWOTB1/xBD/hurricanes/images/florence/hurricane-florence_00000214_post_disaster.png,50,61,1,779,829,952,1013,332,25.435586667670286,17.401044624095707
19723,/media/marda/TWOTB1/xBD/hurricanes/images/florence/hurricane-florence_00000214_post_disaster.png,79,70,1,964,1043,954,1024,988,42.16081290302745,30.48041695076772
19724,/media/marda/TWOTB1/xBD/hurricanes/images/florence/hurricane-florence_00000214_post_disaster.png,56,68,1,805,861,970,1038,493,33.086680033169955,19.90982454084166
19725,/media/marda/TWOTB1/xBD/hurricanes/images/florence/hurricane-florence_00000214_post_disaster.png,55,62,1,646,701,980,1042,371,33.797065502469444,15.177717088655584
19726,/media/marda/TWOTB1/xBD/hurricanes/images/florence/hurricane-florence_00000214_post_disaster.png,49,50,1,870,919,993,1043,111,14.953429962569553,9.810814788093607
19727,/media/marda/TWOTB1/xBD/hurricanes/images/florence/hurricane-florence_00000331_post_disaster.png,21,16,1,192,213,19,35,142,14.188057477793842,13.242056865818324
19728,/media/marda/TWOTB1/xBD/hurricanes/images/florence/hurricane-florence_00000331_post_disaster.png,53,64,1,148,201,37,101,2039,61.144284703653895,44.60990550047406
19729,/media/marda/TWOTB1/xBD/hurricanes/images/florence/hurricane-florence_00000331_post_disaster.png,28,18,1,360,388,134,152,158,15.77070822198573,12.922161063633872
19730,/media/marda/TWOTB1/xBD/hurricanes/images/florence/hurricane-florence_00000331_post_disaster.png,41,58,1,216,257,163,221,1171,61.087929383731236,26.13543256952682
19731,/media/marda/TWOTB1/xBD/hurricanes/images/florence/hurricane-florence_00000331_post_disaster.png,72,30,1,321,393,189,219,1315,67.6090286234382,25.706675544442607
19732,/media/marda/TWOTB1/xBD/hurricanes/images/florence/hurricane-florence_00000331_post_disaster.png,16,21,1,15,31,268,289,153,17.45454784549901,11.478510608547197
19733,/media/marda/TWOTB1/xBD/hurricanes/images/florence/hurricane-florence_00000331_post_disaster.png,28,59,1,89,117,287,346,1163,56.22220888197385,27.393664328561176
19734,/media/marda/TWOTB1/xBD/hurricanes/images/florence/hurricane-florence_00000331_post_disaster.png,51,49,1,947,998,303,352,535,41.235164490202024,17.13716151403573
19735,/media/marda/TWOTB1/xBD/hurricanes/images/florence/hurricane-florence_00000331_post_disaster.png,77,46,1,859,936,361,407,1261,47.49886677349319,35.161240638455304
19736,/media/marda/TWOTB1/xBD/hurricanes/images/florence/hurricane-florence_00000331_post_disaster.png,72,52,1,200,272,372,424,1435,68.63387275604781,27.83003259233649
19737,/media/marda/TWOTB1/xBD/hurricanes/images/florence/hurricane-florence_00000331_post_disaster.png,50,35,1,931,981,379,414,254,24.78321624370103,13.496251973462954
19738,/media/marda/TWOTB1/xBD/hurricanes/images/florence/hurricane-florence_00000331_post_disaster.png,48,27,1,936,984,402,429,97,11.759329340840507,10.523275317905973
19739,/media/marda/TWOTB1/xBD/hurricanes/images/florence/hurricane-florence_00000331_post_disaster.png,62,37,1,841,903,404,441,599,33.108855399151956,23.683760314604353
19740,/media/marda/TWOTB1/xBD/hurricanes/images/florence/hurricane-florence_00000331_post_disaster.png,65,53,1,287,352,413,466,1158,59.658890975299926,25.616209813027428
19741,/media/marda/TWOTB1/xBD/hurricanes/images/florence/hurricane-florence_00000331_post_disaster.png,61,35,1,917,978,416,451,399,27.771828137465963,18.877209317186622
19742,/media/marda/TWOTB1/xBD/hurricanes/images/florence/hurricane-florence_00000331_post_disaster.png,51,26,1,923,974,446,472,136,17.386180019647735,10.426675117839974
19743,/media/marda/TWOTB1/xBD/hurricanes/images/florence/hurricane-florence_00000331_post_disaster.png,85,47,1,918,1003,490,537,1046,54.61049981573085,25.337024839237788
19744,/media/marda/TWOTB1/xBD/hurricanes/images/florence/hurricane-florence_00000331_post_disaster.png,57,78,1,279,336,570,648,1531,62.579654608173676,33.98958606425942
19745,/media/marda/TWOTB1/xBD/hurricanes/images/florence/hurricane-florence_00000331_post_disaster.png,72,79,1,549,621,615,694,1429,54.86060495932955,34.76066434491701
19746,/media/marda/TWOTB1/xBD/hurricanes/images/florence/hurricane-florence_00000331_post_disaster.png,45,93,1,48,93,627,720,1902,69.39953611204248,36.114865636187744
19747,/media/marda/TWOTB1/xBD/hurricanes/images/florence/hurricane-florence_00000331_post_disaster.png,51,67,1,112,163,631,698,1302,43.3830333270125,39.73532628075651
19748,/media/marda/TWOTB1/xBD/hurricanes/images/florence/hurricane-florence_00000331_post_disaster.png,20,51,1,0,20,667,718,398,26.14400545932943,20.337203828966025
19749,/media/marda/TWOTB1/xBD/hurricanes/images/florence/hurricane-florence_00000331_post_disaster.png,57,91,1,277,334,669,760,2009,71.14351722200063,37.401178159564466
19750,/media/marda/TWOTB1/xBD/hurricanes/images/florence/hurricane-florence_00000331_post_disaster.png,16,34,1,114,130,674,708,70,12.17795863310742,7.741181754673888
19751,/media/marda/TWOTB1/xBD/hurricanes/images/florence/hurricane-florence_00000331_post_disaster.png,52,45,1,483,535,707,752,245,37.0081752091185,8.765159472925427
19752,/media/marda/TWOTB1/xBD/hurricanes/images/florence/hurricane-florence_00000331_post_disaster.png,32,48,1,453,485,758,806,168,20.25232792276535,11.0775310622179
19753,/media/marda/TWOTB1/xBD/hurricanes/images/florence/hurricane-florence_00000331_post_disaster.png,36,48,1,464,500,784,832,206,17.201255808253936,15.887729147470624
19754,/media/marda/TWOTB1/xBD/hurricanes/images/florence/hurricane-florence_00000331_post_disaster.png,69,66,1,421,490,804,870,973,57.46292368242138,22.387577482717592
19755,/media/marda/TWOTB1/xBD/hurricanes/images/florence/hurricane-florence_00000331_post_disaster.png,47,67,1,313,360,913,980,590,34.66425601446339,22.555115454363335
19756,/media/marda/TWOTB1/xBD/hurricanes/images/florence/hurricane-florence_00000331_post_disaster.png,27,61,1,13,40,955,1016,295,29.892359496005888,13.176483791872503
19757,/media/marda/TWOTB1/xBD/hurricanes/images/florence/hurricane-florence_00000331_post_disaster.png,42,64,1,92,134,977,1041,664,35.36586034054176,25.809936521226344
19758,/media/marda/TWOTB1/xBD/hurricanes/images/florence/hurricane-florence_00000331_post_disaster.png,38,51,1,312,350,992,1043,148,22.320477162793004,10.197363329538424
19759,/media/marda/TWOTB1/xBD/hurricanes/images/florence/hurricane-florence_00000246_pre_disaster.png,51,23,1,721,772,0,23,292,24.128050042478858,16.569049212388233
19760,/media/marda/TWOTB1/xBD/hurricanes/images/florence/hurricane-florence_00000246_pre_disaster.png,62,76,1,511,573,712,788,1135,49.82445600027664,30.14365748279939
19761,/media/marda/TWOTB1/xBD/hurricanes/images/florence/hurricane-florence_00000442_pre_disaster.png,36,6,1,545,581,0,6,51,14.445109756025985,5.336512516934508
19762,/media/marda/TWOTB1/xBD/hurricanes/images/florence/hurricane-florence_00000442_pre_disaster.png,76,53,1,99,175,135,188,1822,76.0471168792394,37.82104007292975
19763,/media/marda/TWOTB1/xBD/hurricanes/images/florence/hurricane-florence_00000442_pre_disaster.png,73,43,1,693,766,159,202,653,54.601301274607195,15.853935356133617
19764,/media/marda/TWOTB1/xBD/hurricanes/images/florence/hurricane-florence_00000442_pre_disaster.png,66,50,1,641,707,203,253,671,53.22989448869958,16.638736253087764
19765,/media/marda/TWOTB1/xBD/hurricanes/images/florence/hurricane-florence_00000442_pre_disaster.png,22,25,1,101,123,215,240,149,16.17699810685102,12.379869775340484
19766,/media/marda/TWOTB1/xBD/hurricanes/images/florence/hurricane-florence_00000442_pre_disaster.png,61,63,1,819,880,226,289,767,60.35796264667244,16.957721220252306
19767,/media/marda/TWOTB1/xBD/hurricanes/images/florence/hurricane-florence_00000442_pre_disaster.png,70,49,1,709,779,227,276,663,52.86825042824612,16.506393017320846
19768,/media/marda/TWOTB1/xBD/hurricanes/images/florence/hurricane-florence_00000442_pre_disaster.png,34,27,1,351,385,232,259,176,23.536614441314608,10.021098180343015
19769,/media/marda/TWOTB1/xBD/hurricanes/images/florence/hurricane-florence_00000442_pre_disaster.png,39,32,1,296,335,246,278,345,24.262043574405123,18.777483551226524
19770,/media/marda/TWOTB1/xBD/hurricanes/images/florence/hurricane-florence_00000442_pre_disaster.png,49,27,1,853,902,256,283,182,18.389457689537863,13.164249889626216
19771,/media/marda/TWOTB1/xBD/hurricanes/images/florence/hurricane-florence_00000442_pre_disaster.png,64,65,1,340,404,267,332,1421,58.72544968917542,33.84986467677901
19772,/media/marda/TWOTB1/xBD/hurricanes/images/florence/hurricane-florence_00000442_pre_disaster.png,58,45,1,585,643,270,315,504,44.485070640080394,15.129345136236594
19773,/media/marda/TWOTB1/xBD/hurricanes/images/florence/hurricane-florence_00000442_pre_disaster.png,73,54,1,643,716,288,342,796,60.68055168949798,17.373808097409405
19774,/media/marda/TWOTB1/xBD/hurricanes/images/florence/hurricane-florence_00000442_pre_disaster.png,63,61,1,796,859,297,358,804,49.55427517322416,23.146326199774478
19775,/media/marda/TWOTB1/xBD/hurricanes/images/florence/hurricane-florence_00000442_pre_disaster.png,59,30,1,910,969,313,343,197,24.153423919863183,10.90890638355979
19776,/media/marda/TWOTB1/xBD/hurricanes/images/florence/hurricane-florence_00000442_pre_disaster.png,66,53,1,878,944,318,371,611,47.11255862351071,18.467653920687777
19777,/media/marda/TWOTB1/xBD/hurricanes/images/florence/hurricane-florence_00000442_pre_disaster.png,64,58,1,513,577,339,397,727,57.79953333427795,16.721373613258404
19778,/media/marda/TWOTB1/xBD/hurricanes/images/florence/hurricane-florence_00000442_pre_disaster.png,49,57,1,213,262,350,407,929,38.653691626917066,33.018721901890935
19779,/media/marda/TWOTB1/xBD/hurricanes/images/florence/hurricane-florence_00000442_pre_disaster.png,68,62,1,250,318,361,423,1457,54.88574737989267,37.40647727298703
19780,/media/marda/TWOTB1/xBD/hurricanes/images/florence/hurricane-florence_00000442_pre_disaster.png,63,61,1,958,1021,366,427,518,54.17362597411049,12.809864346349105
19781,/media/marda/TWOTB1/xBD/hurricanes/images/florence/hurricane-florence_00000442_pre_disaster.png,42,35,1,527,569,372,407,258,21.158859496667528,16.167890268588692
19782,/media/marda/TWOTB1/xBD/hurricanes/images/florence/hurricane-florence_00000442_pre_disaster.png,67,36,1,589,656,374,410,477,50.66752832627726,12.51940311123999
19783,/media/marda/TWOTB1/xBD/hurricanes/images/florence/hurricane-florence_00000442_pre_disaster.png,54,46,1,807,861,376,422,387,37.327988661351995,13.780321750443656
19784,/media/marda/TWOTB1/xBD/hurricanes/images/florence/hurricane-florence_00000442_pre_disaster.png,19,23,1,209,228,380,403,57,11.40424617140587,6.715732573503555
19785,/media/marda/TWOTB1/xBD/hurricanes/images/florence/hurricane-florence_00000442_pre_disaster.png,61,64,1,849,910,389,453,672,57.641578774660694,15.5268385280212
19786,/media/marda/TWOTB1/xBD/hurricanes/images/florence/hurricane-florence_00000442_pre_disaster.png,23,36,1,48,71,390,426,277,20.552123309837093,18.00946920785881
19787,/media/marda/TWOTB1/xBD/hurricanes/images/florence/hurricane-florence_00000442_pre_disaster.png,47,54,1,6,53,404,458,956,42.72763217951948,29.706807069600274
19788,/media/marda/TWOTB1/xBD/hurricanes/images/florence/hurricane-florence_00000442_pre_disaster.png,77,45,1,656,733,411,456,568,58.489639132245216,12.945367001219934
19789,/media/marda/TWOTB1/xBD/hurricanes/images/florence/hurricane-florence_00000442_pre_disaster.png,58,74,1,724,782,415,489,852,63.78364299300408,20.52623748847307
19790,/media/marda/TWOTB1/xBD/hurricanes/images/florence/hurricane-florence_00000442_pre_disaster.png,59,75,1,183,242,436,511,1561,60.10094616336042,35.995726045227265
19791,/media/marda/TWOTB1/xBD/hurricanes/images/florence/hurricane-florence_00000442_pre_disaster.png,58,65,1,764,822,440,505,665,52.144595972387314,16.88433955055928
19792,/media/marda/TWOTB1/xBD/hurricanes/images/florence/hurricane-florence_00000442_pre_disaster.png,61,57,1,933,994,442,499,561,45.550751904858146,16.28343761119605
19793,/media/marda/TWOTB1/xBD/hurricanes/images/florence/hurricane-florence_00000442_pre_disaster.png,32,43,1,148,180,450,493,362,26.916695407463497,17.97296358267171
19794,/media/marda/TWOTB1/xBD/hurricanes/images/florence/hurricane-florence_00000442_pre_disaster.png,46,36,1,693,739,453,489,210,17.650542328251323,15.979049122128849
19795,/media/marda/TWOTB1/xBD/hurricanes/images/florence/hurricane-florence_00000442_pre_disaster.png,57,57,1,828,885,458,515,487,44.609774018524696,14.604888369134692
19796,/media/marda/TWOTB1/xBD/hurricanes/images/florence/hurricane-florence_00000442_pre_disaster.png,44,29,1,854,898,459,488,97,11.709879180019312,11.128988776611532
19797,/media/marda/TWOTB1/xBD/hurricanes/images/florence/hurricane-florence_00000442_pre_disaster.png,81,53,1,686,767,499,552,627,64.13203860594689,13.140335280335158
19798,/media/marda/TWOTB1/xBD/hurricanes/images/florence/hurricane-florence_00000442_pre_disaster.png,64,68,1,910,974,499,567,666,52.90139878251988,16.826168222005847
19799,/media/marda/TWOTB1/xBD/hurricanes/images/florence/hurricane-florence_00000442_pre_disaster.png,25,39,1,114,139,512,551,199,17.68195403691489,15.040038989085538
19800,/media/marda/TWOTB1/xBD/hurricanes/images/florence/hurricane-florence_00000442_pre_disaster.png,30,50,1,78,108,513,563,360,32.062652665833966,16.603841079641526
19801,/media/marda/TWOTB1/xBD/hurricanes/images/florence/hurricane-florence_00000442_pre_disaster.png,61,72,1,983,1044,519,591,569,50.78846328180747,15.207129826384302
19802,/media/marda/TWOTB1/xBD/hurricanes/images/florence/hurricane-florence_00000442_pre_disaster.png,49,67,1,111,160,527,594,939,56.35339134328594,24.401899146831713
19803,/media/marda/TWOTB1/xBD/hurricanes/images/florence/hurricane-florence_00000442_pre_disaster.png,56,61,1,764,820,534,595,583,41.96353910956208,22.007580529016472
19804,/media/marda/TWOTB1/xBD/hurricanes/images/florence/hurricane-florence_00000442_pre_disaster.png,66,71,1,343,409,543,614,1369,54.17893489716446,33.52518711479528
19805,/media/marda/TWOTB1/xBD/hurricanes/images/florence/hurricane-florence_00000442_pre_disaster.png,39,33,1,761,800,548,581,82,11.715511528737329,9.426548550745954
19806,/media/marda/TWOTB1/xBD/hurricanes/images/florence/hurricane-florence_00000442_pre_disaster.png,61,73,1,862,923,567,640,631,59.933649086947526,14.076030889326415
19807,/media/marda/TWOTB1/xBD/hurricanes/images/florence/hurricane-florence_00000442_pre_disaster.png,51,64,1,746,797,608,672,496,42.22236597100514,15.73694059604707
19808,/media/marda/TWOTB1/xBD/hurricanes/images/florence/hurricane-florence_00000442_pre_disaster.png,59,68,1,392,451,612,680,997,40.43752922105931,32.77000818011643
19809,/media/marda/TWOTB1/xBD/hurricanes/images/florence/hurricane-florence_00000442_pre_disaster.png,60,73,1,839,899,635,708,675,53.09818786186801,16.9422935278345
19810,/media/marda/TWOTB1/xBD/hurricanes/images/florence/hurricane-florence_00000442_pre_disaster.png,63,69,1,436,499,637,706,1056,40.54013238497684,34.76440126604652
19811,/media/marda/TWOTB1/xBD/hurricanes/images/florence/hurricane-florence_00000442_pre_disaster.png,97,58,1,905,1002,642,700,711,68.96725958555164,13.819345956467885
19812,/media/marda/TWOTB1/xBD/hurricanes/images/florence/hurricane-florence_00000442_pre_disaster.png,58,71,1,331,389,648,719,748,60.869329082797584,16.2977988811508
19813,/media/marda/TWOTB1/xBD/hurricanes/images/florence/hurricane-florence_00000442_pre_disaster.png,33,42,1,386,419,672,714,199,17.0980215618905,15.339731564947188
19814,/media/marda/TWOTB1/xBD/hurricanes/images/florence/hurricane-florence_00000442_pre_disaster.png,62,82,1,236,298,691,773,1281,59.74600219522625,28.679400298257193
19815,/media/marda/TWOTB1/xBD/hurricanes/images/florence/hurricane-florence_00000442_pre_disaster.png,15,57,1,0,15,724,781,225,24.726298898094516,13.976660954751141
19816,/media/marda/TWOTB1/xBD/hurricanes/images/florence/hurricane-florence_00000442_pre_disaster.png,46,65,1,284,330,751,816,641,34.948860460427824,24.59326068307786
19817,/media/marda/TWOTB1/xBD/hurricanes/images/florence/hurricane-florence_00000442_pre_disaster.png,44,74,1,107,151,793,867,634,54.15446141962069,15.473376728251298
19818,/media/marda/TWOTB1/xBD/hurricanes/images/florence/hurricane-florence_00000442_pre_disaster.png,55,69,1,84,139,856,925,978,50.59639477736124,26.630197335535026
19819,/media/marda/TWOTB1/xBD/hurricanes/images/florence/hurricane-florence_00000442_pre_disaster.png,44,84,1,0,44,916,1000,1314,46.51616723533184,40.22486706241608
19820,/media/marda/TWOTB1/xBD/hurricanes/images/florence/hurricane-florence_00000442_pre_disaster.png,44,70,1,58,102,922,992,857,45.46369350870429,24.932550101826134
19821,/media/marda/TWOTB1/xBD/hurricanes/images/florence/hurricane-florence_00000489_post_disaster.png,133,60,1,200,333,410,470,4638,134.1408412632236,46.04242838473426
19822,/media/marda/TWOTB1/xBD/hurricanes/images/florence/hurricane-florence_00000489_post_disaster.png,14,22,1,185,199,421,443,48,9.957261911086414,6.1496514544976835
19823,/media/marda/TWOTB1/xBD/hurricanes/images/florence/hurricane-florence_00000484_post_disaster.png,52,29,1,892,944,367,396,129,16.83948708387966,10.264419211891083
19824,/media/marda/TWOTB1/xBD/hurricanes/images/florence/hurricane-florence_00000484_post_disaster.png,56,43,1,980,1036,750,793,118,14.289684737677023,11.09195966021483
19825,/media/marda/TWOTB1/xBD/hurricanes/images/florence/hurricane-florence_00000484_post_disaster.png,73,73,1,970,1043,785,858,770,45.36711722679902,22.184296583187262
19826,/media/marda/TWOTB1/xBD/hurricanes/images/florence/hurricane-florence_00000484_post_disaster.png,64,63,1,807,871,813,876,476,34.73705135395551,18.20577129293656
19827,/media/marda/TWOTB1/xBD/hurricanes/images/florence/hurricane-florence_00000484_post_disaster.png,56,59,1,843,899,859,918,290,27.954201589866724,14.122620723117446
19828,/media/marda/TWOTB1/xBD/hurricanes/images/florence/hurricane-florence_00000484_post_disaster.png,66,66,1,826,892,876,942,515,37.21598517146359,18.484785926761933
19829,/media/marda/TWOTB1/xBD/hurricanes/images/florence/hurricane-florence_00000484_post_disaster.png,56,59,1,811,867,917,976,277,26.962213939351614,13.733081139326178
19830,/media/marda/TWOTB1/xBD/hurricanes/images/florence/hurricane-florence_00000484_post_disaster.png,85,87,1,838,923,923,1010,1358,52.047272537094315,35.32349196232102
19831,/media/marda/TWOTB1/xBD/hurricanes/images/florence/hurricane-florence_00000321_pre_disaster.png,18,34,1,0,18,0,34,467,36.001283433605515,17.54449384574341
19832,/media/marda/TWOTB1/xBD/hurricanes/images/florence/hurricane-florence_00000321_pre_disaster.png,56,43,1,271,327,0,43,1282,49.68084510201215,34.199460121984764
19833,/media/marda/TWOTB1/xBD/hurricanes/images/florence/hurricane-florence_00000321_pre_disaster.png,35,6,1,423,458,0,6,74,19.89338127365119,5.119098663691625
19834,/media/marda/TWOTB1/xBD/hurricanes/images/florence/hurricane-florence_00000321_pre_disaster.png,22,14,1,294,316,42,56,113,12.829987601049007,11.867124712846678
19835,/media/marda/TWOTB1/xBD/hurricanes/images/florence/hurricane-florence_00000321_pre_disaster.png,40,33,1,333,373,44,77,497,30.92514879647632,21.343706293954877
19836,/media/marda/TWOTB1/xBD/hurricanes/images/florence/hurricane-florence_00000321_pre_disaster.png,35,30,1,242,277,73,103,595,30.966260796339913,25.660613637729227
19837,/media/marda/TWOTB1/xBD/hurricanes/images/florence/hurricane-florence_00000321_pre_disaster.png,39,39,1,40,79,125,164,838,38.09342379590995,28.920851481256992
19838,/media/marda/TWOTB1/xBD/hurricanes/images/florence/hurricane-florence_00000321_pre_disaster.png,37,34,1,103,140,150,184,619,31.287236565425285,26.43598796147956
19839,/media/marda/TWOTB1/xBD/hurricanes/images/florence/hurricane-florence_00000321_pre_disaster.png,27,23,1,160,187,187,210,255,22.501803691380335,15.18546812984027
19840,/media/marda/TWOTB1/xBD/hurricanes/images/florence/hurricane-florence_00000321_pre_disaster.png,20,28,1,83,103,303,331,155,16.121156195293626,12.892083024738408
19841,/media/marda/TWOTB1/xBD/hurricanes/images/florence/hurricane-florence_00000321_pre_disaster.png,62,53,1,109,171,376,429,1425,62.832858615928345,30.840433753638973
19842,/media/marda/TWOTB1/xBD/hurricanes/images/florence/hurricane-florence_00000321_pre_disaster.png,34,31,1,170,204,381,412,337,29.187367686459908,15.200171146853455
19843,/media/marda/TWOTB1/xBD/hurricanes/images/florence/hurricane-florence_00000321_pre_disaster.png,50,50,1,233,283,381,431,960,41.123024178671805,34.47820024483002
19844,/media/marda/TWOTB1/xBD/hurricanes/images/florence/hurricane-florence_00000321_pre_disaster.png,26,69,1,0,26,549,618,913,47.63386185309406,26.01740811030004
19845,/media/marda/TWOTB1/xBD/hurricanes/images/florence/hurricane-florence_00000321_pre_disaster.png,54,72,1,2,56,654,726,1462,53.398367953082506,38.33702414251542
19846,/media/marda/TWOTB1/xBD/hurricanes/images/florence/hurricane-florence_00000321_pre_disaster.png,60,82,1,260,320,814,896,1437,48.71990047857914,40.519537728132846
19847,/media/marda/TWOTB1/xBD/hurricanes/images/florence/hurricane-florence_00000321_pre_disaster.png,26,46,1,301,327,837,883,122,13.176564067268837,12.488071503357235
19848,/media/marda/TWOTB1/xBD/hurricanes/images/florence/hurricane-florence_00000321_pre_disaster.png,57,73,1,90,147,913,986,1168,53.89052553305672,30.486611649986045
19849,/media/marda/TWOTB1/xBD/hurricanes/images/florence/hurricane-florence_00000321_pre_disaster.png,29,63,1,44,73,914,977,474,28.44112434503341,22.057675959134656
19850,/media/marda/TWOTB1/xBD/hurricanes/images/florence/hurricane-florence_00000321_pre_disaster.png,32,61,1,62,94,944,1005,523,33.56284928398324,20.38426118464931
19851,/media/marda/TWOTB1/xBD/hurricanes/images/florence/hurricane-florence_00000321_pre_disaster.png,18,51,1,39,57,964,1015,158,16.884388333670664,12.462818821037887
19852,/media/marda/TWOTB1/xBD/hurricanes/images/florence/hurricane-florence_00000321_pre_disaster.png,30,51,1,387,417,979,1030,119,13.652046121732107,11.70035219340214
19853,/media/marda/TWOTB1/xBD/hurricanes/images/florence/hurricane-florence_00000036_pre_disaster.png,46,12,1,177,223,0,12,350,43.46846366985854,10.985018223283113
19854,/media/marda/TWOTB1/xBD/hurricanes/images/florence/hurricane-florence_00000036_pre_disaster.png,46,11,1,498,544,0,11,225,28.337722035055258,10.67339041496953
19855,/media/marda/TWOTB1/xBD/hurricanes/images/florence/hurricane-florence_00000036_pre_disaster.png,37,23,1,572,609,71,94,368,25.923242937260934,18.721553927915934
19856,/media/marda/TWOTB1/xBD/hurricanes/images/florence/hurricane-florence_00000036_pre_disaster.png,38,21,1,417,455,75,96,395,23.55899471656234,22.222680426889532
19857,/media/marda/TWOTB1/xBD/hurricanes/images/florence/hurricane-florence_00000036_pre_disaster.png,32,49,1,153,185,82,131,1012,52.629200979731536,25.664628052804115
19858,/media/marda/TWOTB1/xBD/hurricanes/images/florence/hurricane-florence_00000036_pre_disaster.png,69,42,1,517,586,98,140,1326,54.70000847091664,34.70004950560142
19859,/media/marda/TWOTB1/xBD/hurricanes/images/florence/hurricane-florence_00000036_pre_disaster.png,58,46,1,370,428,119,165,1317,48.7476995561392,38.100832247113125
19860,/media/marda/TWOTB1/xBD/hurricanes/images/florence/hurricane-florence_00000036_pre_disaster.png,27,29,1,0,27,181,210,623,31.248540908680127,26.62510595889762
19861,/media/marda/TWOTB1/xBD/hurricanes/images/florence/hurricane-florence_00000036_pre_disaster.png,15,20,1,183,198,197,217,102,12.393163382123587,11.005907209421995
19862,/media/marda/TWOTB1/xBD/hurricanes/images/florence/hurricane-florence_00000036_pre_disaster.png,53,56,1,196,249,212,268,1434,55.288704173009556,38.13864757966404
19863,/media/marda/TWOTB1/xBD/hurricanes/images/florence/hurricane-florence_00000036_pre_disaster.png,67,48,1,528,595,214,262,1410,55.17516352419198,36.08381542313503
19864,/media/marda/TWOTB1/xBD/hurricanes/images/florence/hurricane-florence_00000036_pre_disaster.png,63,64,1,371,434,238,302,1979,57.80621083682075,46.735487557187604
19865,/media/marda/TWOTB1/xBD/hurricanes/images/florence/hurricane-florence_00000036_pre_disaster.png,49,31,1,588,637,254,285,441,25.93798657979634,22.498283263417722
19866,/media/marda/TWOTB1/xBD/hurricanes/images/florence/hurricane-florence_00000036_pre_disaster.png,67,30,1,444,511,271,301,961,55.500369800066515,23.12825982800042
19867,/media/marda/TWOTB1/xBD/hurricanes/images/florence/hurricane-florence_00000036_pre_disaster.png,44,35,1,373,417,342,377,529,32.41993547284643,21.75575141748278
19868,/media/marda/TWOTB1/xBD/hurricanes/images/florence/hurricane-florence_00000036_pre_disaster.png,23,39,1,193,216,440,479,327,24.555720369231274,17.77548175584873
19869,/media/marda/TWOTB1/xBD/hurricanes/images/florence/hurricane-florence_00000036_pre_disaster.png,49,35,1,217,266,446,481,652,44.51825351086523,19.27881961093987
19870,/media/marda/TWOTB1/xBD/hurricanes/images/florence/hurricane-florence_00000036_pre_disaster.png,49,32,1,422,471,487,519,506,36.59377404002464,18.224728946498853
19871,/media/marda/TWOTB1/xBD/hurricanes/images/florence/hurricane-florence_00000036_pre_disaster.png,59,79,1,461,520,496,575,1932,64.20798266408758,40.28492450018047
19872,/media/marda/TWOTB1/xBD/hurricanes/images/florence/hurricane-florence_00000036_pre_disaster.png,46,59,1,385,431,500,559,1008,43.28281354027697,31.634469324098177
19873,/media/marda/TWOTB1/xBD/hurricanes/images/florence/hurricane-florence_00000036_pre_disaster.png,12,32,1,160,172,514,546,90,13.829725346675374,8.627142384614592
19874,/media/marda/TWOTB1/xBD/hurricanes/images/florence/hurricane-florence_00000036_pre_disaster.png,51,46,1,116,167,538,584,988,52.74793548202011,25.00665365511566
19875,/media/marda/TWOTB1/xBD/hurricanes/images/florence/hurricane-florence_00000036_pre_disaster.png,80,65,1,199,279,547,612,2011,83.0214898679694,40.27134364729893
19876,/media/marda/TWOTB1/xBD/hurricanes/images/florence/hurricane-florence_00000036_pre_disaster.png,42,41,1,606,648,582,623,285,22.069550826690776,17.13947829105611
19877,/media/marda/TWOTB1/xBD/hurricanes/images/florence/hurricane-florence_00000036_pre_disaster.png,59,122,1,456,515,605,727,2895,108.91843423300473,35.40725083950366
19878,/media/marda/TWOTB1/xBD/hurricanes/images/florence/hurricane-florence_00000036_pre_disaster.png,44,48,1,240,284,611,659,664,37.709028432359254,23.229989646791324
19879,/media/marda/TWOTB1/xBD/hurricanes/images/florence/hurricane-florence_00000036_pre_disaster.png,63,54,1,600,663,614,668,1125,43.45700772189582,34.49691690439117
19880,/media/marda/TWOTB1/xBD/hurricanes/images/florence/hurricane-florence_00000036_pre_disaster.png,28,38,1,196,224,615,653,239,23.048530956332147,13.772346557982603
19881,/media/marda/TWOTB1/xBD/hurricanes/images/florence/hurricane-florence_00000036_pre_disaster.png,24,37,1,197,221,652,689,150,17.02243528887729,11.870122490821073
19882,/media/marda/TWOTB1/xBD/hurricanes/images/florence/hurricane-florence_00000036_pre_disaster.png,37,53,1,235,272,662,715,583,28.429267099870373,27.89708696485078
19883,/media/marda/TWOTB1/xBD/hurricanes/images/florence/hurricane-florence_00000036_pre_disaster.png,32,58,1,143,175,682,740,758,35.64158863270919,28.40760743759474
19884,/media/marda/TWOTB1/xBD/hurricanes/images/florence/hurricane-florence_00000036_pre_disaster.png,20,46,1,38,58,686,732,270,19.954558274723563,18.111814549704388
19885,/media/marda/TWOTB1/xBD/hurricanes/images/florence/hurricane-florence_00000036_pre_disaster.png,44,86,1,211,255,692,778,1483,58.811671829370304,33.47440559205623
19886,/media/marda/TWOTB1/xBD/hurricanes/images/florence/hurricane-florence_00000036_pre_disaster.png,23,52,1,147,170,723,775,316,23.855093987082764,17.70926410586406
19887,/media/marda/TWOTB1/xBD/hurricanes/images/florence/hurricane-florence_00000036_pre_disaster.png,32,64,1,137,169,787,851,593,31.989904010087116,24.764779685173092
19888,/media/marda/TWOTB1/xBD/hurricanes/images/florence/hurricane-florence_00000036_pre_disaster.png,45,86,1,200,245,800,886,1472,58.53187969558659,34.41842034374546
19889,/media/marda/TWOTB1/xBD/hurricanes/images/florence/hurricane-florence_00000036_pre_disaster.png,16,45,1,140,156,826,871,110,12.799681582673466,11.618404577905213
19890,/media/marda/TWOTB1/xBD/hurricanes/images/florence/hurricane-florence_00000036_pre_disaster.png,21,49,1,121,142,839,888,210,17.373117764178314,16.241524397448007
19891,/media/marda/TWOTB1/xBD/hurricanes/images/florence/hurricane-florence_00000036_pre_disaster.png,54,72,1,178,232,910,982,1352,49.74043560758631,35.735416792917164
19892,/media/marda/TWOTB1/xBD/hurricanes/images/florence/hurricane-florence_00000036_pre_disaster.png,25,52,1,151,176,935,987,320,23.261388431279826,18.30048655771537
19893,/media/marda/TWOTB1/xBD/hurricanes/images/florence/hurricane-florence_00000206_post_disaster.png,32,17,1,509,541,175,192,106,12.083316741819461,11.855778939096096
19894,/media/marda/TWOTB1/xBD/hurricanes/images/florence/hurricane-florence_00000206_post_disaster.png,34,17,1,503,537,193,210,109,12.993994757072029,11.2807394181584
19895,/media/marda/TWOTB1/xBD/hurricanes/images/florence/hurricane-florence_00000308_post_disaster.png,119,100,1,17,136,264,364,5860,109.35131946261224,76.9582887185126
19896,/media/marda/TWOTB1/xBD/hurricanes/images/florence/hurricane-florence_00000308_post_disaster.png,14,25,1,30,44,265,290,116,16.312829155479236,9.585638767463234
19897,/media/marda/TWOTB1/xBD/hurricanes/images/florence/hurricane-florence_00000308_post_disaster.png,61,74,1,515,576,769,843,1128,51.195352365183,30.1006662011251
19898,/media/marda/TWOTB1/xBD/hurricanes/images/florence/hurricane-florence_00000308_post_disaster.png,61,59,1,299,360,774,833,810,52.15879975360193,20.764166994454854
19899,/media/marda/TWOTB1/xBD/hurricanes/images/florence/hurricane-florence_00000308_post_disaster.png,56,94,1,253,309,779,873,1498,72.09712784581323,29.97953618641085
19900,/media/marda/TWOTB1/xBD/hurricanes/images/florence/hurricane-florence_00000308_post_disaster.png,50,60,1,580,630,797,857,558,28.336428647337108,26.101022115906712
19901,/media/marda/TWOTB1/xBD/hurricanes/images/florence/hurricane-florence_00000308_post_disaster.png,68,71,1,552,620,827,898,1113,46.652159396537726,34.09009243401015
19902,/media/marda/TWOTB1/xBD/hurricanes/images/florence/hurricane-florence_00000308_post_disaster.png,17,41,1,266,283,879,920,62,9.243946207147804,8.541142982746502
19903,/media/marda/TWOTB1/xBD/hurricanes/images/florence/hurricane-florence_00000308_post_disaster.png,83,85,1,279,362,945,1030,2106,80.34212014189619,34.492885890391435
19904,/media/marda/TWOTB1/xBD/hurricanes/images/florence/hurricane-florence_00000308_post_disaster.png,22,54,1,216,238,989,1043,134,13.567887471427376,12.613158082219504
19905,/media/marda/TWOTB1/xBD/hurricanes/images/florence/hurricane-florence_00000308_post_disaster.png,52,58,1,568,620,872,930,482,29.613731188294775,21.581601291818814
19906,/media/marda/TWOTB1/xBD/hurricanes/images/florence/hurricane-florence_00000308_post_disaster.png,57,71,1,619,676,889,960,760,36.73240151573282,28.765428960189695
19907,/media/marda/TWOTB1/xBD/hurricanes/images/florence/hurricane-florence_00000286_pre_disaster.png,33,61,1,69,102,328,389,724,54.996849302552626,17.441505824149736
19908,/media/marda/TWOTB1/xBD/hurricanes/images/florence/hurricane-florence_00000286_pre_disaster.png,17,28,1,189,206,431,459,100,12.241573664011561,11.144930427265065
19909,/media/marda/TWOTB1/xBD/hurricanes/images/florence/hurricane-florence_00000286_pre_disaster.png,20,31,1,187,207,446,477,118,14.593341942236096,10.841717831286884
19910,/media/marda/TWOTB1/xBD/hurricanes/images/florence/hurricane-florence_00000286_pre_disaster.png,23,36,1,206,229,469,505,212,20.12645656873524,14.146847463538492
19911,/media/marda/TWOTB1/xBD/hurricanes/images/florence/hurricane-florence_00000286_pre_disaster.png,39,61,1,156,195,471,532,997,46.105482202638804,29.200693437252564
19912,/media/marda/TWOTB1/xBD/hurricanes/images/florence/hurricane-florence_00000286_pre_disaster.png,41,76,1,200,241,621,697,1030,56.61539926105171,24.1734425386683
19913,/media/marda/TWOTB1/xBD/hurricanes/images/florence/hurricane-florence_00000286_pre_disaster.png,35,47,1,264,299,628,675,417,28.876517356692673,19.564669595576028
19914,/media/marda/TWOTB1/xBD/hurricanes/images/florence/hurricane-florence_00000286_pre_disaster.png,53,67,1,212,265,756,823,1051,47.499285223415605,29.922243737878375
19915,/media/marda/TWOTB1/xBD/hurricanes/images/florence/hurricane-florence_00000286_pre_disaster.png,94,81,1,233,327,805,886,2066,79.69949091428751,40.0189802082441
19916,/media/marda/TWOTB1/xBD/hurricanes/images/florence/hurricane-florence_00000286_pre_disaster.png,45,79,1,467,512,812,891,529,52.194319544444774,13.540204144523706
19917,/media/marda/TWOTB1/xBD/hurricanes/images/florence/hurricane-florence_00000286_pre_disaster.png,50,75,1,420,470,837,912,540,50.019003275021866,14.419998211178436
19918,/media/marda/TWOTB1/xBD/hurricanes/images/florence/hurricane-florence_00000286_pre_disaster.png,43,63,1,283,326,851,914,693,31.69848763935896,28.626789301873433
19919,/media/marda/TWOTB1/xBD/hurricanes/images/florence/hurricane-florence_00000286_pre_disaster.png,51,51,1,923,974,902,953,112,14.305265255456726,10.53666815302356
19920,/media/marda/TWOTB1/xBD/hurricanes/images/florence/hurricane-florence_00000286_pre_disaster.png,32,70,1,260,292,913,983,402,37.08587345641508,14.361131873383112
19921,/media/marda/TWOTB1/xBD/hurricanes/images/florence/hurricane-florence_00000286_pre_disaster.png,68,91,1,976,1044,914,1005,855,46.2058443466409,28.28936680441323
19922,/media/marda/TWOTB1/xBD/hurricanes/images/florence/hurricane-florence_00000286_pre_disaster.png,57,56,1,948,1005,933,989,268,20.895328728484298,16.622566570654914
19923,/media/marda/TWOTB1/xBD/hurricanes/images/florence/hurricane-florence_00000286_pre_disaster.png,34,68,1,286,320,974,1042,404,36.711031644597654,14.722974980350541
19924,/media/marda/TWOTB1/xBD/hurricanes/images/florence/hurricane-florence_00000373_pre_disaster.png,66,56,1,507,573,124,180,1090,53.119729551806834,27.377176485551175
19925,/media/marda/TWOTB1/xBD/hurricanes/images/florence/hurricane-florence_00000373_pre_disaster.png,25,28,1,88,113,176,204,303,21.520771095435734,18.67627642749851
19926,/media/marda/TWOTB1/xBD/hurricanes/images/florence/hurricane-florence_00000373_pre_disaster.png,37,24,1,320,357,191,215,248,24.669530721203216,13.30578094457587
19927,/media/marda/TWOTB1/xBD/hurricanes/images/florence/hurricane-florence_00000373_pre_disaster.png,60,52,1,395,455,210,262,865,50.320301832353664,23.045167587692827
19928,/media/marda/TWOTB1/xBD/hurricanes/images/florence/hurricane-florence_00000373_pre_disaster.png,53,48,1,320,373,218,266,884,35.28859100017574,33.20667063825773
19929,/media/marda/TWOTB1/xBD/hurricanes/images/florence/hurricane-florence_00000373_pre_disaster.png,42,54,1,77,119,223,277,1018,40.05190363113902,33.58702563179832
19930,/media/marda/TWOTB1/xBD/hurricanes/images/florence/hurricane-florence_00000373_pre_disaster.png,39,26,1,510,549,225,251,168,16.907764872732788,13.336710607199008
19931,/media/marda/TWOTB1/xBD/hurricanes/images/florence/hurricane-florence_00000373_pre_disaster.png,37,28,1,416,453,275,303,210,17.366950087313707,16.198427228121698
19932,/media/marda/TWOTB1/xBD/hurricanes/images/florence/hurricane-florence_00000373_pre_disaster.png,15,46,1,0,15,322,368,250,30.224997818129367,13.489844583762812
19933,/media/marda/TWOTB1/xBD/hurricanes/images/florence/hurricane-florence_00000373_pre_disaster.png,62,66,1,352,414,385,451,1097,60.22076011057055,24.32114249295761
19934,/media/marda/TWOTB1/xBD/hurricanes/images/florence/hurricane-florence_00000373_pre_disaster.png,39,32,1,540,579,386,418,202,19.254389524563454,13.952781455592541
19935,/media/marda/TWOTB1/xBD/hurricanes/images/florence/hurricane-florence_00000373_pre_disaster.png,66,67,1,491,557,393,460,1118,51.769815790955306,28.815215271491756
19936,/media/marda/TWOTB1/xBD/hurricanes/images/florence/hurricane-florence_00000373_pre_disaster.png,52,42,1,564,616,416,458,372,29.833203346666966,16.6615595032607
19937,/media/marda/TWOTB1/xBD/hurricanes/images/florence/hurricane-florence_00000373_pre_disaster.png,40,34,1,589,629,430,464,168,15.276800921659687,14.735932215885752
19938,/media/marda/TWOTB1/xBD/hurricanes/images/florence/hurricane-florence_00000373_pre_disaster.png,47,36,1,624,671,450,486,210,24.295616132118532,11.557277179697678
19939,/media/marda/TWOTB1/xBD/hurricanes/images/florence/hurricane-florence_00000373_pre_disaster.png,32,33,1,379,411,462,495,158,16.046566156763653,13.146742124977502
19940,/media/marda/TWOTB1/xBD/hurricanes/images/florence/hurricane-florence_00000373_pre_disaster.png,36,35,1,526,562,463,498,171,16.785473141892176,13.75196724629538
19941,/media/marda/TWOTB1/xBD/hurricanes/images/florence/hurricane-florence_00000373_pre_disaster.png,47,50,1,393,440,468,518,448,39.486678493958294,16.71129510667329
19942,/media/marda/TWOTB1/xBD/hurricanes/images/florence/hurricane-florence_00000373_pre_disaster.png,55,36,1,620,675,471,507,298,29.756011435585833,16.56237930074759
19943,/media/marda/TWOTB1/xBD/hurricanes/images/florence/hurricane-florence_00000373_pre_disaster.png,29,30,1,424,453,479,509,104,12.539326161653484,11.130435803993498
19944,/media/marda/TWOTB1/xBD/hurricanes/images/florence/hurricane-florence_00000373_pre_disaster.png,52,41,1,601,653,489,530,298,30.022176598217982,13.28541844399142
19945,/media/marda/TWOTB1/xBD/hurricanes/images/florence/hurricane-florence_00000373_pre_disaster.png,39,38,1,619,658,538,576,150,15.151911657975196,13.156008166867835
19946,/media/marda/TWOTB1/xBD/hurricanes/images/florence/hurricane-florence_00000373_pre_disaster.png,46,41,1,625,671,573,614,231,18.51283111994241,16.679387821444145
19947,/media/marda/TWOTB1/xBD/hurricanes/images/florence/hurricane-florence_00000162_post_disaster.png,57,52,1,892,949,436,488,409,37.781107864976896,15.969654453856258
19948,/media/marda/TWOTB1/xBD/hurricanes/images/florence/hurricane-florence_00000162_post_disaster.png,48,32,1,914,962,499,531,72,11.620367469828654,8.331356690875289
19949,/media/marda/TWOTB1/xBD/hurricanes/images/florence/hurricane-florence_00000162_post_disaster.png,43,72,1,15,58,512,584,1039,55.15090517977588,25.05942580704323
19950,/media/marda/TWOTB1/xBD/hurricanes/images/florence/hurricane-florence_00000162_post_disaster.png,80,62,1,883,963,563,625,1049,46.82758083458402,32.9224111676019
19951,/media/marda/TWOTB1/xBD/hurricanes/images/florence/hurricane-florence_00000162_post_disaster.png,59,47,1,876,935,636,683,289,27.130202196231878,14.133013614772201
19952,/media/marda/TWOTB1/xBD/hurricanes/images/florence/hurricane-florence_00000162_post_disaster.png,49,44,1,797,846,865,909,97,16.576334420439508,7.785541590245974
19953,/media/marda/TWOTB1/xBD/hurricanes/images/florence/hurricane-florence_00000162_post_disaster.png,55,57,1,767,822,907,964,323,25.285785323335862,16.74010191429329
19954,/media/marda/TWOTB1/xBD/hurricanes/images/florence/hurricane-florence_00000250_pre_disaster.png,72,41,1,467,539,321,362,762,48.46796409008962,22.119791611367912
19955,/media/marda/TWOTB1/xBD/hurricanes/images/florence/hurricane-florence_00000250_pre_disaster.png,35,27,1,495,530,377,404,120,13.03111714566012,12.228336279245228
19956,/media/marda/TWOTB1/xBD/hurricanes/images/florence/hurricane-florence_00000250_pre_disaster.png,40,40,1,624,664,621,661,136,15.101425992941518,12.103170054463149
19957,/media/marda/TWOTB1/xBD/hurricanes/images/florence/hurricane-florence_00000250_pre_disaster.png,53,56,1,555,608,648,704,561,33.32936278439593,22.312168370647015
19958,/media/marda/TWOTB1/xBD/hurricanes/images/florence/hurricane-florence_00000250_pre_disaster.png,73,72,1,587,660,686,758,1089,52.09401341674768,34.15895152571917
19959,/media/marda/TWOTB1/xBD/hurricanes/images/florence/hurricane-florence_00000492_post_disaster.png,56,41,1,42,98,0,41,1432,53.52167881631231,34.92832909800774
19960,/media/marda/TWOTB1/xBD/hurricanes/images/florence/hurricane-florence_00000492_post_disaster.png,92,66,1,327,419,9,75,2525,73.34722274744419,60.33004108063871
19961,/media/marda/TWOTB1/xBD/hurricanes/images/florence/hurricane-florence_00000492_post_disaster.png,68,64,1,106,174,206,270,2026,58.04104402595048,48.340101900763315
19962,/media/marda/TWOTB1/xBD/hurricanes/images/florence/hurricane-florence_00000492_post_disaster.png,59,83,1,36,95,243,326,2548,70.90307383852564,50.30490631720609
19963,/media/marda/TWOTB1/xBD/hurricanes/images/florence/hurricane-florence_00000402_post_disaster.png,48,18,1,410,458,0,18,396,32.24987557256891,16.6882202107343
19964,/media/marda/TWOTB1/xBD/hurricanes/images/florence/hurricane-florence_00000402_post_disaster.png,39,18,1,335,374,2,20,450,29.866877723152655,19.724974086790795
19965,/media/marda/TWOTB1/xBD/hurricanes/images/florence/hurricane-florence_00000402_post_disaster.png,23,11,1,378,401,12,23,93,12.027651394952851,10.420312555266552
19966,/media/marda/TWOTB1/xBD/hurricanes/images/florence/hurricane-florence_00000402_post_disaster.png,23,12,1,318,341,21,33,106,13.247364806100476,10.711815754175676
19967,/media/marda/TWOTB1/xBD/hurricanes/images/florence/hurricane-florence_00000402_post_disaster.png,53,42,1,397,450,28,70,837,43.08069786537454,26.435884793243027
19968,/media/marda/TWOTB1/xBD/hurricanes/images/florence/hurricane-florence_00000402_post_disaster.png,56,32,1,437,493,32,64,703,38.88307800033951,23.970545802855607
19969,/media/marda/TWOTB1/xBD/hurricanes/images/florence/hurricane-florence_00000402_post_disaster.png,39,18,1,374,413,41,59,421,28.717477084158627,19.4811289476217
19970,/media/marda/TWOTB1/xBD/hurricanes/images/florence/hurricane-florence_00000402_post_disaster.png,73,38,1,971,1044,281,319,661,39.291405084247664,22.2455216558598
19971,/media/marda/TWOTB1/xBD/hurricanes/images/florence/hurricane-florence_00000402_post_disaster.png,77,43,1,896,973,321,364,776,41.64306695870985,24.75131536246691
19972,/media/marda/TWOTB1/xBD/hurricanes/images/florence/hurricane-florence_00000402_post_disaster.png,60,53,1,568,628,349,402,997,38.14284382376069,34.895595229665695
19973,/media/marda/TWOTB1/xBD/hurricanes/images/florence/hurricane-florence_00000402_post_disaster.png,53,28,1,879,932,358,386,191,17.608698387816744,14.036313132818135
19974,/media/marda/TWOTB1/xBD/hurricanes/images/florence/hurricane-florence_00000402_post_disaster.png,227,114,1,453,680,497,611,6193,239.32550354904942,34.51802085209157
19975,/media/marda/TWOTB1/xBD/hurricanes/images/florence/hurricane-florence_00000340_post_disaster.png,55,12,1,775,830,0,12,204,26.28269891043499,10.773908322251648
19976,/media/marda/TWOTB1/xBD/hurricanes/images/florence/hurricane-florence_00000340_post_disaster.png,65,49,1,743,808,45,94,1034,50.207583071884436,27.40850566363514
19977,/media/marda/TWOTB1/xBD/hurricanes/images/florence/hurricane-florence_00000340_post_disaster.png,68,52,1,718,786,119,171,1088,48.87776953051086,29.708113032582418
19978,/media/marda/TWOTB1/xBD/hurricanes/images/florence/hurricane-florence_00000340_post_disaster.png,39,27,1,471,510,165,192,340,22.00202640436992,20.68833406249376
19979,/media/marda/TWOTB1/xBD/hurricanes/images/florence/hurricane-florence_00000340_post_disaster.png,50,43,1,491,541,195,238,706,39.1130069584459,24.13328469084986
19980,/media/marda/TWOTB1/xBD/hurricanes/images/florence/hurricane-florence_00000340_post_disaster.png,60,55,1,677,737,269,324,990,46.504097190542055,28.15714307506342
19981,/media/marda/TWOTB1/xBD/hurricanes/images/florence/hurricane-florence_00000340_post_disaster.png,49,53,1,449,498,271,324,857,46.06473535995674,24.841682051252903
19982,/media/marda/TWOTB1/xBD/hurricanes/images/florence/hurricane-florence_00000340_post_disaster.png,51,53,1,566,617,301,354,754,40.853681981536276,24.65407569935144
19983,/media/marda/TWOTB1/xBD/hurricanes/images/florence/hurricane-florence_00000340_post_disaster.png,60,57,1,627,687,345,402,1031,47.85433706865039,28.643045785837565
19984,/media/marda/TWOTB1/xBD/hurricanes/images/florence/hurricane-florence_00000340_post_disaster.png,71,59,1,423,494,423,482,1480,52.695533647689395,37.394131779073675
19985,/media/marda/TWOTB1/xBD/hurricanes/images/florence/hurricane-florence_00000340_post_disaster.png,69,76,1,613,682,439,515,1522,60.220822065965244,38.036082070306854
19986,/media/marda/TWOTB1/xBD/hurricanes/images/florence/hurricane-florence_00000340_post_disaster.png,64,52,1,509,573,446,498,954,45.54542827404187,27.914518974011678
19987,/media/marda/TWOTB1/xBD/hurricanes/images/florence/hurricane-florence_00000340_post_disaster.png,32,30,1,574,606,482,512,113,12.829987601049009,11.867124712846678
19988,/media/marda/TWOTB1/xBD/hurricanes/images/florence/hurricane-florence_00000340_post_disaster.png,51,39,1,422,473,491,530,793,39.82792734204361,26.527989771590633
19989,/media/marda/TWOTB1/xBD/hurricanes/images/florence/hurricane-florence_00000340_post_disaster.png,56,43,1,490,546,491,534,759,39.548514572790964,25.649139650682354
19990,/media/marda/TWOTB1/xBD/hurricanes/images/florence/hurricane-florence_00000340_post_disaster.png,31,31,1,571,602,496,527,74,10.477126781232585,9.627716560555156
19991,/media/marda/TWOTB1/xBD/hurricanes/images/florence/hurricane-florence_00000340_post_disaster.png,44,46,1,414,458,763,809,460,31.27233615361998,19.638100217506715
19992,/media/marda/TWOTB1/xBD/hurricanes/images/florence/hurricane-florence_00000340_post_disaster.png,42,77,1,451,493,795,872,937,47.65150993617855,26.56437197727702
19993,/media/marda/TWOTB1/xBD/hurricanes/images/florence/hurricane-florence_00000340_post_disaster.png,44,73,1,416,460,800,873,994,47.03779817477743,28.968722167802643
19994,/media/marda/TWOTB1/xBD/hurricanes/images/florence/hurricane-florence_00000340_post_disaster.png,50,90,1,487,537,862,952,1028,62.40482645683889,21.98877893361066
19995,/media/marda/TWOTB1/xBD/hurricanes/images/florence/hurricane-florence_00000340_post_disaster.png,46,83,1,217,263,883,966,1100,51.919681362153874,28.766435497283176
19996,/media/marda/TWOTB1/xBD/hurricanes/images/florence/hurricane-florence_00000340_post_disaster.png,29,47,1,316,345,921,968,166,19.148321585414486,11.572987037652394
19997,/media/marda/TWOTB1/xBD/hurricanes/images/florence/hurricane-florence_00000312_post_disaster.png,25,21,1,170,195,77,98,250,18.79821375087839,17.720477413892855
19998,/media/marda/TWOTB1/xBD/hurricanes/images/florence/hurricane-florence_00000312_post_disaster.png,42,42,1,183,225,94,136,809,40.31386390684394,26.662608863763083
19999,/media/marda/TWOTB1/xBD/hurricanes/images/florence/hurricane-florence_00000312_post_disaster.png,25,17,1,247,272,127,144,118,16.70858428562419,9.466759427909428
20000,/media/marda/TWOTB1/xBD/hurricanes/images/florence/hurricane-florence_00000312_post_disaster.png,52,46,1,331,383,128,174,883,43.29799876793003,27.239208897516974
20001,/media/marda/TWOTB1/xBD/hurricanes/images/florence/hurricane-florence_00000312_post_disaster.png,20,17,1,194,214,133,150,98,14.046016614452641,9.355519429573786
20002,/media/marda/TWOTB1/xBD/hurricanes/images/florence/hurricane-florence_00000312_post_disaster.png,40,21,1,628,668,242,263,118,15.722673760292622,9.976821764283871
20003,/media/marda/TWOTB1/xBD/hurricanes/images/florence/hurricane-florence_00000312_post_disaster.png,71,51,1,599,670,251,302,1030,49.8648550005455,29.311593558708697
20004,/media/marda/TWOTB1/xBD/hurricanes/images/florence/hurricane-florence_00000312_post_disaster.png,69,51,1,567,636,366,417,1122,47.318989437596876,31.700319828852265
20005,/media/marda/TWOTB1/xBD/hurricanes/images/florence/hurricane-florence_00000312_post_disaster.png,33,26,1,603,636,399,425,70,9.9945015576432,9.519161119037014
20006,/media/marda/TWOTB1/xBD/hurricanes/images/florence/hurricane-florence_00000312_post_disaster.png,66,59,1,617,683,460,519,1206,41.4697235593055,38.652119782374776
20007,/media/marda/TWOTB1/xBD/hurricanes/images/florence/hurricane-florence_00000312_post_disaster.png,46,40,1,657,703,474,514,336,22.032809743623,20.416684576273045
20008,/media/marda/TWOTB1/xBD/hurricanes/images/florence/hurricane-florence_00000059_post_disaster.png,94,86,1,938,1032,596,682,1316,67.42440772311934,35.27847084271766
20009,/media/marda/TWOTB1/xBD/hurricanes/images/florence/hurricane-florence_00000059_post_disaster.png,78,81,1,775,853,651,732,1413,53.24476151053055,37.78913574487084
20010,/media/marda/TWOTB1/xBD/hurricanes/images/florence/hurricane-florence_00000387_pre_disaster.png,57,27,1,839,896,158,185,466,26.941068247265147,22.72336763142363
20011,/media/marda/TWOTB1/xBD/hurricanes/images/florence/hurricane-florence_00000387_pre_disaster.png,45,45,1,555,600,162,207,602,43.856875618545615,18.34376612008675
20012,/media/marda/TWOTB1/xBD/hurricanes/images/florence/hurricane-florence_00000387_pre_disaster.png,42,47,1,491,533,166,213,571,48.65219300943093,15.644396721997818
20013,/media/marda/TWOTB1/xBD/hurricanes/images/florence/hurricane-florence_00000387_pre_disaster.png,47,45,1,412,459,168,213,533,47.5541012815889,14.963707740752087
20014,/media/marda/TWOTB1/xBD/hurricanes/images/florence/hurricane-florence_00000387_pre_disaster.png,43,42,1,453,496,169,211,462,41.84344291447717,14.786177817940752
20015,/media/marda/TWOTB1/xBD/hurricanes/images/florence/hurricane-florence_00000387_pre_disaster.png,37,38,1,526,563,172,210,381,36.96134303272901,13.8855037119775
20016,/media/marda/TWOTB1/xBD/hurricanes/images/florence/hurricane-florence_00000387_pre_disaster.png,55,23,1,827,882,188,211,375,24.438381413026466,20.218561222585606
20017,/media/marda/TWOTB1/xBD/hurricanes/images/florence/hurricane-florence_00000387_pre_disaster.png,73,19,1,338,411,190,209,677,67.66446101050553,13.376687213548333
20018,/media/marda/TWOTB1/xBD/hurricanes/images/florence/hurricane-florence_00000387_pre_disaster.png,65,58,1,838,903,202,260,1353,50.70122359200937,35.294548215074634
20019,/media/marda/TWOTB1/xBD/hurricanes/images/florence/hurricane-florence_00000387_pre_disaster.png,117,55,1,76,193,222,277,1984,131.9618282267638,20.06569052351203
20020,/media/marda/TWOTB1/xBD/hurricanes/images/florence/hurricane-florence_00000387_pre_disaster.png,45,64,1,543,588,225,289,866,63.42677388878355,18.23836307206387
20021,/media/marda/TWOTB1/xBD/hurricanes/images/florence/hurricane-florence_00000387_pre_disaster.png,37,48,1,449,486,227,275,604,43.25918813058288,18.666299090956297
20022,/media/marda/TWOTB1/xBD/hurricanes/images/florence/hurricane-florence_00000387_pre_disaster.png,43,59,1,513,556,227,286,771,57.938698132987234,17.78249348182318
20023,/media/marda/TWOTB1/xBD/hurricanes/images/florence/hurricane-florence_00000387_pre_disaster.png,44,55,1,480,524,232,287,814,51.02746367866034,21.356821412070584
20024,/media/marda/TWOTB1/xBD/hurricanes/images/florence/hurricane-florence_00000387_pre_disaster.png,38,46,1,415,453,235,281,534,40.425195024533366,17.65732525945904
20025,/media/marda/TWOTB1/xBD/hurricanes/images/florence/hurricane-florence_00000387_pre_disaster.png,34,43,1,352,386,236,279,475,37.70195368946107,16.84144610282317
20026,/media/marda/TWOTB1/xBD/hurricanes/images/florence/hurricane-florence_00000387_pre_disaster.png,48,54,1,568,616,238,292,652,49.68332104327572,19.160892941702237
20027,/media/marda/TWOTB1/xBD/hurricanes/images/florence/hurricane-florence_00000387_pre_disaster.png,37,45,1,381,418,239,284,510,40.25103292850224,16.93831720196036
20028,/media/marda/TWOTB1/xBD/hurricanes/images/florence/hurricane-florence_00000387_pre_disaster.png,34,50,1,281,315,249,299,597,44.81859601114543,17.799130524721804
20029,/media/marda/TWOTB1/xBD/hurricanes/images/florence/hurricane-florence_00000387_pre_disaster.png,116,54,1,70,186,251,305,1964,130.65278942335996,20.05653562567876
20030,/media/marda/TWOTB1/xBD/hurricanes/images/florence/hurricane-florence_00000387_pre_disaster.png,39,47,1,311,350,251,298,545,43.50641478299038,16.793878869096794
20031,/media/marda/TWOTB1/xBD/hurricanes/images/florence/hurricane-florence_00000387_pre_disaster.png,115,54,1,62,177,277,331,1940,129.99493299526293,19.912505756773303
20032,/media/marda/TWOTB1/xBD/hurricanes/images/florence/hurricane-florence_00000387_pre_disaster.png,75,56,1,363,438,321,377,1804,67.75458755357113,40.98192732056525
20033,/media/marda/TWOTB1/xBD/hurricanes/images/florence/hurricane-florence_00000387_pre_disaster.png,44,48,1,443,487,329,377,848,39.19415117027742,28.562519370592053
20034,/media/marda/TWOTB1/xBD/hurricanes/images/florence/hurricane-florence_00000387_pre_disaster.png,53,65,1,393,446,486,551,1175,49.726149132318234,31.540494797515088
20035,/media/marda/TWOTB1/xBD/hurricanes/images/florence/hurricane-florence_00000387_pre_disaster.png,82,63,1,204,286,510,573,1804,80.14911790473036,30.377437903130616
20036,/media/marda/TWOTB1/xBD/hurricanes/images/florence/hurricane-florence_00000387_pre_disaster.png,23,31,1,300,323,547,578,85,11.37225632005023,10.137461140295846
20037,/media/marda/TWOTB1/xBD/hurricanes/images/florence/hurricane-florence_00000387_pre_disaster.png,43,45,1,461,504,593,638,411,27.518936327165548,19.725210481810727
20038,/media/marda/TWOTB1/xBD/hurricanes/images/florence/hurricane-florence_00000387_pre_disaster.png,70,58,1,320,390,599,657,1182,59.38579108611879,27.183992364417914
20039,/media/marda/TWOTB1/xBD/hurricanes/images/florence/hurricane-florence_00000387_pre_disaster.png,53,48,1,774,827,603,651,552,27.688746209726915,26.5329983228432
20040,/media/marda/TWOTB1/xBD/hurricanes/images/florence/hurricane-florence_00000387_pre_disaster.png,33,37,1,506,539,606,643,148,14.883462326246935,13.240970842871976
20041,/media/marda/TWOTB1/xBD/hurricanes/images/florence/hurricane-florence_00000387_pre_disaster.png,48,38,1,599,647,609,647,264,26.475171917072718,13.226945782554285
20042,/media/marda/TWOTB1/xBD/hurricanes/images/florence/hurricane-florence_00000387_pre_disaster.png,69,77,1,724,793,618,695,1672,56.84824218586499,39.51102167132626
20043,/media/marda/TWOTB1/xBD/hurricanes/images/florence/hurricane-florence_00000387_pre_disaster.png,65,68,1,442,507,619,687,1388,49.23300849622061,39.12426385843938
20044,/media/marda/TWOTB1/xBD/hurricanes/images/florence/hurricane-florence_00000387_pre_disaster.png,51,44,1,833,884,620,664,197,18.228101647795594,14.335509320066583
20045,/media/marda/TWOTB1/xBD/hurricanes/images/florence/hurricane-florence_00000387_pre_disaster.png,66,71,1,583,649,625,696,1432,48.444348098768685,42.55995761279281
20046,/media/marda/TWOTB1/xBD/hurricanes/images/florence/hurricane-florence_00000387_pre_disaster.png,60,69,1,516,576,628,697,1410,52.68224332616719,36.8655885056798
20047,/media/marda/TWOTB1/xBD/hurricanes/images/florence/hurricane-florence_00000387_pre_disaster.png,71,67,1,658,729,632,699,1371,51.65997927648752,38.57378564448825
20048,/media/marda/TWOTB1/xBD/hurricanes/images/florence/hurricane-florence_00000387_pre_disaster.png,84,72,1,797,881,635,707,1313,48.56929682339171,39.177904707054836
20049,/media/marda/TWOTB1/xBD/hurricanes/images/florence/hurricane-florence_00000387_pre_disaster.png,65,75,1,827,892,703,778,1078,48.10218741804795,30.860461357659403
20050,/media/marda/TWOTB1/xBD/hurricanes/images/florence/hurricane-florence_00000387_pre_disaster.png,44,65,1,19,63,705,770,978,47.65335146918607,27.40392792673263
20051,/media/marda/TWOTB1/xBD/hurricanes/images/florence/hurricane-florence_00000387_pre_disaster.png,63,71,1,275,338,727,798,1447,53.019548077259614,37.727812421937635
20052,/media/marda/TWOTB1/xBD/hurricanes/images/florence/hurricane-florence_00000387_pre_disaster.png,60,61,1,338,398,744,805,1040,50.62489783372663,27.07833558005883
20053,/media/marda/TWOTB1/xBD/hurricanes/images/florence/hurricane-florence_00000387_pre_disaster.png,67,72,1,410,477,754,826,1486,51.88041179592849,39.88106102109261
20054,/media/marda/TWOTB1/xBD/hurricanes/images/florence/hurricane-florence_00000387_pre_disaster.png,58,73,1,492,550,762,835,1255,45.693602367417974,38.527556741058795
20055,/media/marda/TWOTB1/xBD/hurricanes/images/florence/hurricane-florence_00000387_pre_disaster.png,64,74,1,637,701,764,838,1356,48.35181328579369,40.23370950554102
20056,/media/marda/TWOTB1/xBD/hurricanes/images/florence/hurricane-florence_00000387_pre_disaster.png,60,70,1,555,615,766,836,1156,44.3790932449142,34.97865314772948
20057,/media/marda/TWOTB1/xBD/hurricanes/images/florence/hurricane-florence_00000387_pre_disaster.png,81,76,1,786,867,768,844,1293,49.18688760318211,38.92635484125284
20058,/media/marda/TWOTB1/xBD/hurricanes/images/florence/hurricane-florence_00000387_pre_disaster.png,68,68,1,703,771,770,838,1171,42.28278968293405,37.5616477330892
20059,/media/marda/TWOTB1/xBD/hurricanes/images/florence/hurricane-florence_00000387_pre_disaster.png,33,47,1,359,392,796,843,201,20.805576595622725,12.868300937923406
20060,/media/marda/TWOTB1/xBD/hurricanes/images/florence/hurricane-florence_00000387_pre_disaster.png,34,42,1,517,551,796,838,132,16.209660544372728,10.85499548939444
20061,/media/marda/TWOTB1/xBD/hurricanes/images/florence/hurricane-florence_00000387_pre_disaster.png,36,47,1,597,633,803,850,155,16.42425964938546,12.623550941073134
20062,/media/marda/TWOTB1/xBD/hurricanes/images/florence/hurricane-florence_00000387_pre_disaster.png,42,44,1,688,730,813,857,137,15.766208736747712,11.703184055757083
20063,/media/marda/TWOTB1/xBD/hurricanes/images/florence/hurricane-florence_00000387_pre_disaster.png,39,71,1,2,41,814,885,1059,40.56091891259518,35.5191641210561
20064,/media/marda/TWOTB1/xBD/hurricanes/images/florence/hurricane-florence_00000387_pre_disaster.png,176,155,1,133,309,834,989,9777,185.30445814925793,103.6771928474231
20065,/media/marda/TWOTB1/xBD/hurricanes/images/florence/hurricane-florence_00000387_pre_disaster.png,69,56,1,324,393,853,909,790,60.33322430472275,19.574665956775803
20066,/media/marda/TWOTB1/xBD/hurricanes/images/florence/hurricane-florence_00000387_pre_disaster.png,10,73,1,0,10,943,1016,269,39.01650398039197,10.198654381739173
20067,/media/marda/TWOTB1/xBD/hurricanes/images/florence/hurricane-florence_00000387_pre_disaster.png,30,62,1,352,382,974,1036,292,26.001146339571527,15.029946544741112
20068,/media/marda/TWOTB1/xBD/hurricanes/images/florence/hurricane-florence_00000237_pre_disaster.png,52,30,1,294,346,0,30,477,44.2595624113894,14.539773135614178
20069,/media/marda/TWOTB1/xBD/hurricanes/images/florence/hurricane-florence_00000237_pre_disaster.png,43,21,1,317,360,0,21,299,31.11879883475488,12.90289895001306
20070,/media/marda/TWOTB1/xBD/hurricanes/images/florence/hurricane-florence_00000237_pre_disaster.png,108,64,1,728,836,79,143,1662,94.78993319358324,23.404689079901104
20071,/media/marda/TWOTB1/xBD/hurricanes/images/florence/hurricane-florence_00000237_pre_disaster.png,116,80,1,928,1044,189,269,3355,88.15434608302742,51.11330885235072
20072,/media/marda/TWOTB1/xBD/hurricanes/images/florence/hurricane-florence_00000237_pre_disaster.png,67,38,1,882,949,235,273,457,28.776671125819373,21.221018206112337
20073,/media/marda/TWOTB1/xBD/hurricanes/images/florence/hurricane-florence_00000237_pre_disaster.png,111,68,1,861,972,260,328,3128,86.94019539926795,56.36235305383688
20074,/media/marda/TWOTB1/xBD/hurricanes/images/florence/hurricane-florence_00000237_pre_disaster.png,88,80,1,690,778,289,369,2214,65.09219010636318,50.91369488651924
20075,/media/marda/TWOTB1/xBD/hurricanes/images/florence/hurricane-florence_00000237_pre_disaster.png,88,62,1,604,692,332,394,1260,69.94431222104838,28.462007593616715
20076,/media/marda/TWOTB1/xBD/hurricanes/images/florence/hurricane-florence_00000237_pre_disaster.png,59,50,1,672,731,345,395,588,39.503894765514126,19.8716444696772
20077,/media/marda/TWOTB1/xBD/hurricanes/images/florence/hurricane-florence_00000237_pre_disaster.png,66,48,1,631,697,379,427,665,45.00588749579401,19.728059964758252
20078,/media/marda/TWOTB1/xBD/hurricanes/images/florence/hurricane-florence_00000237_pre_disaster.png,48,33,1,702,750,379,412,204,20.272609009172445,13.474804027111611
20079,/media/marda/TWOTB1/xBD/hurricanes/images/florence/hurricane-florence_00000237_pre_disaster.png,87,75,1,639,726,398,473,1237,76.90296624488883,24.464726482315104
20080,/media/marda/TWOTB1/xBD/hurricanes/images/florence/hurricane-florence_00000237_pre_disaster.png,69,67,1,507,576,497,564,1021,53.57196190204251,25.42657288616278
20081,/media/marda/TWOTB1/xBD/hurricanes/images/florence/hurricane-florence_00000237_pre_disaster.png,85,77,1,446,531,535,612,1439,75.32568894200833,28.168485832799767
20082,/media/marda/TWOTB1/xBD/hurricanes/images/florence/hurricane-florence_00000237_pre_disaster.png,45,67,1,71,116,624,691,865,43.32136304952267,28.051271893258676
20083,/media/marda/TWOTB1/xBD/hurricanes/images/florence/hurricane-florence_00000237_pre_disaster.png,25,69,1,0,25,685,754,669,38.64692450114776,24.589194833468323
20084,/media/marda/TWOTB1/xBD/hurricanes/images/florence/hurricane-florence_00000237_pre_disaster.png,49,83,1,0,49,785,868,743,68.44798748812953,14.547374381466442
20085,/media/marda/TWOTB1/xBD/hurricanes/images/florence/hurricane-florence_00000237_pre_disaster.png,60,82,1,0,60,800,882,818,75.63348512086152,14.43652651882035
20086,/media/marda/TWOTB1/xBD/hurricanes/images/florence/hurricane-florence_00000237_pre_disaster.png,55,115,1,0,55,864,979,2563,75.8336344213999,49.402362358022515
20087,/media/marda/TWOTB1/xBD/hurricanes/images/florence/hurricane-florence_00000237_pre_disaster.png,124,124,1,146,270,918,1042,5651,105.47062118839374,75.2495371351466
20088,/media/marda/TWOTB1/xBD/hurricanes/images/florence/hurricane-florence_00000237_pre_disaster.png,89,112,1,28,117,929,1041,2821,85.40924356338512,47.16031221334982
20089,/media/marda/TWOTB1/xBD/hurricanes/images/florence/hurricane-florence_00000237_pre_disaster.png,77,61,1,930,1007,981,1042,508,42.54996313012096,15.825878033805983
20090,/media/marda/TWOTB1/xBD/hurricanes/images/florence/hurricane-florence_00000237_pre_disaster.png,55,61,1,100,155,983,1044,510,46.00547986387324,18.40823573176398
20091,/media/marda/TWOTB1/xBD/hurricanes/images/florence/hurricane-florence_00000391_pre_disaster.png,51,32,1,0,51,0,32,1188,57.53010350727673,28.98490882208456
20092,/media/marda/TWOTB1/xBD/hurricanes/images/florence/hurricane-florence_00000391_pre_disaster.png,55,15,1,894,949,16,31,157,19.012782211659925,11.097651595696597
20093,/media/marda/TWOTB1/xBD/hurricanes/images/florence/hurricane-florence_00000391_pre_disaster.png,64,16,1,980,1044,41,57,264,27.756054298342068,12.723952626784019
20094,/media/marda/TWOTB1/xBD/hurricanes/images/florence/hurricane-florence_00000391_pre_disaster.png,46,10,1,929,975,55,65,54,9.17755932939589,7.980263984369161
20095,/media/marda/TWOTB1/xBD/hurricanes/images/florence/hurricane-florence_00000391_pre_disaster.png,99,24,1,902,1001,77,101,707,69.77128101470873,13.391021678855898
20096,/media/marda/TWOTB1/xBD/hurricanes/images/florence/hurricane-florence_00000391_pre_disaster.png,41,25,1,373,414,102,127,413,28.58527332845612,19.051889014218713
20097,/media/marda/TWOTB1/xBD/hurricanes/images/florence/hurricane-florence_00000391_pre_disaster.png,43,48,1,366,409,147,195,919,48.62194834947007,25.263546316273857
20098,/media/marda/TWOTB1/xBD/hurricanes/images/florence/hurricane-florence_00000391_pre_disaster.png,25,19,1,154,179,149,168,200,22.720440546814444,11.662125936495036
20099,/media/marda/TWOTB1/xBD/hurricanes/images/florence/hurricane-florence_00000391_pre_disaster.png,46,40,1,170,216,197,237,933,37.49073858257521,33.28678090888529
20100,/media/marda/TWOTB1/xBD/hurricanes/images/florence/hurricane-florence_00000391_pre_disaster.png,60,46,1,903,963,205,251,583,39.92359852204616,19.514485738881252
20101,/media/marda/TWOTB1/xBD/hurricanes/images/florence/hurricane-florence_00000391_pre_disaster.png,86,56,1,941,1027,240,296,1683,47.957997114133214,46.302275632125976
20102,/media/marda/TWOTB1/xBD/hurricanes/images/florence/hurricane-florence_00000391_pre_disaster.png,26,29,1,23,49,250,279,284,22.528712819691226,16.80839567427387
20103,/media/marda/TWOTB1/xBD/hurricanes/images/florence/hurricane-florence_00000391_pre_disaster.png,47,39,1,64,111,264,303,848,46.75961049334514,24.09211539997797
20104,/media/marda/TWOTB1/xBD/hurricanes/images/florence/hurricane-florence_00000391_pre_disaster.png,49,46,1,547,596,274,320,762,38.54682838026782,26.32433641944191
20105,/media/marda/TWOTB1/xBD/hurricanes/images/florence/hurricane-florence_00000391_pre_disaster.png,65,47,1,398,463,303,350,1180,51.71174270700329,30.168630982102123
20106,/media/marda/TWOTB1/xBD/hurricanes/images/florence/hurricane-florence_00000391_pre_disaster.png,40,36,1,404,444,344,380,414,26.27272238599411,20.64222613178274
20107,/media/marda/TWOTB1/xBD/hurricanes/images/florence/hurricane-florence_00000391_pre_disaster.png,19,37,1,211,230,604,641,110,12.779681778337052,11.20649449062493
20108,/media/marda/TWOTB1/xBD/hurricanes/images/florence/hurricane-florence_00000391_pre_disaster.png,31,41,1,186,217,608,649,283,28.732063562682267,13.884856557811009
20109,/media/marda/TWOTB1/xBD/hurricanes/images/florence/hurricane-florence_00000130_post_disaster.png,31,64,1,17,48,924,988,499,27.975749224860234,23.664668707384497
20110,/media/marda/TWOTB1/xBD/hurricanes/images/florence/hurricane-florence_00000130_post_disaster.png,13,46,1,98,111,924,970,58,9.40637645035564,8.342860200143672
20111,/media/marda/TWOTB1/xBD/hurricanes/images/florence/hurricane-florence_00000130_post_disaster.png,33,71,1,50,83,940,1011,612,35.59927760187271,22.78375572924735
20112,/media/marda/TWOTB1/xBD/hurricanes/images/florence/hurricane-florence_00000133_pre_disaster.png,52,36,1,965,1017,587,623,125,15.916871156885575,10.541123876281125
20113,/media/marda/TWOTB1/xBD/hurricanes/images/florence/hurricane-florence_00000133_pre_disaster.png,80,70,1,964,1044,604,674,599,58.38734369311171,13.696616481530773
20114,/media/marda/TWOTB1/xBD/hurricanes/images/florence/hurricane-florence_00000481_pre_disaster.png,57,12,1,900,957,80,92,232,22.424120744536424,13.756224760264104
20115,/media/marda/TWOTB1/xBD/hurricanes/images/florence/hurricane-florence_00000481_pre_disaster.png,49,37,1,822,871,667,704,190,18.700431046635842,13.294542045482583
20116,/media/marda/TWOTB1/xBD/hurricanes/images/florence/hurricane-florence_00000481_pre_disaster.png,51,82,1,870,921,686,768,762,60.46095010706871,16.728325299374813
20117,/media/marda/TWOTB1/xBD/hurricanes/images/florence/hurricane-florence_00000481_pre_disaster.png,39,46,1,608,647,697,743,197,18.726577730784147,13.975006451370705
20118,/media/marda/TWOTB1/xBD/hurricanes/images/florence/hurricane-florence_00000481_pre_disaster.png,40,64,1,116,156,778,842,701,39.3970998254856,24.21481292442666
20119,/media/marda/TWOTB1/xBD/hurricanes/images/florence/hurricane-florence_00000481_pre_disaster.png,64,63,1,778,842,787,850,777,34.78275463957019,29.522752928862488
20120,/media/marda/TWOTB1/xBD/hurricanes/images/florence/hurricane-florence_00000481_pre_disaster.png,76,68,1,848,924,805,873,948,47.86305317423139,29.285128166631488
20121,/media/marda/TWOTB1/xBD/hurricanes/images/florence/hurricane-florence_00000481_pre_disaster.png,51,72,1,77,128,822,894,1050,49.7870214849915,27.981957647464803
20122,/media/marda/TWOTB1/xBD/hurricanes/images/florence/hurricane-florence_00000481_pre_disaster.png,33,57,1,408,441,825,882,379,28.42943655861544,17.888054875335797
20123,/media/marda/TWOTB1/xBD/hurricanes/images/florence/hurricane-florence_00000481_pre_disaster.png,39,62,1,285,324,837,899,601,30.821186364110066,26.045206390634817
20124,/media/marda/TWOTB1/xBD/hurricanes/images/florence/hurricane-florence_00000481_pre_disaster.png,61,67,1,360,421,858,925,1021,49.170226868977956,28.41352311780125
20125,/media/marda/TWOTB1/xBD/hurricanes/images/florence/hurricane-florence_00000481_pre_disaster.png,55,73,1,240,295,887,960,885,50.93966328196721,23.0814793893932
20126,/media/marda/TWOTB1/xBD/hurricanes/images/florence/hurricane-florence_00000481_pre_disaster.png,70,79,1,828,898,918,997,967,42.34953573648577,30.190044103226164
20127,/media/marda/TWOTB1/xBD/hurricanes/images/florence/hurricane-florence_00000481_pre_disaster.png,68,69,1,365,433,944,1013,669,64.91052394940425,13.63450427050168
20128,/media/marda/TWOTB1/xBD/hurricanes/images/florence/hurricane-florence_00000481_pre_disaster.png,55,75,1,34,89,952,1027,1154,57.19234749315347,27.0489229499216
20129,/media/marda/TWOTB1/xBD/hurricanes/images/florence/hurricane-florence_00000527_pre_disaster.png,63,58,1,479,542,48,106,1465,57.60346182059759,33.916881531724314
20130,/media/marda/TWOTB1/xBD/hurricanes/images/florence/hurricane-florence_00000527_pre_disaster.png,40,24,1,584,624,65,89,264,23.263404698113753,15.188355152768736
20131,/media/marda/TWOTB1/xBD/hurricanes/images/florence/hurricane-florence_00000527_pre_disaster.png,52,39,1,359,411,246,285,957,42.33928985926721,30.166150811297495
20132,/media/marda/TWOTB1/xBD/hurricanes/images/florence/hurricane-florence_00000527_pre_disaster.png,58,51,1,189,247,294,345,1522,55.24087966122968,36.278513534353856
20133,/media/marda/TWOTB1/xBD/hurricanes/images/florence/hurricane-florence_00000527_pre_disaster.png,44,57,1,434,478,316,373,1037,50.93586329051443,27.095023997693804
20134,/media/marda/TWOTB1/xBD/hurricanes/images/florence/hurricane-florence_00000527_pre_disaster.png,76,62,1,236,312,384,446,1982,67.05815066916155,43.96684967732098
20135,/media/marda/TWOTB1/xBD/hurricanes/images/florence/hurricane-florence_00000527_pre_disaster.png,21,29,1,206,227,405,434,130,14.072364061419032,12.429485911281288
20136,/media/marda/TWOTB1/xBD/hurricanes/images/florence/hurricane-florence_00000527_pre_disaster.png,100,76,1,605,705,693,769,2274,81.22287644890218,37.293254659276926
20137,/media/marda/TWOTB1/xBD/hurricanes/images/florence/hurricane-florence_00000527_pre_disaster.png,101,86,1,682,783,715,801,2545,68.78654264616654,51.57642727223731
20138,/media/marda/TWOTB1/xBD/hurricanes/images/florence/hurricane-florence_00000527_pre_disaster.png,86,70,1,790,876,814,884,898,63.63105803181584,19.641832277421976
20139,/media/marda/TWOTB1/xBD/hurricanes/images/florence/hurricane-florence_00000527_pre_disaster.png,55,47,1,814,869,878,925,261,24.902326538140503,13.908612663409208
20140,/media/marda/TWOTB1/xBD/hurricanes/images/florence/hurricane-florence_00000527_pre_disaster.png,67,67,1,823,890,894,961,917,39.12240273327905,31.254572609434934
20141,/media/marda/TWOTB1/xBD/hurricanes/images/florence/hurricane-florence_00000478_post_disaster.png,77,17,1,519,596,55,72,740,65.43615628873896,15.099430793000185
20142,/media/marda/TWOTB1/xBD/hurricanes/images/florence/hurricane-florence_00000478_post_disaster.png,53,18,1,586,639,229,247,202,35.459569605410564,7.669297200935851
20143,/media/marda/TWOTB1/xBD/hurricanes/images/florence/hurricane-florence_00000478_post_disaster.png,50,17,1,585,635,245,262,221,31.877219856790827,9.223150127334593
20144,/media/marda/TWOTB1/xBD/hurricanes/images/florence/hurricane-florence_00000478_post_disaster.png,53,17,1,579,632,258,275,219,36.072835020670716,8.105011587954603
20145,/media/marda/TWOTB1/xBD/hurricanes/images/florence/hurricane-florence_00000478_post_disaster.png,34,41,1,289,323,361,402,491,29.775475275103645,21.96617523766172
20146,/media/marda/TWOTB1/xBD/hurricanes/images/florence/hurricane-florence_00000478_post_disaster.png,23,27,1,235,258,365,392,119,13.464478805633526,11.936185168427915
20147,/media/marda/TWOTB1/xBD/hurricanes/images/florence/hurricane-florence_00000478_post_disaster.png,58,57,1,274,332,401,458,1280,47.275458876755366,36.67601544723694
20148,/media/marda/TWOTB1/xBD/hurricanes/images/florence/hurricane-florence_00000478_post_disaster.png,36,29,1,652,688,401,430,132,14.561702286111437,12.152421340498078
20149,/media/marda/TWOTB1/xBD/hurricanes/images/florence/hurricane-florence_00000478_post_disaster.png,23,31,1,144,167,403,434,162,20.60655766054585,10.516671834439189
20150,/media/marda/TWOTB1/xBD/hurricanes/images/florence/hurricane-florence_00000478_post_disaster.png,54,35,1,133,187,442,477,552,56.67673424365566,13.008699642297215
20151,/media/marda/TWOTB1/xBD/hurricanes/images/florence/hurricane-florence_00000478_post_disaster.png,39,32,1,404,443,449,481,212,24.00554188036055,11.855960176675897
20152,/media/marda/TWOTB1/xBD/hurricanes/images/florence/hurricane-florence_00000478_post_disaster.png,49,30,1,3,52,455,485,568,56.560203665949345,13.388633302718178
20153,/media/marda/TWOTB1/xBD/hurricanes/images/florence/hurricane-florence_00000478_post_disaster.png,36,33,1,456,492,457,490,208,20.559219304209073,13.545196482712358
20154,/media/marda/TWOTB1/xBD/hurricanes/images/florence/hurricane-florence_00000478_post_disaster.png,54,54,1,482,536,459,513,909,37.46263787458515,32.39322632248315
20155,/media/marda/TWOTB1/xBD/hurricanes/images/florence/hurricane-florence_00000478_post_disaster.png,43,50,1,405,448,465,515,586,33.81902828059649,23.138023010967718
20156,/media/marda/TWOTB1/xBD/hurricanes/images/florence/hurricane-florence_00000478_post_disaster.png,59,47,1,368,427,487,534,802,47.00115424566531,22.784407157959315
20157,/media/marda/TWOTB1/xBD/hurricanes/images/florence/hurricane-florence_00000478_post_disaster.png,66,56,1,450,516,511,567,977,49.40086485267948,26.925957758808835
20158,/media/marda/TWOTB1/xBD/hurricanes/images/florence/hurricane-florence_00000478_post_disaster.png,61,41,1,718,779,539,580,290,36.330454607589566,10.658405669075826
20159,/media/marda/TWOTB1/xBD/hurricanes/images/florence/hurricane-florence_00000478_post_disaster.png,53,39,1,22,75,544,583,810,61.268315921324344,18.44783596492096
20160,/media/marda/TWOTB1/xBD/hurricanes/images/florence/hurricane-florence_00000478_post_disaster.png,36,54,1,134,170,554,608,713,32.67627622127245,29.139996520842836
20161,/media/marda/TWOTB1/xBD/hurricanes/images/florence/hurricane-florence_00000478_post_disaster.png,51,50,1,626,677,569,619,448,29.633544095387098,20.098487652765847
20162,/media/marda/TWOTB1/xBD/hurricanes/images/florence/hurricane-florence_00000478_post_disaster.png,22,50,1,53,75,589,639,258,29.40979674433934,11.547353065442474
20163,/media/marda/TWOTB1/xBD/hurricanes/images/florence/hurricane-florence_00000478_post_disaster.png,20,34,1,228,248,593,627,70,11.289032502847839,8.40035168400414
20164,/media/marda/TWOTB1/xBD/hurricanes/images/florence/hurricane-florence_00000478_post_disaster.png,53,42,1,278,331,594,636,494,48.96359185968521,13.504307028405034
20165,/media/marda/TWOTB1/xBD/hurricanes/images/florence/hurricane-florence_00000478_post_disaster.png,28,42,1,178,206,597,639,287,23.7213022942947,15.999989629204928
20166,/media/marda/TWOTB1/xBD/hurricanes/images/florence/hurricane-florence_00000478_post_disaster.png,76,69,1,563,639,597,666,1392,50.66138865541508,38.00739350223961
20167,/media/marda/TWOTB1/xBD/hurricanes/images/florence/hurricane-florence_00000478_post_disaster.png,17,35,1,154,171,619,654,98,13.098624402236698,10.11724107068797
20168,/media/marda/TWOTB1/xBD/hurricanes/images/florence/hurricane-florence_00000478_post_disaster.png,55,71,1,690,745,782,853,586,43.93418768076866,17.824995052391564
20169,/media/marda/TWOTB1/xBD/hurricanes/images/florence/hurricane-florence_00000478_post_disaster.png,74,73,1,598,672,786,859,1169,50.208720015866746,30.832550340220777
20170,/media/marda/TWOTB1/xBD/hurricanes/images/florence/hurricane-florence_00000478_post_disaster.png,81,68,1,883,964,877,945,933,51.59929239796501,23.672892308643114
20171,/media/marda/TWOTB1/xBD/hurricanes/images/florence/hurricane-florence_00000478_post_disaster.png,55,55,1,928,983,905,960,209,17.079925155674907,16.382033643583192
20172,/media/marda/TWOTB1/xBD/hurricanes/images/florence/hurricane-florence_00000315_pre_disaster.png,82,56,1,872,954,185,241,1095,55.94150632892327,26.161543390730767
20173,/media/marda/TWOTB1/xBD/hurricanes/images/florence/hurricane-florence_00000315_pre_disaster.png,51,26,1,847,898,204,230,146,20.938392440589205,9.349570015678518
20174,/media/marda/TWOTB1/xBD/hurricanes/images/florence/hurricane-florence_00000315_pre_disaster.png,47,26,1,777,824,274,300,158,15.00888143811322,14.13787283058326
20175,/media/marda/TWOTB1/xBD/hurricanes/images/florence/hurricane-florence_00000412_post_disaster.png,76,36,1,593,669,63,99,1720,58.47109929602855,39.2491185986386
20176,/media/marda/TWOTB1/xBD/hurricanes/images/florence/hurricane-florence_00000412_post_disaster.png,141,120,1,750,891,72,192,5906,150.306329504877,61.763119787682186
20177,/media/marda/TWOTB1/xBD/hurricanes/images/florence/hurricane-florence_00000412_post_disaster.png,50,15,1,774,824,96,111,202,21.229101112679324,12.476878087419843
20178,/media/marda/TWOTB1/xBD/hurricanes/images/florence/hurricane-florence_00000412_post_disaster.png,58,21,1,151,209,113,134,611,59.095251300270405,14.625166969301263
20179,/media/marda/TWOTB1/xBD/hurricanes/images/florence/hurricane-florence_00000412_post_disaster.png,28,24,1,111,139,141,165,412,26.832181562605047,20.94706499001547
20180,/media/marda/TWOTB1/xBD/hurricanes/images/florence/hurricane-florence_00000412_post_disaster.png,60,51,1,984,1044,141,192,595,47.103822105841374,17.99360058375341
20181,/media/marda/TWOTB1/xBD/hurricanes/images/florence/hurricane-florence_00000412_post_disaster.png,42,22,1,557,599,180,202,366,25.409684993890842,19.175333763704657
20182,/media/marda/TWOTB1/xBD/hurricanes/images/florence/hurricane-florence_00000412_post_disaster.png,34,24,1,584,618,181,205,210,22.111774114412956,12.692207107124377
20183,/media/marda/TWOTB1/xBD/hurricanes/images/florence/hurricane-florence_00000412_post_disaster.png,65,46,1,591,656,191,237,928,43.06935662348948,28.418764967222398
20184,/media/marda/TWOTB1/xBD/hurricanes/images/florence/hurricane-florence_00000412_post_disaster.png,69,36,1,414,483,234,270,992,59.673340237959295,22.091049543142777
20185,/media/marda/TWOTB1/xBD/hurricanes/images/florence/hurricane-florence_00000412_post_disaster.png,75,60,1,699,774,236,296,1057,56.224679948224704,25.0834105894339
20186,/media/marda/TWOTB1/xBD/hurricanes/images/florence/hurricane-florence_00000412_post_disaster.png,61,32,1,781,842,250,282,371,33.75814176165816,14.59119604434635
20187,/media/marda/TWOTB1/xBD/hurricanes/images/florence/hurricane-florence_00000412_post_disaster.png,78,55,1,926,1004,284,339,996,46.8932782541371,28.36978610891182
20188,/media/marda/TWOTB1/xBD/hurricanes/images/florence/hurricane-florence_00000412_post_disaster.png,89,75,1,640,729,305,380,1832,66.17469512720258,37.135414731439006
20189,/media/marda/TWOTB1/xBD/hurricanes/images/florence/hurricane-florence_00000412_post_disaster.png,96,74,1,705,801,359,433,2090,67.11396598655892,42.611296565995225
20190,/media/marda/TWOTB1/xBD/hurricanes/images/florence/hurricane-florence_00000412_post_disaster.png,55,35,1,776,831,366,401,292,26.387051624360716,14.741467321708662
20191,/media/marda/TWOTB1/xBD/hurricanes/images/florence/hurricane-florence_00000412_post_disaster.png,67,56,1,603,670,373,429,939,47.34133942917081,26.66263434577822
20192,/media/marda/TWOTB1/xBD/hurricanes/images/florence/hurricane-florence_00000412_post_disaster.png,47,40,1,663,710,404,444,286,22.568194517040453,16.980705375679694
20193,/media/marda/TWOTB1/xBD/hurricanes/images/florence/hurricane-florence_00000412_post_disaster.png,62,60,1,567,629,420,480,776,46.6498121452306,22.205255624067018
20194,/media/marda/TWOTB1/xBD/hurricanes/images/florence/hurricane-florence_00000412_post_disaster.png,57,48,1,641,698,420,468,540,27.871356578288285,25.865968626092776
20195,/media/marda/TWOTB1/xBD/hurricanes/images/florence/hurricane-florence_00000412_post_disaster.png,45,37,1,676,721,420,457,199,23.840934515996647,10.994898313787964
20196,/media/marda/TWOTB1/xBD/hurricanes/images/florence/hurricane-florence_00000412_post_disaster.png,61,42,1,851,912,438,480,364,27.818107120910096,17.503325883799924
20197,/media/marda/TWOTB1/xBD/hurricanes/images/florence/hurricane-florence_00000412_post_disaster.png,56,53,1,525,581,454,507,662,33.98987624369182,26.001847913268115
20198,/media/marda/TWOTB1/xBD/hurricanes/images/florence/hurricane-florence_00000412_post_disaster.png,71,84,1,469,540,492,576,1514,67.02095656608195,33.3393697459246
20199,/media/marda/TWOTB1/xBD/hurricanes/images/florence/hurricane-florence_00000412_post_disaster.png,51,43,1,665,716,524,567,294,24.076579350248704,16.344053413574382
20200,/media/marda/TWOTB1/xBD/hurricanes/images/florence/hurricane-florence_00000412_post_disaster.png,51,56,1,517,568,530,586,537,34.355620688388015,21.660151542106295
20201,/media/marda/TWOTB1/xBD/hurricanes/images/florence/hurricane-florence_00000412_post_disaster.png,40,39,1,455,495,554,593,211,25.537133190712005,10.999105406395573
20202,/media/marda/TWOTB1/xBD/hurricanes/images/florence/hurricane-florence_00000412_post_disaster.png,41,43,1,442,483,572,615,319,21.505161959560464,19.5722146598581
20203,/media/marda/TWOTB1/xBD/hurricanes/images/florence/hurricane-florence_00000412_post_disaster.png,50,58,1,470,520,573,631,460,44.087274862946224,13.936295192893017
20204,/media/marda/TWOTB1/xBD/hurricanes/images/florence/hurricane-florence_00000412_post_disaster.png,57,68,1,402,459,598,666,925,39.91878575936641,31.078649047604603
20205,/media/marda/TWOTB1/xBD/hurricanes/images/florence/hurricane-florence_00000412_post_disaster.png,57,69,1,512,569,601,670,633,51.760506809849005,16.33460811728452
20206,/media/marda/TWOTB1/xBD/hurricanes/images/florence/hurricane-florence_00000412_post_disaster.png,53,60,1,572,625,643,703,467,42.77854396219483,14.501600631316567
20207,/media/marda/TWOTB1/xBD/hurricanes/images/florence/hurricane-florence_00000412_post_disaster.png,24,40,1,150,174,645,685,161,20.380310410052655,10.479514157887769
20208,/media/marda/TWOTB1/xBD/hurricanes/images/florence/hurricane-florence_00000412_post_disaster.png,60,75,1,334,394,650,725,1083,54.68205143261495,29.86743713681756
20209,/media/marda/TWOTB1/xBD/hurricanes/images/florence/hurricane-florence_00000412_post_disaster.png,48,53,1,442,490,663,716,454,29.820827646733225,20.316552151565176
20210,/media/marda/TWOTB1/xBD/hurricanes/images/florence/hurricane-florence_00000412_post_disaster.png,39,54,1,173,212,683,737,483,35.04802160273315,18.26547657182999
20211,/media/marda/TWOTB1/xBD/hurricanes/images/florence/hurricane-florence_00000412_post_disaster.png,20,38,1,156,176,684,722,129,13.901789374200392,12.353925132722512
20212,/media/marda/TWOTB1/xBD/hurricanes/images/florence/hurricane-florence_00000412_post_disaster.png,48,75,1,144,192,701,776,980,48.67087550474221,26.87254421717313
20213,/media/marda/TWOTB1/xBD/hurricanes/images/florence/hurricane-florence_00000412_post_disaster.png,42,52,1,400,442,704,756,316,24.338628066757938,17.206821394287292
20214,/media/marda/TWOTB1/xBD/hurricanes/images/florence/hurricane-florence_00000412_post_disaster.png,27,43,1,361,388,712,755,124,13.786389302006455,11.90034000699107
20215,/media/marda/TWOTB1/xBD/hurricanes/images/florence/hurricane-florence_00000412_post_disaster.png,36,61,1,56,92,719,780,639,32.318894618759735,26.12068734692469
20216,/media/marda/TWOTB1/xBD/hurricanes/images/florence/hurricane-florence_00000412_post_disaster.png,52,62,1,400,452,735,797,530,41.24130231652292,17.684487130045763
20217,/media/marda/TWOTB1/xBD/hurricanes/images/florence/hurricane-florence_00000412_post_disaster.png,19,46,1,39,58,736,782,172,16.740792030829112,13.759389068369783
20218,/media/marda/TWOTB1/xBD/hurricanes/images/florence/hurricane-florence_00000412_post_disaster.png,49,81,1,120,169,780,861,1264,51.71721609989442,34.84580154547946
20219,/media/marda/TWOTB1/xBD/hurricanes/images/florence/hurricane-florence_00000412_post_disaster.png,20,51,1,52,72,813,864,189,17.187776556295784,14.751689226499726
20220,/media/marda/TWOTB1/xBD/hurricanes/images/florence/hurricane-florence_00000412_post_disaster.png,53,87,1,55,108,819,906,1494,48.99498209041326,40.0959725799596
20221,/media/marda/TWOTB1/xBD/hurricanes/images/florence/hurricane-florence_00000412_post_disaster.png,17,46,1,43,60,825,871,119,15.056838058972607,10.97348602861071
20222,/media/marda/TWOTB1/xBD/hurricanes/images/florence/hurricane-florence_00000353_post_disaster.png,33,69,1,158,191,319,388,837,62.42556548902604,17.907095411802207
20223,/media/marda/TWOTB1/xBD/hurricanes/images/florence/hurricane-florence_00000353_post_disaster.png,34,62,1,216,250,335,397,725,54.33717882234208,17.834104437870607
20224,/media/marda/TWOTB1/xBD/hurricanes/images/florence/hurricane-florence_00000353_post_disaster.png,36,44,1,285,321,373,417,524,30.333966254938165,23.2955516596616
20225,/media/marda/TWOTB1/xBD/hurricanes/images/florence/hurricane-florence_00000353_post_disaster.png,21,29,1,118,139,399,428,137,17.766712212556534,10.381921350647772
20226,/media/marda/TWOTB1/xBD/hurricanes/images/florence/hurricane-florence_00000353_post_disaster.png,55,69,1,345,400,404,473,1378,55.05500438037005,34.07200435806242
20227,/media/marda/TWOTB1/xBD/hurricanes/images/florence/hurricane-florence_00000353_post_disaster.png,25,33,1,182,207,415,448,222,19.65841257217637,14.965106479008865
20228,/media/marda/TWOTB1/xBD/hurricanes/images/florence/hurricane-florence_00000353_post_disaster.png,116,94,1,732,848,415,509,5860,97.09966128308508,79.10577574786463
20229,/media/marda/TWOTB1/xBD/hurricanes/images/florence/hurricane-florence_00000353_post_disaster.png,33,43,1,218,251,416,459,479,26.478936137477906,23.911882105147427
20230,/media/marda/TWOTB1/xBD/hurricanes/images/florence/hurricane-florence_00000353_post_disaster.png,199,216,1,126,325,494,710,16817,194.2708731186312,170.93636929765708
20231,/media/marda/TWOTB1/xBD/hurricanes/images/florence/hurricane-florence_00000353_post_disaster.png,26,55,1,98,124,607,662,470,30.914789985100978,20.32093290855458
20232,/media/marda/TWOTB1/xBD/hurricanes/images/florence/hurricane-florence_00000353_post_disaster.png,92,80,1,461,553,646,726,2043,89.28133222365007,34.927608753261126
20233,/media/marda/TWOTB1/xBD/hurricanes/images/florence/hurricane-florence_00000353_post_disaster.png,57,77,1,616,673,720,797,1223,50.35170359925948,32.09721878322454
20234,/media/marda/TWOTB1/xBD/hurricanes/images/florence/hurricane-florence_00000024_post_disaster.png,59,43,1,621,680,40,83,946,45.46847243748545,29.250190793147926
20235,/media/marda/TWOTB1/xBD/hurricanes/images/florence/hurricane-florence_00000024_post_disaster.png,68,51,1,905,973,277,328,903,52.57200189567766,27.955638244261706
20236,/media/marda/TWOTB1/xBD/hurricanes/images/florence/hurricane-florence_00000024_post_disaster.png,63,52,1,721,784,300,352,1027,41.83009083656471,34.22848039117684
20237,/media/marda/TWOTB1/xBD/hurricanes/images/florence/hurricane-florence_00000024_post_disaster.png,66,37,1,782,848,308,345,724,37.64428828594994,26.292479008193155
20238,/media/marda/TWOTB1/xBD/hurricanes/images/florence/hurricane-florence_00000024_post_disaster.png,40,24,1,773,813,344,368,138,14.05059836167152,13.037378964587367
20239,/media/marda/TWOTB1/xBD/hurricanes/images/florence/hurricane-florence_00000024_post_disaster.png,52,28,1,960,1012,353,381,126,15.14081174597413,11.210640936836306
20240,/media/marda/TWOTB1/xBD/hurricanes/images/florence/hurricane-florence_00000024_post_disaster.png,62,55,1,710,772,392,447,1034,47.47926032334975,28.895511190089863
20241,/media/marda/TWOTB1/xBD/hurricanes/images/florence/hurricane-florence_00000024_post_disaster.png,53,39,1,788,841,394,433,373,25.233559153479487,19.78726551258566
20242,/media/marda/TWOTB1/xBD/hurricanes/images/florence/hurricane-florence_00000024_post_disaster.png,38,24,1,779,817,411,435,53,8.772461452899979,8.161906748191695
20243,/media/marda/TWOTB1/xBD/hurricanes/images/florence/hurricane-florence_00000024_post_disaster.png,85,58,1,852,937,462,520,1502,53.05593072418598,37.82151569397514
20244,/media/marda/TWOTB1/xBD/hurricanes/images/florence/hurricane-florence_00000024_post_disaster.png,57,57,1,696,753,486,543,825,41.748025803199006,26.151803031037478
20245,/media/marda/TWOTB1/xBD/hurricanes/images/florence/hurricane-florence_00000024_post_disaster.png,48,36,1,750,798,491,527,230,20.193635184081142,15.254640427554472
20246,/media/marda/TWOTB1/xBD/hurricanes/images/florence/hurricane-florence_00000024_post_disaster.png,48,41,1,783,831,494,535,303,23.72086978787783,17.073369571562395
20247,/media/marda/TWOTB1/xBD/hurricanes/images/florence/hurricane-florence_00000452_pre_disaster.png,45,7,1,845,890,0,7,87,14.385224916288328,7.997219152629088
20248,/media/marda/TWOTB1/xBD/hurricanes/images/florence/hurricane-florence_00000452_pre_disaster.png,68,25,1,976,1044,0,25,690,33.40239700949069,27.483741275358728
20249,/media/marda/TWOTB1/xBD/hurricanes/images/florence/hurricane-florence_00000452_pre_disaster.png,56,43,1,735,791,25,68,673,44.39683629150922,22.9397687797462
20250,/media/marda/TWOTB1/xBD/hurricanes/images/florence/hurricane-florence_00000452_pre_disaster.png,53,17,1,923,976,37,54,242,18.910408801890497,17.07192037556706
20251,/media/marda/TWOTB1/xBD/hurricanes/images/florence/hurricane-florence_00000452_pre_disaster.png,63,35,1,866,929,40,75,929,38.61898127896699,31.970286491067807
20252,/media/marda/TWOTB1/xBD/hurricanes/images/florence/hurricane-florence_00000452_pre_disaster.png,46,12,1,930,976,79,91,120,13.808210118138652,11.489125293076057
20253,/media/marda/TWOTB1/xBD/hurricanes/images/florence/hurricane-florence_00000452_pre_disaster.png,52,22,1,716,768,174,196,330,26.029393699380975,16.808301567003358
20254,/media/marda/TWOTB1/xBD/hurricanes/images/florence/hurricane-florence_00000452_pre_disaster.png,50,27,1,994,1044,283,310,167,21.11287672897634,10.676287116731192
20255,/media/marda/TWOTB1/xBD/hurricanes/images/florence/hurricane-florence_00000452_pre_disaster.png,80,40,1,931,1011,286,326,1026,45.27886357672811,30.212545204329267
20256,/media/marda/TWOTB1/xBD/hurricanes/images/florence/hurricane-florence_00000452_pre_disaster.png,61,57,1,458,519,506,563,660,49.55739879686972,22.936840265918285
20257,/media/marda/TWOTB1/xBD/hurricanes/images/florence/hurricane-florence_00000452_pre_disaster.png,38,38,1,430,468,567,605,248,21.559635407125292,15.41655455704928
20258,/media/marda/TWOTB1/xBD/hurricanes/images/florence/hurricane-florence_00000452_pre_disaster.png,62,61,1,501,563,583,644,1234,42.95701894016661,38.11124856790701
20259,/media/marda/TWOTB1/xBD/hurricanes/images/florence/hurricane-florence_00000452_pre_disaster.png,29,35,1,465,494,613,648,89,13.612357932426352,8.737471228999578
20260,/media/marda/TWOTB1/xBD/hurricanes/images/florence/hurricane-florence_00000452_pre_disaster.png,33,40,1,457,490,629,669,174,16.633760868279694,14.06243715111645
20261,/media/marda/TWOTB1/xBD/hurricanes/images/florence/hurricane-florence_00000452_pre_disaster.png,92,54,1,873,965,872,926,1219,67.01476223759244,24.24392606805315
20262,/media/marda/TWOTB1/xBD/hurricanes/images/florence/hurricane-florence_00000452_pre_disaster.png,59,56,1,985,1044,934,990,364,22.403186501778382,21.582521651697004
20263,/media/marda/TWOTB1/xBD/hurricanes/images/florence/hurricane-florence_00000452_pre_disaster.png,69,57,1,946,1015,949,1006,571,36.455111598639625,20.730353376592166
20264,/media/marda/TWOTB1/xBD/hurricanes/images/florence/hurricane-florence_00000035_pre_disaster.png,45,38,1,307,352,0,38,702,38.00676130160949,24.32353938437654
20265,/media/marda/TWOTB1/xBD/hurricanes/images/florence/hurricane-florence_00000035_pre_disaster.png,56,24,1,353,409,0,24,535,36.690159673787505,21.445388606911354
20266,/media/marda/TWOTB1/xBD/hurricanes/images/florence/hurricane-florence_00000035_pre_disaster.png,48,41,1,235,283,55,96,885,36.91220066059833,31.97291115624661
20267,/media/marda/TWOTB1/xBD/hurricanes/images/florence/hurricane-florence_00000035_pre_disaster.png,43,52,1,84,127,144,196,1197,43.61831530257718,36.49160323842477
20268,/media/marda/TWOTB1/xBD/hurricanes/images/florence/hurricane-florence_00000035_pre_disaster.png,19,26,1,64,83,174,200,244,20.421782065243523,15.96864361500116
20269,/media/marda/TWOTB1/xBD/hurricanes/images/florence/hurricane-florence_00000035_pre_disaster.png,67,34,1,649,716,183,217,1123,45.11528531458438,32.737702102547686
20270,/media/marda/TWOTB1/xBD/hurricanes/images/florence/hurricane-florence_00000035_pre_disaster.png,40,54,1,0,40,192,246,1463,49.476324901203746,38.79058101585181
20271,/media/marda/TWOTB1/xBD/hurricanes/images/florence/hurricane-florence_00000035_pre_disaster.png,27,32,1,54,81,241,273,461,30.017775616193962,20.140200964457904
20272,/media/marda/TWOTB1/xBD/hurricanes/images/florence/hurricane-florence_00000035_pre_disaster.png,38,26,1,398,436,275,301,202,22.306624358989108,12.126148096252713
20273,/media/marda/TWOTB1/xBD/hurricanes/images/florence/hurricane-florence_00000035_pre_disaster.png,43,36,1,344,387,276,312,480,29.667703709673486,21.486235799163335
20274,/media/marda/TWOTB1/xBD/hurricanes/images/florence/hurricane-florence_00000035_pre_disaster.png,46,33,1,645,691,282,315,246,26.43977854321564,12.461122501618707
20275,/media/marda/TWOTB1/xBD/hurricanes/images/florence/hurricane-florence_00000035_pre_disaster.png,45,34,1,268,313,319,353,553,35.632107484715625,20.162052790033776
20276,/media/marda/TWOTB1/xBD/hurricanes/images/florence/hurricane-florence_00000035_pre_disaster.png,41,32,1,300,341,364,396,236,32.06925365460787,9.817154850487672
20277,/media/marda/TWOTB1/xBD/hurricanes/images/florence/hurricane-florence_00000035_pre_disaster.png,34,48,1,78,112,368,416,705,33.93809822527196,27.29674066433491
20278,/media/marda/TWOTB1/xBD/hurricanes/images/florence/hurricane-florence_00000035_pre_disaster.png,25,34,1,264,289,368,402,175,23.80007142898815,9.79054249896508
20279,/media/marda/TWOTB1/xBD/hurricanes/images/florence/hurricane-florence_00000035_pre_disaster.png,36,45,1,535,571,733,778,136,16.453167331339735,11.116987110453698
20280,/media/marda/TWOTB1/xBD/hurricanes/images/florence/hurricane-florence_00000035_pre_disaster.png,40,44,1,577,617,734,778,280,20.310432364561105,18.337844509271566
20281,/media/marda/TWOTB1/xBD/hurricanes/images/florence/hurricane-florence_00000035_pre_disaster.png,68,62,1,522,590,744,806,596,57.520088132285146,13.68031782763849
20282,/media/marda/TWOTB1/xBD/hurricanes/images/florence/hurricane-florence_00000035_pre_disaster.png,22,59,1,0,22,908,967,335,22.27688535010855,19.799146502344723
20283,/media/marda/TWOTB1/xBD/hurricanes/images/florence/hurricane-florence_00000326_post_disaster.png,39,34,1,311,350,93,127,511,32.13670178271267,21.309133145121084
20284,/media/marda/TWOTB1/xBD/hurricanes/images/florence/hurricane-florence_00000326_post_disaster.png,53,42,1,325,378,123,165,885,37.025588270997495,31.8856905423981
20285,/media/marda/TWOTB1/xBD/hurricanes/images/florence/hurricane-florence_00000326_post_disaster.png,26,17,1,329,355,150,167,91,11.527930924778188,10.626228631595575
20286,/media/marda/TWOTB1/xBD/hurricanes/images/florence/hurricane-florence_00000326_post_disaster.png,49,38,1,370,419,184,222,651,33.62889723786087,25.35060437755053
20287,/media/marda/TWOTB1/xBD/hurricanes/images/florence/hurricane-florence_00000326_post_disaster.png,26,28,1,352,378,205,233,123,19.01651319068033,10.134782764310192
20288,/media/marda/TWOTB1/xBD/hurricanes/images/florence/hurricane-florence_00000326_post_disaster.png,70,48,1,402,472,227,275,1091,51.55556932427393,29.25123421157223
20289,/media/marda/TWOTB1/xBD/hurricanes/images/florence/hurricane-florence_00000326_post_disaster.png,60,31,1,869,929,293,324,314,25.371460202617488,16.56362995853363
20290,/media/marda/TWOTB1/xBD/hurricanes/images/florence/hurricane-florence_00000326_post_disaster.png,55,61,1,412,467,321,382,978,49.06054624986446,26.632781596869787
20291,/media/marda/TWOTB1/xBD/hurricanes/images/florence/hurricane-florence_00000326_post_disaster.png,78,60,1,820,898,324,384,937,53.54922421332648,23.355688772480192
20292,/media/marda/TWOTB1/xBD/hurricanes/images/florence/hurricane-florence_00000326_post_disaster.png,87,70,1,554,641,409,479,1725,61.092664445895835,41.308567485045515
20293,/media/marda/TWOTB1/xBD/hurricanes/images/florence/hurricane-florence_00000326_post_disaster.png,85,73,1,836,921,432,505,1551,56.89851280989489,38.83948987177406
20294,/media/marda/TWOTB1/xBD/hurricanes/images/florence/hurricane-florence_00000326_post_disaster.png,34,30,1,553,587,450,480,97,13.049149194797932,10.004275348645582
20295,/media/marda/TWOTB1/xBD/hurricanes/images/florence/hurricane-florence_00000326_post_disaster.png,68,63,1,627,695,480,543,933,49.9960696009676,24.92339483047166
20296,/media/marda/TWOTB1/xBD/hurricanes/images/florence/hurricane-florence_00000326_post_disaster.png,63,54,1,907,970,490,544,469,31.17595147098293,21.029881404150476
20297,/media/marda/TWOTB1/xBD/hurricanes/images/florence/hurricane-florence_00000326_post_disaster.png,85,70,1,864,949,499,569,1093,59.70086525149725,26.813151928296367
20298,/media/marda/TWOTB1/xBD/hurricanes/images/florence/hurricane-florence_00000326_post_disaster.png,51,40,1,955,1006,627,667,120,15.552063100009164,10.353743284435827
20299,/media/marda/TWOTB1/xBD/hurricanes/images/florence/hurricane-florence_00000326_post_disaster.png,72,79,1,500,572,634,713,1600,51.70671276609024,41.28941577359796
20300,/media/marda/TWOTB1/xBD/hurricanes/images/florence/hurricane-florence_00000326_post_disaster.png,58,55,1,784,842,651,706,320,36.86317878281075,11.621301294456273
20301,/media/marda/TWOTB1/xBD/hurricanes/images/florence/hurricane-florence_00000326_post_disaster.png,78,67,1,840,918,709,776,813,45.43507940678729,23.629462952320065
20302,/media/marda/TWOTB1/xBD/hurricanes/images/florence/hurricane-florence_00000326_post_disaster.png,64,60,1,677,741,713,773,723,40.35078031267041,23.78610720417541
20303,/media/marda/TWOTB1/xBD/hurricanes/images/florence/hurricane-florence_00000326_post_disaster.png,74,70,1,560,634,729,799,1393,53.096825891690834,35.691851110903805
20304,/media/marda/TWOTB1/xBD/hurricanes/images/florence/hurricane-florence_00000326_post_disaster.png,47,61,1,315,362,841,902,617,37.514387183165134,21.66174705116653
20305,/media/marda/TWOTB1/xBD/hurricanes/images/florence/hurricane-florence_00000539_pre_disaster.png,36,35,1,117,153,197,232,666,33.29378923966583,26.612645866190366
20306,/media/marda/TWOTB1/xBD/hurricanes/images/florence/hurricane-florence_00000539_pre_disaster.png,41,85,1,67,108,327,412,2055,81.1717839442037,33.63695657044747
20307,/media/marda/TWOTB1/xBD/hurricanes/images/florence/hurricane-florence_00000539_pre_disaster.png,52,45,1,977,1029,752,797,92,20.778605738655344,5.855701589054222
20308,/media/marda/TWOTB1/xBD/hurricanes/images/florence/hurricane-florence_00000539_pre_disaster.png,59,49,1,981,1040,828,877,159,18.59977583579088,11.490681452463015
20309,/media/marda/TWOTB1/xBD/hurricanes/images/florence/hurricane-florence_00000539_pre_disaster.png,95,112,1,865,960,838,950,1752,96.06731640569895,24.28513323743735
20310,/media/marda/TWOTB1/xBD/hurricanes/images/florence/hurricane-florence_00000539_pre_disaster.png,95,113,1,900,995,859,972,1720,96.57623071327761,23.689703130061897
20311,/media/marda/TWOTB1/xBD/hurricanes/images/florence/hurricane-florence_00000539_pre_disaster.png,98,112,1,937,1035,882,994,1722,95.6196460520707,23.93069917084656
20312,/media/marda/TWOTB1/xBD/hurricanes/images/florence/hurricane-florence_00000539_pre_disaster.png,72,102,1,972,1044,916,1018,1019,62.616047613875956,22.711341583805844
20313,/media/marda/TWOTB1/xBD/hurricanes/images/florence/hurricane-florence_00000493_pre_disaster.png,25,21,1,175,200,81,102,224,18.719979167721927,15.895642046878953
20314,/media/marda/TWOTB1/xBD/hurricanes/images/florence/hurricane-florence_00000493_pre_disaster.png,24,16,1,228,252,91,107,176,16.45987459847926,14.358392573447986
20315,/media/marda/TWOTB1/xBD/hurricanes/images/florence/hurricane-florence_00000493_pre_disaster.png,19,19,1,164,183,104,123,112,12.556668154913018,12.04841352713554
